Departement,Commune,Numero_Du_College,Total,Hors_Segpa_Hors_Ulis,Segpa,Ulis,Filles,Garcons,Niveau
CALVADOS,ARGENCES,0140072C,155,155,0,0,78,77,6 ème
CALVADOS,BAYEUX,0141860W,157,157,0,0,81,76,6 ème
CALVADOS,CABOURG,0141812U,54,54,0,0,19,35,6 ème
CALVADOS,CAEN,0140015R,102,95,0,7,46,56,6 ème
CALVADOS,CAEN,0140024A,123,119,0,4,58,65,6 ème
CALVADOS,CAEN,0141596J,115,112,0,3,58,57,6 ème
CALVADOS,CAEN,0141816Y,120,109,10,1,56,64,6 ème
CALVADOS,COURSEULLES-SUR-MER,0140041U,124,120,0,4,73,51,6 ème
CALVADOS,CREULLY SUR SEULLES,0140042V,94,90,0,4,47,47,6 ème
CALVADOS,DOUVRES-LA-DELIVRANDE,0141216W,177,168,9,0,75,102,6 ème
CALVADOS,EVRECY,0140051E,175,171,0,4,80,95,6 ème
CALVADOS,HEROUVILLE-SAINT-CLAIR,0141166S,55,55,0,0,24,31,6 ème
CALVADOS,LISIEUX,0141766U,151,144,0,7,81,70,6 ème
CALVADOS,ORBEC,0140073D,89,89,0,0,41,48,6 ème
CALVADOS,PONT-L'EVEQUE,0140075F,137,129,0,8,63,74,6 ème
CALVADOS,SAINT-MARTIN-DE-FONTENAY,0140068Y,168,168,0,0,90,78,6 ème
CALVADOS,VERSON,0140087U,176,173,0,3,79,97,6 ème
EURE,BERNAY,0271096V,123,121,0,2,64,59,6 ème
EURE,BERNAY,0271316J,73,62,11,0,36,37,6 ème
EURE,BROGLIE,0271122Y,47,47,0,0,27,20,6 ème
EURE,BUEIL,0271744Z,131,131,0,0,56,75,6 ème
EURE,EVREUX,0271449D,111,111,0,0,56,55,6 ème
EURE,GASNY,0271442W,147,143,0,4,60,87,6 ème
EURE,GISORS,0270026G,0,0,0,0,0,0,6 ème
EURE,LES ANDELYS,0270001E,103,103,0,0,38,65,6 ème
EURE,LE VAL D'HAZEY,0271482P,131,123,8,0,62,69,6 ème
EURE,LOUVIERS,0270029K,0,0,0,0,0,0,6 ème
EURE,LOUVIERS,0271336F,165,144,16,5,75,90,6 ème
EURE,LOUVIERS,0271634E,0,0,0,0,0,0,6 ème
EURE,MESNILS-SUR-ITON,0270014U,93,92,0,1,40,53,6 ème
EURE,PONT-AUDEMER,0271081D,0,0,0,0,0,0,6 ème
EURE,PONT-AUDEMER,0271450E,84,80,0,4,37,47,6 ème
EURE,ROMILLY-SUR-ANDELLE,0271533V,154,154,0,0,61,93,6 ème
EURE,VERNEUIL D'AVRE ET D'ITON,0271676A,4,4,0,0,3,1,6 ème
EURE,VERNON,0270052K,0,0,0,0,0,0,6 ème
EURE,VERNON,0271068P,86,86,0,0,39,47,6 ème
MANCHE,AGON-COUTAINVILLE,0500001E,72,72,0,0,31,41,6 ème
MANCHE,AVRANCHES,0500003G,91,90,0,1,42,49,6 ème
MANCHE,BRICQUEBEC-EN-COTENTIN,0500010P,122,108,11,3,56,66,6 ème
MANCHE,CARENTAN-LES-MARAIS,0500139E,122,117,0,5,68,54,6 ème
MANCHE,CERISY-LA-SALLE,0500014U,48,48,0,0,24,24,6 ème
MANCHE,CHERBOURG-EN-COTENTIN,0501205N,72,64,8,0,27,45,6 ème
MANCHE,CHERBOURG-EN-COTENTIN,0501216A,120,118,0,2,59,61,6 ème
MANCHE,CHERBOURG-EN-COTENTIN,0501482P,94,85,4,5,49,45,6 ème
MANCHE,CHERBOURG-EN-COTENTIN,0502008L,84,81,0,3,32,52,6 ème
MANCHE,GAVRAY-SUR-SIENNE,0500035S,46,45,0,1,24,22,6 ème
MANCHE,ISIGNY-LE-BUAT,0501830T,26,26,0,0,16,10,6 ème
MANCHE,LA HAYE,0501218C,49,45,0,4,23,26,6 ème
MANCHE,SAINT-HILAIRE-DU-HARCOUET,0500148P,47,47,0,0,22,25,6 ème
MANCHE,SAINT-JEAN-DE-DAYE,0501301T,54,54,0,0,25,29,6 ème
MANCHE,SAINT-LO,0501219D,0,0,0,0,0,0,6 ème
MANCHE,SAINT-PIERRE-EGLISE,0500122L,50,50,0,0,21,29,6 ème
MANCHE,SAINT-VAAST-LA-HOUGUE,0501300S,36,36,0,0,14,22,6 ème
MANCHE,TORIGNY-LES-VILLES,0500079P,150,148,0,2,87,63,6 ème
ORNE,ALENCON,0610056E,81,80,0,1,46,35,6 ème
ORNE,ARGENTAN,0611022E,85,69,15,1,37,48,6 ème
ORNE,ARGENTAN,0611023F,128,125,0,3,68,60,6 ème
ORNE,ARGENTAN,0611099N,48,48,0,0,22,26,6 ème
ORNE,DOMFRONT EN POIRAIE,0610696A,42,42,0,0,18,24,6 ème
ORNE,DOMFRONT EN POIRAIE,0610970Y,70,70,0,0,31,39,6 ème
ORNE,ECOUCHE-LES-VALLEES,0610016L,63,63,0,0,35,28,6 ème
ORNE,FLERS,0610698C,0,0,0,0,0,0,6 ème
ORNE,GIEL-COURTEILLES,0610724F,0,0,0,0,0,0,6 ème
ORNE,LA FERTE MACE,0610709P,77,77,0,0,34,43,6 ème
ORNE,L'AIGLE,0610691V,79,79,0,0,42,37,6 ème
ORNE,LE MELE-SUR-SARTHE,0610031C,82,81,0,1,46,36,6 ème
ORNE,LONGNY LES VILLAGES,0610739X,51,51,0,0,25,26,6 ème
ORNE,PUTANGES-LE-LAC,0610037J,41,41,0,0,25,16,6 ème
ORNE,SEES,0611095J,67,67,0,0,31,36,6 ème
SEINE MARITIME,AUMALE,0762107C,57,57,0,0,28,29,6 ème
SEINE MARITIME,BACQUEVILLE-EN-CAUX,0760004S,74,74,0,0,39,35,6 ème
SEINE MARITIME,BARENTIN,0760007V,0,0,0,0,0,0,6 ème
SEINE MARITIME,BARENTIN,0762286X,152,152,0,0,72,80,6 ème
SEINE MARITIME,BARENTIN,0762764S,153,136,14,3,71,82,6 ème
SEINE MARITIME,BOLBEC,0761701L,157,138,16,3,85,72,6 ème
SEINE MARITIME,BOLBEC,0761725M,97,97,0,0,48,49,6 ème
SEINE MARITIME,DIEPPE,0760024N,0,0,0,0,0,0,6 ème
SEINE MARITIME,DIEPPE,0762225F,124,123,0,1,55,69,6 ème
SEINE MARITIME,EU,0762170W,144,136,8,0,81,63,6 ème
SEINE MARITIME,FORGES-LES-EAUX,0762600N,0,0,0,0,0,0,6 ème
SEINE MARITIME,GRAND-COURONNE,0762836V,0,0,0,0,0,0,6 ème
SEINE MARITIME,LA FEUILLIE,0762177D,76,76,0,0,37,39,6 ème
SEINE MARITIME,LE GRAND-QUEVILLY,0760049R,112,107,0,5,59,53,6 ème
SEINE MARITIME,LE GRAND-QUEVILLY,0762093M,123,106,13,4,54,69,6 ème
SEINE MARITIME,LE HAVRE,0760062E,0,0,0,0,0,0,6 ème
SEINE MARITIME,LE HAVRE,0761328F,92,92,0,0,47,45,6 ème
SEINE MARITIME,LE HAVRE,0761699J,109,109,0,0,54,55,6 ème
SEINE MARITIME,LE HAVRE,0761781Y,102,88,11,3,51,51,6 ème
SEINE MARITIME,LE HAVRE,0762564Z,289,289,0,0,148,141,6 ème
SEINE MARITIME,LE HAVRE,0763500S,0,0,0,0,0,0,6 ème
SEINE MARITIME,LE HOULME,0761746K,150,150,0,0,65,85,6 ème
SEINE MARITIME,LE MESNIL-ESNARD,0762565A,172,172,0,0,87,85,6 ème
SEINE MARITIME,LILLEBONNE,0762289A,175,156,16,3,90,85,6 ème
SEINE MARITIME,RIVES-EN-SEINE,0762084C,129,129,0,0,71,58,6 ème
SEINE MARITIME,ROUEN,0761717D,61,61,0,0,25,36,6 ème
SEINE MARITIME,ROUEN,0762178E,120,120,0,0,61,59,6 ème
SEINE MARITIME,SAINT-ETIENNE-DU-ROUVRAY,0761647C,92,82,10,0,39,53,6 ème
SEINE MARITIME,SAINT-ETIENNE-DU-ROUVRAY,0762132E,68,68,0,0,35,33,6 ème
SEINE MARITIME,SOTTEVILLE-LES-ROUEN,0761691A,182,167,12,3,92,90,6 ème
SEINE MARITIME,TERRES-DE-CAUX,0760034Z,130,130,0,0,75,55,6 ème
SEINE MARITIME,YVETOT,0762880T,0,0,0,0,0,0,6 ème
DORDOGNE,ANNESSE-ET-BEAULIEU,0240997D,45,45,0,0,23,22,6 ème
DORDOGNE,BEAUMONTOIS EN PERIGORD,0240001W,56,56,0,0,24,32,6 ème
DORDOGNE,BERGERAC,0240094X,0,0,0,0,0,0,6 ème
DORDOGNE,BERGERAC,0240996C,129,123,0,6,62,67,6 ème
DORDOGNE,COULAURES,0240012H,0,0,0,0,0,0,6 ème
DORDOGNE,LA FORCE,0240053C,141,124,13,4,78,63,6 ème
DORDOGNE,LALINDE,0240158S,88,88,0,0,42,46,6 ème
DORDOGNE,MONTIGNAC,0240927C,99,99,0,0,46,53,6 ème
DORDOGNE,MUSSIDAN,0240961P,101,97,0,4,47,54,6 ème
DORDOGNE,NEUVIC,0240044T,87,86,0,1,36,51,6 ème
DORDOGNE,PERIGUEUX,0241043D,101,101,0,0,55,46,6 ème
DORDOGNE,SAINT-CYPRIEN,0240065R,76,76,0,0,34,42,6 ème
DORDOGNE,SARLAT-LA-CANEDA,0240121B,231,216,13,2,117,114,6 ème
DORDOGNE,TERRASSON-LAVILLEDIEU,0240037K,146,139,3,4,74,72,6 ème
DORDOGNE,THENON,0240066S,74,74,0,0,34,40,6 ème
GIRONDE,ARCACHON,0330167C,88,88,0,0,48,40,6 ème
GIRONDE,BEGLES,0331752A,147,138,0,9,58,89,6 ème
GIRONDE,BIGANOS,0330017P,137,132,0,5,76,61,6 ème
GIRONDE,BLAYE,0331511N,63,61,0,2,34,29,6 ème
GIRONDE,BLAYE,0332347X,179,166,6,7,80,99,6 ème
GIRONDE,BORDEAUX,0331462K,85,85,0,0,38,47,6 ème
GIRONDE,BORDEAUX,0331662C,195,192,0,3,89,106,6 ème
GIRONDE,BORDEAUX,0331663D,122,110,8,4,56,66,6 ème
GIRONDE,BORDEAUX,0332082J,97,97,0,0,53,44,6 ème
GIRONDE,BORDEAUX,0332491D,33,33,0,0,24,9,6 ème
GIRONDE,BORDEAUX,0332496J,0,0,0,0,0,0,6 ème
GIRONDE,BORDEAUX,0333531J,107,107,0,0,52,55,6 ème
GIRONDE,BOURG,0332341R,165,161,0,4,83,82,6 ème
GIRONDE,CARBON-BLANC,0333132A,165,163,0,2,84,81,6 ème
GIRONDE,CASTILLON-LA-BATAILLE,0330064R,100,96,0,4,50,50,6 ème
GIRONDE,CUDOS,0332327A,44,44,0,0,22,22,6 ème
GIRONDE,HOURTIN,0330081J,94,94,0,0,55,39,6 ème
GIRONDE,LANGON,0330082K,0,0,0,0,0,0,6 ème
GIRONDE,LANGON,0330083L,114,111,0,3,47,67,6 ème
GIRONDE,LIBOURNE,0330162X,77,75,0,2,35,42,6 ème
GIRONDE,MERIGNAC,0330145D,120,119,0,1,65,55,6 ème
GIRONDE,MERIGNAC,0331668J,0,0,0,0,0,0,6 ème
GIRONDE,MONSEGUR,0330100E,52,52,0,0,27,25,6 ème
GIRONDE,PAREMPUYRE,0332569N,149,149,0,0,79,70,6 ème
GIRONDE,PAUILLAC,0331644H,90,90,0,0,34,56,6 ème
GIRONDE,PESSAC,0331758G,178,174,0,4,84,94,6 ème
GIRONDE,PODENSAC,0330108N,153,144,9,0,75,78,6 ème
GIRONDE,SAINT-ANDRE-DE-CUBZAC,0331530J,159,155,0,4,78,81,6 ème
GIRONDE,SAINT-LOUBES,0332340P,273,273,0,0,119,154,6 ème
GIRONDE,SAINT-MEDARD-EN-JALLES,0330119A,0,0,0,0,0,0,6 ème
GIRONDE,TALENCE,0330128K,110,110,0,0,55,55,6 ème
LANDES,CAPBRETON,0400005N,118,113,5,0,53,65,6 ème
LANDES,DAX,0400729A,162,159,0,3,86,76,6 ème
LANDES,DAX,0401022U,150,145,0,5,68,82,6 ème
LANDES,GEAUNE,0400011V,59,59,0,0,24,35,6 ème
LANDES,MONT-DE-MARSAN,0400020E,0,0,0,0,0,0,6 ème
LANDES,MONT-DE-MARSAN,0400648M,148,143,0,5,63,85,6 ème
LANDES,MONTFORT-EN-CHALOSSE,0400023H,114,110,0,4,45,69,6 ème
LANDES,PARENTIS-EN-BORN,0400026L,174,158,12,4,83,91,6 ème
LANDES,RION-DES-LANDES,0400033U,60,60,0,0,26,34,6 ème
LANDES,SAINT-PAUL-LES-DAX,0401066S,106,105,0,1,47,59,6 ème
LANDES,SAINT-VINCENT-DE-TYROSSE,0400039A,119,119,0,0,48,71,6 ème
LANDES,SOUSTONS,0400728Z,144,140,0,4,68,76,6 ème
LANDES,TARNOS,0400091G,136,136,0,0,57,79,6 ème
LOT-ET-GARONNE,AGEN,0470777P,182,180,0,2,91,91,6 ème
LOT-ET-GARONNE,CASSENEUIL,0470011G,71,71,0,0,35,36,6 ème
LOT-ET-GARONNE,CLAIRAC,0470015L,0,0,0,0,0,0,6 ème
LOT-ET-GARONNE,LE MAS-D'AGENAIS,0470043S,113,107,0,6,62,51,6 ème
LOT-ET-GARONNE,LE PASSAGE,0470105J,222,205,12,5,98,124,6 ème
LOT-ET-GARONNE,MARMANDE,0470733S,169,168,0,1,80,89,6 ème
LOT-ET-GARONNE,NERAC,0470776N,110,110,0,0,55,55,6 ème
LOT-ET-GARONNE,NERAC,0471038Y,20,20,0,0,10,10,6 ème
LOT-ET-GARONNE,VILLENEUVE-SUR-LOT,0470038L,0,0,0,0,0,0,6 ème
PYRENEES-ATLANTIQUES,ANGLET,0640110X,112,109,0,3,53,59,6 ème
PYRENEES-ATLANTIQUES,BAYONNE,0640212H,187,177,9,1,93,94,6 ème
PYRENEES-ATLANTIQUES,BIARRITZ,0641414P,86,77,4,5,41,45,6 ème
PYRENEES-ATLANTIQUES,BIZANOS,0641413N,127,125,0,2,55,72,6 ème
PYRENEES-ATLANTIQUES,CAMBO-LES-BAINS,0641392R,97,91,4,2,43,54,6 ème
PYRENEES-ATLANTIQUES,GELOS,0640026F,0,0,0,0,0,0,6 ème
PYRENEES-ATLANTIQUES,LASSEUBE,0640036S,53,48,0,5,28,25,6 ème
PYRENEES-ATLANTIQUES,LESCAR,0640121J,71,71,0,0,28,43,6 ème
PYRENEES-ATLANTIQUES,LESTELLE-BETHARRAM,0641655B,52,46,6,0,20,32,6 ème
PYRENEES-ATLANTIQUES,MAULEON-LICHARRE,0641656C,21,21,0,0,10,11,6 ème
PYRENEES-ATLANTIQUES,MOURENX,0641561Z,75,66,5,4,40,35,6 ème
PYRENEES-ATLANTIQUES,ORTHEZ,0641659F,58,58,0,0,26,32,6 ème
PYRENEES-ATLANTIQUES,PAU,0640058R,0,0,0,0,0,0,6 ème
PYRENEES-ATLANTIQUES,PAU,0640189H,0,0,0,0,0,0,6 ème
PYRENEES-ATLANTIQUES,PAU,0640227Z,217,206,9,2,110,107,6 ème
PYRENEES-ATLANTIQUES,PAU,0640607M,191,186,0,5,87,104,6 ème
PYRENEES-ATLANTIQUES,PAU,0640608N,146,130,12,4,69,77,6 ème
PYRENEES-ATLANTIQUES,SAINT-JEAN-DE-LUZ,0640066Z,0,0,0,0,0,0,6 ème
PYRENEES-ATLANTIQUES,SAINT-JEAN-DE-LUZ,0640229B,88,77,8,3,50,38,6 ème
CORREZE,BRIVE-LA-GAILLARDE,0190059L,120,120,0,0,50,70,6 ème
CORREZE,BRIVE-LA-GAILLARDE,0190635M,92,83,8,1,49,43,6 ème
CORREZE,EGLETONS,0190019T,86,82,0,4,42,44,6 ème
CORREZE,MERLINES,0190023X,29,29,0,0,15,14,6 ème
CORREZE,MEYMAC,0190025Z,62,62,0,0,30,32,6 ème
CORREZE,OBJAT,0190717B,145,143,0,2,74,71,6 ème
CORREZE,TREIGNAC,0190632J,39,39,0,0,26,13,6 ème
CORREZE,TULLE,0190614P,132,129,0,3,55,77,6 ème
CORREZE,USSEL,0190782X,23,23,0,0,7,16,6 ème
CREUSE,AUBUSSON,0230506A,80,75,2,3,41,39,6 ème
CREUSE,BENEVENT-L'ABBAYE,0230005F,55,55,0,0,28,27,6 ème
CREUSE,BONNAT,0230006G,38,38,0,0,18,20,6 ème
CREUSE,FELLETIN,0230017U,51,51,0,0,27,24,6 ème
CREUSE,SAINT-VAURY,0230028F,60,60,0,0,36,24,6 ème
HAUTE-VIENNE,AMBAZAC,0870684W,161,161,0,0,76,85,6 ème
HAUTE-VIENNE,EYMOUTIERS,0870014T,45,45,0,0,26,19,6 ème
HAUTE-VIENNE,LIMOGES,0870022B,117,99,16,2,61,56,6 ème
HAUTE-VIENNE,LIMOGES,0870771R,182,161,16,5,74,108,6 ème
HAUTE-VIENNE,LIMOGES,0870816P,172,172,0,0,98,74,6 ème
HAUTE-VIENNE,LIMOGES,0870817R,115,112,0,3,64,51,6 ème
HAUTE-VIENNE,LIMOGES,0870865T,128,124,0,4,62,66,6 ème
HAUTE-VIENNE,NEXON,0870032M,87,87,0,0,36,51,6 ème
HAUTE-VIENNE,ROCHECHOUART,0870037T,74,74,0,0,40,34,6 ème
HAUTE-VIENNE,SAINT-MATHIEU,0870047D,43,43,0,0,24,19,6 ème
CHARENTE,AIGRE,0160001P,43,43,0,0,20,23,6 ème
CHARENTE,ANGOULEME,0160061E,149,149,0,0,80,69,6 ème
CHARENTE,ANGOULEME,0160113L,63,63,0,0,33,30,6 ème
CHARENTE,CHAMPAGNE-MOUTON,0160016F,34,34,0,0,21,13,6 ème
CHARENTE,JARNAC,0160075V,27,27,0,0,15,12,6 ème
CHARENTE,RUFFEC,0160077X,47,47,0,0,23,24,6 ème
CHARENTE,RUFFEC,0161003D,0,0,0,0,0,0,6 ème
CHARENTE-MARITIME,AYTRE,0171339N,111,109,0,2,49,62,6 ème
CHARENTE-MARITIME,COURCON,0170007R,183,181,0,2,89,94,6 ème
CHARENTE-MARITIME,LAGORD,0170970M,202,202,0,0,82,120,6 ème
CHARENTE-MARITIME,LA ROCHELLE,0171184V,201,197,0,4,113,88,6 ème
CHARENTE-MARITIME,LA ROCHELLE,0171238D,0,0,0,0,0,0,6 ème
CHARENTE-MARITIME,LA TREMBLADE,0170388E,144,144,0,0,72,72,6 ème
CHARENTE-MARITIME,LE CHATEAU-D'OLERON,0170005N,94,94,0,0,43,51,6 ème
CHARENTE-MARITIME,MONTLIEU-LA-GARDE,0170076R,67,67,0,0,33,34,6 ème
CHARENTE-MARITIME,ROCHEFORT,0170081W,102,82,14,6,47,55,6 ème
CHARENTE-MARITIME,ROYAN,0170384A,65,64,0,1,29,36,6 ème
DEUX-SEVRES,BRESSUIRE,0790091V,162,160,0,2,82,80,6 ème
DEUX-SEVRES,BRESSUIRE,0791029P,0,0,0,0,0,0,6 ème
DEUX-SEVRES,CELLES-SUR-BELLE,0790011H,149,149,0,0,75,74,6 ème
DEUX-SEVRES,CERIZAY,0790063P,69,69,0,0,36,33,6 ème
DEUX-SEVRES,MAUZE-SUR-LE-MIGNON,0790929F,91,91,0,0,56,35,6 ème
DEUX-SEVRES,MELLE,0790943W,122,104,15,3,53,69,6 ème
DEUX-SEVRES,MONCOUTANT-SUR-SEVRE,0790067U,87,87,0,0,39,48,6 ème
DEUX-SEVRES,NIORT,0791016A,133,132,0,1,62,71,6 ème
DEUX-SEVRES,PARTHENAY,0790030D,89,87,0,2,46,43,6 ème
DEUX-SEVRES,PARTHENAY,0791042D,99,96,0,3,50,49,6 ème
DEUX-SEVRES,SAINT-MAIXENT-L'ECOLE,0790031E,0,0,0,0,0,0,6 ème
VIENNE,CHATELLERAULT,0860752A,0,0,0,0,0,0,6 ème
VIENNE,CIVRAY,0860761K,42,42,0,0,22,20,6 ème
VIENNE,DANGE-SAINT-ROMAIN,0860763M,36,36,0,0,15,21,6 ème
VIENNE,JAUNAY-MARIGNY,0861038L,196,194,0,2,99,97,6 ème
VIENNE,LOUDUN,0860022G,0,0,0,0,0,0,6 ème
VIENNE,LUSIGNAN,0861053C,115,115,0,0,55,60,6 ème
VIENNE,MIGNALOUX-BEAUVOIR,0860793V,12,0,12,0,6,6,6 ème
VIENNE,POITIERS,0860037Y,0,0,0,0,0,0,6 ème
VIENNE,POITIERS,0860040B,108,108,0,0,51,57,6 ème
VIENNE,POITIERS,0860759H,99,99,0,0,52,47,6 ème
VIENNE,POITIERS,0861092V,109,107,0,2,54,55,6 ème
VIENNE,SAINT-BENOIT,0861073Z,153,136,14,3,69,84,6 ème
VIENNE,SAINT-JEAN-DE-SAUVES,0860045G,68,68,0,0,34,34,6 ème
VIENNE,VALENCE-EN-POITOU,0860014Y,65,65,0,0,37,28,6 ème
VIENNE,VIVONNE,0860047J,154,150,0,4,70,84,6 ème
AUDE,CARCASSONNE,0110007Y,0,0,0,0,0,0,6 ème
AUDE,CASTELNAUDARY,0110012D,0,0,0,0,0,0,6 ème
AUDE,CASTELNAUDARY,0110896P,46,46,0,0,27,19,6 ème
AUDE,LEZIGNAN-CORBIERES,0111034P,88,88,0,0,36,52,6 ème
AUDE,LEZIGNAN-CORBIERES,0111051H,124,108,16,0,47,77,6 ème
AUDE,NARBONNE,0110021N,190,164,17,9,91,99,6 ème
AUDE,NARBONNE,0110023R,0,0,0,0,0,0,6 ème
AUDE,NARBONNE,0110026U,163,149,14,0,76,87,6 ème
AUDE,RIEUX-MINERVOIS,0110667R,114,114,0,0,55,59,6 ème
AUDE,TREBES,0110674Y,99,97,0,2,49,50,6 ème
GARD,ARAMON,0301325C,137,135,0,2,67,70,6 ème
GARD,BAGNOLS-SUR-CEZE,0300055X,196,191,0,5,104,92,6 ème
GARD,BAGNOLS-SUR-CEZE,0300106C,0,0,0,0,0,0,6 ème
GARD,BAGNOLS-SUR-CEZE,0301327E,151,150,0,1,72,79,6 ème
GARD,BEAUCAIRE,0300089J,92,86,0,6,47,45,6 ème
GARD,BEAUCAIRE,0301208A,121,117,0,4,60,61,6 ème
GARD,NIMES,0300946R,112,111,0,1,49,63,6 ème
GARD,NIMES,0301010K,138,120,15,3,65,73,6 ème
GARD,NIMES,0301098F,127,114,13,0,58,69,6 ème
GARD,NIMES,0301210C,0,0,0,0,0,0,6 ème
GARD,QUISSAC,0300032X,106,106,0,0,46,60,6 ème
GARD,SAINT-AMBROIX,0300036B,106,104,0,2,57,49,6 ème
GARD,SAINT-GENIES-DE-MALGOIRES,0301670C,154,143,11,0,75,79,6 ème
GARD,SOMMIERES,0301232B,235,233,0,2,132,103,6 ème
GARD,UZES,0300047N,0,0,0,0,0,0,6 ème
GARD,VERGEZE,0300050S,192,175,16,1,95,97,6 ème
HERAULT,AGDE,0342080B,96,96,0,0,48,48,6 ème
HERAULT,BEDARIEUX,0340119V,178,172,2,4,83,95,6 ème
HERAULT,CAZOULS-LES-BEZIERS,0340021N,189,169,16,4,102,87,6 ème
HERAULT,CLERMONT-L'HERAULT,0340893L,131,131,0,0,66,65,6 ème
HERAULT,GIGNAC,0341386X,232,226,0,6,110,122,6 ème
HERAULT,MONTAGNAC,0340037F,71,69,0,2,29,42,6 ème
HERAULT,MONTPELLIER,0340042L,0,0,0,0,0,0,6 ème
HERAULT,MONTPELLIER,0340109J,146,144,0,2,82,64,6 ème
HERAULT,MONTPELLIER,0340833W,7,0,7,0,0,7,6 ème
HERAULT,MONTPELLIER,0340880X,128,128,0,0,61,67,6 ème
HERAULT,MONTPELLIER,0341278E,204,187,16,1,93,111,6 ème
HERAULT,MONTPELLIER,0342266D,30,22,0,8,13,17,6 ème
HERAULT,PEZENAS,0340837A,141,122,16,3,59,82,6 ème
HERAULT,SAINT-JEAN-DE-VEDAS,0341276C,207,204,0,3,108,99,6 ème
HERAULT,SAINT-PONS-DE-THOMIERES,0340069R,0,0,0,0,0,0,6 ème
HERAULT,SAINT-PONS-DE-THOMIERES,0340070S,66,59,7,0,30,36,6 ème
HERAULT,SERIGNAN,0341388Z,214,197,16,1,101,113,6 ème
HERAULT,SETE,0340115R,114,114,0,0,65,49,6 ème
LOZERE,FLORAC TROIS RIVIERES,0480003T,73,70,0,3,40,33,6 ème
LOZERE,LA CANOURGUE,0480006W,53,53,0,0,31,22,6 ème
LOZERE,LE COLLET-DE-DEZE,0480002S,11,11,0,0,5,6,6 ème
LOZERE,MENDE,0480607Z,163,144,13,6,76,87,6 ème
LOZERE,MEYRUEIS,0480011B,20,20,0,0,7,13,6 ème
LOZERE,MEYRUEIS,0480034B,13,13,0,0,4,9,6 ème
LOZERE,MONT LOZERE ET GOULET,0480001R,20,20,0,0,12,8,6 ème
PYRENEES-ORIENTALES,BOURG-MADAME,0660600U,79,74,5,0,48,31,6 ème
PYRENEES-ORIENTALES,CABESTANY,0660521H,219,202,14,3,126,93,6 ème
PYRENEES-ORIENTALES,CANET-EN-ROUSSILLON,0660648W,225,223,0,2,108,117,6 ème
PYRENEES-ORIENTALES,CERET,0660601V,207,192,13,2,98,109,6 ème
PYRENEES-ORIENTALES,LE SOLER,0660872P,65,65,0,0,32,33,6 ème
PYRENEES-ORIENTALES,PRADES,0660021P,0,0,0,0,0,0,6 ème
PYRENEES-ORIENTALES,RIVESALTES,0660037G,189,170,16,3,83,106,6 ème
PYRENEES-ORIENTALES,SAINT-CYPRIEN,0660846L,125,125,0,0,59,66,6 ème
ARIEGE,LAVELANET,0090006H,0,0,0,0,0,0,6 ème
ARIEGE,LAVELANET,0090490J,56,53,0,3,31,25,6 ème
ARIEGE,PAMIERS,0090037S,112,110,0,2,53,59,6 ème
ARIEGE,PAMIERS,0090481Z,11,0,11,0,2,9,6 ème
AVEYRON,AUBIN,0120096P,0,0,0,0,0,0,6 ème
AVEYRON,DECAZEVILLE,0120006S,0,0,0,0,0,0,6 ème
AVEYRON,RIGNAC,0120070L,48,48,0,0,27,21,6 ème
AVEYRON,RODEZ,0121133S,97,82,12,3,44,53,6 ème
AVEYRON,VILLEFRANCHE-DE-ROUERGUE,0121213D,141,135,0,6,62,79,6 ème
AVEYRON,VILLEFRANCHE-DE-ROUERGUE,0121260E,0,0,0,0,0,0,6 ème
GERS,AUCH,0320562M,119,112,7,0,63,56,6 ème
GERS,FLEURANCE,0320686X,30,30,0,0,15,15,6 ème
GERS,MASSEUBE,0320608M,56,56,0,0,29,27,6 ème
GERS,MIRANDE,0320035P,68,65,0,3,36,32,6 ème
GERS,NOGARO,0320025D,0,0,0,0,0,0,6 ème
GERS,RISCLE,0320029H,61,61,0,0,32,29,6 ème
GERS,VIC-FEZENSAC,0320033M,71,68,0,3,33,38,6 ème
HAUTE-GARONNE,AUCAMVILLE,0311632F,199,193,0,6,88,111,6 ème
HAUTE-GARONNE,AURIGNAC,0310003K,57,51,0,6,39,18,6 ème
HAUTE-GARONNE,BALMA,0311330C,198,188,7,3,94,104,6 ème
HAUTE-GARONNE,BEAUZELLE,0313078C,171,166,0,5,85,86,6 ème
HAUTE-GARONNE,CARAMAN,0311690U,141,128,13,0,69,72,6 ème
HAUTE-GARONNE,CASTANET-TOLOSAN,0311266H,190,190,0,0,102,88,6 ème
HAUTE-GARONNE,CAZERES,0310012V,147,144,0,3,73,74,6 ème
HAUTE-GARONNE,COLOMIERS,0311238C,142,139,0,3,82,60,6 ème
HAUTE-GARONNE,COLOMIERS,0311687R,142,138,0,4,76,66,6 ème
HAUTE-GARONNE,FONSORBES,0312338Y,170,167,0,3,76,94,6 ème
HAUTE-GARONNE,LEGUEVIN,0312337X,226,223,0,3,107,119,6 ème
HAUTE-GARONNE,MURET,0311240E,5,0,5,0,1,4,6 ème
HAUTE-GARONNE,NAILLOUX,0312699R,154,150,0,4,66,88,6 ème
HAUTE-GARONNE,NOE,0312868Z,219,216,0,3,112,107,6 ème
HAUTE-GARONNE,SAINT-GAUDENS,0310083X,120,105,13,2,54,66,6 ème
HAUTE-GARONNE,TOULOUSE,0310057U,0,0,0,0,0,0,6 ème
HAUTE-GARONNE,TOULOUSE,0310092G,191,191,0,0,99,92,6 ème
HAUTE-GARONNE,TOULOUSE,0311231V,99,96,0,3,49,50,6 ème
HAUTE-GARONNE,TOULOUSE,0311236A,211,211,0,0,101,110,6 ème
HAUTE-GARONNE,TOULOUSE,0311264F,101,99,0,2,53,48,6 ème
HAUTE-GARONNE,TOULOUSE,0311570N,43,43,0,0,20,23,6 ème
HAUTE-GARONNE,TOULOUSE,0311631E,191,189,0,2,103,88,6 ème
HAUTE-GARONNE,TOULOUSE,0311962P,221,221,0,0,103,118,6 ème
HAUTE-GARONNE,TOULOUSE,0312284P,12,12,0,0,4,8,6 ème
HAUTE-GARONNE,VERFEIL,0311335H,106,106,0,0,52,54,6 ème
HAUTES-PYRENEES,ARGELES-GAZOST,0650836F,96,96,0,0,35,61,6 ème
HAUTES-PYRENEES,AUREILHAN,0650028C,0,0,0,0,0,0,6 ème
HAUTES-PYRENEES,LOURDES,0650015N,96,85,6,5,51,45,6 ème
HAUTES-PYRENEES,LOURDES,0650877A,160,157,0,3,73,87,6 ème
HAUTES-PYRENEES,LOURES-BAROUSSE,0650017R,57,57,0,0,30,27,6 ème
HAUTES-PYRENEES,MAUBOURGUET,0650019T,54,46,0,8,31,23,6 ème
HAUTES-PYRENEES,TARBES,0650031F,129,127,0,2,59,70,6 ème
HAUTES-PYRENEES,TARBES,0650034J,131,117,14,0,60,71,6 ème
HAUTES-PYRENEES,TARBES,0650886K,0,0,0,0,0,0,6 ème
HAUTES-PYRENEES,TOURNAY,0650036L,74,70,0,4,36,38,6 ème
HAUTES-PYRENEES,VIC-EN-BIGORRE,0650035K,0,0,0,0,0,0,6 ème
LOT,BRETENOUX,0460573Y,71,71,0,0,38,33,6 ème
LOT,FIGEAC,0460032K,0,0,0,0,0,0,6 ème
LOT,FIGEAC,0460054J,132,119,10,3,65,67,6 ème
LOT,GRAMAT,0460046A,29,28,0,1,16,13,6 ème
LOT,LATRONQUIERE,0460018V,32,32,0,0,19,13,6 ème
LOT,SOUILLAC,0460594W,71,70,0,1,34,37,6 ème
TARN,ALBI,0811061N,117,112,0,5,69,48,6 ème
TARN,CASTRES,0810016C,0,0,0,0,0,0,6 ème
TARN,CASTRES,0810088F,48,48,0,0,16,32,6 ème
TARN,GRAULHET,0810125W,163,144,15,4,78,85,6 ème
TARN,LABRUGUIERE,0810089G,80,80,0,0,39,41,6 ème
TARN,LAUTREC,0810028R,52,52,0,0,23,29,6 ème
TARN,LAVAUR,0811032G,219,212,6,1,106,113,6 ème
TARN,MAZAMET,0810126X,115,99,16,0,51,64,6 ème
TARN,SAINT-SULPICE-LA-POINTE,0810041E,179,175,0,4,94,85,6 ème
TARN-ET-GARONNE,DIEUPENTALE,0820678S,50,50,0,0,17,33,6 ème
TARN-ET-GARONNE,MOISSAC,0820017Y,215,194,13,8,101,114,6 ème
TARN-ET-GARONNE,MONTAUBAN,0820754Z,161,154,7,0,75,86,6 ème
TARN-ET-GARONNE,MONTEILS,0820883P,0,0,0,0,0,0,6 ème
LOIRE-ATLANTIQUE,BASSE-GOULAINE,0442277L,138,138,0,0,68,70,6 ème
LOIRE-ATLANTIQUE,BOUGUENAIS,0440316E,170,154,16,0,84,86,6 ème
LOIRE-ATLANTIQUE,GORGES,0440107C,22,22,0,0,4,18,6 ème
LOIRE-ATLANTIQUE,GUERANDE,0442368K,75,75,0,0,26,49,6 ème
LOIRE-ATLANTIQUE,HERBIGNAC,0440015C,115,115,0,0,54,61,6 ème
LOIRE-ATLANTIQUE,HERBIGNAC,0440195Y,109,109,0,0,47,62,6 ème
LOIRE-ATLANTIQUE,LE LOROUX-BOTTEREAU,0440200D,192,187,0,5,92,100,6 ème
LOIRE-ATLANTIQUE,LE PELLERIN,0441658N,152,152,0,0,78,74,6 ème
LOIRE-ATLANTIQUE,LIGNE,0440199C,132,132,0,0,59,73,6 ème
LOIRE-ATLANTIQUE,MONTOIR-DE-BRETAGNE,0440539X,86,81,0,5,40,46,6 ème
LOIRE-ATLANTIQUE,NANTES,0440033X,0,0,0,0,0,0,6 ème
LOIRE-ATLANTIQUE,NANTES,0440049P,118,114,0,4,59,59,6 ème
LOIRE-ATLANTIQUE,NANTES,0440210P,69,69,0,0,30,39,6 ème
LOIRE-ATLANTIQUE,NANTES,0440219Z,33,33,0,0,11,22,6 ème
LOIRE-ATLANTIQUE,NANTES,0440246D,0,0,0,0,0,0,6 ème
LOIRE-ATLANTIQUE,NANTES,0440309X,74,74,0,0,41,33,6 ème
LOIRE-ATLANTIQUE,NANTES,0441545R,160,146,9,5,77,83,6 ème
LOIRE-ATLANTIQUE,NANTES,0441608J,87,69,12,6,36,51,6 ème
LOIRE-ATLANTIQUE,NANTES,0441938T,184,184,0,0,86,98,6 ème
LOIRE-ATLANTIQUE,NANTES,0442725Y,0,0,0,0,0,0,6 ème
LOIRE-ATLANTIQUE,NOZAY,0440223D,147,147,0,0,69,78,6 ème
LOIRE-ATLANTIQUE,ORVAULT,0440055W,184,184,0,0,96,88,6 ème
LOIRE-ATLANTIQUE,PAIMBOEUF,0441862K,97,85,12,0,39,58,6 ème
LOIRE-ATLANTIQUE,REZE,0440064F,134,134,0,0,70,64,6 ème
LOIRE-ATLANTIQUE,REZE,0440065G,171,171,0,0,84,87,6 ème
LOIRE-ATLANTIQUE,SAINT-BREVIN-LES-PINS,0440233P,110,107,0,3,55,55,6 ème
LOIRE-ATLANTIQUE,SAINT-PERE-EN-RETZ,0440238V,140,140,0,0,72,68,6 ème
LOIRE-ATLANTIQUE,THOUARE-SUR-LOIRE,0442417N,154,153,0,1,78,76,6 ème
LOIRE-ATLANTIQUE,TREILLIERES,0440209N,150,150,0,0,77,73,6 ème
LOIRE-ATLANTIQUE,TREILLIERES,0442418P,171,171,0,0,77,94,6 ème
LOIRE-ATLANTIQUE,VERTOU,0440080Y,132,127,0,5,69,63,6 ème
MAINE-ET-LOIRE,ANGERS,0490784L,0,0,0,0,0,0,6 ème
MAINE-ET-LOIRE,ANGERS,0490921K,153,153,0,0,64,89,6 ème
MAINE-ET-LOIRE,ANGERS,0491028B,116,116,0,0,56,60,6 ème
MAINE-ET-LOIRE,ANGERS,0491083L,175,175,0,0,83,92,6 ème
MAINE-ET-LOIRE,ANGERS,0491641T,87,87,0,0,31,56,6 ème
MAINE-ET-LOIRE,ANGERS,0492004M,239,227,7,5,121,118,6 ème
MAINE-ET-LOIRE,ANGERS,0492081W,140,140,0,0,63,77,6 ème
MAINE-ET-LOIRE,BEAUPREAU-EN-MAUGES,0490851J,205,203,0,2,97,108,6 ème
MAINE-ET-LOIRE,BELLEVIGNE-EN-LAYON,0490879P,110,110,0,0,62,48,6 ème
MAINE-ET-LOIRE,CHALONNES-SUR-LOIRE,0490955X,139,137,0,2,61,78,6 ème
MAINE-ET-LOIRE,CHEMILLE-EN-ANJOU,0490858S,179,173,0,6,94,85,6 ème
MAINE-ET-LOIRE,CHOLET,0491675E,84,69,15,0,50,34,6 ème
MAINE-ET-LOIRE,DOUE-EN-ANJOU,0490863X,116,116,0,0,45,71,6 ème
MAINE-ET-LOIRE,GENNES-VAL-DE-LOIRE,0491261E,107,107,0,0,51,56,6 ème
MAINE-ET-LOIRE,INGRANDES-LE FRESNE SUR LOIRE,0490026M,65,65,0,0,31,34,6 ème
MAINE-ET-LOIRE,LE LION-D'ANGERS,0490866A,98,97,0,1,59,39,6 ème
MAINE-ET-LOIRE,LES HAUTS-D'ANJOU,0490857R,117,117,0,0,68,49,6 ème
MAINE-ET-LOIRE,LES PONTS-DE-CE,0491923Z,112,112,0,0,47,65,6 ème
MAINE-ET-LOIRE,LYS-HAUT-LAYON,0490881S,83,83,0,0,45,38,6 ème
MAINE-ET-LOIRE,MAUGES-SUR-LOIRE,0490873H,112,112,0,0,46,66,6 ème
MAINE-ET-LOIRE,NOYANT-VILLAGES,0491766D,54,54,0,0,29,25,6 ème
MAINE-ET-LOIRE,OMBREE D'ANJOU,0490037Z,60,60,0,0,42,18,6 ème
MAINE-ET-LOIRE,OMBREE D'ANJOU,0490871F,75,75,0,0,34,41,6 ème
MAINE-ET-LOIRE,SAUMUR,0490055U,0,0,0,0,0,0,6 ème
MAINE-ET-LOIRE,SAUMUR,0490836T,72,68,0,4,38,34,6 ème
MAINE-ET-LOIRE,SAUMUR,0490839W,79,79,0,0,27,52,6 ème
MAINE-ET-LOIRE,SEVREMOINE,0490874J,70,70,0,0,35,35,6 ème
MAINE-ET-LOIRE,TRELAZE,0490048L,147,131,16,0,56,91,6 ème
MAINE-ET-LOIRE,VAL D'ERDRE-AUXENCE,0490029R,114,114,0,0,59,55,6 ème
MAINE-ET-LOIRE,VERRIERES-EN-ANJOU,0492140K,152,152,0,0,78,74,6 ème
MAYENNE,AMBRIERES-LES-VALLEES,0530001N,53,53,0,0,28,25,6 ème
MAYENNE,CHATEAU-GONTIER-SUR-MAYENNE,0530040F,0,0,0,0,0,0,6 ème
MAYENNE,ERNEE,0530770Z,125,123,0,2,72,53,6 ème
MAYENNE,GORRON,0530060C,28,28,0,0,9,19,6 ème
MAYENNE,LAVAL,0530484N,103,88,14,1,50,53,6 ème
SARTHE,ALLONNES,0720001K,131,116,10,5,67,64,6 ème
SARTHE,CHANGE,0721477P,89,89,0,0,45,44,6 ème
SARTHE,CONLIE,0720014Z,85,74,10,1,38,47,6 ème
SARTHE,CONNERRE,0720015A,142,142,0,0,79,63,6 ème
SARTHE,ECOMMOY,0721043T,130,130,0,0,60,70,6 ème
SARTHE,LA FLECHE,0720023J,132,103,29,0,62,70,6 ème
SARTHE,LE MANS,0720033V,0,0,0,0,0,0,6 ème
SARTHE,LE MANS,0720034W,0,0,0,0,0,0,6 ème
SARTHE,LE MANS,0720038A,51,51,0,0,30,21,6 ème
SARTHE,LE MANS,0720812S,196,196,0,0,103,93,6 ème
SARTHE,LE MANS,0720902P,113,95,16,2,51,62,6 ème
SARTHE,LE MANS,0720986F,132,114,15,3,49,83,6 ème
SARTHE,LE MANS,0721608G,0,0,0,0,0,0,6 ème
SARTHE,MAROLLES-LES-BRAULTS,0720043F,47,47,0,0,20,27,6 ème
SARTHE,SILLE-LE-GUILLAUME,0720817X,68,68,0,0,37,31,6 ème
SARTHE,TELOCHE,0721261E,196,194,0,2,85,111,6 ème
SARTHE,YVRE-L'EVEQUE,0721225R,90,86,0,4,52,38,6 ème
VENDEE,CHALLANS,0850142T,0,0,0,0,0,0,6 ème
VENDEE,CHALLANS,0850147Y,196,177,16,3,92,104,6 ème
VENDEE,CHALLANS,0851158X,312,300,9,3,161,151,6 ème
VENDEE,CHALLANS,0851698J,127,122,0,5,70,57,6 ème
VENDEE,FONTENAY-LE-COMTE,0850066K,135,135,0,0,72,63,6 ème
VENDEE,LA CHATAIGNERAIE,0850097U,104,104,0,0,48,56,6 ème
VENDEE,LA ROCHE-SUR-YON,0850027T,0,0,0,0,0,0,6 ème
VENDEE,LA ROCHE-SUR-YON,0851274Y,154,154,0,0,72,82,6 ème
VENDEE,LES ACHARDS,0851655M,136,136,0,0,77,59,6 ème
VENDEE,LES HERBIERS,0851400K,0,0,0,0,0,0,6 ème
VENDEE,LES SABLES-D'OLONNE,0850033Z,0,0,0,0,0,0,6 ème
VENDEE,LES SABLES-D'OLONNE,0850117R,170,164,5,1,97,73,6 ème
VENDEE,LUCON,0851290R,151,148,0,3,77,74,6 ème
VENDEE,MONTAIGU-VENDEE,0850104B,250,230,17,3,127,123,6 ème
VENDEE,MOUTIERS-LES-MAUXFAITS,0850107E,150,150,0,0,72,78,6 ème
VENDEE,MOUTIERS-LES-MAUXFAITS,0850641K,147,147,0,0,78,69,6 ème
VENDEE,NOIRMOUTIER-EN-L'ILE,0850109G,25,25,0,0,11,14,6 ème
VENDEE,PALLUAU,0850108F,114,114,0,0,54,60,6 ème
VENDEE,SAINT-JEAN-DE-MONTS,0850123X,71,71,0,0,40,31,6 ème
VENDEE,SAINT-MICHEL-EN-L'HERM,0851132U,77,77,0,0,35,42,6 ème
ALPES-DE-HTE-PROVENCE,ANNOT,0040001E,29,29,0,0,17,12,6 ème
ALPES-DE-HTE-PROVENCE,BANON,0040002F,39,39,0,0,12,27,6 ème
ALPES-DE-HTE-PROVENCE,CHATEAU-ARNOUX-SAINT-AUBAN,0040052K,183,179,0,4,87,96,6 ème
ALPES-DE-HTE-PROVENCE,DIGNE-LES-BAINS,0040007L,0,0,0,0,0,0,6 ème
ALPES-DE-HTE-PROVENCE,FORCALQUIER,0040382U,137,137,0,0,70,67,6 ème
ALPES-DE-HTE-PROVENCE,MANOSQUE,0040011R,0,0,0,0,0,0,6 ème
ALPES-DE-HTE-PROVENCE,MANOSQUE,0040462F,120,115,0,5,65,55,6 ème
ALPES-DE-HTE-PROVENCE,RIEZ,0040017X,87,87,0,0,43,44,6 ème
ALPES-DE-HTE-PROVENCE,SAINT-ANDRE-LES-ALPES,0040019Z,48,48,0,0,21,27,6 ème
BOUCHES-DU-RHONE,AIX-EN-PROVENCE,0132325G,83,80,0,3,44,39,6 ème
BOUCHES-DU-RHONE,AIX-EN-PROVENCE,0133395V,0,0,0,0,0,0,6 ème
BOUCHES-DU-RHONE,ARLES,0131322S,125,125,0,0,62,63,6 ème
BOUCHES-DU-RHONE,ARLES,0131610E,177,177,0,0,87,90,6 ème
BOUCHES-DU-RHONE,ARLES,0132572A,139,135,0,4,66,73,6 ème
BOUCHES-DU-RHONE,FUVEAU,0133243E,210,210,0,0,99,111,6 ème
BOUCHES-DU-RHONE,MARIGNANE,0130033R,0,0,0,0,0,0,6 ème
BOUCHES-DU-RHONE,MARSEILLE,0132204A,128,126,0,2,69,59,6 ème
BOUCHES-DU-RHONE,MARSEILLE,0130068D,0,0,0,0,0,0,6 ème
BOUCHES-DU-RHONE,MARSEILLE,0131379D,102,100,0,2,50,52,6 ème
BOUCHES-DU-RHONE,MARSEILLE,0131385K,90,90,0,0,49,41,6 ème
BOUCHES-DU-RHONE,MARSEILLE,0132401P,139,127,12,0,67,72,6 ème
BOUCHES-DU-RHONE,MARSEILLE,0132402R,210,210,0,0,102,108,6 ème
BOUCHES-DU-RHONE,MARSEILLE,0131756N,168,150,15,3,74,94,6 ème
BOUCHES-DU-RHONE,MARSEILLE,0133494C,30,30,0,0,15,15,6 ème
BOUCHES-DU-RHONE,MARSEILLE,0132312T,237,234,0,3,120,117,6 ème
BOUCHES-DU-RHONE,MARSEILLE,0133827P,14,14,0,0,10,4,6 ème
BOUCHES-DU-RHONE,MARSEILLE,0131604Y,136,135,0,1,72,64,6 ème
BOUCHES-DU-RHONE,MARSEILLE,0132114C,93,93,0,0,55,38,6 ème
BOUCHES-DU-RHONE,MARSEILLE,0132491M,143,115,24,4,68,75,6 ème
BOUCHES-DU-RHONE,MARSEILLE,0132956T,119,119,0,0,64,55,6 ème
BOUCHES-DU-RHONE,MARSEILLE,0133775H,72,71,0,1,40,32,6 ème
BOUCHES-DU-RHONE,MARSEILLE,0131372W,104,104,0,0,45,59,6 ème
BOUCHES-DU-RHONE,MARSEILLE,0131885D,165,165,0,0,83,82,6 ème
BOUCHES-DU-RHONE,MARSEILLE,0132785G,108,105,0,3,53,55,6 ème
BOUCHES-DU-RHONE,MARSEILLE,0131605Z,155,136,14,5,81,74,6 ème
BOUCHES-DU-RHONE,MARSEILLE,0131370U,50,50,0,0,22,28,6 ème
BOUCHES-DU-RHONE,MARSEILLE,0130055P,0,0,0,0,0,0,6 ème
BOUCHES-DU-RHONE,MARSEILLE,0132949K,127,127,0,0,63,64,6 ème
BOUCHES-DU-RHONE,MARSEILLE,0133445Z,7,7,0,0,0,7,6 ème
BOUCHES-DU-RHONE,MARSEILLE,0131943S,172,169,0,3,77,95,6 ème
BOUCHES-DU-RHONE,MARSEILLE,0132193N,0,0,0,0,0,0,6 ème
BOUCHES-DU-RHONE,MARSEILLE,0130062X,0,0,0,0,0,0,6 ème
BOUCHES-DU-RHONE,MARSEILLE,0132913W,187,187,0,0,87,100,6 ème
BOUCHES-DU-RHONE,MARSEILLE,0132914X,187,185,0,2,90,97,6 ème
BOUCHES-DU-RHONE,MARSEILLE,0132311S,112,110,0,2,67,45,6 ème
BOUCHES-DU-RHONE,MARTIGUES,0131707K,136,134,0,2,68,68,6 ème
BOUCHES-DU-RHONE,PLAN-DE-CUQUES,0133665N,160,160,0,0,88,72,6 ème
BOUCHES-DU-RHONE,PORT-DE-BOUC,0132322D,114,114,0,0,52,62,6 ème
BOUCHES-DU-RHONE,SAINT-ANDIOL,0133621R,159,157,0,2,72,87,6 ème
BOUCHES-DU-RHONE,SAINT-REMY-DE-PROVENCE,0132573B,156,144,12,0,68,88,6 ème
BOUCHES-DU-RHONE,SALON-DE-PROVENCE,0130163G,152,128,17,7,70,82,6 ème
BOUCHES-DU-RHONE,SALON-DE-PROVENCE,0131349W,133,127,0,6,61,72,6 ème
BOUCHES-DU-RHONE,VELAUX,0133353Z,191,191,0,0,93,98,6 ème
BOUCHES-DU-RHONE,VITROLLES,0133196D,144,141,0,3,65,79,6 ème
HAUTES-ALPES,GAP,0050008G,0,0,0,0,0,0,6 ème
HAUTES-ALPES,GAP,0050480V,189,167,17,5,99,90,6 ème
HAUTES-ALPES,L'ARGENTIERE-LA-BESSEE,0050409T,69,66,0,3,30,39,6 ème
HAUTES-ALPES,SERRES,0050520N,33,33,0,0,17,16,6 ème
HAUTES-ALPES,TALLARD,0050638S,97,97,0,0,45,52,6 ème
HAUTES-ALPES,VEYNES,0050022X,70,70,0,0,30,40,6 ème
VAUCLUSE,CARPENTRAS,0840761W,137,133,0,4,71,66,6 ème
VAUCLUSE,CARPENTRAS,0840851U,112,112,0,0,112,0,6 ème
VAUCLUSE,CAVAILLON,0840018N,139,110,24,5,68,71,6 ème
VAUCLUSE,CAVAILLON,0841086Z,120,120,0,0,53,67,6 ème
VAUCLUSE,LE PONTET,0840664R,194,175,14,5,101,93,6 ème
VAUCLUSE,L'ISLE-SUR-LA-SORGUE,0840585E,97,94,0,3,53,44,6 ème
VAUCLUSE,L'ISLE-SUR-LA-SORGUE,0841118J,133,133,0,0,53,80,6 ème
VAUCLUSE,MAZAN,0841043C,197,197,0,0,97,100,6 ème
VAUCLUSE,MONTEUX,0840698C,169,169,0,0,88,81,6 ème
VAUCLUSE,PERTUIS,0840069U,92,92,0,0,53,39,6 ème
VAUCLUSE,PERTUIS,0840926A,117,112,0,5,49,68,6 ème
VAUCLUSE,SORGUES,0840583C,183,166,17,0,80,103,6 ème
VAUCLUSE,SORGUES,0841078R,0,0,0,0,0,0,6 ème
VAUCLUSE,VEDENE,0840803S,151,151,0,0,74,77,6 ème
ALPES-MARITIMES,ANTIBES,0060795G,105,105,0,0,47,58,6 ème
ALPES-MARITIMES,BEAUSOLEIL,0061278G,149,149,0,0,67,82,6 ème
ALPES-MARITIMES,CANNES,0061174U,136,128,0,8,64,72,6 ème
ALPES-MARITIMES,CANNES,0061394H,0,0,0,0,0,0,6 ème
ALPES-MARITIMES,CANNES,0061457B,248,248,0,0,143,105,6 ème
ALPES-MARITIMES,CANNES,0061561P,0,0,0,0,0,0,6 ème
ALPES-MARITIMES,LA TRINITE,0060910G,164,164,0,0,79,85,6 ème
ALPES-MARITIMES,MANDELIEU-LA-NAPOULE,0061175V,150,150,0,0,73,77,6 ème
ALPES-MARITIMES,MANDELIEU-LA-NAPOULE,0061924J,150,146,0,4,83,67,6 ème
ALPES-MARITIMES,NICE,0060043P,0,0,0,0,0,0,6 ème
ALPES-MARITIMES,NICE,0060085K,148,148,0,0,81,67,6 ème
ALPES-MARITIMES,NICE,0060679F,116,116,0,0,58,58,6 ème
ALPES-MARITIMES,NICE,0060681H,69,69,0,0,33,36,6 ème
ALPES-MARITIMES,NICE,0060745C,93,86,0,7,56,37,6 ème
ALPES-MARITIMES,NICE,0060840F,207,182,16,9,104,103,6 ème
ALPES-MARITIMES,NICE,0061462G,0,0,0,0,0,0,6 ème
ALPES-MARITIMES,PEGOMAS,0062181N,131,131,0,0,57,74,6 ème
ALPES-MARITIMES,ROQUEBILLIERE,0061237M,51,47,4,0,26,25,6 ème
ALPES-MARITIMES,ROQUEFORT-LES-PINS,0062056C,164,164,0,0,84,80,6 ème
VAR,AUPS,0830002B,148,145,0,3,65,83,6 ème
VAR,BANDOL,0830003C,89,77,9,3,35,54,6 ème
VAR,BESSE-SUR-ISSOLE,0831630W,181,181,0,0,85,96,6 ème
VAR,BRIGNOLES,0830103L,193,191,0,2,101,92,6 ème
VAR,BRIGNOLES,0830734X,193,171,16,6,94,99,6 ème
VAR,CUERS,0831482K,59,59,0,0,21,38,6 ème
VAR,DRAGUIGNAN,0830929J,150,148,0,2,74,76,6 ème
VAR,DRAGUIGNAN,0830956N,199,183,16,0,90,109,6 ème
VAR,DRAGUIGNAN,0831306U,87,87,0,0,45,42,6 ème
VAR,GAREOULT,0831391L,181,181,0,0,81,100,6 ème
VAR,HYERES,0830145G,183,164,15,4,103,80,6 ème
VAR,LA SEYNE-SUR-MER,0831052T,169,169,0,0,81,88,6 ème
VAR,LA SEYNE-SUR-MER,0831196Z,157,150,7,0,75,82,6 ème
VAR,LORGUES,0830076G,130,122,0,8,69,61,6 ème
VAR,OLLIOULES,0831188R,210,200,0,10,100,110,6 ème
VAR,ROCBARON,0831645M,144,144,0,0,68,76,6 ème
VAR,SAINT-MANDRIER-SUR-MER,0830071B,48,48,0,0,23,25,6 ème
VAR,SAINT-ZACHARIE,0831657A,182,182,0,0,80,102,6 ème
VAR,SANARY-SUR-MER,0830178T,125,125,0,0,52,73,6 ème
VAR,TOULON,0830953K,174,171,0,3,89,85,6 ème
VAR,TOULON,0831197A,126,124,0,2,61,65,6 ème
VAR,TOULON,0831198B,117,117,0,0,65,52,6 ème
VAR,VINON-SUR-VERDON,0831552L,141,141,0,0,68,73,6 ème
ALLIER,BOURBON-L'ARCHAMBAULT,0030004N,74,69,0,5,33,41,6 ème
ALLIER,CERILLY,0030005P,31,31,0,0,15,16,6 ème
ALLIER,CUSSET,0030061A,0,0,0,0,0,0,6 ème
ALLIER,GANNAT,0030017C,92,91,0,1,39,53,6 ème
ALLIER,MONTLUCON,0030981A,70,70,0,0,28,42,6 ème
ALLIER,MOULINS,0030081X,74,71,0,3,34,40,6 ème
ALLIER,YZEURE,0030837U,157,153,0,4,73,84,6 ème
CANTAL,AURILLAC,0150008C,0,0,0,0,0,0,6 ème
CANTAL,AURILLAC,0150639N,97,95,0,2,48,49,6 ème
CANTAL,MAURIAC,0150061K,10,10,0,0,5,5,6 ème
CANTAL,PIERREFORT,0150024V,15,15,0,0,6,9,6 ème
CANTAL,RIOM-ES-MONTAGNES,0150062L,4,4,0,0,4,0,6 ème
CANTAL,VIC-SUR-CERE,0150033E,39,39,0,0,20,19,6 ème
HAUTE-LOIRE,BRIVES-CHARENSAC,0430917N,40,27,12,1,17,23,6 ème
HAUTE-LOIRE,ESPALY-SAINT-MARCEL,0430023S,0,0,0,0,0,0,6 ème
HAUTE-LOIRE,LANGEAC,0430013F,46,44,0,2,22,24,6 ème
HAUTE-LOIRE,LANGEAC,0430072V,29,29,0,0,21,8,6 ème
HAUTE-LOIRE,LE PUY-EN-VELAY,0430903Y,53,47,0,6,22,31,6 ème
HAUTE-LOIRE,MONISTROL-SUR-LOIRE,0430906B,217,204,13,0,97,120,6 ème
HAUTE-LOIRE,SAINTE-FLORINE,0430029Y,74,72,0,2,46,28,6 ème
HAUTE-LOIRE,SAINTE-FLORINE,0430085J,9,9,0,0,0,9,6 ème
HAUTE-LOIRE,YSSINGEAUX,0430953C,0,0,0,0,0,0,6 ème
PUY-DE-DOME,BEAUMONT,0630007R,127,126,0,1,64,63,6 ème
PUY-DE-DOME,CEYRAT,0630063B,135,131,0,4,72,63,6 ème
PUY-DE-DOME,CHATEL-GUYON,0630017B,119,119,0,0,57,62,6 ème
PUY-DE-DOME,CLERMONT-FERRAND,0631073Z,125,125,0,0,59,66,6 ème
PUY-DE-DOME,CLERMONT-FERRAND,0631120A,102,81,17,4,48,54,6 ème
PUY-DE-DOME,CLERMONT-FERRAND,0631126G,135,116,17,2,63,72,6 ème
PUY-DE-DOME,CLERMONT-FERRAND,0631522M,145,129,14,2,71,74,6 ème
PUY-DE-DOME,CLERMONT-FERRAND,0632091F,0,0,0,0,0,0,6 ème
PUY-DE-DOME,COURNON-D'AUVERGNE,0631688T,168,153,13,2,69,99,6 ème
PUY-DE-DOME,CUNLHAT,0630031S,19,19,0,0,10,9,6 ème
PUY-DE-DOME,GERZAT,0631161V,192,172,14,6,86,106,6 ème
PUY-DE-DOME,ISSOIRE,0631734T,111,111,0,0,46,65,6 ème
PUY-DE-DOME,LA TOUR-D'AUVERGNE,0630036X,17,17,0,0,5,12,6 ème
PUY-DE-DOME,LEMPDES,0631412T,175,154,10,11,83,92,6 ème
PUY-DE-DOME,LEZOUX,0631481T,181,176,0,5,93,88,6 ème
PUY-DE-DOME,MANZAT,0630038Z,44,44,0,0,19,25,6 ème
PUY-DE-DOME,OLLIERGUES,0630045G,23,23,0,0,10,13,6 ème
PUY-DE-DOME,ORCINES,0631100D,21,21,0,0,7,14,6 ème
PUY-DE-DOME,PONT-DU-CHATEAU,0630916D,122,122,0,0,65,57,6 ème
PUY-DE-DOME,PONT-DU-CHATEAU,0631480S,0,0,0,0,0,0,6 ème
PUY-DE-DOME,PUY-GUILLAUME,0630050M,83,83,0,0,48,35,6 ème
PUY-DE-DOME,RIOM,0631580A,129,127,0,2,65,64,6 ème
PUY-DE-DOME,ROMAGNAT,0630665F,0,0,0,0,0,0,6 ème
PUY-DE-DOME,SAINT-ELOY-LES-MINES,0630061Z,0,0,0,0,0,0,6 ème
PUY-DE-DOME,SAINT-ELOY-LES-MINES,0631109N,21,21,0,0,11,10,6 ème
PUY-DE-DOME,SAINT-SATURNIN,0631111R,61,59,0,2,27,34,6 ème
ARDECHE,BOURG-SAINT-ANDEOL,0070006U,140,129,7,4,58,82,6 ème
ARDECHE,LE POUZIN,0070019H,75,74,0,1,42,33,6 ème
ARDECHE,LE TEIL,0070864B,49,49,0,0,21,28,6 ème
ARDECHE,TOURNON-SUR-RHONE,0070848J,227,205,15,7,114,113,6 ème
DROME,BOURG-DE-PEAGE,0260090G,217,217,0,0,111,106,6 ème
DROME,CREST,0261092W,138,133,0,5,71,67,6 ème
DROME,DIE,0261093X,118,114,0,4,58,60,6 ème
DROME,MONTELIMAR,0260789S,150,129,14,7,81,69,6 ème
DROME,MONTELIMAR,0261088S,135,135,0,0,67,68,6 ème
DROME,ROMANS-SUR-ISERE,0260115J,134,119,13,2,68,66,6 ème
DROME,SAINT-VALLIER,0260032U,155,134,16,5,77,78,6 ème
DROME,SAINT-VALLIER,0261397C,0,0,0,0,0,0,6 ème
DROME,VALENCE,0260049M,111,109,0,2,44,67,6 ème
DROME,VALENCE,0260070K,136,136,0,0,60,76,6 ème
DROME,VALENCE,0260082Y,0,0,0,0,0,0,6 ème
DROME,VALENCE,0260978X,167,152,15,0,79,88,6 ème
HAUTE SAVOIE,ANNECY,0740062R,0,0,0,0,0,0,6 ème
HAUTE SAVOIE,ANNECY,0741096P,131,127,0,4,74,57,6 ème
HAUTE SAVOIE,BONS-EN-CHABLAIS,0740015P,189,187,0,2,86,103,6 ème
HAUTE SAVOIE,CLUSES,0740017S,0,0,0,0,0,0,6 ème
HAUTE SAVOIE,COLLONGES-SOUS-SALEVE,0741596H,25,25,0,0,11,14,6 ème
HAUTE SAVOIE,CRANVES-SALES,0741514U,233,230,0,3,116,117,6 ème
HAUTE SAVOIE,EVIAN-LES-BAINS,0740117A,66,66,0,0,35,31,6 ème
HAUTE SAVOIE,GROISY,0740025A,186,185,0,1,96,90,6 ème
HAUTE SAVOIE,LA ROCHE-SUR-FORON,0741279N,201,201,0,0,110,91,6 ème
HAUTE SAVOIE,MEGEVE,0740119C,63,63,0,0,32,31,6 ème
HAUTE SAVOIE,REIGNIER-ESERY,0740029E,254,248,0,6,124,130,6 ème
HAUTE SAVOIE,SAINT-JULIEN-EN-GENEVOIS,0741282S,142,140,0,2,75,67,6 ème
HAUTE SAVOIE,SAINT-JULIEN-EN-GENEVOIS,0741419R,150,147,0,3,74,76,6 ème
HAUTE SAVOIE,SAINT-PIERRE-EN-FAUCIGNY,0741665H,158,138,16,4,87,71,6 ème
HAUTE SAVOIE,SALLANCHES,0740039R,116,114,0,2,67,49,6 ème
HAUTE SAVOIE,SCIONZIER,0741139L,191,177,13,1,93,98,6 ème
ISERE,ALLEVARD,0380002W,127,127,0,0,60,67,6 ème
ISERE,ALLEVARD,0381741L,0,0,0,0,0,0,6 ème
ISERE,BOURGOIN-JALLIEU,0381687C,120,120,0,0,57,63,6 ème
ISERE,CHATTE,0383345E,113,113,0,0,54,59,6 ème
ISERE,CLAIX,0382107J,13,0,13,0,3,10,6 ème
ISERE,CLAIX,0382865H,103,101,0,2,45,58,6 ème
ISERE,CREMIEU,0382103E,196,192,0,4,94,102,6 ème
ISERE,ECHIROLLES,0382044R,96,96,0,0,47,49,6 ème
ISERE,GRENOBLE,0380036H,0,0,0,0,0,0,6 ème
ISERE,GRENOBLE,0381667F,150,150,0,0,60,90,6 ème
ISERE,GRENOBLE,0381776Z,140,140,0,0,69,71,6 ème
ISERE,GRENOBLE,0383243U,149,149,0,0,90,59,6 ème
ISERE,HEYRIEUX,0380038K,128,128,0,0,58,70,6 ème
ISERE,LA COTE-SAINT-ANDRE,0380014J,0,0,0,0,0,0,6 ème
ISERE,LA MOTTE-D'AVEILLANS,0380047V,47,47,0,0,28,19,6 ème
ISERE,LA TOUR-DU-PIN,0380073Y,0,0,0,0,0,0,6 ème
ISERE,LA VERPILLIERE,0382176J,143,143,0,0,71,72,6 ème
ISERE,LE GRAND-LEMPS,0380026X,162,162,0,0,85,77,6 ème
ISERE,LE PEAGE-DE-ROUSSILLON,0381733C,0,0,0,0,0,0,6 ème
ISERE,LE PEAGE-DE-ROUSSILLON,0382582A,163,163,0,0,71,92,6 ème
ISERE,LES ABRETS EN DAUPHINE,0380001V,200,194,0,6,109,91,6 ème
ISERE,L'ISLE-D'ABEAU,0383056R,134,129,0,5,66,68,6 ème
ISERE,MEYLAN,0382492C,69,69,0,0,35,34,6 ème
ISERE,PONTCHARRA,0381905P,157,149,8,0,73,84,6 ème
ISERE,PONT-EVEQUE,0382504R,124,123,0,1,65,59,6 ème
ISERE,ROUSSILLON,0381599G,0,0,0,0,0,0,6 ème
ISERE,SAINT-EGREVE,0380058G,182,182,0,0,93,89,6 ème
ISERE,SAINT-ISMIER,0382100B,164,164,0,0,78,86,6 ème
ISERE,SASSENAGE,0382098Z,179,177,0,2,91,88,6 ème
ISERE,SEYSSINET-PARISET,0380072X,92,89,0,3,47,45,6 ème
ISERE,SEYSSUEL,0382115T,240,225,11,4,117,123,6 ème
ISERE,VIENNE,0382583B,254,253,0,1,132,122,6 ème
ISERE,VILLARD-DE-LANS,0382429J,169,164,0,5,78,91,6 ème
ISERE,VOIRON,0382042N,163,159,0,4,80,83,6 ème
SAVOIE,AIX-LES-BAINS,0730853F,154,134,16,4,79,75,6 ème
SAVOIE,ALBERTVILLE,0731272L,79,75,0,4,39,40,6 ème
SAVOIE,CHAMBERY,0730776X,0,0,0,0,0,0,6 ème
SAVOIE,CHAMBERY,0730902J,159,157,0,2,88,71,6 ème
SAVOIE,LES ECHELLES,0730022C,70,66,0,4,34,36,6 ème
SAVOIE,MOUTIERS,0730796U,49,49,0,0,21,28,6 ème
SAVOIE,SAINT-ALBAN-LEYSSE,0730810J,126,113,11,2,66,60,6 ème
SAVOIE,UGINE,0730044B,89,89,0,0,56,33,6 ème
SAVOIE,VALGELON-LA ROCHETTE,0731114P,128,121,0,7,54,74,6 ème
SAVOIE,YENNE,0730045C,97,97,0,0,46,51,6 ème
AIN,BELLEY,0011010T,0,0,0,0,0,0,6 ème
AIN,BOURG-EN-BRESSE,0010018P,128,123,0,5,58,70,6 ème
AIN,BOURG-EN-BRESSE,0010080G,89,89,0,0,36,53,6 ème
AIN,BOURG-EN-BRESSE,0010974D,142,122,16,4,80,62,6 ème
AIN,BOURG-EN-BRESSE,0011118K,0,0,0,0,0,0,6 ème
AIN,BOURG-EN-BRESSE,0011275F,132,128,0,4,71,61,6 ème
AIN,CHATILLON-SUR-CHALARONNE,0010821M,145,142,0,3,72,73,6 ème
AIN,FEILLENS,0010086N,123,123,0,0,55,68,6 ème
AIN,LAGNIEU,0010026Y,196,196,0,0,94,102,6 ème
AIN,LEYMENT,0011300H,173,169,0,4,87,86,6 ème
AIN,MEXIMIEUX,0010041P,248,232,16,0,121,127,6 ème
AIN,MONTLUEL,0010796K,175,172,0,3,77,98,6 ème
AIN,PLATEAU D'HAUTEVILLE,0010025X,88,83,0,5,49,39,6 ème
AIN,REYRIEUX,0011338Z,160,160,0,0,75,85,6 ème
AIN,SAINT-ANDRE-DE-CORCY,0011257L,162,160,0,2,82,80,6 ème
AIN,TREVOUX,0010066S,187,183,0,4,90,97,6 ème
AIN,VALSERHONE,0010006B,0,0,0,0,0,0,6 ème
AIN,VONNAS,0010046V,108,104,0,4,56,52,6 ème
LOIRE,ANDREZIEUX-BOUTHEON,0421691K,0,0,0,0,0,0,6 ème
LOIRE,CHAZELLES-SUR-LYON,0420998G,0,0,0,0,0,0,6 ème
LOIRE,FEURS,0420012K,191,188,0,3,89,102,6 ème
LOIRE,FIRMINY,0421570D,89,80,6,3,43,46,6 ème
LOIRE,FIRMINY,0421659A,76,74,0,2,35,41,6 ème
LOIRE,FIRMINY,0421681Z,85,82,0,3,49,36,6 ème
LOIRE,LE CHAMBON-FEUGEROLLES,0421044G,57,57,0,0,35,22,6 ème
LOIRE,LE CHAMBON-FEUGEROLLES,0421919H,134,120,14,0,61,73,6 ème
LOIRE,PELUSSIN,0420024Y,121,121,0,0,58,63,6 ème
LOIRE,SAINT-CHAMOND,0421688G,101,97,0,4,42,59,6 ème
LOIRE,SAINT-ETIENNE,0421038A,64,64,0,0,29,35,6 ème
LOIRE,SAINT-ETIENNE,0421569C,128,126,0,2,65,63,6 ème
LOIRE,SAINT-ETIENNE,0421741P,137,135,0,2,56,81,6 ème
LOIRE,SAINT-ETIENNE,0421742R,0,0,0,0,0,0,6 ème
LOIRE,SURY-LE-COMTAL,0420985T,0,0,0,0,0,0,6 ème
RHONE,BELLEVILLE-EN-BEAUJOLAIS,0693734J,0,0,0,0,0,0,6 ème
RHONE,BELLEVILLE-EN-BEAUJOLAIS,0694279B,107,107,0,0,57,50,6 ème
RHONE,BRON,0691479H,114,113,0,1,58,56,6 ème
RHONE,CHAPONOST,0693365H,172,167,0,5,95,77,6 ème
RHONE,CHAZAY-D'AZERGUES,0692448L,156,153,0,3,81,75,6 ème
RHONE,CRAPONNE,0692422H,187,184,0,3,95,92,6 ème
RHONE,LAMURE-SUR-AZERGUES,0690022Z,83,81,0,2,34,49,6 ème
RHONE,LYON,0692334M,114,110,0,4,54,60,6 ème
RHONE,LYON,0694007F,150,146,0,4,63,87,6 ème
RHONE,LYON,0692937T,181,181,0,0,100,81,6 ème
RHONE,LYON,0691663H,142,140,0,2,76,66,6 ème
RHONE,LYON,0693137K,159,159,0,0,72,87,6 ème
RHONE,LYON,0694453R,194,187,0,7,90,104,6 ème
RHONE,LYON,0690060R,70,66,0,4,29,41,6 ème
RHONE,LYON,0691669P,159,155,0,4,77,82,6 ème
RHONE,LYON,0693406C,0,0,0,0,0,0,6 ème
RHONE,LYON,0694295U,110,110,0,0,56,54,6 ème
RHONE,LYON,0692703N,115,114,0,1,65,50,6 ème
RHONE,OULLINS,0690541N,152,152,0,0,70,82,6 ème
RHONE,OULLINS,0692924D,331,331,0,0,165,166,6 ème
RHONE,SAINTE-FOY-LES-LYON,0691484N,75,72,0,3,45,30,6 ème
RHONE,SAINT-MARTIN-EN-HAUT,0694092Y,86,86,0,0,41,45,6 ème
RHONE,SAINT-PRIEST,0692417C,162,158,0,4,81,81,6 ème
RHONE,SAINT-PRIEST,0694406P,149,138,8,3,62,87,6 ème
RHONE,TASSIN-LA-DEMI-LUNE,0692943Z,210,205,0,5,93,117,6 ème
RHONE,THIZY-LES-BOURGS,0690581G,43,43,0,0,27,16,6 ème
RHONE,VAL D'OINGT,0691674V,125,122,0,3,61,64,6 ème
RHONE,VAULX-EN-VELIN,0691666L,130,120,8,2,67,63,6 ème
RHONE,VENISSIEUX,0690093B,0,0,0,0,0,0,6 ème
RHONE,VENISSIEUX,0691799F,161,144,14,3,77,84,6 ème
RHONE,VENISSIEUX,0692418D,0,0,0,0,0,0,6 ème
RHONE,VILLEFRANCHE-SUR-SAONE,0690097F,0,0,0,0,0,0,6 ème
RHONE,VILLEFRANCHE-SUR-SAONE,0691645N,140,136,0,4,67,73,6 ème
RHONE,VILLEFRANCHE-SUR-SAONE,0692944A,282,279,0,3,151,131,6 ème
RHONE,VILLEURBANNE,0690599B,86,86,0,0,40,46,6 ème
RHONE,VILLEURBANNE,0692945B,205,205,0,0,102,103,6 ème
RHONE,VOURLES,0690624D,190,190,0,0,100,90,6 ème
DOUBS,BAUME-LES-DAMES,0250063H,0,0,0,0,0,0,6 ème
DOUBS,BESANCON,0250009Z,87,83,0,4,44,43,6 ème
DOUBS,BESANCON,0251371E,8,0,8,0,1,7,6 ème
DOUBS,BESANCON,0251587P,129,129,0,0,64,65,6 ème
DOUBS,BLAMONT,0250015F,45,45,0,0,16,29,6 ème
DOUBS,ETUPES,0251211F,155,149,0,6,71,84,6 ème
DOUBS,L'ISLE-SUR-LE-DOUBS,0250024R,91,89,0,2,42,49,6 ème
DOUBS,ORCHAMPS-VENNES,0251054K,80,80,0,0,38,42,6 ème
DOUBS,ORNANS,0251055L,78,78,0,0,40,38,6 ème
DOUBS,PIERREFONTAINE-LES-VARANS,0251315U,55,55,0,0,23,32,6 ème
DOUBS,PONT-DE-ROIDE-VERMONDANS,0250047R,146,142,0,4,66,80,6 ème
DOUBS,QUINGEY,0250049T,111,103,0,8,63,48,6 ème
DOUBS,SELONCOURT,0251397H,78,78,0,0,37,41,6 ème
HAUTE-SAONE,CHAMPAGNEY,0700895T,112,112,0,0,53,59,6 ème
HAUTE-SAONE,FAUCOGNEY-ET-LA-MER,0700005A,44,44,0,0,19,25,6 ème
HAUTE-SAONE,GRAY,0700060K,36,36,0,0,17,19,6 ème
HAUTE-SAONE,GRAY,0700904C,100,82,16,2,41,59,6 ème
HAUTE-SAONE,GY,0700061L,48,48,0,0,29,19,6 ème
HAUTE-SAONE,JUSSEY,0700016M,88,80,8,0,40,48,6 ème
HAUTE-SAONE,LURE,0700045U,197,183,11,3,104,93,6 ème
HAUTE-SAONE,LUXEUIL-LES-BAINS,0700056F,70,70,0,0,35,35,6 ème
HAUTE-SAONE,VAUVILLERS,0700035H,39,39,0,0,21,18,6 ème
JURA,ARBOIS,0390074U,14,14,0,0,7,7,6 ème
JURA,ARINTHOD,0390783P,71,71,0,0,31,40,6 ème
JURA,CHAUSSIN,0390922R,83,83,0,0,40,43,6 ème
JURA,LONS-LE-SAUNIER,0390022M,112,108,0,4,53,59,6 ème
JURA,NOZEROY,0390784R,61,61,0,0,25,36,6 ème
JURA,SAINT-AMOUR,0390785S,50,50,0,0,34,16,6 ème
JURA,SAINT-CLAUDE,0390924T,81,65,10,6,32,49,6 ème
TERRITOIRE DE BELFORT,BELFORT,0900017E,66,60,0,6,36,30,6 ème
TERRITOIRE DE BELFORT,CHEVREMONT,0900032W,47,47,0,0,23,24,6 ème
TERRITOIRE DE BELFORT,VALDOIE,0900014B,132,130,0,2,68,64,6 ème
COTE D'OR,AUXONNE,0210003P,0,0,0,0,0,0,6 ème
COTE D'OR,BEAUNE,0211229X,166,163,0,3,86,80,6 ème
COTE D'OR,BEAUNE,0211428N,21,0,21,0,10,11,6 ème
COTE D'OR,BLIGNY-SUR-OUCHE,0210011Y,35,35,0,0,15,20,6 ème
COTE D'OR,CHATILLON-SUR-SEINE,0210013A,0,0,0,0,0,0,6 ème
COTE D'OR,CHATILLON-SUR-SEINE,0211079J,26,26,0,0,9,17,6 ème
COTE D'OR,DIJON,0210018F,0,0,0,0,0,0,6 ème
COTE D'OR,DIJON,0211034K,140,137,0,3,75,65,6 ème
COTE D'OR,DIJON,0211071A,108,108,0,0,60,48,6 ème
COTE D'OR,DIJON,0211081L,123,123,0,0,60,63,6 ème
COTE D'OR,DIJON,0211136W,99,80,15,4,52,47,6 ème
COTE D'OR,DIJON,0211150L,109,96,13,0,49,60,6 ème
COTE D'OR,DIJON,0211162Z,104,81,16,7,43,61,6 ème
COTE D'OR,GENLIS,0211164B,138,130,0,8,61,77,6 ème
COTE D'OR,SAULIEU,0210046L,49,46,0,3,21,28,6 ème
COTE D'OR,SOMBERNON,0210051S,97,97,0,0,51,46,6 ème
COTE D'OR,VITTEAUX,0210053U,23,23,0,0,12,11,6 ème
NIEVRE,CORBIGNY,0580012Y,23,23,0,0,11,12,6 ème
NIEVRE,COSNE-COURS-SUR-LOIRE,0580669M,111,93,16,2,41,70,6 ème
NIEVRE,COSNE-COURS-SUR-LOIRE,0580746W,109,109,0,0,61,48,6 ème
NIEVRE,NEVERS,0580050P,0,0,0,0,0,0,6 ème
NIEVRE,NEVERS,0580599L,119,113,0,6,57,62,6 ème
NIEVRE,VARZY,0580042F,0,0,0,0,0,0,6 ème
SAONE-ET-LOIRE,AUTUN,0710115P,72,72,0,0,35,37,6 ème
SAONE-ET-LOIRE,CHALON-SUR-SAONE,0711348E,174,173,0,1,96,78,6 ème
SAONE-ET-LOIRE,CLUNY,0710024R,129,126,0,3,58,71,6 ème
SAONE-ET-LOIRE,CUISEAUX,0710033A,64,64,0,0,35,29,6 ème
SAONE-ET-LOIRE,EPINAC,0710037E,40,40,0,0,17,23,6 ème
SAONE-ET-LOIRE,LA CHAPELLE-DE-GUINCHAY,0711321A,115,115,0,0,60,55,6 ème
SAONE-ET-LOIRE,LE CREUSOT,0711069B,124,114,10,0,57,67,6 ème
SAONE-ET-LOIRE,MACON,0710080B,0,0,0,0,0,0,6 ème
SAONE-ET-LOIRE,MACON,0710534V,117,106,11,0,52,65,6 ème
SAONE-ET-LOIRE,MARCIGNY,0711071D,101,101,0,0,51,50,6 ème
SAONE-ET-LOIRE,MONTCEAU-LES-MINES,0710056A,94,75,16,3,47,47,6 ème
SAONE-ET-LOIRE,MONTCEAU-LES-MINES,0711777W,107,107,0,0,46,61,6 ème
SAONE-ET-LOIRE,MONTCENIS,0711323C,80,77,0,3,39,41,6 ème
SAONE-ET-LOIRE,PARAY-LE-MONIAL,0711755X,0,0,0,0,0,0,6 ème
SAONE-ET-LOIRE,SAINT-GERMAIN-DU-BOIS,0711146K,78,78,0,0,40,38,6 ème
SAONE-ET-LOIRE,SAINT-MARCEL,0711490J,145,131,14,0,69,76,6 ème
YONNE,AUXERRE,0890789Z,174,161,12,1,80,94,6 ème
YONNE,AUXERRE,0890819G,0,0,0,0,0,0,6 ème
YONNE,AVALLON,0890008A,0,0,0,0,0,0,6 ème
YONNE,COURSON-LES-CARRIERES,0890015H,75,75,0,0,39,36,6 ème
YONNE,JOIGNY,0890065M,108,108,0,0,54,54,6 ème
YONNE,JOIGNY,0890937K,111,106,0,5,48,63,6 ème
YONNE,JOIGNY,0891199V,0,0,0,0,0,0,6 ème
YONNE,MONTHOLON,0890788Y,111,111,0,0,48,63,6 ème
YONNE,SAINT-VALERIEN,0890028X,133,133,0,0,69,64,6 ème
YONNE,SENS,0891055N,171,171,0,0,88,83,6 ème
YONNE,SENS,0891093E,98,93,0,5,53,45,6 ème
YONNE,VILLENEUVE-LA-GUYARD,0891186F,124,124,0,0,62,62,6 ème
YONNE,VILLENEUVE-L'ARCHEVEQUE,0890038H,94,94,0,0,44,50,6 ème
COTES D'ARMOR,CREHEN,0221619R,95,95,0,0,40,55,6 ème
COTES D'ARMOR,EVRAN,0220140H,40,40,0,0,21,19,6 ème
COTES D'ARMOR,GUINGAMP,0220197V,129,124,0,5,63,66,6 ème
COTES D'ARMOR,GUINGAMP,0221698B,99,86,13,0,61,38,6 ème
COTES D'ARMOR,HILLION,0222030M,209,208,0,1,106,103,6 ème
COTES D'ARMOR,LAMBALLE-ARMOR,0221537B,153,133,18,2,78,75,6 ème
COTES D'ARMOR,MONCONTOUR,0221594N,97,97,0,0,50,47,6 ème
COTES D'ARMOR,PAIMPOL,0221991V,106,90,16,0,53,53,6 ème
COTES D'ARMOR,PERROS-GUIREC,0220167M,27,27,0,0,11,16,6 ème
COTES D'ARMOR,PERROS-GUIREC,0221029Z,102,102,0,0,56,46,6 ème
COTES D'ARMOR,PLEMET,0220153X,33,33,0,0,15,18,6 ème
COTES D'ARMOR,PLESIDY,0221877W,51,51,0,0,23,28,6 ème
COTES D'ARMOR,PLOUFRAGAN,0221621T,138,127,10,1,70,68,6 ème
COTES D'ARMOR,PLOUGUENAST-LANGAST,0220162G,32,32,0,0,10,22,6 ème
COTES D'ARMOR,SAINT-BRIEUC,0220054P,143,139,0,4,78,65,6 ème
COTES D'ARMOR,SAINT-BRIEUC,0220058U,0,0,0,0,0,0,6 ème
COTES D'ARMOR,SAINT-BRIEUC,0221513A,175,162,12,1,87,88,6 ème
COTES D'ARMOR,SAINT-BRIEUC,0221751J,79,79,0,0,40,39,6 ème
COTES D'ARMOR,TREGUIER,0220072J,0,0,0,0,0,0,6 ème
COTES D'ARMOR,TREGUIER,0220177Y,38,38,0,0,21,17,6 ème
FINISTERE,BREST,0290335G,0,0,0,0,0,0,6 ème
FINISTERE,BREST,0291824A,88,84,0,4,56,32,6 ème
FINISTERE,BREST,0291867X,179,160,16,3,94,85,6 ème
FINISTERE,CARANTEC,0290021R,59,59,0,0,20,39,6 ème
FINISTERE,CARHAIX-PLOUGUER,0291102R,119,104,12,3,57,62,6 ème
FINISTERE,CLEDER,0290253T,37,37,0,0,15,22,6 ème
FINISTERE,CONCARNEAU,0290030A,0,0,0,0,0,0,6 ème
FINISTERE,CONCARNEAU,0290132L,67,51,16,0,29,38,6 ème
FINISTERE,CONCARNEAU,0291873D,133,133,0,0,55,78,6 ème
FINISTERE,DAOULAS,0290033D,118,117,0,1,75,43,6 ème
FINISTERE,DOUARNENEZ,0291591X,152,137,12,3,83,69,6 ème
FINISTERE,FOUESNANT,0290262C,90,90,0,0,42,48,6 ème
FINISTERE,LANDERNEAU,0290184T,0,0,0,0,0,0,6 ème
FINISTERE,LANMEUR,0290047U,99,99,0,0,54,45,6 ème
FINISTERE,LANNILIS,0291639Z,85,85,0,0,49,36,6 ème
FINISTERE,LE RELECQ-KERHUON,0290308C,72,72,0,0,35,37,6 ème
FINISTERE,MORLAIX,0291085X,124,108,16,0,62,62,6 ème
FINISTERE,QUIMPER,0290068S,126,122,0,4,68,58,6 ème
FINISTERE,QUIMPER,0291087Z,124,105,16,3,63,61,6 ème
FINISTERE,QUIMPER,0291592Y,162,159,0,3,86,76,6 ème
FINISTERE,QUIMPER,0292204N,46,46,0,0,20,26,6 ème
FINISTERE,SAINT-POL-DE-LEON,0290207T,0,0,0,0,0,0,6 ème
FINISTERE,SAINT-RENAN,0290086L,130,130,0,0,62,68,6 ème
ILLE-ET-VILAINE,CESSON-SEVIGNE,0351906G,175,174,0,1,94,81,6 ème
ILLE-ET-VILAINE,CHATEAUBOURG,0350854N,145,144,0,1,80,65,6 ème
ILLE-ET-VILAINE,CHATEAUGIRON,0352248D,161,161,0,0,82,79,6 ème
ILLE-ET-VILAINE,DOL-DE-BRETAGNE,0350708E,129,110,19,0,57,72,6 ème
ILLE-ET-VILAINE,FOUGERES,0351997F,148,148,0,0,67,81,6 ème
ILLE-ET-VILAINE,LA GUERCHE-DE-BRETAGNE,0351799R,69,67,0,2,39,30,6 ème
ILLE-ET-VILAINE,MAEN ROCH,0350883V,120,118,0,2,58,62,6 ème
ILLE-ET-VILAINE,MONTAUBAN-DE-BRETAGNE,0350870F,100,100,0,0,40,60,6 ème
ILLE-ET-VILAINE,PACE,0352319F,263,263,0,0,123,140,6 ème
ILLE-ET-VILAINE,REDON,0351969A,105,102,0,3,51,54,6 ème
ILLE-ET-VILAINE,RENNES,0350759K,118,117,0,1,54,64,6 ème
ILLE-ET-VILAINE,RENNES,0350781J,146,145,0,1,81,65,6 ème
ILLE-ET-VILAINE,RENNES,0351878B,0,0,0,0,0,0,6 ème
ILLE-ET-VILAINE,RETIERS,0351882F,133,133,0,0,63,70,6 ème
ILLE-ET-VILAINE,VERN-SUR-SEICHE,0352541X,154,154,0,0,78,76,6 ème
ILLE-ET-VILAINE,VITRE,0350709F,0,0,0,0,0,0,6 ème
MORBIHAN,ALLAIRE,0561376S,120,120,0,0,63,57,6 ème
MORBIHAN,GOURIN,0561546B,58,51,7,0,27,31,6 ème
MORBIHAN,GUER,0560135T,86,86,0,0,39,47,6 ème
MORBIHAN,HENNEBONT,0560070X,0,0,0,0,0,0,6 ème
MORBIHAN,JOSSELIN,0560020T,50,43,7,0,23,27,6 ème
MORBIHAN,LANESTER,0560142A,108,108,0,0,59,49,6 ème
MORBIHAN,LE PALAIS,0560154N,21,21,0,0,6,15,6 ème
MORBIHAN,LORIENT,0560029C,139,139,0,0,79,60,6 ème
MORBIHAN,LORIENT,0560102G,145,135,10,0,60,85,6 ème
MORBIHAN,LORIENT,0562028A,145,136,0,9,56,89,6 ème
MORBIHAN,MAURON,0560032F,29,29,0,0,17,12,6 ème
MORBIHAN,PLOEMEUR,0560802T,98,95,0,3,43,55,6 ème
MORBIHAN,PONTIVY,0561332U,125,104,14,7,53,72,6 ème
MORBIHAN,PONTIVY,0561474Y,100,100,0,0,58,42,6 ème
MORBIHAN,PORT-LOUIS,0560042S,0,0,0,0,0,0,6 ème
MORBIHAN,QUESTEMBERT,0560044U,104,87,15,2,51,53,6 ème
MORBIHAN,RIANTEC,0561409C,148,143,0,5,65,83,6 ème
MORBIHAN,SAINT-AVE,0561840W,111,111,0,0,52,59,6 ème
MORBIHAN,SAINTE-ANNE-D'AURAY,0560119A,0,0,0,0,0,0,6 ème
MORBIHAN,SAINTE-ANNE-D'AURAY,0561545A,154,141,11,2,73,81,6 ème
MORBIHAN,SARZEAU,0560173J,40,40,0,0,21,19,6 ème
MORBIHAN,SENE,0561622J,120,110,0,10,56,64,6 ème
MORBIHAN,VANNES,0560050A,145,145,0,0,75,70,6 ème
CHER,BOURGES,0180008L,0,0,0,0,0,0,6 ème
CHER,BOURGES,0180009M,0,0,0,0,0,0,6 ème
CHER,BOURGES,0180673J,133,119,11,3,69,64,6 ème
CHER,NERONDES,0180023C,48,48,0,0,24,24,6 ème
CHER,NERONDES,0180567U,29,29,0,0,15,14,6 ème
CHER,SAINT-FLORENT-SUR-CHER,0180028H,155,150,5,0,79,76,6 ème
CHER,VIERZON,0180570X,71,66,5,0,36,35,6 ème
CHER,VIERZON,0180592W,153,137,14,2,72,81,6 ème
EURE-ET-LOIR,AUNEAU-BLEURY-SAINT-SYMPHORIEN,0280671C,64,64,0,0,27,37,6 ème
EURE-ET-LOIR,BROU,0280006E,99,95,0,4,52,47,6 ème
EURE-ET-LOIR,BROU,0280674F,43,43,0,0,27,16,6 ème
EURE-ET-LOIR,CHARTRES,0280663U,210,210,0,0,100,110,6 ème
EURE-ET-LOIR,CHARTRES,0280755U,182,181,0,1,90,92,6 ème
EURE-ET-LOIR,DREUX,0280687V,0,0,0,0,0,0,6 ème
EURE-ET-LOIR,DREUX,0280716B,140,129,11,0,64,76,6 ème
EURE-ET-LOIR,DREUX,0280994D,200,196,4,0,101,99,6 ème
EURE-ET-LOIR,DREUX,0281060A,151,149,0,2,76,75,6 ème
EURE-ET-LOIR,VERNOUILLET,0280753S,127,125,0,2,63,64,6 ème
INDRE,ARGENTON-SUR-CREUSE,0360718K,118,106,8,4,56,62,6 ème
INDRE,CHABRIS,0360044C,48,48,0,0,22,26,6 ème
INDRE,CHATEAUROUX,0360011S,0,0,0,0,0,0,6 ème
INDRE,CHATEAUROUX,0360048G,105,104,0,1,46,59,6 ème
INDRE,CHATEAUROUX,0360496U,100,97,0,3,53,47,6 ème
INDRE,CHATEAUROUX,0360541T,92,81,11,0,52,40,6 ème
INDRE,CHATILLON-SUR-INDRE,0360018Z,37,37,0,0,18,19,6 ème
INDRE,DEOLS,0360658V,110,99,8,3,51,59,6 ème
INDRE,ECUEILLE,0360022D,22,22,0,0,13,9,6 ème
INDRE,ISSOUDUN,0360721N,101,88,10,3,49,52,6 ème
INDRE,LA CHATRE,0360019A,0,0,0,0,0,0,6 ème
INDRE,LE BLANC,0360510J,40,40,0,0,20,20,6 ème
INDRE-ET-LOIRE,AMBOISE,0371122U,180,165,12,3,86,94,6 ème
INDRE-ET-LOIRE,AZAY-LE-RIDEAU,0371210P,183,168,9,6,99,84,6 ème
INDRE-ET-LOIRE,CHATEAU-RENAULT,0371211R,0,0,0,0,0,0,6 ème
INDRE-ET-LOIRE,CHINON,0371208M,19,19,0,0,11,8,6 ème
INDRE-ET-LOIRE,JOUE-LES-TOURS,0370071B,86,70,16,0,43,43,6 ème
INDRE-ET-LOIRE,LANGEAIS,0370885L,204,203,0,1,103,101,6 ème
INDRE-ET-LOIRE,NEUVY-LE-ROI,0370023Z,104,104,0,0,53,51,6 ème
INDRE-ET-LOIRE,RICHELIEU,0371191U,31,31,0,0,11,20,6 ème
INDRE-ET-LOIRE,SAINT-CYR-SUR-LOIRE,0371126Y,78,75,0,3,33,45,6 ème
INDRE-ET-LOIRE,SAINT-PIERRE-DES-CORPS,0370766G,58,58,0,0,30,28,6 ème
INDRE-ET-LOIRE,TOURS,0370044X,107,105,0,2,52,55,6 ème
INDRE-ET-LOIRE,TOURS,0370730T,73,73,0,0,35,38,6 ème
INDRE-ET-LOIRE,TOURS,0370764E,97,97,0,0,58,39,6 ème
INDRE-ET-LOIRE,TOURS,0370765F,115,111,0,4,60,55,6 ème
INDRE-ET-LOIRE,TOURS,0371209N,143,142,0,1,74,69,6 ème
INDRE-ET-LOIRE,TOURS,0371330V,115,115,0,0,51,64,6 ème
INDRE-ET-LOIRE,VOUVRAY,0370746K,42,42,0,0,13,29,6 ème
LOIRET,AMILLY,0451104F,0,0,0,0,0,0,6 ème
LOIRET,ARTENAY,0450003J,128,128,0,0,66,62,6 ème
LOIRET,BAZOCHES-LES-GALLERANDES,0450004K,94,92,0,2,50,44,6 ème
LOIRET,BEAUGENCY,0450479B,20,20,0,0,9,11,6 ème
LOIRET,CHATEAUNEUF-SUR-LOIRE,0450783G,172,170,0,2,77,95,6 ème
LOIRET,CHATILLON-SUR-LOIRE,0450017Z,61,59,0,2,21,40,6 ème
LOIRET,DADONVILLE,0451787Y,124,121,1,2,64,60,6 ème
LOIRET,GIEN,0451450G,96,95,0,1,45,51,6 ème
LOIRET,LA FERTE-SAINT-AUBIN,0450023F,162,157,0,5,80,82,6 ème
LOIRET,LE MALESHERBOIS,0450787L,141,140,0,1,67,74,6 ème
LOIRET,LORRIS,0450034T,97,94,0,3,49,48,6 ème
LOIRET,MONTARGIS,0451330B,44,44,0,0,17,27,6 ème
LOIRET,NEUVILLE-AUX-BOIS,0450045E,150,137,9,4,64,86,6 ème
LOIRET,OLIVET,0451304Y,0,0,0,0,0,0,6 ème
LOIRET,ORLEANS,0450049J,0,0,0,0,0,0,6 ème
LOIRET,ORLEANS,0450053N,133,131,0,2,73,60,6 ème
LOIRET,ORLEANS,0450055R,131,122,7,2,60,71,6 ème
LOIRET,ORLEANS,0450782F,0,0,0,0,0,0,6 ème
LOIRET,ORLEANS,0450785J,132,130,0,2,57,75,6 ème
LOIRET,ORLEANS,0451329A,157,157,0,0,83,74,6 ème
LOIRET,SAINT-AY,0451719Z,119,114,0,5,57,62,6 ème
LOIRET,SAINT-BENOIT-SUR-LOIRE,0450123P,57,57,0,0,31,26,6 ème
LOIRET,SAINT-JEAN-DE-BRAYE,0450839T,128,128,0,0,63,65,6 ème
LOIRET,TRAINOU,0451443Z,198,196,0,2,93,105,6 ème
LOIRET,VILLEMANDEUR,0451665R,147,145,0,2,81,66,6 ème
LOIR-ET-CHER,BLOIS,0410621C,47,47,0,0,26,21,6 ème
LOIR-ET-CHER,BLOIS,0410678P,45,39,6,0,19,26,6 ème
LOIR-ET-CHER,LAMOTTE-BEUVRON,0410008L,98,92,6,0,41,57,6 ème
LOIR-ET-CHER,MONTOIRE-SUR-LE-LOIR,0410682U,31,31,0,0,11,20,6 ème
LOIR-ET-CHER,SAINT-AIGNAN,0410714D,86,72,12,2,43,43,6 ème
LOIR-ET-CHER,VENDOME,0410792N,134,131,0,3,75,59,6 ème
CORSE-DU-SUD,AJACCIO,6200006M,204,165,27,12,98,106,6 ème
CORSE-DU-SUD,GROSSETO-PRUGNA,6200080T,92,92,0,0,52,40,6 ème
CORSE-DU-SUD,LEVIE,6200026J,14,14,0,0,5,9,6 ème
HAUTE-CORSE,BASTIA,7200012A,69,67,0,2,37,32,6 ème
HAUTE-CORSE,BASTIA,7200612C,131,123,7,1,62,69,6 ème
HAUTE-CORSE,CALVI,7200017F,128,123,0,5,58,70,6 ème
MEURTHE-ET-MOSELLE,COLOMBEY-LES-BELLES,0540012V,143,141,0,2,68,75,6 ème
MEURTHE-ET-MOSELLE,CUSTINES,0540078S,87,87,0,0,42,45,6 ème
MEURTHE-ET-MOSELLE,GERBEVILLER,0540022F,57,57,0,0,29,28,6 ème
MEURTHE-ET-MOSELLE,LANDRES,0540086A,0,0,0,0,0,0,6 ème
MEURTHE-ET-MOSELLE,LEXY,0541579Y,163,147,14,2,91,72,6 ème
MEURTHE-ET-MOSELLE,LUNEVILLE,0541328A,118,118,0,0,51,67,6 ème
MEURTHE-ET-MOSELLE,LUNEVILLE,0541990V,68,68,0,0,27,41,6 ème
MEURTHE-ET-MOSELLE,MONT-SAINT-MARTIN,0541357G,0,0,0,0,0,0,6 ème
MEURTHE-ET-MOSELLE,NANCY,0541340N,40,40,0,0,18,22,6 ème
MEURTHE-ET-MOSELLE,NANCY,0541370W,0,0,0,0,0,0,6 ème
MEURTHE-ET-MOSELLE,NANCY,0541998D,0,0,0,0,0,0,6 ème
MEURTHE-ET-MOSELLE,NEUVES-MAISONS,0540052N,114,114,0,0,65,49,6 ème
MEURTHE-ET-MOSELLE,PONT-A-MOUSSON,0541270M,0,0,0,0,0,0,6 ème
MEURTHE-ET-MOSELLE,TOUL,0541377D,0,0,0,0,0,0,6 ème
MEURTHE-ET-MOSELLE,TOUL,0541999E,116,112,0,4,62,54,6 ème
MEURTHE-ET-MOSELLE,VANDOEUVRE-LES-NANCY,0540111C,105,104,0,1,52,53,6 ème
MEURTHE-ET-MOSELLE,VANDOEUVRE-LES-NANCY,0541515D,106,90,16,0,45,61,6 ème
MEUSE,BAR-LE-DUC,0550703R,77,67,0,10,35,42,6 ème
MEUSE,CLERMONT-EN-ARGONNE,0550007J,59,59,0,0,28,31,6 ème
MEUSE,COMMERCY,0550008K,0,0,0,0,0,0,6 ème
MEUSE,COMMERCY,0550840P,176,166,4,6,84,92,6 ème
MEUSE,COMMERCY,0550920B,32,32,0,0,8,24,6 ème
MEUSE,MONTMEDY,0550016U,55,55,0,0,21,34,6 ème
MEUSE,SAINT-MIHIEL,0550804A,151,150,0,1,73,78,6 ème
MEUSE,STENAY,0550072E,0,0,0,0,0,0,6 ème
MEUSE,THIERVILLE-SUR-MEUSE,0550759B,115,112,0,3,51,64,6 ème
MEUSE,VERDUN,0550050F,82,82,0,0,29,53,6 ème
MOSELLE,AUDUN-LE-TICHE,0572170Z,77,77,0,0,36,41,6 ème
MOSELLE,BITCHE,0573326F,0,0,0,0,0,0,6 ème
MOSELLE,DIEUZE,0570021N,0,0,0,0,0,0,6 ème
MOSELLE,FAMECK,0572075W,0,0,0,0,0,0,6 ème
MOSELLE,FAULQUEMONT,0572176F,79,71,8,0,44,35,6 ème
MOSELLE,FORBACH,0570030Y,0,0,0,0,0,0,6 ème
MOSELLE,FORBACH,0572922S,239,239,0,0,123,116,6 ème
MOSELLE,FREYMING-MERLEBACH,0570326V,121,103,10,8,64,57,6 ème
MOSELLE,GUENANGE,0573244S,166,159,3,4,81,85,6 ème
MOSELLE,HAGONDANGE,0572172B,156,156,0,0,72,84,6 ème
MOSELLE,METZ,0570069R,119,113,0,6,53,66,6 ème
MOSELLE,METZ,0572088K,110,95,11,4,50,60,6 ème
MOSELLE,METZ,0572166V,171,163,8,0,75,96,6 ème
MOSELLE,METZ,0572352X,97,97,0,0,47,50,6 ème
MOSELLE,MOULINS-LES-METZ,0572186S,71,67,0,4,32,39,6 ème
MOSELLE,OTTANGE,0572101Z,0,0,0,0,0,0,6 ème
MOSELLE,ROMBAS,0572585A,119,117,0,2,54,65,6 ème
MOSELLE,SARREGUEMINES,0572184P,124,118,0,6,68,56,6 ème
MOSELLE,SARREGUEMINES,0572587C,105,95,6,4,49,56,6 ème
MOSELLE,THIONVILLE,0570108H,0,0,0,0,0,0,6 ème
MOSELLE,THIONVILLE,0572951Y,0,0,0,0,0,0,6 ème
MOSELLE,VITRY-SUR-ORNE,0572019K,137,137,0,0,72,65,6 ème
VOSGES,CAPAVENIR VOSGES,0880064S,0,0,0,0,0,0,6 ème
VOSGES,CONTREXEVILLE,0881102V,96,86,5,5,52,44,6 ème
VOSGES,DOMPAIRE,0880017R,104,104,0,0,39,65,6 ème
VOSGES,GERARDMER,0880031F,0,0,0,0,0,0,6 ème
VOSGES,LA VOGE-LES-BAINS,0880002Z,36,36,0,0,19,17,6 ème
VOSGES,LE VAL-D'AJOL,0880068W,63,63,0,0,31,32,6 ème
VOSGES,REMIREMONT,0880154P,123,110,10,3,58,65,6 ème
VOSGES,SAINT-DIE-DES-VOSGES,0880152M,0,0,0,0,0,0,6 ème
ARDENNES,ASFELD,0081102E,106,106,0,0,49,57,6 ème
ARDENNES,BOGNY-SUR-MEUSE,0080105W,54,51,0,3,23,31,6 ème
ARDENNES,CHARLEVILLE-MEZIERES,0080084Y,162,160,0,2,77,85,6 ème
ARDENNES,GRANDPRE,0081096Y,26,26,0,0,17,9,6 ème
ARDENNES,RIMOGNE,0080042C,67,58,9,0,30,37,6 ème
ARDENNES,SAULT-LES-RETHEL,0080909V,101,81,18,2,52,49,6 ème
ARDENNES,SEDAN,0080910W,78,75,0,3,42,36,6 ème
AUBE,AIX-VILLEMAUR-PALIS,0100806X,98,98,0,0,48,50,6 ème
AUBE,BAR-SUR-SEINE,0100004A,0,0,0,0,0,0,6 ème
AUBE,BAR-SUR-SEINE,0100745F,34,34,0,0,16,18,6 ème
AUBE,LA CHAPELLE-SAINT-LUC,0100009F,142,142,0,0,75,67,6 ème
AUBE,MARIGNY-LE-CHATEL,0100011H,110,110,0,0,55,55,6 ème
AUBE,MERY-SUR-SEINE,0100785Z,114,114,0,0,54,60,6 ème
AUBE,SAINT-ANDRE-LES-VERGERS,0100019S,126,123,3,0,63,63,6 ème
AUBE,TROYES,0100031E,104,103,0,1,47,57,6 ème
AUBE,TROYES,0100057H,89,89,0,0,44,45,6 ème
AUBE,TROYES,0100058J,93,93,0,0,49,44,6 ème
AUBE,TROYES,0100947A,122,119,0,3,58,64,6 ème
AUBE,TROYES,0101015Z,0,0,0,0,0,0,6 ème
HAUTE-MARNE,CHAUMONT,0520008B,0,0,0,0,0,0,6 ème
HAUTE-MARNE,CHAUMONT,0520039K,97,82,10,5,45,52,6 ème
HAUTE-MARNE,CHEVILLON,0520842H,77,77,0,0,39,38,6 ème
HAUTE-MARNE,JOINVILLE,0520822L,91,89,0,2,45,46,6 ème
HAUTE-MARNE,SAINT-DIZIER,0520050X,98,98,0,0,45,53,6 ème
HAUTE-MARNE,SAINT-DIZIER,0520051Y,118,116,0,2,65,53,6 ème
MARNE,BAZANCOURT,0511326P,154,154,0,0,83,71,6 ème
MARNE,CHALONS-EN-CHAMPAGNE,0510011K,141,140,0,1,73,68,6 ème
MARNE,CHALONS-EN-CHAMPAGNE,0511083A,118,118,0,0,63,55,6 ème
MARNE,CHALONS-EN-CHAMPAGNE,0511951U,0,0,0,0,0,0,6 ème
MARNE,DORMANS,0511258R,80,72,6,2,42,38,6 ème
MARNE,ESTERNAY,0511567B,61,61,0,0,29,32,6 ème
MARNE,MONTMIRAIL,0510026B,96,95,0,1,43,53,6 ème
MARNE,MONTMORT-LUCY,0510027C,33,33,0,0,17,16,6 ème
MARNE,REIMS,0510036M,0,0,0,0,0,0,6 ème
MARNE,REIMS,0511084B,175,172,0,3,101,74,6 ème
MARNE,REIMS,0511153B,0,0,0,0,0,0,6 ème
MARNE,REIMS,0511251H,88,75,13,0,47,41,6 ème
MARNE,REIMS,0511254L,115,109,0,6,43,72,6 ème
MARNE,RILLY-LA-MONTAGNE,0510048A,73,73,0,0,33,40,6 ème
MARNE,VITRY-LE-FRANCOIS,0510062R,0,0,0,0,0,0,6 ème
BAS-RHIN,BISCHHEIM,0670004R,184,165,11,8,84,100,6 ème
BAS-RHIN,BISCHWILLER,0670006T,0,0,0,0,0,0,6 ème
BAS-RHIN,ESCHAU,0671687V,189,186,0,3,93,96,6 ème
BAS-RHIN,GEISPOLSHEIM,0671824U,161,156,0,5,90,71,6 ème
BAS-RHIN,HAGUENAU,0671603D,150,150,0,0,63,87,6 ème
BAS-RHIN,HAGUENAU,0671734W,136,119,14,3,69,67,6 ème
BAS-RHIN,HOCHFELDEN,0671961T,194,191,0,3,85,109,6 ème
BAS-RHIN,ILLKIRCH-GRAFFENSTADEN,0671455T,7,0,7,0,3,4,6 ème
BAS-RHIN,ILLKIRCH-GRAFFENSTADEN,0671956M,95,92,0,3,46,49,6 ème
BAS-RHIN,ILLKIRCH-GRAFFENSTADEN,0672198A,0,0,0,0,0,0,6 ème
BAS-RHIN,LA BROQUE,0671697F,96,79,14,3,45,51,6 ème
BAS-RHIN,MARLENHEIM,0671989Y,146,146,0,0,71,75,6 ème
BAS-RHIN,MOLSHEIM,0670043H,0,0,0,0,0,0,6 ème
BAS-RHIN,MOLSHEIM,0672615D,0,0,0,0,0,0,6 ème
BAS-RHIN,RHINAU,0671963V,58,58,0,0,28,30,6 ème
BAS-RHIN,SOUFFLENHEIM,0670076U,143,140,0,3,84,59,6 ème
BAS-RHIN,SOULTZ-SOUS-FORETS,0671827X,182,177,0,5,89,93,6 ème
BAS-RHIN,STRASBOURG,0670133F,180,178,0,2,86,94,6 ème
BAS-RHIN,STRASBOURG,0671593T,176,174,0,2,90,86,6 ème
BAS-RHIN,STRASBOURG,0671607H,151,151,0,0,70,81,6 ème
BAS-RHIN,STRASBOURG,0671742E,163,149,9,5,73,90,6 ème
BAS-RHIN,STRASBOURG,0672899M,96,96,0,0,50,46,6 ème
BAS-RHIN,WALBOURG,0672302N,98,98,0,0,43,55,6 ème
BAS-RHIN,WASSELONNE,0671740C,136,133,0,3,66,70,6 ème
BAS-RHIN,WINGEN-SUR-MODER,0671739B,63,63,0,0,28,35,6 ème
HAUT-RHIN,BLOTZHEIM,0680131Y,127,127,0,0,64,63,6 ème
HAUT-RHIN,BRUNSTATT-DIDENHEIM,0681957H,123,116,0,7,57,66,6 ème
HAUT-RHIN,COLMAR,0680133A,126,126,0,0,65,61,6 ème
HAUT-RHIN,HIRSINGUE,0680019B,135,133,0,2,66,69,6 ème
HAUT-RHIN,ILLZACH,0680021D,116,112,0,4,55,61,6 ème
HAUT-RHIN,ISSENHEIM,0680144M,236,236,0,0,110,126,6 ème
HAUT-RHIN,LUTTERBACH,0681370V,154,145,7,2,73,81,6 ème
HAUT-RHIN,MULHOUSE,0680110A,136,115,15,6,61,75,6 ème
HAUT-RHIN,MULHOUSE,0681395X,184,158,21,5,91,93,6 ème
HAUT-RHIN,ORBEY,0681448E,91,91,0,0,40,51,6 ème
HAUT-RHIN,SAINT-LOUIS,0681747E,127,125,0,2,67,60,6 ème
HAUT-RHIN,SEPPOIS-LE-BAS,0680071H,88,88,0,0,52,36,6 ème
HAUT-RHIN,THANN,0680074L,0,0,0,0,0,0,6 ème
HAUT-RHIN,THANN,0681541F,110,105,0,5,56,54,6 ème
HAUT-RHIN,WITTELSHEIM,0680079S,104,104,0,0,42,62,6 ème
HAUT-RHIN,WITTENHEIM,0681126E,120,102,17,1,54,66,6 ème
HAUT-RHIN,WITTENHEIM,0681930D,155,155,0,0,67,88,6 ème
GUADELOUPE,GOURBEYRE,9710034K,70,66,0,4,38,32,6 ème
GUADELOUPE,GOURBEYRE,9710067W,0,0,0,0,0,0,6 ème
GUADELOUPE,GRAND-BOURG,9710926E,57,57,0,0,25,32,6 ème
GUADELOUPE,LE GOSIER,9711066G,0,0,0,0,0,0,6 ème
GUADELOUPE,LE MOULE,9710052E,0,0,0,0,0,0,6 ème
GUADELOUPE,LES ABYMES,9711205H,0,0,0,0,0,0,6 ème
GUADELOUPE,POINTE-A-PITRE,9710072B,48,48,0,0,24,24,6 ème
GUADELOUPE,SAINTE-ANNE,9710021W,178,164,13,1,88,90,6 ème
GUADELOUPE,SAINT-FRANCOIS,9710030F,136,135,0,1,72,64,6 ème
GUADELOUPE,SAINT-MARTIN,9710981P,0,0,0,0,0,0,6 ème
GUADELOUPE,SAINT-MARTIN,9711023K,141,138,0,3,60,81,6 ème
GUYANE,KOUROU,9730125Y,212,166,39,7,105,107,6 ème
GUYANE,KOUROU,9730237V,156,152,0,4,71,85,6 ème
GUYANE,MANA,9730192W,144,128,13,3,65,79,6 ème
GUYANE,REMIRE-MONTJOLY,9730334A,118,118,0,0,59,59,6 ème
GUYANE,SAINT-LAURENT-DU-MARONI,9730394R,247,240,0,7,127,120,6 ème
AISNE,BEAUREVOIR,0020004U,80,80,0,0,41,39,6 ème
AISNE,BRAINE,0020009Z,121,115,0,6,53,68,6 ème
AISNE,CHATEAU-THIERRY,0020468Y,89,86,0,3,48,41,6 ème
AISNE,CHATEAU-THIERRY,0021826Z,202,190,4,8,98,104,6 ème
AISNE,CHAUNY,0021493M,120,110,7,3,57,63,6 ème
AISNE,CUFFIES,0021491K,112,112,0,0,49,63,6 ème
AISNE,FERE-EN-TARDENOIS,0020024R,129,119,7,3,62,67,6 ème
AISNE,GUISE,0020483P,30,30,0,0,14,16,6 ème
AISNE,LA CAPELLE,0020479K,23,23,0,0,8,15,6 ème
AISNE,LAON,0020078Z,0,0,0,0,0,0,6 ème
AISNE,MOY-DE-L'AISNE,0020037E,83,83,0,0,41,42,6 ème
AISNE,NEUILLY-SAINT-FRONT,0020038F,101,101,0,0,45,56,6 ème
AISNE,SAINT-QUENTIN,0020080B,110,103,0,7,48,62,6 ème
AISNE,SAINT-QUENTIN,0021478W,11,0,11,0,5,6,6 ème
AISNE,VILLENEUVE-SAINT-GERMAIN,0021490J,97,84,13,0,45,52,6 ème
OISE,BEAUVAIS,0601140N,212,212,0,0,109,103,6 ème
OISE,BEAUVAIS,0601188R,184,165,14,5,82,102,6 ème
OISE,BEAUVAIS,0601487R,153,139,13,1,80,73,6 ème
OISE,BETZ,0601447X,131,131,0,0,62,69,6 ème
OISE,CHANTILLY,0601606V,149,146,0,3,73,76,6 ème
OISE,CLERMONT,0601471Y,179,174,0,5,104,75,6 ème
OISE,CREIL,0601449Z,152,135,16,1,70,82,6 ème
OISE,CREPY-EN-VALOIS,0601363F,0,0,0,0,0,0,6 ème
OISE,CREVECOEUR-LE-GRAND,0600070A,7,0,7,0,1,6,6 ème
OISE,CUISE-LA-MOTTE,0601146V,21,18,0,3,12,9,6 ème
OISE,GOUVIEUX,0601192V,108,97,7,4,52,56,6 ème
OISE,MERU,0601191U,139,133,5,1,69,70,6 ème
OISE,MONTATAIRE,0601178E,204,191,10,3,108,96,6 ème
OISE,MORTEFONTAINE,0601145U,243,242,0,1,124,119,6 ème
OISE,NANTEUIL-LE-HAUDOUIN,0601408E,216,214,0,2,94,122,6 ème
OISE,NOGENT-SUR-OISE,0600062S,0,0,0,0,0,0,6 ème
OISE,NOYON,0601297J,126,113,13,0,56,70,6 ème
OISE,RIBECOURT-DRESLINCOURT,0600046Z,110,107,0,3,54,56,6 ème
OISE,SAINT-MAXIMIN,0600048B,0,0,0,0,0,0,6 ème
OISE,VILLERS-SAINT-PAUL,0601821D,109,108,0,1,43,66,6 ème
SOMME,ABBEVILLE,0800002T,190,170,16,4,97,93,6 ème
SOMME,AILLY-SUR-NOYE,0800004V,127,122,0,5,60,67,6 ème
SOMME,AMIENS,0801212H,114,114,0,0,44,70,6 ème
SOMME,AMIENS,0801220S,92,92,0,0,37,55,6 ème
SOMME,AMIENS,0802214X,0,0,0,0,0,0,6 ème
SOMME,CORBIE,0801511H,76,74,0,2,34,42,6 ème
SOMME,DOULLENS,0800029X,139,127,9,3,68,71,6 ème
SOMME,DOULLENS,0801900F,0,0,0,0,0,0,6 ème
SOMME,FRIVILLE-ESCARBOTIN,0800033B,112,110,0,2,55,57,6 ème
SOMME,GAMACHES,0800034C,141,131,7,3,61,80,6 ème
SOMME,HAM,0801224W,97,97,0,0,55,42,6 ème
SOMME,MERS-LES-BAINS,0800039H,62,62,0,0,30,32,6 ème
SOMME,NESLE,0801369D,56,56,0,0,32,24,6 ème
SOMME,NOUVION,0801488H,74,74,0,0,37,37,6 ème
SOMME,POIX-DE-PICARDIE,0801326G,99,96,0,3,53,46,6 ème
SOMME,ROISEL,0800050V,60,60,0,0,30,30,6 ème
SOMME,ROYE,0801341Y,101,91,10,0,53,48,6 ème
NORD,ANNOEULLIN,0593234V,158,158,0,0,74,84,6 ème
NORD,ARMENTIERES,0593060F,0,0,0,0,0,0,6 ème
NORD,ARMENTIERES,0595382E,187,187,0,0,92,95,6 ème
NORD,AULNOYE-AYMERIES,0590015W,0,0,0,0,0,0,6 ème
NORD,BONDUES,0595385H,227,227,0,0,117,110,6 ème
NORD,BOURBOURG,0592955S,148,148,0,0,64,84,6 ème
NORD,CONDE-SUR-L'ESCAUT,0590050J,129,121,6,2,55,74,6 ème
NORD,CONDE-SUR-L'ESCAUT,0596854E,0,0,0,0,0,0,6 ème
NORD,COUDEKERQUE-BRANCHE,0593182N,60,60,0,0,37,23,6 ème
NORD,COUDEKERQUE-BRANCHE,0593494C,92,86,4,2,51,41,6 ème
NORD,DENAIN,0590264S,0,0,0,0,0,0,6 ème
NORD,DOUAI,0595171A,158,155,0,3,84,74,6 ème
NORD,DOUAI,0595894L,0,0,0,0,0,0,6 ème
NORD,DUNKERQUE,0590200X,111,111,0,0,47,64,6 ème
NORD,DUNKERQUE,0593143W,106,103,0,3,49,57,6 ème
NORD,DUNKERQUE,0596716E,84,80,0,4,45,39,6 ème
NORD,ESTAIRES,0595757M,149,149,0,0,71,78,6 ème
NORD,FOURMIES,0594879H,82,82,0,0,33,49,6 ème
NORD,FOURMIES,0595390N,49,47,0,2,21,28,6 ème
NORD,GRANDE-SYNTHE,0594398K,104,94,6,4,48,56,6 ème
NORD,GRANDE-SYNTHE,0595388L,76,76,0,0,38,38,6 ème
NORD,GRAND-FORT-PHILIPPE,0595712N,40,40,0,0,19,21,6 ème
NORD,HAUTMONT,0592634T,166,166,0,0,77,89,6 ème
NORD,HAUTMONT,0594309N,105,94,8,3,48,57,6 ème
NORD,HAZEBROUCK,0595391P,140,137,0,3,60,80,6 ème
NORD,LA MADELEINE,0592896C,148,148,0,0,84,64,6 ème
NORD,LAMBRES-LEZ-DOUAI,0594298B,97,94,0,3,47,50,6 ème
NORD,LANDRECIES,0595178H,113,113,0,0,59,54,6 ème
NORD,LE CATEAU-CAMBRESIS,0595337F,176,160,10,6,86,90,6 ème
NORD,LE QUESNOY,0595172B,235,229,6,0,117,118,6 ème
NORD,LESQUIN,0593991T,133,133,0,0,70,63,6 ème
NORD,LILLE,0593131H,113,113,0,0,61,52,6 ème
NORD,LILLE,0593179K,111,108,0,3,51,60,6 ème
NORD,LILLE,0593235W,122,110,12,0,61,61,6 ème
NORD,LOON-PLAGE,0595596M,70,67,0,3,33,37,6 ème
NORD,MERVILLE,0592899F,146,143,0,3,65,81,6 ème
NORD,MONS-EN-BAROEUL,0590155Y,92,88,0,4,42,50,6 ème
NORD,ORCHIES,0592900G,157,156,0,1,69,88,6 ème
NORD,ORCHIES,0593040J,0,0,0,0,0,0,6 ème
NORD,PECQUENCOURT,0596529B,142,136,0,6,66,76,6 ème
NORD,PONT-A-MARCQ,0594866U,125,125,0,0,55,70,6 ème
NORD,ROUBAIX,0590190L,117,113,0,4,62,55,6 ème
NORD,ROUBAIX,0592917A,178,178,0,0,103,75,6 ème
NORD,SAINT-ANDRE-LEZ-LILLE,0592832H,0,0,0,0,0,0,6 ème
NORD,SAINT-ANDRE-LEZ-LILLE,0593228N,106,106,0,0,51,55,6 ème
NORD,SAINT-SAULVE,0594644C,103,99,0,4,48,55,6 ème
NORD,SAINT-SAULVE,0595402B,229,226,0,3,111,118,6 ème
NORD,SEBOURG,0593144X,111,111,0,0,53,58,6 ème
NORD,SOLRE-LE-CHATEAU,0590206D,92,92,0,0,45,47,6 ème
NORD,THIANT,0594645D,174,170,4,0,75,99,6 ème
NORD,TOURCOING,0593217B,344,334,10,0,179,165,6 ème
NORD,VALENCIENNES,0593154H,116,112,0,4,59,57,6 ème
NORD,VALENCIENNES,0593680E,80,73,7,0,40,40,6 ème
NORD,VILLENEUVE-D'ASCQ,0593196D,158,150,4,4,71,87,6 ème
NORD,VILLENEUVE-D'ASCQ,0593198F,117,117,0,0,44,73,6 ème
NORD,VILLENEUVE-D'ASCQ,0594291U,150,150,0,0,77,73,6 ème
NORD,VILLENEUVE-D'ASCQ,0594525Y,82,78,0,4,48,34,6 ème
NORD,WAZIERS,0590238N,73,73,0,0,34,39,6 ème
NORD,WAZIERS,0593495D,0,0,0,0,0,0,6 ème
PAS-DE-CALAIS,ANGRES,0622579S,141,141,0,0,75,66,6 ème
PAS-DE-CALAIS,ANZIN-SAINT-AUBIN,0622125Y,302,300,0,2,145,157,6 ème
PAS-DE-CALAIS,ARRAS,0622196A,0,0,0,0,0,0,6 ème
PAS-DE-CALAIS,BERTINCOURT,0620039F,71,71,0,0,36,35,6 ème
PAS-DE-CALAIS,CALAIS,0620189U,0,0,0,0,0,0,6 ème
PAS-DE-CALAIS,CALAIS,0622109F,126,126,0,0,64,62,6 ème
PAS-DE-CALAIS,CALAIS,0622431F,73,69,0,4,36,37,6 ème
PAS-DE-CALAIS,CALAIS,0622432G,98,98,0,0,46,52,6 ème
PAS-DE-CALAIS,CALAIS,0622576N,85,82,0,3,46,39,6 ème
PAS-DE-CALAIS,CALAIS,0623315S,126,123,0,3,73,53,6 ème
PAS-DE-CALAIS,CARVIN,0623919Y,135,132,0,3,65,70,6 ème
PAS-DE-CALAIS,DESVRES,0623023Z,138,135,0,3,64,74,6 ème
PAS-DE-CALAIS,DOUVRIN,0622867E,166,163,0,3,80,86,6 ème
PAS-DE-CALAIS,FOUQUIERES-LES-LENS,0622098U,85,85,0,0,39,46,6 ème
PAS-DE-CALAIS,FRUGES,0622112J,30,27,0,3,16,14,6 ème
PAS-DE-CALAIS,FRUGES,0622195Z,0,0,0,0,0,0,6 ème
PAS-DE-CALAIS,HENIN-BEAUMONT,0620096T,82,76,6,0,43,39,6 ème
PAS-DE-CALAIS,HESDIN,0622139N,44,44,0,0,23,21,6 ème
PAS-DE-CALAIS,HUCQUELIERS,0620104B,96,93,0,3,46,50,6 ème
PAS-DE-CALAIS,LAVENTIE,0622140P,73,73,0,0,45,28,6 ème
PAS-DE-CALAIS,LENS,0622868F,118,108,7,3,60,58,6 ème
PAS-DE-CALAIS,LE TOUQUET-PARIS-PLAGE,0622806N,88,86,0,2,38,50,6 ème
PAS-DE-CALAIS,LIBERCOURT,0622239X,95,95,0,0,38,57,6 ème
PAS-DE-CALAIS,LICQUES,0620194Z,90,90,0,0,41,49,6 ème
PAS-DE-CALAIS,LIEVIN,0622302R,2,0,2,0,1,1,6 ème
PAS-DE-CALAIS,LILLERS,0620121V,0,0,0,0,0,0,6 ème
PAS-DE-CALAIS,LILLERS,0623312N,108,105,0,3,53,55,6 ème
PAS-DE-CALAIS,LONGUENESSE,0623572W,100,100,0,0,39,61,6 ème
PAS-DE-CALAIS,LOOS-EN-GOHELLE,0620123X,69,69,0,0,38,31,6 ème
PAS-DE-CALAIS,LUMBRES,0620124Y,0,0,0,0,0,0,6 ème
PAS-DE-CALAIS,LUMBRES,0622142S,125,125,0,0,56,69,6 ème
PAS-DE-CALAIS,MARQUISE,0622096S,217,217,0,0,105,112,6 ème
PAS-DE-CALAIS,MONTREUIL,0622117P,88,88,0,0,50,38,6 ème
PAS-DE-CALAIS,MONTREUIL,0622951W,169,159,5,5,70,99,6 ème
PAS-DE-CALAIS,PERNES,0620156H,93,93,0,0,39,54,6 ème
PAS-DE-CALAIS,SANGATTE,0623865P,126,126,0,0,68,58,6 ème
PAS-DE-CALAIS,WINGLES,0620258U,0,0,0,0,0,0,6 ème
PAS-DE-CALAIS,WIZERNES,0622874M,105,101,0,4,49,56,6 ème
SEINE-ET-MARNE,BOIS-LE-ROI,0770002J,169,169,0,0,82,87,6 ème
SEINE-ET-MARNE,CHAMPS-SUR-MARNE,0771511Z,137,137,0,0,69,68,6 ème
SEINE-ET-MARNE,CHELLES,0771171E,0,0,0,0,0,0,6 ème
SEINE-ET-MARNE,CHELLES,0771926A,161,161,0,0,81,80,6 ème
SEINE-ET-MARNE,CHESSY,0772651N,142,141,0,1,73,69,6 ème
SEINE-ET-MARNE,ESBLY,0771361L,158,142,14,2,73,85,6 ème
SEINE-ET-MARNE,LAGNY-SUR-MARNE,0771918S,312,312,0,0,155,157,6 ème
SEINE-ET-MARNE,LE CHATELET-EN-BRIE,0771068T,137,137,0,0,77,60,6 ème
SEINE-ET-MARNE,MAGNY-LE-HONGRE,0772713F,168,168,0,0,89,79,6 ème
SEINE-ET-MARNE,MEAUX,0771420A,173,159,10,4,86,87,6 ème
SEINE-ET-MARNE,MELUN,0771070V,72,65,0,7,39,33,6 ème
SEINE-ET-MARNE,MELUN,0771220H,97,97,0,0,45,52,6 ème
SEINE-ET-MARNE,MELUN,0771923X,203,200,0,3,93,110,6 ème
SEINE-ET-MARNE,MOISSY-CRAMAYEL,0772191N,147,147,0,0,71,76,6 ème
SEINE-ET-MARNE,MORET-LOING-ET-ORVANNE,0770038Y,169,168,0,1,81,88,6 ème
SEINE-ET-MARNE,NANGIS,0770040A,162,158,0,4,93,69,6 ème
SEINE-ET-MARNE,OTHIS,0771562E,171,171,0,0,75,96,6 ème
SEINE-ET-MARNE,OZOIR-LA-FERRIERE,0771334G,161,161,0,0,75,86,6 ème
SEINE-ET-MARNE,OZOIR-LA-FERRIERE,0772293Z,128,123,0,5,71,57,6 ème
SEINE-ET-MARNE,PROVINS,0771176K,110,95,15,0,55,55,6 ème
SEINE-ET-MARNE,SAINT-FARGEAU-PONTHIERRY,0771517F,257,257,0,0,117,140,6 ème
SEINE-ET-MARNE,SAINT-SOUPPLETS,0772483F,114,112,0,2,63,51,6 ème
SEINE-ET-MARNE,SAVIGNY-LE-TEMPLE,0772274D,139,136,0,3,71,68,6 ème
SEINE-ET-MARNE,SERRIS,0772589W,144,140,0,4,76,68,6 ème
SEINE-ET-MARNE,VAIRES-SUR-MARNE,0771177L,205,202,0,3,90,115,6 ème
SEINE-ET-MARNE,VAUX-LE-PENIL,0771178M,177,174,0,3,100,77,6 ème
SEINE-ET-MARNE,VERNEUIL-L'ETANG,0771619S,130,129,0,1,59,71,6 ème
SEINE-ET-MARNE,VOISENON,0771930E,224,224,0,0,111,113,6 ème
SEINE-ET-MARNE,VULAINES-SUR-SEINE,0772867Y,118,118,0,0,47,71,6 ème
SEINE-SAINT-DENIS,AUBERVILLIERS,0930902A,49,49,0,0,26,23,6 ème
SEINE-SAINT-DENIS,AULNAY-SOUS-BOIS,0931379U,175,160,15,0,94,81,6 ème
SEINE-SAINT-DENIS,AULNAY-SOUS-BOIS,0932310F,144,144,0,0,75,69,6 ème
SEINE-SAINT-DENIS,BAGNOLET,0931022F,157,157,0,0,63,94,6 ème
SEINE-SAINT-DENIS,BOBIGNY,0930900Y,142,139,0,3,62,80,6 ème
SEINE-SAINT-DENIS,BOBIGNY,0931194T,195,182,12,1,99,96,6 ème
SEINE-SAINT-DENIS,BONDY,0931711E,128,128,0,0,60,68,6 ème
SEINE-SAINT-DENIS,BONDY,0931860S,125,124,0,1,62,63,6 ème
SEINE-SAINT-DENIS,CLICHY-SOUS-BOIS,0930616P,146,146,0,0,67,79,6 ème
SEINE-SAINT-DENIS,CLICHY-SOUS-BOIS,0932366S,151,151,0,0,78,73,6 ème
SEINE-SAINT-DENIS,DRANCY,0931199Y,142,140,0,2,69,73,6 ème
SEINE-SAINT-DENIS,GAGNY,0931233K,0,0,0,0,0,0,6 ème
SEINE-SAINT-DENIS,GAGNY,0931855L,33,33,0,0,1,32,6 ème
SEINE-SAINT-DENIS,GAGNY,0932311G,161,139,16,6,77,84,6 ème
SEINE-SAINT-DENIS,LA COURNEUVE,0930128J,0,0,0,0,0,0,6 ème
SEINE-SAINT-DENIS,LE BLANC-MESNIL,0932580Z,144,141,0,3,74,70,6 ème
SEINE-SAINT-DENIS,LE PRE-SAINT-GERVAIS,0930917S,93,93,0,0,50,43,6 ème
SEINE-SAINT-DENIS,LE RAINCY,0930970Z,23,23,0,0,12,11,6 ème
SEINE-SAINT-DENIS,LE RAINCY,0932772H,54,54,0,0,29,25,6 ème
SEINE-SAINT-DENIS,LES LILAS,0931439J,166,166,0,0,66,100,6 ème
SEINE-SAINT-DENIS,MONTFERMEIL,0931546A,178,174,0,4,94,84,6 ème
SEINE-SAINT-DENIS,MONTREUIL,0931211L,115,115,0,0,45,70,6 ème
SEINE-SAINT-DENIS,MONTREUIL,0931212M,118,99,16,3,58,60,6 ème
SEINE-SAINT-DENIS,MONTREUIL,0931845A,122,122,0,0,56,66,6 ème
SEINE-SAINT-DENIS,NEUILLY-SUR-MARNE,0931228E,132,127,0,5,58,74,6 ème
SEINE-SAINT-DENIS,NOISY-LE-GRAND,0930883E,140,136,0,4,76,64,6 ème
SEINE-SAINT-DENIS,NOISY-LE-GRAND,0931614Z,182,167,15,0,92,90,6 ème
SEINE-SAINT-DENIS,NOISY-LE-SEC,0931610V,193,178,15,0,97,96,6 ème
SEINE-SAINT-DENIS,PANTIN,0931713G,175,159,16,0,83,92,6 ème
SEINE-SAINT-DENIS,PIERREFITTE-SUR-SEINE,0931223Z,205,183,14,8,102,103,6 ème
SEINE-SAINT-DENIS,SAINT-DENIS,0930959M,252,250,0,2,115,137,6 ème
SEINE-SAINT-DENIS,SAINT-DENIS,0931231H,136,136,0,0,55,81,6 ème
SEINE-SAINT-DENIS,SAINT-DENIS,0932273R,121,120,0,1,66,55,6 ème
SEINE-SAINT-DENIS,SAINT-DENIS,0932586F,64,64,0,0,33,31,6 ème
SEINE-SAINT-DENIS,SAINT-DENIS,0932773J,0,0,0,0,0,0,6 ème
SEINE-SAINT-DENIS,SEVRAN,0931979W,140,140,0,0,61,79,6 ème
SEINE-SAINT-DENIS,STAINS,0931225B,161,159,0,2,86,75,6 ème
SEINE-SAINT-DENIS,VILLEPINTE,0931607S,139,120,17,2,66,73,6 ème
VAL-DE-MARNE,ALFORTVILLE,0940126B,0,0,0,0,0,0,6 ème
VAL-DE-MARNE,BOISSY-SAINT-LEGER,0940892J,58,58,0,0,27,31,6 ème
VAL-DE-MARNE,BONNEUIL-SUR-MARNE,0941095E,128,119,7,2,63,65,6 ème
VAL-DE-MARNE,CHAMPIGNY-SUR-MARNE,0941092B,100,100,0,0,49,51,6 ème
VAL-DE-MARNE,CHAMPIGNY-SUR-MARNE,0941299B,177,167,10,0,83,94,6 ème
VAL-DE-MARNE,CHAMPIGNY-SUR-MARNE,0941431V,134,134,0,0,64,70,6 ème
VAL-DE-MARNE,CHARENTON-LE-PONT,0940808T,184,184,0,0,100,84,6 ème
VAL-DE-MARNE,CHENNEVIERES-SUR-MARNE,0940787V,86,82,0,4,46,40,6 ème
VAL-DE-MARNE,CHOISY-LE-ROI,0941229A,198,193,5,0,109,89,6 ème
VAL-DE-MARNE,CRETEIL,0940003T,76,70,0,6,35,41,6 ème
VAL-DE-MARNE,CRETEIL,0941018W,0,0,0,0,0,0,6 ème
VAL-DE-MARNE,CRETEIL,0941351H,109,105,0,4,56,53,6 ème
VAL-DE-MARNE,FONTENAY-SOUS-BOIS,0940516A,227,227,0,0,109,118,6 ème
VAL-DE-MARNE,FONTENAY-SOUS-BOIS,0941296Y,148,139,9,0,66,82,6 ème
VAL-DE-MARNE,GENTILLY,0941099J,98,98,0,0,52,46,6 ème
VAL-DE-MARNE,LE KREMLIN-BICETRE,0940022N,89,89,0,0,42,47,6 ème
VAL-DE-MARNE,LE PERREUX-SUR-MARNE,0940789X,145,145,0,0,69,76,6 ème
VAL-DE-MARNE,MAISONS-ALFORT,0941046B,150,150,0,0,77,73,6 ème
VAL-DE-MARNE,ORLY,0941044Z,144,144,0,0,72,72,6 ème
VAL-DE-MARNE,SAINT-MANDE,0940790Y,137,132,0,5,69,68,6 ème
VAL-DE-MARNE,SAINT-MANDE,0941715D,130,130,0,0,60,70,6 ème
VAL-DE-MARNE,SAINT-MAUR-DES-FOSSES,0940585A,0,0,0,0,0,0,6 ème
VAL-DE-MARNE,SAINT-MAUR-DES-FOSSES,0940811W,87,87,0,0,53,34,6 ème
VAL-DE-MARNE,SAINT-MAURICE,0941597A,83,83,0,0,43,40,6 ème
VAL-DE-MARNE,SUCY-EN-BRIE,0940748C,176,173,0,3,85,91,6 ème
VAL-DE-MARNE,VILLECRESNES,0941412Z,148,148,0,0,70,78,6 ème
VAL-DE-MARNE,VILLEJUIF,0941035P,100,86,14,0,46,54,6 ème
VAL-DE-MARNE,VILLENEUVE-LE-ROI,0941103N,108,108,0,0,49,59,6 ème
VAL-DE-MARNE,VILLENEUVE-LE-ROI,0941234F,88,88,0,0,38,50,6 ème
VAL-DE-MARNE,VILLIERS-SUR-MARNE,0940625U,122,119,0,3,57,65,6 ème
VAL-DE-MARNE,VINCENNES,0942188T,150,146,0,4,71,79,6 ème
VAL-DE-MARNE,VITRY-SUR-SEINE,0941034N,98,98,0,0,44,54,6 ème
VAL-DE-MARNE,VITRY-SUR-SEINE,0942434K,96,93,0,3,47,49,6 ème
PARIS,PARIS,0752251P,90,89,0,1,44,46,6 ème
PARIS,PARIS,0753047E,93,92,0,1,46,47,6 ème
PARIS,PARIS,0754506R,148,148,0,0,80,68,6 ème
PARIS,PARIS,0750676C,0,0,0,0,0,0,6 ème
PARIS,PARIS,0752895P,110,110,0,0,110,0,6 ème
PARIS,PARIS,0752954D,0,0,0,0,0,0,6 ème
PARIS,PARIS,0753978S,78,78,0,0,31,47,6 ème
PARIS,PARIS,0754528P,123,107,14,2,56,67,6 ème
PARIS,PARIS,0750444A,146,144,0,2,70,76,6 ème
PARIS,PARIS,0750610F,105,99,0,6,48,57,6 ème
PARIS,PARIS,0750783U,0,0,0,0,0,0,6 ème
PARIS,PARIS,0752538B,122,122,0,0,60,62,6 ème
PARIS,PARIS,0752540D,108,108,0,0,55,53,6 ème
PARIS,PARIS,0752896R,99,99,0,0,50,49,6 ème
PARIS,PARIS,0752957G,113,113,0,0,45,68,6 ème
PARIS,PARIS,0753937X,97,96,0,1,39,58,6 ème
PARIS,PARIS,0750611G,132,131,0,1,62,70,6 ème
PARIS,PARIS,0751705W,131,130,0,1,50,81,6 ème
PARIS,PARIS,0753908R,144,144,0,0,78,66,6 ème
PARIS,PARIS,0754253R,73,73,0,0,33,40,6 ème
PARIS,PARIS,0752843H,178,178,0,0,87,91,6 ème
PARIS,PARIS,0754305X,148,145,0,3,75,73,6 ème
PARIS,PARIS,0752548M,347,343,0,4,176,171,6 ème
PARIS,PARIS,0752549N,186,186,0,0,97,89,6 ème
PARIS,PARIS,0753996L,67,67,0,0,42,25,6 ème
PARIS,PARIS,0752107H,176,176,0,0,93,83,6 ème
PARIS,PARIS,0752387M,114,114,0,0,50,64,6 ème
PARIS,PARIS,0752552S,176,174,0,2,85,91,6 ème
PARIS,PARIS,0752821J,161,161,0,0,85,76,6 ème
PARIS,PARIS,0752898T,132,131,0,1,64,68,6 ème
PARIS,PARIS,0752958H,102,100,0,2,50,52,6 ème
PARIS,PARIS,0750182R,107,105,0,2,58,49,6 ème
PARIS,PARIS,0750800M,0,0,0,0,0,0,6 ème
PARIS,PARIS,0751793S,114,112,0,2,61,53,6 ème
PARIS,PARIS,0752108J,118,118,0,0,60,58,6 ème
PARIS,PARIS,0754706H,101,99,0,2,52,49,6 ème
PARIS,PARIS,0750360J,113,109,0,4,68,45,6 ème
PARIS,PARIS,0752555V,83,82,0,1,41,42,6 ème
PARIS,PARIS,0752606A,87,86,0,1,41,46,6 ème
PARIS,PARIS,0752556W,112,112,0,0,50,62,6 ème
PARIS,PARIS,0754006X,98,95,0,3,43,55,6 ème
PARIS,PARIS,0755241P,83,81,0,2,44,39,6 ème
PARIS,PARIS,0752248L,70,70,0,0,30,40,6 ème
PARIS,PARIS,0750387N,90,90,0,0,51,39,6 ème
PARIS,PARIS,0750651A,0,0,0,0,0,0,6 ème
PARIS,PARIS,0752902X,251,245,0,6,122,129,6 ème
PARIS,PARIS,0752526N,132,132,0,0,65,67,6 ème
PARIS,PARIS,0752900V,325,317,6,2,131,194,6 ème
PARIS,PARIS,0752924W,58,58,0,0,20,38,6 ème
PARIS,PARIS,0752249M,139,136,0,3,66,73,6 ème
PARIS,PARIS,0752530T,113,112,0,1,58,55,6 ème
ESSONNE,ATHIS-MONS,0911745C,313,306,4,3,154,159,6 ème
ESSONNE,BRUNOY,0910714G,105,105,0,0,51,54,6 ème
ESSONNE,CERNY,0910630R,0,0,0,0,0,0,6 ème
ESSONNE,CHAMPCUEIL,0912233H,144,141,0,3,72,72,6 ème
ESSONNE,CORBEIL-ESSONNES,0911443Z,184,163,16,5,95,89,6 ème
ESSONNE,ETAMPES,0911747E,128,128,0,0,68,60,6 ème
ESSONNE,EVRY-COURCOURONNES,0911254U,0,0,0,0,0,0,6 ème
ESSONNE,EVRY-COURCOURONNES,0912173T,108,107,0,1,55,53,6 ème
ESSONNE,LA NORVILLE,0911255V,160,144,16,0,73,87,6 ème
ESSONNE,LES ULIS,0911127F,145,137,8,0,59,86,6 ème
ESSONNE,LISSES,0911754M,128,126,0,2,64,64,6 ème
ESSONNE,MENNECY,0911185U,243,226,13,4,114,129,6 ème
ESSONNE,MONTGERON,0911353B,24,24,0,0,6,18,6 ème
ESSONNE,NOZAY,0912174U,130,129,0,1,53,77,6 ème
ESSONNE,OLLAINVILLE,0912175V,141,139,0,2,68,73,6 ème
ESSONNE,PALAISEAU,0910046F,119,117,0,2,53,66,6 ème
ESSONNE,PALAISEAU,0910820X,152,152,0,0,77,75,6 ème
ESSONNE,SAINTE-GENEVIEVE-DES-BOIS,0910678T,140,140,0,0,67,73,6 ème
ESSONNE,SAINT-MICHEL-SUR-ORGE,0911257X,199,186,12,1,111,88,6 ème
ESSONNE,SAINT-MICHEL-SUR-ORGE,0911946W,0,0,0,0,0,0,6 ème
ESSONNE,SAVIGNY-SUR-ORGE,0911038J,119,119,0,0,64,55,6 ème
ESSONNE,VILLEBON-SUR-YVETTE,0911335G,155,145,9,1,71,84,6 ème
ESSONNE,VILLEMOISSON-SUR-ORGE,0911145A,165,163,0,2,87,78,6 ème
ESSONNE,VIRY-CHATILLON,0910971L,183,166,15,2,88,95,6 ème
ESSONNE,VIRY-CHATILLON,0911752K,221,221,0,0,130,91,6 ème
ESSONNE,YERRES,0910062Y,203,203,0,0,108,95,6 ème
ESSONNE,YERRES,0912000E,54,52,0,2,53,1,6 ème
HAUTS-DE-SEINE,ANTONY,0921507N,139,139,0,0,76,63,6 ème
HAUTS-DE-SEINE,ASNIERES-SUR-SEINE,0921545E,170,160,8,2,79,91,6 ème
HAUTS-DE-SEINE,ASNIERES-SUR-SEINE,0921902T,193,193,0,0,105,88,6 ème
HAUTS-DE-SEINE,BAGNEUX,0920680P,0,0,0,0,0,0,6 ème
HAUTS-DE-SEINE,BOIS-COLOMBES,0921779J,180,178,0,2,81,99,6 ème
HAUTS-DE-SEINE,BOULOGNE-BILLANCOURT,0921237V,112,111,0,1,58,54,6 ème
HAUTS-DE-SEINE,CHATENAY-MALABRY,0921906X,206,206,0,0,97,109,6 ème
HAUTS-DE-SEINE,CLAMART,0920998K,96,96,0,0,44,52,6 ème
HAUTS-DE-SEINE,CLICHY,0921623P,125,120,0,5,65,60,6 ème
HAUTS-DE-SEINE,COLOMBES,0921229L,0,0,0,0,0,0,6 ème
HAUTS-DE-SEINE,COURBEVOIE,0921550K,103,101,0,2,55,48,6 ème
HAUTS-DE-SEINE,COURBEVOIE,0922020W,116,115,0,1,63,53,6 ème
HAUTS-DE-SEINE,COURBEVOIE,0922867S,32,32,0,0,16,16,6 ème
HAUTS-DE-SEINE,FONTENAY-AUX-ROSES,0920081N,209,205,0,4,102,107,6 ème
HAUTS-DE-SEINE,ISSY-LES-MOULINEAUX,0921003R,38,38,0,0,12,26,6 ème
HAUTS-DE-SEINE,ISSY-LES-MOULINEAUX,0922247T,183,183,0,0,84,99,6 ème
HAUTS-DE-SEINE,ISSY-LES-MOULINEAUX,0922653J,0,0,0,0,0,0,6 ème
HAUTS-DE-SEINE,LE PLESSIS-ROBINSON,0920883K,81,81,0,0,36,45,6 ème
HAUTS-DE-SEINE,MALAKOFF,0921241Z,146,144,0,2,71,75,6 ème
HAUTS-DE-SEINE,MEUDON,0921782M,148,148,0,0,71,77,6 ème
HAUTS-DE-SEINE,MONTROUGE,0921911C,96,96,0,0,50,46,6 ème
HAUTS-DE-SEINE,NANTERRE,0920594W,127,123,0,4,70,57,6 ème
HAUTS-DE-SEINE,NANTERRE,0921940J,116,112,0,4,57,59,6 ème
HAUTS-DE-SEINE,NANTERRE,0922464D,0,0,0,0,0,0,6 ème
HAUTS-DE-SEINE,NEUILLY-SUR-SEINE,0921498D,118,113,0,5,49,69,6 ème
HAUTS-DE-SEINE,PUTEAUX,0921233R,168,168,0,0,81,87,6 ème
HAUTS-DE-SEINE,RUEIL-MALMAISON,0920852B,53,51,0,2,23,30,6 ème
HAUTS-DE-SEINE,RUEIL-MALMAISON,0921235T,144,144,0,0,61,83,6 ème
HAUTS-DE-SEINE,SCEAUX,0921784P,150,147,0,3,68,82,6 ème
HAUTS-DE-SEINE,VILLE-D'AVRAY,0920886N,108,105,0,3,50,58,6 ème
HAUTS-DE-SEINE,VILLENEUVE-LA-GARENNE,0921543C,161,158,2,1,81,80,6 ème
VAL-D'OISE,ARGENTEUIL,0950789S,133,133,0,0,71,62,6 ème
VAL-D'OISE,CERGY,0951401G,133,116,12,5,65,68,6 ème
VAL-D'OISE,DOMONT,0950014Z,231,227,0,4,129,102,6 ème
VAL-D'OISE,ENGHIEN-LES-BAINS,0950930V,81,80,0,1,44,37,6 ème
VAL-D'OISE,FRANCONVILLE,0950793W,124,124,0,0,60,64,6 ème
VAL-D'OISE,GARGES-LES-GONESSE,0952036X,130,130,0,0,66,64,6 ème
VAL-D'OISE,JOUY-LE-MOUTIER,0951527U,177,168,5,4,78,99,6 ème
VAL-D'OISE,LE PLESSIS-BOUCHARD,0951232Y,118,110,0,8,54,64,6 ème
VAL-D'OISE,L'ISLE-ADAM,0950758H,93,93,0,0,52,41,6 ème
VAL-D'OISE,LOUVRES,0951354F,148,148,0,0,74,74,6 ème
VAL-D'OISE,MAGNY-EN-VEXIN,0950823D,55,55,0,0,27,28,6 ème
VAL-D'OISE,MARINES,0950936B,181,172,9,0,91,90,6 ème
VAL-D'OISE,PARMAIN,0951279Z,142,142,0,0,55,87,6 ème
VAL-D'OISE,PIERRELAYE,0951726K,124,119,0,5,58,66,6 ème
VAL-D'OISE,PONTOISE,0950895G,151,150,0,1,75,76,6 ème
VAL-D'OISE,PONTOISE,0951506W,189,185,0,4,98,91,6 ème
VAL-D'OISE,SAINT-GRATIEN,0950037Z,116,116,0,0,57,59,6 ème
VAL-D'OISE,SAINT-OUEN-L'AUMONE,0950658Z,0,0,0,0,0,0,6 ème
VAL-D'OISE,SAINT-PRIX,0951992Z,112,112,0,0,45,67,6 ème
VAL-D'OISE,SARCELLES,0951939S,34,34,0,0,0,34,6 ème
VAL-D'OISE,VILLIERS-LE-BEL,0950796Z,189,188,0,1,96,93,6 ème
VAL-D'OISE,VILLIERS-LE-BEL,0951090U,0,0,0,0,0,0,6 ème
VAL-D'OISE,VILLIERS-LE-BEL,0951993A,161,159,0,2,88,73,6 ème
YVELINES,BONNIERES-SUR-SEINE,0780707V,188,184,0,4,106,82,6 ème
YVELINES,BREVAL,0781862A,141,141,0,0,69,72,6 ème
YVELINES,CHATOU,0781601S,28,28,0,0,17,11,6 ème
YVELINES,CHEVREUSE,0780418F,192,190,0,2,98,94,6 ème
YVELINES,CONFLANS-SAINTE-HONORINE,0780183A,213,198,12,3,107,106,6 ème
YVELINES,ELANCOURT,0780856G,110,106,0,4,49,61,6 ème
YVELINES,GAILLON-SUR-MONTCIENT,0783464S,146,146,0,0,89,57,6 ème
YVELINES,GARGENVILLE,0780758A,147,147,0,0,74,73,6 ème
YVELINES,HOUDAN,0780254C,178,176,0,2,88,90,6 ème
YVELINES,HOUILLES,0783287Z,154,154,0,0,76,78,6 ème
YVELINES,LE CHESNAY-ROCQUENCOURT,0782602E,0,0,0,0,0,0,6 ème
YVELINES,LE CHESNAY-ROCQUENCOURT,0783252L,161,161,0,0,73,88,6 ème
YVELINES,LIMAY,0780255D,141,141,0,0,71,70,6 ème
YVELINES,MAGNANVILLE,0781098V,211,193,15,3,104,107,6 ème
YVELINES,MAISONS-LAFFITTE,0781587B,108,108,0,0,52,56,6 ème
YVELINES,MANTES-LA-JOLIE,0780708W,164,164,0,0,69,95,6 ème
YVELINES,MANTES-LA-JOLIE,0781590E,199,199,0,0,91,108,6 ème
YVELINES,MANTES-LA-JOLIE,0781955B,110,109,0,1,49,61,6 ème
YVELINES,MANTES-LA-JOLIE,0781977A,88,86,0,2,47,41,6 ème
YVELINES,MANTES-LA-VILLE,0780569V,150,138,10,2,76,74,6 ème
YVELINES,MEULAN-EN-YVELINES,0783340G,156,156,0,0,81,75,6 ème
YVELINES,MONTFORT-L'AMAURY,0780262L,216,209,6,1,105,111,6 ème
YVELINES,MONTIGNY-LE-BRETONNEUX,0781954A,77,76,0,1,49,28,6 ème
YVELINES,PLAISIR,0780420H,131,124,7,0,71,60,6 ème
YVELINES,POISSY,0781101Y,110,109,0,1,61,49,6 ème
YVELINES,SAINT-GERMAIN-EN-LAYE,0783816Z,30,30,0,0,8,22,6 ème
YVELINES,VERNEUIL-SUR-SEINE,0780267S,137,121,11,5,74,63,6 ème
YVELINES,VERSAILLES,0783325R,0,0,0,0,0,0,6 ème
LA REUNION,CILAOS,9740096L,75,73,0,2,38,37,6 ème
LA REUNION,LA PLAINE-DES-PALMISTES,9740037X,120,117,0,3,59,61,6 ème
LA REUNION,LE PORT,9740548C,176,173,0,3,89,87,6 ème
LA REUNION,LE PORT,9740812P,180,148,31,1,105,75,6 ème
LA REUNION,LE PORT,9741045T,100,97,0,3,48,52,6 ème
LA REUNION,LES AVIRONS,9740005M,154,154,0,0,68,86,6 ème
LA REUNION,LE TAMPON,9740070H,217,213,0,4,119,98,6 ème
LA REUNION,LE TAMPON,9741581A,142,135,0,7,72,70,6 ème
LA REUNION,SAINT-ANDRE,9740076P,147,147,0,0,69,78,6 ème
LA REUNION,SAINT-BENOIT,9740083X,119,119,0,0,49,70,6 ème
LA REUNION,SAINT-BENOIT,9740702V,198,159,32,7,84,114,6 ème
LA REUNION,SAINT-DENIS,9740080U,191,188,0,3,95,96,6 ème
LA REUNION,SAINT-DENIS,9741044S,153,150,0,3,79,74,6 ème
LA REUNION,SAINT-DENIS,9741188Y,224,220,0,4,103,121,6 ème
LA REUNION,SAINT-DENIS,9741260B,141,138,0,3,75,66,6 ème
LA REUNION,SAINT-LEU,9740018B,108,105,0,3,58,50,6 ème
LA REUNION,SAINT-LOUIS,9741189Z,159,156,0,3,75,84,6 ème
LA REUNION,SAINT-PAUL,9740035V,174,139,30,5,78,96,6 ème
LA REUNION,SAINT-PAUL,9740039Z,183,176,0,7,84,99,6 ème
LA REUNION,SAINT-PAUL,9740784J,197,196,0,1,100,97,6 ème
LA REUNION,SAINT-PAUL,9740932V,156,133,16,7,68,88,6 ème
LA REUNION,SAINT-PIERRE,9740574F,177,150,23,4,79,98,6 ème
LA REUNION,SAINT-PIERRE,9740576H,117,112,0,5,48,69,6 ème
LA REUNION,SAINT-PIERRE,9740811N,147,133,7,7,72,75,6 ème
LA REUNION,SAINT-PIERRE,9741235Z,165,162,0,3,77,88,6 ème
MARTINIQUE,FORT-DE-FRANCE,9720010D,102,84,17,1,42,60,6 ème
MARTINIQUE,FORT-DE-FRANCE,9720064M,216,216,0,0,99,117,6 ème
MARTINIQUE,FORT-DE-FRANCE,9720349X,97,97,0,0,50,47,6 ème
MARTINIQUE,FORT-DE-FRANCE,9720412R,108,81,27,0,49,59,6 ème
MARTINIQUE,FORT-DE-FRANCE,9720855X,31,31,0,0,12,19,6 ème
MARTINIQUE,LE FRANCOIS,9720495F,72,72,0,0,38,34,6 ème
MARTINIQUE,LE MARIN,9720447D,99,88,11,0,53,46,6 ème
MARTINIQUE,LE MORNE-ROUGE,9720066P,39,39,0,0,21,18,6 ème
MARTINIQUE,LE ROBERT,9720019N,61,61,0,0,31,30,6 ème
MARTINIQUE,SAINTE-ANNE,9720514B,53,53,0,0,29,24,6 ème
MARTINIQUE,SAINTE-MARIE,9720513A,53,39,12,2,25,28,6 ème
MAYOTTE,BANDRELE,9760179R,262,260,0,2,131,131,6 ème
MAYOTTE,CHIRONGUI,9760042S,252,252,0,0,128,124,6 ème
MAYOTTE,MAMOUDZOU,9760162X,244,244,0,0,122,122,6 ème
ALLIER,DOMPIERRE-SUR-BESBRE,0030013Y,84,80,0,4,47,37,6 ème
ALLIER,HURIEL,0030018D,57,57,0,0,30,27,6 ème
ALLIER,JALIGNY-SUR-BESBRE,0030019E,44,41,0,3,25,19,6 ème
ALLIER,LAPALISSE,0030092J,87,85,0,2,43,44,6 ème
ALLIER,LE MAYET-DE-MONTAGNE,0030023J,46,46,0,0,21,25,6 ème
ALLIER,MARCILLAT-EN-COMBRAILLE,0030022H,23,23,0,0,16,7,6 ème
ALLIER,MONTLUCON,0030758H,101,93,0,8,50,51,6 ème
ALLIER,MOULINS,0030838V,103,83,16,4,50,53,6 ème
ALLIER,SAINT-YORRE,0031010G,68,66,0,2,39,29,6 ème
ALLIER,VARENNES-SUR-ALLIER,0030924N,0,0,0,0,0,0,6 ème
ALLIER,VICHY,0030050N,109,96,9,4,52,57,6 ème
ALLIER,VICHY,0030070K,121,121,0,0,58,63,6 ème
CANTAL,AURILLAC,0150647X,140,139,0,1,77,63,6 ème
CANTAL,MASSIAC,0150014J,28,28,0,0,19,9,6 ème
CANTAL,MAURIAC,0150016L,66,53,11,2,33,33,6 ème
CANTAL,SAINT-FLOUR,0150029A,69,58,8,3,30,39,6 ème
HAUTE-LOIRE,BRIOUDE,0430109K,2,0,2,0,1,1,6 ème
HAUTE-LOIRE,BRIVES-CHARENSAC,0430101B,0,0,0,0,0,0,6 ème
HAUTE-LOIRE,CRAPONNE-SUR-ARZON,0430010C,37,37,0,0,19,18,6 ème
HAUTE-LOIRE,CRAPONNE-SUR-ARZON,0430068R,29,29,0,0,18,11,6 ème
HAUTE-LOIRE,LA CHAISE-DIEU,0430006Y,13,8,0,5,9,4,6 ème
HAUTE-LOIRE,LE CHAMBON-SUR-LIGNON,0430820H,30,23,7,0,17,13,6 ème
HAUTE-LOIRE,LE MONASTIER-SUR-GAZEILLE,0430017K,52,52,0,0,28,24,6 ème
HAUTE-LOIRE,LE MONASTIER-SUR-GAZEILLE,0430074X,28,28,0,0,13,15,6 ème
HAUTE-LOIRE,LE PUY-EN-VELAY,0430025U,58,58,0,0,18,40,6 ème
HAUTE-LOIRE,LE PUY-EN-VELAY,0430098Y,0,0,0,0,0,0,6 ème
HAUTE-LOIRE,MONISTROL-SUR-LOIRE,0430103D,0,0,0,0,0,0,6 ème
HAUTE-LOIRE,SAINT-DIDIER-EN-VELAY,0430027W,145,145,0,0,75,70,6 ème
HAUTE-LOIRE,SAINTE-SIGOLENE,0430090P,56,53,0,3,22,34,6 ème
HAUTE-LOIRE,YSSINGEAUX,0430135N,127,111,9,7,67,60,6 ème
PUY-DE-DOME,AMBERT,0630001J,0,0,0,0,0,0,6 ème
PUY-DE-DOME,ARLANC,0630006P,30,30,0,0,17,13,6 ème
PUY-DE-DOME,CLERMONT-FERRAND,0631050Z,0,0,0,0,0,0,6 ème
PUY-DE-DOME,CLERMONT-FERRAND,0631410R,136,136,0,0,57,79,6 ème
PUY-DE-DOME,CLERMONT-FERRAND,0631736V,0,0,0,0,0,0,6 ème
PUY-DE-DOME,COURNON-D'AUVERGNE,0630028N,174,172,0,2,94,80,6 ème
PUY-DE-DOME,ISSOIRE,0631604B,159,143,13,3,82,77,6 ème
PUY-DE-DOME,LES MARTRES-DE-VEYRE,0631479R,191,190,0,1,92,99,6 ème
PUY-DE-DOME,MARINGUES,0630039A,126,126,0,0,54,72,6 ème
PUY-DE-DOME,PONTAUMUR,0630047J,44,44,0,0,16,28,6 ème
PUY-DE-DOME,PONTGIBAUD,0630049L,90,90,0,0,38,52,6 ème
PUY-DE-DOME,RIOM,0631121B,137,137,0,0,65,72,6 ème
PUY-DE-DOME,SAINT-ANTHEME,0630058W,16,16,0,0,10,6,6 ème
PUY-DE-DOME,SAINT-DIER-D'AUVERGNE,0630059X,55,55,0,0,22,33,6 ème
PUY-DE-DOME,THIERS,0631238D,169,142,17,10,77,92,6 ème
PUY-DE-DOME,VOLVIC,0630074N,143,139,0,4,73,70,6 ème
PUY-DE-DOME,VOLVIC,0631115V,32,32,0,0,16,16,6 ème
ARDECHE,AUBENAS,0070062E,203,203,0,0,89,114,6 ème
ARDECHE,AUBENAS,0070115M,0,0,0,0,0,0,6 ème
ARDECHE,AUBENAS,0071169H,133,111,21,1,65,68,6 ème
ARDECHE,LES VANS,0070037C,75,75,0,0,30,45,6 ème
ARDECHE,LE TEIL,0070112J,0,0,0,0,0,0,6 ème
ARDECHE,RUOMS,0070863A,67,67,0,0,26,41,6 ème
ARDECHE,VALLON-PONT-D'ARC,0070035A,93,93,0,0,43,50,6 ème
ARDECHE,VILLENEUVE-DE-BERG,0070040F,105,105,0,0,47,58,6 ème
DROME,BEAUMONT-LES-VALENCE,0261528V,146,140,0,6,73,73,6 ème
DROME,CHABEUIL,0260092J,85,85,0,0,38,47,6 ème
DROME,CREST,0260072M,0,0,0,0,0,0,6 ème
DROME,MONTELIMAR,0261034H,12,0,10,2,9,3,6 ème
DROME,PIERRELATTE,0260019E,0,0,0,0,0,0,6 ème
DROME,ROMANS-SUR-ISERE,0260044G,0,0,0,0,0,0,6 ème
DROME,ROMANS-SUR-ISERE,0260078U,0,0,0,0,0,0,6 ème
DROME,SAINT-RAMBERT-D'ALBON,0260029R,113,113,0,0,55,58,6 ème
DROME,VALENCE,0260116K,0,0,0,0,0,0,6 ème
DROME,VALENCE,0261094Y,87,85,0,2,46,41,6 ème
DROME,VALENCE,0261136U,227,226,0,1,109,118,6 ème
HAUTE SAVOIE,ABONDANCE,0741442R,26,26,0,0,16,10,6 ème
HAUTE SAVOIE,ANNECY,0740124H,229,213,16,0,99,130,6 ème
HAUTE SAVOIE,ANNECY,0740929H,163,160,0,3,78,85,6 ème
HAUTE SAVOIE,ANNECY,0741117M,179,168,9,2,87,92,6 ème
HAUTE SAVOIE,BELLEVAUX,0740109S,72,72,0,0,34,38,6 ème
HAUTE SAVOIE,BOEGE,0740048A,144,144,0,0,67,77,6 ème
HAUTE SAVOIE,CHAMONIX-MONT-BLANC,0741116L,109,109,0,0,52,57,6 ème
HAUTE SAVOIE,CRUSEILLES,0740018T,205,205,0,0,90,115,6 ème
HAUTE SAVOIE,DOUVAINE,0740116Z,92,92,0,0,42,50,6 ème
HAUTE SAVOIE,PASSY,0740263J,187,169,13,5,82,105,6 ème
HAUTE SAVOIE,RUMILLY,0741469V,0,0,0,0,0,0,6 ème
HAUTE SAVOIE,SAINT-JORIOZ,0740036M,143,141,0,2,85,58,6 ème
HAUTE SAVOIE,SILLINGY,0741488R,179,174,0,5,88,91,6 ème
HAUTE SAVOIE,THONES,0741283T,147,147,0,0,66,81,6 ème
HAUTE SAVOIE,THONON-LES-BAINS,0740156T,0,0,0,0,0,0,6 ème
HAUTE SAVOIE,THONON-LES-BAINS,0741163M,148,145,0,3,81,67,6 ème
ISERE,BOURGOIN-JALLIEU,0380111P,209,209,0,0,107,102,6 ème
ISERE,CHAMPIER,0383542U,178,178,0,0,87,91,6 ème
ISERE,CHIRENS,0383454Y,167,167,0,0,77,90,6 ème
ISERE,DOMENE,0382268J,152,139,8,5,69,83,6 ème
ISERE,ECHIROLLES,0380021S,141,139,0,2,60,81,6 ème
ISERE,ENTRE-DEUX-GUIERS,0381692H,78,71,0,7,34,44,6 ème
ISERE,GRENOBLE,0381604M,70,70,0,0,35,35,6 ème
ISERE,GRENOBLE,0381664C,246,243,0,3,123,123,6 ème
ISERE,GRENOBLE,0382032C,96,95,0,1,42,54,6 ème
ISERE,GRENOBLE,0382581Z,154,150,0,4,70,84,6 ème
ISERE,LE PONT-DE-BEAUVOISIN,0380053B,0,0,0,0,0,0,6 ème
ISERE,MONESTIER-DE-CLERMONT,0380044S,82,82,0,0,39,43,6 ème
ISERE,MORESTEL,0380046U,134,132,0,2,60,74,6 ème
ISERE,PONT-DE-CHERUY,0382110M,202,184,16,2,89,113,6 ème
ISERE,PONT-EN-ROYANS,0380055D,77,77,0,0,37,40,6 ème
ISERE,RIVES,0382266G,200,182,14,4,114,86,6 ème
ISERE,ROUSSILLON,0380050Y,144,141,0,3,77,67,6 ème
ISERE,SAINT-JEAN-DE-BOURNAY,0382265F,162,161,0,1,72,90,6 ème
ISERE,SAINT-LAURENT-DU-PONT,0380062L,101,101,0,0,51,50,6 ème
ISERE,SAINT-MARCELLIN,0382428H,135,118,15,2,66,69,6 ème
ISERE,SAINT-MAURICE-L'EXIL,0382043P,130,119,9,2,68,62,6 ème
ISERE,SASSENAGE,0382099A,0,0,0,0,0,0,6 ème
ISERE,SEYSSINS,0382431L,125,120,0,5,51,74,6 ème
ISERE,VIENNE,0381678T,0,0,0,0,0,0,6 ème
ISERE,VIENNE,0382195E,200,200,0,0,96,104,6 ème
ISERE,VIF,0382039K,170,168,0,2,85,85,6 ème
ISERE,VILLARD-BONNOT,0381778B,195,195,0,0,101,94,6 ème
ISERE,VIZILLE,0380089R,0,0,0,0,0,0,6 ème
SAVOIE,ALBERTVILLE,0730006K,0,0,0,0,0,0,6 ème
SAVOIE,ALBERTVILLE,0731069R,90,87,0,3,52,38,6 ème
SAVOIE,BARBY,0731306Y,137,135,0,2,57,80,6 ème
SAVOIE,COGNIN,0731113N,131,131,0,0,63,68,6 ème
SAVOIE,FRONTENEX,0730023D,164,159,0,5,86,78,6 ème
SAVOIE,GRESY-SUR-AIX,0731521G,160,157,0,3,70,90,6 ème
SAVOIE,LA MOTTE-SERVOLEX,0730774V,0,0,0,0,0,0,6 ème
SAVOIE,LE CHATELARD,0730020A,65,64,0,1,38,27,6 ème
SAVOIE,MOUTIERS,0730008M,140,120,16,4,70,70,6 ème
SAVOIE,SAINT-ETIENNE-DE-CUINES,0730017X,81,81,0,0,41,40,6 ème
SAVOIE,SAINT-GENIX-LES-VILLAGES,0730036T,150,148,0,2,80,70,6 ème
SAVOIE,SAINT-PAUL-SUR-ISERE,0730769P,27,27,0,0,5,22,6 ème
SAVOIE,UGINE,0730043A,0,0,0,0,0,0,6 ème
AIN,AMBERIEU-EN-BUGEY,0010001W,0,0,0,0,0,0,6 ème
AIN,ARBENT,0010987T,129,128,0,1,59,70,6 ème
AIN,COLIGNY,0011071J,94,94,0,0,45,49,6 ème
AIN,CULOZ,0010022U,102,100,0,2,50,52,6 ème
AIN,FERNEY-VOLTAIRE,0010896U,221,220,0,1,120,101,6 ème
AIN,JASSANS-RIOTTIER,0011193S,143,122,16,5,60,83,6 ème
AIN,MIRIBEL,0011151W,84,84,0,0,37,47,6 ème
AIN,NANTUA,0011068F,106,103,0,3,48,58,6 ème
AIN,PONT-DE-VAUX,0011070H,118,115,0,3,55,63,6 ème
AIN,SAINT-DENIS-LES-BOURG,0011333U,135,133,0,2,69,66,6 ème
AIN,SAINT-RAMBERT-EN-BUGEY,0010039M,84,80,0,4,47,37,6 ème
LOIRE,BALBIGNY,0421455D,109,107,0,2,50,59,6 ème
LOIRE,CHAZELLES-SUR-LYON,0421658Z,91,91,0,0,44,47,6 ème
LOIRE,MONTBRISON,0421002L,0,0,0,0,0,0,6 ème
LOIRE,PANISSIERES,0420023X,69,69,0,0,32,37,6 ème
LOIRE,RIORGES,0421457F,142,140,0,2,72,70,6 ème
LOIRE,SAINT-BONNET-LE-CHATEAU,0421082Y,53,53,0,0,34,19,6 ème
LOIRE,SAINT-CHAMOND,0420968Z,169,150,14,5,79,90,6 ème
LOIRE,SAINT-ETIENNE,0420984S,0,0,0,0,0,0,6 ème
LOIRE,SAINT-ETIENNE,0421041D,126,126,0,0,67,59,6 ème
LOIRE,SAINT-ETIENNE,0421451Z,87,72,12,3,39,48,6 ème
LOIRE,SAINT-ETIENNE,0421801E,179,179,0,0,90,89,6 ème
LOIRE,SAINT-ETIENNE,0421803G,69,66,0,3,28,41,6 ème
LOIRE,SAINT-ETIENNE,0422158T,0,0,0,0,0,0,6 ème
LOIRE,SAINT-GALMIER,0421058X,151,147,0,4,80,71,6 ème
LOIRE,SAINT-GALMIER,0421607U,158,140,16,2,72,86,6 ème
LOIRE,SAINT-GENEST-LERPT,0422160V,0,0,0,0,0,0,6 ème
LOIRE,SAINT-JUST-SAINT-RAMBERT,0421063C,96,96,0,0,51,45,6 ème
LOIRE,SAINT-JUST-SAINT-RAMBERT,0421734G,227,225,0,2,112,115,6 ème
RHONE,ANSE,0690002C,207,205,0,2,98,109,6 ème
RHONE,BEAUJEU,0690005F,70,67,0,3,27,43,6 ème
RHONE,BELLEVILLE-EN-BEAUJOLAIS,0690007H,200,186,13,1,93,107,6 ème
RHONE,CALUIRE-ET-CUIRE,0692165D,8,8,0,0,2,6,6 ème
RHONE,CALUIRE-ET-CUIRE,0692410V,150,148,0,2,61,89,6 ème
RHONE,CHAMPAGNE-AU-MONT-D'OR,0692414Z,171,162,4,5,81,90,6 ème
RHONE,COMMUNAY,0693092L,167,165,0,2,72,95,6 ème
RHONE,ECULLY,0691481K,119,119,0,0,47,72,6 ème
RHONE,ECULLY,0693095P,0,0,0,0,0,0,6 ème
RHONE,GENAS,0693331W,213,213,0,0,89,124,6 ème
RHONE,GIVORS,0690018V,0,0,0,0,0,0,6 ème
RHONE,GIVORS,0691483M,141,140,0,1,68,73,6 ème
RHONE,L'ARBRESLE,0690003D,0,0,0,0,0,0,6 ème
RHONE,LYON,0690043X,0,0,0,0,0,0,6 ème
RHONE,LYON,0690660T,0,0,0,0,0,0,6 ème
RHONE,LYON,0693370N,0,0,0,0,0,0,6 ème
RHONE,LYON,0692693C,109,107,0,2,53,56,6 ème
RHONE,LYON,0692695E,114,109,0,5,59,55,6 ème
RHONE,LYON,0690125L,0,0,0,0,0,0,6 ème
RHONE,LYON,0690601D,50,50,0,0,17,33,6 ème
RHONE,LYON,0691662G,166,164,0,2,79,87,6 ème
RHONE,LYON,0691670R,82,63,15,4,40,42,6 ème
RHONE,LYON,0692696F,213,210,0,3,100,113,6 ème
RHONE,LYON,0692931L,120,120,0,0,63,57,6 ème
RHONE,LYON,0690604G,89,89,0,0,53,36,6 ème
RHONE,LYON,0692938U,45,45,0,0,27,18,6 ème
RHONE,LYON,0690045Z,0,0,0,0,0,0,6 ème
RHONE,MEYZIEU,0691668N,149,149,0,0,75,74,6 ème
RHONE,MEYZIEU,0692335N,158,144,12,2,78,80,6 ème
RHONE,NEUVILLE-SUR-SAONE,0692423J,230,215,11,4,110,120,6 ème
RHONE,OULLINS,0690075G,115,101,11,3,59,56,6 ème
RHONE,OULLINS,0690129R,0,0,0,0,0,0,6 ème
RHONE,RILLIEUX-LA-PAPE,0691680B,0,0,0,0,0,0,6 ème
RHONE,RILLIEUX-LA-PAPE,0692517L,0,0,0,0,0,0,6 ème
RHONE,SAINT-PIERRE-DE-CHANDIEU,0694227V,152,151,0,1,80,72,6 ème
RHONE,SAINT-PRIEST,0691497C,164,164,0,0,74,90,6 ème
RHONE,THIZY-LES-BOURGS,0692164C,38,34,0,4,16,22,6 ème
RHONE,THIZY-LES-BOURGS,0693566B,0,0,0,0,0,0,6 ème
RHONE,VAULX-EN-VELIN,0690249W,147,144,0,3,81,66,6 ème
RHONE,VAULX-EN-VELIN,0690652J,0,0,0,0,0,0,6 ème
RHONE,VENISSIEUX,0692717D,0,0,0,0,0,0,6 ème
RHONE,VILLEFRANCHE-SUR-SAONE,0691644M,0,0,0,0,0,0,6 ème
RHONE,VILLEFRANCHE-SUR-SAONE,0692699J,159,159,0,0,76,83,6 ème
RHONE,VILLEURBANNE,0691478G,165,162,0,3,73,92,6 ème
RHONE,VILLEURBANNE,0691664J,127,108,16,3,66,61,6 ème
RHONE,VILLEURBANNE,0691675W,128,115,12,1,55,73,6 ème
DOUBS,AUDINCOURT,0250003T,137,121,16,0,72,65,6 ème
DOUBS,BART,0251556F,132,126,0,6,56,76,6 ème
DOUBS,BESANCON,0251116C,125,118,0,7,59,66,6 ème
DOUBS,BESANCON,0251348E,128,123,0,5,63,65,6 ème
DOUBS,BESANCON,0251586N,21,19,0,2,13,8,6 ème
DOUBS,BESANCON,0251589S,187,173,14,0,93,94,6 ème
DOUBS,BESANCON,0251592V,0,0,0,0,0,0,6 ème
DOUBS,DOUBS,0251949H,176,158,15,3,82,94,6 ème
DOUBS,LABERGEMENT-SAINTE-MARIE,0251065X,31,31,0,0,16,15,6 ème
DOUBS,LE RUSSEY,0250052W,62,62,0,0,33,29,6 ème
DOUBS,MAICHE,0251373G,102,91,7,4,53,49,6 ème
DOUBS,MANDEURE,0251324D,77,75,0,2,44,33,6 ème
DOUBS,MONTBELIARD,0250067M,0,0,0,0,0,0,6 ème
DOUBS,MONTBELIARD,0251994G,0,0,0,0,0,0,6 ème
DOUBS,PONTARLIER,0251349F,0,0,0,0,0,0,6 ème
DOUBS,PONTARLIER,0251524W,155,152,0,3,79,76,6 ème
DOUBS,PONTARLIER,0251590T,152,152,0,0,77,75,6 ème
DOUBS,PONTARLIER,0251677M,114,109,0,5,53,61,6 ème
DOUBS,ROUGEMONT,0250050U,74,74,0,0,35,39,6 ème
DOUBS,SANCEY,0251061T,27,27,0,0,14,13,6 ème
DOUBS,SAONE,0251376K,150,150,0,0,65,85,6 ème
DOUBS,SOCHAUX,0250056A,192,173,16,3,100,92,6 ème
DOUBS,VALDAHON,0251372F,160,153,0,7,84,76,6 ème
DOUBS,VALENTIGNEY,0251599C,117,111,0,6,54,63,6 ème
HAUTE-SAONE,GRAY,0700010F,69,67,0,2,34,35,6 ème
HAUTE-SAONE,GRAY,0701001H,0,0,0,0,0,0,6 ème
HAUTE-SAONE,GY,0700013J,70,70,0,0,36,34,6 ème
HAUTE-SAONE,LUXEUIL-LES-BAINS,0701078S,0,0,0,0,0,0,6 ème
HAUTE-SAONE,MELISEY,0700925A,76,73,0,3,37,39,6 ème
HAUTE-SAONE,NOIDANS-LES-VESOUL,0701036W,108,107,0,1,45,63,6 ème
HAUTE-SAONE,VESOUL,0701002J,115,115,0,0,61,54,6 ème
HAUTE-SAONE,VILLERSEXEL,0700896U,94,91,0,3,43,51,6 ème
JURA,BLETTERANS,0390004T,99,95,0,4,43,56,6 ème
JURA,CHAMPAGNOLE,0391001B,0,0,0,0,0,0,6 ème
JURA,DOLE,0390015E,0,0,0,0,0,0,6 ème
JURA,LES ROUSSES,0390923S,92,92,0,0,41,51,6 ème
JURA,LONS-LE-SAUNIER,0390906Y,128,125,0,3,57,71,6 ème
JURA,MONT-SOUS-VAUDREY,0390997X,50,50,0,0,28,22,6 ème
JURA,SAINT-AUBIN,0390083D,54,54,0,0,27,27,6 ème
JURA,SALINS-LES-BAINS,0390085F,19,19,0,0,7,12,6 ème
TERRITOIRE DE BELFORT,BELFORT,0900018F,123,122,0,1,65,58,6 ème
TERRITOIRE DE BELFORT,BELFORT,0900235S,65,65,0,0,34,31,6 ème
TERRITOIRE DE BELFORT,BELFORT,0900295G,183,162,17,4,83,100,6 ème
TERRITOIRE DE BELFORT,BELFORT,0900335A,224,224,0,0,110,114,6 ème
TERRITOIRE DE BELFORT,MONTREUX-CHATEAU,0900011Y,114,114,0,0,57,57,6 ème
TERRITOIRE DE BELFORT,MORVILLARS,0900277M,88,88,0,0,37,51,6 ème
COTE D'OR,DIJON,0211227V,75,75,0,0,41,34,6 ème
COTE D'OR,LONGVIC,0210057Y,140,140,0,0,64,76,6 ème
COTE D'OR,SEMUR-EN-AUXOIS,0211088U,64,64,0,0,32,32,6 ème
NIEVRE,CHATEAU-CHINON (VILLE),0580552K,0,0,0,0,0,0,6 ème
NIEVRE,CLAMECY,0580651T,82,82,0,0,46,36,6 ème
NIEVRE,CORBIGNY,0580065F,33,33,0,0,9,24,6 ème
NIEVRE,DECIZE,0580068J,29,29,0,0,13,16,6 ème
NIEVRE,GUERIGNY,0580023K,74,73,0,1,35,39,6 ème
NIEVRE,LA MACHINE,0580028R,33,33,0,0,15,18,6 ème
NIEVRE,NEVERS,0580071M,0,0,0,0,0,0,6 ème
NIEVRE,SAINT-PIERRE-LE-MOUTIER,0580039C,86,86,0,0,36,50,6 ème
SAONE-ET-LOIRE,AUTUN,0710001R,0,0,0,0,0,0,6 ème
SAONE-ET-LOIRE,AUTUN,0711294W,116,98,12,6,53,63,6 ème
SAONE-ET-LOIRE,BUXY,0710007X,87,87,0,0,42,45,6 ème
SAONE-ET-LOIRE,CHALON-SUR-SAONE,0711322B,0,0,0,0,0,0,6 ème
SAONE-ET-LOIRE,CHALON-SUR-SAONE,0711896A,0,0,0,0,0,0,6 ème
SAONE-ET-LOIRE,CHAROLLES,0710155H,107,87,17,3,52,55,6 ème
SAONE-ET-LOIRE,COUCHES,0710025S,86,86,0,0,36,50,6 ème
SAONE-ET-LOIRE,GIVRY,0710125A,25,25,0,0,12,13,6 ème
SAONE-ET-LOIRE,GIVRY,0710154G,119,114,0,5,52,67,6 ème
SAONE-ET-LOIRE,GUEUGNON,0711252A,145,127,16,2,72,73,6 ème
SAONE-ET-LOIRE,LOUHANS,0710042K,0,0,0,0,0,0,6 ème
SAONE-ET-LOIRE,LOUHANS,0711449P,177,158,16,3,77,100,6 ème
SAONE-ET-LOIRE,LUGNY,0710128D,16,16,0,0,8,8,6 ème
SAONE-ET-LOIRE,PARAY-LE-MONIAL,0710061F,82,77,0,5,39,43,6 ème
SAONE-ET-LOIRE,VERDUN-SUR-LE-DOUBS,0710073U,102,102,0,0,49,53,6 ème
YONNE,AUXERRE,0890006Y,184,165,14,5,106,78,6 ème
YONNE,AUXERRE,0890090P,146,141,0,5,73,73,6 ème
YONNE,AVALLON,0890822K,83,62,16,5,44,39,6 ème
YONNE,JOIGNY,0891016W,20,0,20,0,7,13,6 ème
YONNE,MIGENNES,0890017K,80,79,0,1,36,44,6 ème
YONNE,TONNERRE,0890980G,116,94,18,4,63,53,6 ème
YONNE,VILLENEUVE-SUR-YONNE,0890540D,133,132,0,1,65,68,6 ème
COTES D'ARMOR,DINAN,0220081U,130,103,21,6,64,66,6 ème
COTES D'ARMOR,DINAN,0221623V,204,197,0,7,113,91,6 ème
COTES D'ARMOR,LOUDEAC,0220027K,0,0,0,0,0,0,6 ème
COTES D'ARMOR,MERDRIGNAC,0221538C,67,67,0,0,21,46,6 ème
COTES D'ARMOR,PLANCOET,0220038X,130,127,0,3,57,73,6 ème
COTES D'ARMOR,PLENEE-JUGON,0220040Z,99,99,0,0,47,52,6 ème
COTES D'ARMOR,PLENEUF-VAL-ANDRE,0220158C,79,79,0,0,43,36,6 ème
COTES D'ARMOR,PLERIN,0221039K,164,162,0,2,81,83,6 ème
COTES D'ARMOR,PLOUHA,0221512Z,83,83,0,0,49,34,6 ème
COTES D'ARMOR,ROSTRENEN,0221749G,54,51,0,3,31,23,6 ème
COTES D'ARMOR,SAINT-BRIEUC,0220059V,0,0,0,0,0,0,6 ème
COTES D'ARMOR,SAINT-BRIEUC,0220172T,56,53,0,3,27,29,6 ème
COTES D'ARMOR,SAINT-BRIEUC,0221750H,130,130,0,0,73,57,6 ème
COTES D'ARMOR,TREGUIER,0220073K,132,132,0,0,64,68,6 ème
FINISTERE,BANNALEC,0291086Y,112,112,0,0,55,57,6 ème
FINISTERE,BREST,0290100B,126,124,0,2,65,61,6 ème
FINISTERE,BREST,0290108K,0,0,0,0,0,0,6 ème
FINISTERE,BREST,0290149E,88,69,15,4,45,43,6 ème
FINISTERE,BREST,0291594A,110,107,0,3,48,62,6 ème
FINISTERE,BREST,0291868Y,137,137,0,0,73,64,6 ème
FINISTERE,BREST,0292139T,0,0,0,0,0,0,6 ème
FINISTERE,BRIEC,0290244H,80,80,0,0,34,46,6 ème
FINISTERE,CHATEAUNEUF-DU-FAOU,0290252S,28,28,0,0,17,11,6 ème
FINISTERE,LANDERNEAU,0291874E,171,170,0,1,64,107,6 ème
FINISTERE,LANDIVISIAU,0290153J,129,126,0,3,66,63,6 ème
FINISTERE,LANDIVISIAU,0291640A,244,241,0,3,114,130,6 ème
FINISTERE,LANNILIS,0290048V,91,91,0,0,41,50,6 ème
FINISTERE,LESNEVEN,0290049W,138,136,0,2,76,62,6 ème
FINISTERE,LESNEVEN,0291875F,217,201,16,0,108,109,6 ème
FINISTERE,MORLAIX,0291227B,92,90,0,2,38,54,6 ème
FINISTERE,PLABENNEC,0292290G,134,131,0,3,64,70,6 ème
FINISTERE,PLEYBEN,0290053A,64,59,0,5,39,25,6 ème
FINISTERE,PLEYBEN,0290130J,0,0,0,0,0,0,6 ème
FINISTERE,PLOUESCAT,0290056D,55,55,0,0,24,31,6 ème
FINISTERE,PLOUGASNOU,0290057E,24,24,0,0,14,10,6 ème
FINISTERE,PLOZEVET,0290331C,50,50,0,0,13,37,6 ème
FINISTERE,PONT-AVEN,0290060H,60,60,0,0,30,30,6 ème
FINISTERE,PONT-CROIX,0290302W,50,50,0,0,26,24,6 ème
FINISTERE,QUIMPER,0291879K,76,76,0,0,22,54,6 ème
FINISTERE,QUIMPER,0292144Y,0,0,0,0,0,0,6 ème
FINISTERE,ROSPORDEN,0291634U,130,127,0,3,68,62,6 ème
FINISTERE,SAINT-POL-DE-LEON,0290333E,103,87,16,0,55,48,6 ème
FINISTERE,SAINT-POL-DE-LEON,0291883P,175,175,0,0,86,89,6 ème
FINISTERE,SCAER,0290088N,77,77,0,0,37,40,6 ème
FINISTERE,SIZUN,0290089P,67,67,0,0,37,30,6 ème
ILLE-ET-VILAINE,BETTON,0352260S,132,132,0,0,70,62,6 ème
ILLE-ET-VILAINE,CESSON-SEVIGNE,0352972R,9,9,0,0,2,7,6 ème
ILLE-ET-VILAINE,CHARTRES-DE-BRETAGNE,0351852Y,147,147,0,0,75,72,6 ème
ILLE-ET-VILAINE,DOL-DE-BRETAGNE,0350009V,0,0,0,0,0,0,6 ème
ILLE-ET-VILAINE,DOL-DE-BRETAGNE,0350767U,170,168,0,2,71,99,6 ème
ILLE-ET-VILAINE,GUIGNEN,0350864Z,108,108,0,0,47,61,6 ème
ILLE-ET-VILAINE,JANZE,0351053E,153,125,28,0,69,84,6 ème
ILLE-ET-VILAINE,LAILLE,0352959B,121,121,0,0,55,66,6 ème
ILLE-ET-VILAINE,LA MEZIERE,0352760K,165,165,0,0,80,85,6 ème
ILLE-ET-VILAINE,LE RHEU,0351847T,172,169,0,3,77,95,6 ème
ILLE-ET-VILAINE,LIFFRE,0350867C,157,157,0,0,63,94,6 ème
ILLE-ET-VILAINE,ORGERES,0352691K,142,142,0,0,74,68,6 ème
ILLE-ET-VILAINE,REDON,0350775C,183,170,10,3,86,97,6 ème
ILLE-ET-VILAINE,REDON,0350790U,0,0,0,0,0,0,6 ème
ILLE-ET-VILAINE,RENNES,0350027P,152,152,0,0,84,68,6 ème
ILLE-ET-VILAINE,RENNES,0350734H,86,86,0,0,38,48,6 ème
ILLE-ET-VILAINE,RENNES,0350836U,104,104,0,0,64,40,6 ème
ILLE-ET-VILAINE,RENNES,0350963G,173,159,14,0,78,95,6 ème
ILLE-ET-VILAINE,RENNES,0351638R,190,190,0,0,95,95,6 ème
ILLE-ET-VILAINE,RENNES,0352069J,172,158,14,0,75,97,6 ème
ILLE-ET-VILAINE,ROMILLE,0350057X,124,124,0,0,63,61,6 ème
ILLE-ET-VILAINE,SAINT-AUBIN-D'AUBIGNE,0350881T,146,146,0,0,74,72,6 ème
ILLE-ET-VILAINE,SAINT-AUBIN-D'AUBIGNE,0351849V,156,138,16,2,66,90,6 ème
ILLE-ET-VILAINE,SAINT-AUBIN-DU-CORMIER,0350039C,134,134,0,0,66,68,6 ème
ILLE-ET-VILAINE,SAINT-GEORGES-DE-REINTEMBAULT,0350885X,46,46,0,0,23,23,6 ème
ILLE-ET-VILAINE,SAINT-JACQUES-DE-LA-LANDE,0352589Z,107,106,0,1,53,54,6 ème
ILLE-ET-VILAINE,SAINT-MALO,0350044H,87,84,0,3,40,47,6 ème
ILLE-ET-VILAINE,SAINT-MALO,0350916F,124,112,12,0,55,69,6 ème
ILLE-ET-VILAINE,VAL-COUESNON,0350848G,39,39,0,0,23,16,6 ème
ILLE-ET-VILAINE,VITRE,0351909K,147,127,19,1,72,75,6 ème
MORBIHAN,ARRADON,0561598H,143,142,0,1,60,83,6 ème
MORBIHAN,AURAY,0560002Y,108,91,12,5,58,50,6 ème
MORBIHAN,CARNAC,0560006C,92,92,0,0,45,47,6 ème
MORBIHAN,CARNAC,0560127J,84,84,0,0,41,43,6 ème
MORBIHAN,ELVEN,0560129L,146,146,0,0,84,62,6 ème
MORBIHAN,GUEMENE-SUR-SCORFF,0560133R,31,31,0,0,15,16,6 ème
MORBIHAN,JOSSELIN,0560019S,0,0,0,0,0,0,6 ème
MORBIHAN,LANESTER,0560022V,98,98,0,0,47,51,6 ème
MORBIHAN,LA TRINITE-PORHOET,0560174K,50,50,0,0,27,23,6 ème
MORBIHAN,LE FAOUET,0560010G,49,46,0,3,25,24,6 ème
MORBIHAN,LOCMINE,0560024X,92,92,0,0,48,44,6 ème
MORBIHAN,LORIENT,0561330S,64,47,14,3,33,31,6 ème
MORBIHAN,PLOUAY,0561403W,73,73,0,0,26,47,6 ème
MORBIHAN,PLUNERET,0561616C,107,107,0,0,49,58,6 ème
MORBIHAN,QUIBERON,0560168D,24,24,0,0,12,12,6 ème
MORBIHAN,SARZEAU,0560048Y,110,110,0,0,60,50,6 ème
MORBIHAN,VANNES,0560053D,0,0,0,0,0,0,6 ème
MORBIHAN,VANNES,0560115W,116,108,0,8,45,71,6 ème
MORBIHAN,VANNES,0561792U,38,38,0,0,16,22,6 ème
CHER,BOURGES,0180777X,159,144,14,1,75,84,6 ème
CHER,DUN-SUR-AURON,0180736C,76,70,5,1,35,41,6 ème
CHER,SAINT-AMAND-MONTROND,0180025E,0,0,0,0,0,0,6 ème
CHER,SAINT-AMAND-MONTROND,0180026F,0,0,0,0,0,0,6 ème
CHER,SANCERGUES,0180745M,62,62,0,0,33,29,6 ème
EURE-ET-LOIR,CHARTRES,0280756V,100,99,0,1,65,35,6 ème
EURE-ET-LOIR,CHATEAUDUN,0280700J,0,0,0,0,0,0,6 ème
EURE-ET-LOIR,CLOYES-LES-TROIS-RIVIERES,0280867R,111,107,0,4,56,55,6 ème
EURE-ET-LOIR,COURVILLE-SUR-EURE,0280018T,190,188,0,2,93,97,6 ème
EURE-ET-LOIR,DREUX,0280658N,108,106,0,2,51,57,6 ème
EURE-ET-LOIR,DREUX,0280925D,0,0,0,0,0,0,6 ème
EURE-ET-LOIR,GALLARDON,0280701K,140,138,0,2,77,63,6 ème
EURE-ET-LOIR,LUCE,0280009H,0,0,0,0,0,0,6 ème
EURE-ET-LOIR,MAINVILLIERS,0280659P,16,0,16,0,4,12,6 ème
EURE-ET-LOIR,MIGNIERES,0280664V,81,78,0,3,38,43,6 ème
EURE-ET-LOIR,NOGENT-LE-ROTROU,0280669A,34,32,0,2,20,14,6 ème
EURE-ET-LOIR,TOURY,0280884J,88,87,0,1,37,51,6 ème
INDRE,BUZANCAIS,0360498W,113,96,9,8,51,62,6 ème
INDRE,CHATEAUROUX,0360543V,86,86,0,0,42,44,6 ème
INDRE,LA CHATRE,0360720M,104,96,6,2,47,57,6 ème
INDRE,VATAN,0360040Y,59,59,0,0,32,27,6 ème
INDRE-ET-LOIRE,AMBOISE,0371123V,0,0,0,0,0,0,6 ème
INDRE-ET-LOIRE,BLERE,0371124W,138,138,0,0,74,64,6 ème
INDRE-ET-LOIRE,CHATEAU-RENAULT,0370007G,178,164,9,5,90,88,6 ème
INDRE-ET-LOIRE,CHINON,0371159J,156,135,16,5,81,75,6 ème
INDRE-ET-LOIRE,CORMERY,0370010K,138,138,0,0,70,68,6 ème
INDRE-ET-LOIRE,ESVRES,0371204H,139,139,0,0,67,72,6 ème
INDRE-ET-LOIRE,JOUE-LES-TOURS,0371098T,108,105,0,3,59,49,6 ème
INDRE-ET-LOIRE,JOUE-LES-TOURS,0371316E,72,68,0,4,36,36,6 ème
INDRE-ET-LOIRE,LOCHES,0370768J,205,185,15,5,107,98,6 ème
INDRE-ET-LOIRE,LUYNES,0371378X,95,95,0,0,43,52,6 ème
INDRE-ET-LOIRE,MONTRESOR,0370051E,60,60,0,0,34,26,6 ème
INDRE-ET-LOIRE,PREUILLY-SUR-CLAISE,0370738B,17,17,0,0,8,9,6 ème
INDRE-ET-LOIRE,TOURS,0370041U,105,100,0,5,50,55,6 ème
INDRE-ET-LOIRE,TOURS,0370053G,0,0,0,0,0,0,6 ème
INDRE-ET-LOIRE,TOURS,0370743G,62,62,0,0,26,36,6 ème
INDRE-ET-LOIRE,VOUVRAY,0371189S,162,157,0,5,84,78,6 ème
LOIRET,CHATEAU-RENARD,0451107J,120,117,0,3,64,56,6 ème
LOIRET,CHECY,0451365P,174,172,0,2,88,86,6 ème
LOIRET,CLERY-SAINT-ANDRE,0451434P,125,122,0,3,62,63,6 ème
LOIRET,FLEURY-LES-AUBRAIS,0450784H,192,184,8,0,94,98,6 ème
LOIRET,GIEN,0451037H,0,0,0,0,0,0,6 ème
LOIRET,ORLEANS,0450109Z,134,132,0,2,73,61,6 ème
LOIRET,PITHIVIERS,0451332D,54,54,0,0,27,27,6 ème
LOIR-ET-CHER,BLOIS,0410693F,0,0,0,0,0,0,6 ème
LOIR-ET-CHER,BLOIS,0410790L,178,161,14,3,98,80,6 ème
LOIR-ET-CHER,BLOIS,0410860M,170,163,0,7,89,81,6 ème
LOIR-ET-CHER,BLOIS,0410952M,77,77,0,0,40,37,6 ème
LOIR-ET-CHER,BRACIEUX,0410005H,98,96,0,2,53,45,6 ème
LOIR-ET-CHER,LE CONTROIS-EN-SOLOGNE,0410595Z,163,162,0,1,76,87,6 ème
LOIR-ET-CHER,MONDOUBLEAU,0410596A,79,78,0,1,36,43,6 ème
LOIR-ET-CHER,ROMORANTIN-LANTHENAY,0410036S,0,0,0,0,0,0,6 ème
LOIR-ET-CHER,ROMORANTIN-LANTHENAY,0410793P,124,117,0,7,66,58,6 ème
LOIR-ET-CHER,SAMBIN,0410677N,136,136,0,0,71,65,6 ème
LOIR-ET-CHER,SELLES-SUR-CHER,0410651K,103,98,0,5,46,57,6 ème
LOIR-ET-CHER,VENDOME,0410031L,0,0,0,0,0,0,6 ème
LOIR-ET-CHER,VINEUIL,0410773T,37,37,0,0,18,19,6 ème
CORSE-DU-SUD,AJACCIO,6200010S,133,133,0,0,68,65,6 ème
CORSE-DU-SUD,BONIFACIO,6200015X,64,64,0,0,27,37,6 ème
CORSE-DU-SUD,SARROLA-CARCOPINO,6200191N,180,180,0,0,92,88,6 ème
HAUTE-CORSE,BASTIA,7200139N,105,105,0,0,47,58,6 ème
HAUTE-CORSE,BIGUGLIA,7200727C,142,131,11,0,60,82,6 ème
MEURTHE-ET-MOSELLE,BACCARAT,0540001H,91,89,0,2,41,50,6 ème
MEURTHE-ET-MOSELLE,BLENOD-LES-PONT-A-MOUSSON,0541576V,160,140,17,3,80,80,6 ème
MEURTHE-ET-MOSELLE,CHAMPIGNEULLES,0541466A,119,104,14,1,55,64,6 ème
MEURTHE-ET-MOSELLE,CIREY-SUR-VEZOUZE,0540011U,73,64,9,0,36,37,6 ème
MEURTHE-ET-MOSELLE,DIEULOUARD,0540013W,147,147,0,0,71,76,6 ème
MEURTHE-ET-MOSELLE,DOMBASLE-SUR-MEURTHE,0540014X,71,68,0,3,39,32,6 ème
MEURTHE-ET-MOSELLE,DOMBASLE-SUR-MEURTHE,0540015Y,0,0,0,0,0,0,6 ème
MEURTHE-ET-MOSELLE,EINVILLE-AU-JARD,0540017A,66,66,0,0,34,32,6 ème
MEURTHE-ET-MOSELLE,FOUG,0540019C,27,27,0,0,14,13,6 ème
MEURTHE-ET-MOSELLE,HEILLECOURT,0542468P,158,150,0,8,70,88,6 ème
MEURTHE-ET-MOSELLE,JARNY,0540025J,187,171,12,4,85,102,6 ème
MEURTHE-ET-MOSELLE,LONGLAVILLE,0541578X,90,90,0,0,51,39,6 ème
MEURTHE-ET-MOSELLE,LONGUYON,0541452K,15,15,0,0,6,9,6 ème
MEURTHE-ET-MOSELLE,LONGWY,0541989U,147,147,0,0,67,80,6 ème
MEURTHE-ET-MOSELLE,LUNEVILLE,0540037X,0,0,0,0,0,0,6 ème
MEURTHE-ET-MOSELLE,MALZEVILLE,0541474J,147,146,0,1,79,68,6 ème
MEURTHE-ET-MOSELLE,NANCY,0541364P,0,0,0,0,0,0,6 ème
MEURTHE-ET-MOSELLE,NANCY,0541819J,111,111,0,0,47,64,6 ème
MEURTHE-ET-MOSELLE,NEUVES-MAISONS,0541573S,141,124,14,3,69,72,6 ème
MEURTHE-ET-MOSELLE,PONT-A-MOUSSON,0541440X,74,74,0,0,28,46,6 ème
MEURTHE-ET-MOSELLE,TOUL,0541330C,102,99,0,3,46,56,6 ème
MEURTHE-ET-MOSELLE,TOUL,0541565H,157,134,21,2,67,90,6 ème
MEURTHE-ET-MOSELLE,VAL DE BRIEY,0541338L,11,0,10,1,6,5,6 ème
MEURTHE-ET-MOSELLE,VILLERS-LES-NANCY,0541776M,85,83,0,2,40,45,6 ème
MEUSE,ANCEMONT,0550859K,82,82,0,0,37,45,6 ème
MEUSE,ANCERVILLE,0550848Y,74,74,0,0,36,38,6 ème
MEUSE,BAR-LE-DUC,0550046B,83,83,0,0,37,46,6 ème
MEUSE,LIGNY-EN-BARROIS,0550052H,23,23,0,0,12,11,6 ème
MEUSE,LIGNY-EN-BARROIS,0550700M,0,0,0,0,0,0,6 ème
MEUSE,VAUCOULEURS,0550023B,85,83,0,2,44,41,6 ème
MOSELLE,AMNEVILLE,0572689N,137,133,0,4,62,75,6 ème
MOSELLE,BOULAY-MOSELLE,0570225K,0,0,0,0,0,0,6 ème
MOSELLE,CHATEAU-SALINS,0570327W,71,70,0,1,30,41,6 ème
MOSELLE,CREUTZWALD,0572022N,0,0,0,0,0,0,6 ème
MOSELLE,FALCK,0572358D,95,95,0,0,52,43,6 ème
MOSELLE,HAM-SOUS-VARSBERG,0572359E,110,110,0,0,53,57,6 ème
MOSELLE,HARTZVILLER,0570038G,58,58,0,0,23,35,6 ème
MOSELLE,HAYANGE,0570077Z,0,0,0,0,0,0,6 ème
MOSELLE,HAYANGE,0572171A,103,101,0,2,45,58,6 ème
MOSELLE,HAYANGE,0572480L,154,149,0,5,68,86,6 ème
MOSELLE,KEDANGE-SUR-CANNER,0570315H,157,157,0,0,82,75,6 ème
MOSELLE,MARLY,0572082D,139,133,0,6,57,82,6 ème
MOSELLE,MARLY,0572754J,83,83,0,0,53,30,6 ème
MOSELLE,METZ,0570127D,101,101,0,0,49,52,6 ème
MOSELLE,METZ,0572809U,165,165,0,0,83,82,6 ème
MOSELLE,METZ,0572925V,234,234,0,0,107,127,6 ème
MOSELLE,METZ,0573688Z,9,9,0,0,3,6,6 ème
MOSELLE,MONTIGNY-LES-METZ,0570144X,0,0,0,0,0,0,6 ème
MOSELLE,MOULINS-LES-METZ,0572477H,73,63,6,4,30,43,6 ème
MOSELLE,PELTRE,0572928Y,36,36,0,0,13,23,6 ème
MOSELLE,PUTTELANGE-AUX-LACS,0572183N,94,90,0,4,44,50,6 ème
MOSELLE,REMILLY,0572013D,141,138,0,3,64,77,6 ème
MOSELLE,SAINT-AVOLD,0570087K,0,0,0,0,0,0,6 ème
MOSELLE,SAINT-AVOLD,0570268G,0,0,0,0,0,0,6 ème
MOSELLE,SARRALBE,0570093S,113,113,0,0,51,62,6 ème
MOSELLE,SARREBOURG,0572816B,136,135,0,1,77,59,6 ème
MOSELLE,SARREGUEMINES,0572021M,80,74,0,6,41,39,6 ème
MOSELLE,TALANGE,0572174D,89,85,3,1,42,47,6 ème
MOSELLE,THIONVILLE,0572812X,108,106,0,2,44,64,6 ème
MOSELLE,THIONVILLE,0572931B,326,326,0,0,176,150,6 ème
MOSELLE,UCKANGE,0570318L,99,96,0,3,56,43,6 ème
VOSGES,BRUYERES,0880106M,33,33,0,0,20,13,6 ème
VOSGES,ELOYES,0881371M,91,88,0,3,42,49,6 ème
VOSGES,EPINAL,0881119N,3,0,3,0,0,3,6 ème
VOSGES,EPINAL,0881146T,170,160,4,6,71,99,6 ème
VOSGES,GOLBEY,0881097P,185,180,0,5,84,101,6 ème
VOSGES,LAMARCHE,0880034J,28,28,0,0,19,9,6 ème
VOSGES,LIFFOL-LE-GRAND,0881103W,41,41,0,0,16,25,6 ème
VOSGES,MONTHUREUX-SUR-SAONE,0881386D,52,52,0,0,23,29,6 ème
VOSGES,NEUFCHATEAU,0880040R,0,0,0,0,0,0,6 ème
VOSGES,PROVENCHERES-ET-COLROY,0880044V,42,42,0,0,24,18,6 ème
VOSGES,RAMBERVILLERS,0880114W,36,34,0,2,11,25,6 ème
VOSGES,RAON-L'ETAPE,0881370L,0,0,0,0,0,0,6 ème
VOSGES,REMIREMONT,0881498A,0,0,0,0,0,0,6 ème
VOSGES,VAGNEY,0881372N,86,86,0,0,41,45,6 ème
ARDENNES,CHARLEVILLE-MEZIERES,0080011U,100,100,0,0,57,43,6 ème
ARDENNES,CHARLEVILLE-MEZIERES,0080082W,0,0,0,0,0,0,6 ème
ARDENNES,CHARLEVILLE-MEZIERES,0080829H,54,54,0,0,29,25,6 ème
ARDENNES,CHARLEVILLE-MEZIERES,0080994M,92,92,0,0,39,53,6 ème
ARDENNES,FUMAY,0080017A,60,49,7,4,28,32,6 ème
ARDENNES,RAUCOURT-ET-FLABA,0081103F,72,72,0,0,34,38,6 ème
ARDENNES,RETHEL,0080897G,82,82,0,0,41,41,6 ème
ARDENNES,SEDAN,0080826E,61,52,6,3,26,35,6 ème
ARDENNES,SEDAN,0080995N,157,157,0,0,78,79,6 ème
ARDENNES,SIGNY-L'ABBAYE,0081104G,91,91,0,0,46,45,6 ème
AUBE,BRIENNE-LE-CHATEAU,0100007D,88,84,4,0,37,51,6 ème
AUBE,MESNIL-SAINT-LOUP,0100051B,30,30,0,0,12,18,6 ème
AUBE,NOGENT-SUR-SEINE,0100786A,154,153,0,1,75,79,6 ème
AUBE,PINEY,0100013K,81,81,0,0,42,39,6 ème
AUBE,TROYES,0100038M,121,120,0,1,59,62,6 ème
AUBE,TROYES,0100056G,64,64,0,0,31,33,6 ème
HAUTE-MARNE,BOURBONNE-LES-BAINS,0520706K,40,37,0,3,20,20,6 ème
HAUTE-MARNE,CHALINDREY,0520794F,36,36,0,0,24,12,6 ème
HAUTE-MARNE,CHAUMONT,0520733P,96,95,0,1,47,49,6 ème
HAUTE-MARNE,CHAUMONT,0520737U,84,82,0,2,37,47,6 ème
HAUTE-MARNE,COLOMBEY LES DEUX EGLISES,0520814C,33,33,0,0,18,15,6 ème
HAUTE-MARNE,LANGRES,0520052Z,72,68,0,4,44,28,6 ème
HAUTE-MARNE,LANGRES,0520967U,47,47,0,0,25,22,6 ème
HAUTE-MARNE,SAINT-DIZIER,0521123N,2,2,0,0,0,2,6 ème
HAUTE-MARNE,VAL-DE-MEUSE,0520023T,37,37,0,0,14,23,6 ème
HAUTE-MARNE,WASSY,0520708M,94,89,0,5,35,59,6 ème
MARNE,BLANCS-COTEAUX,0510059M,90,90,0,0,38,52,6 ème
MARNE,CHALONS-EN-CHAMPAGNE,0511711H,69,67,0,2,27,42,6 ème
MARNE,EPERNAY,0510068X,0,0,0,0,0,0,6 ème
MARNE,FERE-CHAMPENOISE,0510022X,70,70,0,0,36,34,6 ème
MARNE,FISMES,0511176B,66,64,0,2,22,44,6 ème
MARNE,PONTFAVERGER-MORONVILLIERS,0510030F,76,76,0,0,41,35,6 ème
MARNE,REIMS,0511138K,204,202,0,2,105,99,6 ème
MARNE,REIMS,0511146U,0,0,0,0,0,0,6 ème
MARNE,REIMS,0511799D,99,96,0,3,45,54,6 ème
MARNE,REIMS,0511802G,87,86,0,1,34,53,6 ème
MARNE,SERMAIZE-LES-BAINS,0510052E,98,92,6,0,46,52,6 ème
MARNE,SEZANNE,0510053F,0,0,0,0,0,0,6 ème
MARNE,SEZANNE,0510054G,114,102,9,3,47,67,6 ème
MARNE,TINQUEUX,0511187N,177,166,11,0,77,100,6 ème
MARNE,VITRY-LE-FRANCOIS,0511256N,126,111,12,3,64,62,6 ème
BAS-RHIN,BARR,0673006D,98,89,7,2,42,56,6 ème
BAS-RHIN,BISCHHEIM,0671822S,140,134,0,6,69,71,6 ème
BAS-RHIN,BISCHWILLER,0672130B,221,207,12,2,109,112,6 ème
BAS-RHIN,BOUXWILLER,0672076T,131,115,12,4,64,67,6 ème
BAS-RHIN,DIEMERINGEN,0671741D,68,58,0,10,33,35,6 ème
BAS-RHIN,HAGUENAU,0670024M,0,0,0,0,0,0,6 ème
BAS-RHIN,HAGUENAU,0671509B,0,0,0,0,0,0,6 ème
BAS-RHIN,INGWILLER,0670035Z,71,70,0,1,37,34,6 ème
BAS-RHIN,LA WANTZENAU,0671689X,156,154,0,2,68,88,6 ème
BAS-RHIN,OBERNAI,0670050R,0,0,0,0,0,0,6 ème
BAS-RHIN,PFULGRIESHEIM,0672193V,123,120,0,3,53,70,6 ème
BAS-RHIN,SCHILTIGHEIM,0670062D,0,0,0,0,0,0,6 ème
BAS-RHIN,SCHILTIGHEIM,0672602P,0,0,0,0,0,0,6 ème
BAS-RHIN,SELESTAT,0671832C,0,0,0,0,0,0,6 ème
BAS-RHIN,STRASBOURG,0670129B,0,0,0,0,0,0,6 ème
BAS-RHIN,STRASBOURG,0671692A,99,86,11,2,40,59,6 ème
BAS-RHIN,STRASBOURG,0671907J,199,183,16,0,106,93,6 ème
BAS-RHIN,STRASBOURG,0671958P,125,122,0,3,64,61,6 ème
BAS-RHIN,STRASBOURG,0672129A,139,131,0,8,71,68,6 ème
BAS-RHIN,STRASBOURG,0672306T,174,174,0,0,94,80,6 ème
BAS-RHIN,STRASBOURG,0672806L,0,0,0,0,0,0,6 ème
HAUT-RHIN,BUHL,0682018Z,88,84,0,4,41,47,6 ème
HAUT-RHIN,BURNHAUPT-LE-HAUT,0682017Y,149,145,0,4,79,70,6 ème
HAUT-RHIN,CARSPACH,0680154Y,0,0,0,0,0,0,6 ème
HAUT-RHIN,COLMAR,0680009R,115,111,0,4,62,53,6 ème
HAUT-RHIN,COLMAR,0680084X,136,112,19,5,70,66,6 ème
HAUT-RHIN,COLMAR,0681656F,0,0,0,0,0,0,6 ème
HAUT-RHIN,GUEBWILLER,0681318N,176,155,20,1,77,99,6 ème
HAUT-RHIN,HABSHEIM,0681713T,86,86,0,0,32,54,6 ème
HAUT-RHIN,ILLZACH,0681757R,85,83,0,2,45,40,6 ème
HAUT-RHIN,INGERSHEIM,0681654D,113,112,0,1,60,53,6 ème
HAUT-RHIN,KAYSERSBERG VIGNOBLE,0680022E,58,58,0,0,31,27,6 ème
HAUT-RHIN,KINGERSHEIM,0681369U,140,140,0,0,62,78,6 ème
HAUT-RHIN,MASEVAUX-NIEDERBRUCK,0681265F,117,117,0,0,57,60,6 ème
HAUT-RHIN,MULHOUSE,0680037W,0,0,0,0,0,0,6 ème
HAUT-RHIN,MULHOUSE,0681284B,118,118,0,0,57,61,6 ème
HAUT-RHIN,MUNSTER,0681539D,135,135,0,0,57,78,6 ème
HAUT-RHIN,PULVERSHEIM,0681801N,0,0,0,0,0,0,6 ème
HAUT-RHIN,RIEDISHEIM,0680112C,111,107,0,4,56,55,6 ème
HAUT-RHIN,RIXHEIM,0680129W,176,156,16,4,81,95,6 ème
HAUT-RHIN,ROUFFACH,0680139G,91,91,0,0,46,45,6 ème
HAUT-RHIN,SAINTE-MARIE-AUX-MINES,0680068E,0,0,0,0,0,0,6 ème
HAUT-RHIN,SAINTE-MARIE-AUX-MINES,0681394W,101,84,12,5,49,52,6 ème
HAUT-RHIN,WINTZENHEIM,0681365P,135,114,14,7,59,76,6 ème
GUADELOUPE,BAIE-MAHAULT,9710040S,229,228,0,1,109,120,6 ème
GUADELOUPE,BAIE-MAHAULT,9710057K,217,217,0,0,113,104,6 ème
GUADELOUPE,BAIE-MAHAULT,9710593T,0,0,0,0,0,0,6 ème
GUADELOUPE,BASSE-TERRE,9710061P,30,30,0,0,16,14,6 ème
GUADELOUPE,DESHAIES,9710643X,44,44,0,0,19,25,6 ème
GUADELOUPE,GRAND-BOURG,9711012Y,0,0,0,0,0,0,6 ème
GUADELOUPE,LES ABYMES,9711046K,0,0,0,0,0,0,6 ème
GUADELOUPE,MORNE-A-L'EAU,9710709U,0,0,0,0,0,0,6 ème
GUADELOUPE,PETIT-BOURG,9710016R,225,207,13,5,127,98,6 ème
GUADELOUPE,POINTE-A-PITRE,9710661S,71,71,0,0,40,31,6 ème
GUADELOUPE,POINTE-A-PITRE,9710987W,146,146,0,0,83,63,6 ème
GUADELOUPE,POINTE-A-PITRE,9710988X,99,99,0,0,36,63,6 ème
GUADELOUPE,SAINT-BARTHELEMY,9710035L,82,79,0,3,44,38,6 ème
GUADELOUPE,TROIS-RIVIERES,9710707S,83,80,0,3,51,32,6 ème
GUYANE,CAMOPI,9730451C,35,27,8,0,15,20,6 ème
GUYANE,CAYENNE,9730132F,132,132,0,0,72,60,6 ème
GUYANE,MATOURY,9730536V,91,91,0,0,56,35,6 ème
GUYANE,SAINT-LAURENT-DU-MARONI,9730497C,63,63,0,0,30,33,6 ème
GUYANE,SINNAMARY,9730145V,58,38,19,1,34,24,6 ème
AISNE,ANIZY-LE-GRAND,0020002S,119,116,3,0,58,61,6 ème
AISNE,BOHAIN-EN-VERMANDOIS,0020007X,99,80,14,5,56,43,6 ème
AISNE,BOHAIN-EN-VERMANDOIS,0020498F,0,0,0,0,0,0,6 ème
AISNE,CHAUNY,0020469Z,56,56,0,0,33,23,6 ème
AISNE,CHAUNY,0021906L,0,0,0,0,0,0,6 ème
AISNE,CRECY-SUR-SERRE,0021721K,101,101,0,0,48,53,6 ème
AISNE,FONTAINE-LES-VERVINS,0020470A,46,46,0,0,33,13,6 ème
AISNE,FRESNOY-LE-GRAND,0021661V,83,82,0,1,42,41,6 ème
AISNE,GAUCHY,0021494N,112,107,4,1,61,51,6 ème
AISNE,GUISE,0020030X,95,72,15,8,50,45,6 ème
AISNE,GUISE,0021479X,0,0,0,0,0,0,6 ème
AISNE,HIRSON,0020484R,29,29,0,0,15,14,6 ème
AISNE,LAON,0020034B,0,0,0,0,0,0,6 ème
AISNE,LAON,0020471B,63,63,0,0,28,35,6 ème
AISNE,LAON,0021598B,159,143,7,9,79,80,6 ème
AISNE,LAON,0021685W,150,144,0,6,90,60,6 ème
AISNE,MARLE,0021778X,82,80,0,2,44,38,6 ème
AISNE,SAINS-RICHAUMONT,0020044M,42,42,0,0,23,19,6 ème
AISNE,SAINT-QUENTIN,0020055Z,108,95,13,0,48,60,6 ème
AISNE,SAINT-QUENTIN,0020076X,87,87,0,0,50,37,6 ème
AISNE,SOISSONS,0021525X,207,207,0,0,101,106,6 ème
AISNE,SOISSONS,0021535H,97,92,0,5,45,52,6 ème
OISE,AUNEUIL,0601799E,122,108,13,1,57,65,6 ème
OISE,BEAUVAIS,0601139M,141,140,0,1,91,50,6 ème
OISE,BEAUVAIS,0601190T,166,155,11,0,83,83,6 ème
OISE,BREUIL-LE-VERT,0601834T,195,179,16,0,100,95,6 ème
OISE,CHAUMONT-EN-VEXIN,0600012M,105,105,0,0,45,60,6 ème
OISE,CHAUMONT-EN-VEXIN,0601882V,125,125,0,0,60,65,6 ème
OISE,GUISCARD,0602004C,68,68,0,0,35,33,6 ème
OISE,MERU,0601718S,88,87,0,1,47,41,6 ème
OISE,NOGENT-SUR-OISE,0600036N,143,142,0,1,66,77,6 ème
OISE,NOGENT-SUR-OISE,0601179F,193,190,0,3,85,108,6 ème
OISE,SAINTE-GENEVIEVE,0601938F,133,130,0,3,73,60,6 ème
OISE,SENLIS,0600049C,0,0,0,0,0,0,6 ème
OISE,SENLIS,0601150Z,253,250,0,3,132,121,6 ème
OISE,THOUROTTE,0601446W,149,148,0,1,78,71,6 ème
OISE,VERBERIE,0601407D,130,130,0,0,73,57,6 ème
SOMME,ACHEUX-EN-AMIENOIS,0800003U,63,63,0,0,30,33,6 ème
SOMME,AIRAINES,0801510G,98,76,17,5,40,58,6 ème
SOMME,ALBERT,0801786G,91,80,11,0,46,45,6 ème
SOMME,AMIENS,0800017J,117,105,11,1,56,61,6 ème
SOMME,AMIENS,0800018K,168,148,17,3,72,96,6 ème
SOMME,AMIENS,0801208D,74,74,0,0,40,34,6 ème
SOMME,AMIENS,0801211G,154,154,0,0,74,80,6 ème
SOMME,AMIENS,0802134K,104,102,0,2,46,58,6 ème
SOMME,BEAUCAMPS-LE-VIEUX,0801443J,58,57,0,1,32,26,6 ème
SOMME,FLIXECOURT,0801222U,79,79,0,0,31,48,6 ème
SOMME,PERONNE,0801723N,74,74,0,0,36,38,6 ème
SOMME,VILLERS-BOCAGE,0801339W,145,145,0,0,63,82,6 ème
NORD,ANICHE,0590002G,229,212,13,4,118,111,6 ème
NORD,ARMENTIERES,0593246H,149,141,8,0,80,69,6 ème
NORD,AUBY,0594297A,98,89,6,3,41,57,6 ème
NORD,AUBY,0594532F,0,0,0,0,0,0,6 ème
NORD,AULNOYE-AYMERIES,0595383F,56,56,0,0,22,34,6 ème
NORD,AULNOYE-AYMERIES,0596694F,145,138,6,1,80,65,6 ème
NORD,AULNOY-LEZ-VALENCIENNES,0593673X,87,76,7,4,44,43,6 ème
NORD,AVESNES-LES-AUBERT,0593676A,125,124,0,1,70,55,6 ème
NORD,BEAUCAMPS-LIGNY,0595360F,381,381,0,0,169,212,6 ème
NORD,CAMBRAI,0593061G,0,0,0,0,0,0,6 ème
NORD,CAPPELLE-LA-GRANDE,0593181M,103,100,0,3,66,37,6 ème
NORD,CAUDRY,0590046E,183,183,0,0,84,99,6 ème
NORD,CAUDRY,0595277R,143,123,16,4,69,74,6 ème
NORD,COMINES,0592959W,142,142,0,0,64,78,6 ème
NORD,DOUCHY-LES-MINES,0593484S,172,168,3,1,74,98,6 ème
NORD,ESCAUTPONT,0594409X,66,66,0,0,36,30,6 ème
NORD,ESTAIRES,0597005U,0,0,0,0,0,0,6 ème
NORD,FACHES-THUMESNIL,0592830F,89,89,0,0,44,45,6 ème
NORD,FERRIERE-LA-GRANDE,0593681F,119,115,4,0,61,58,6 ème
NORD,FOURNES-EN-WEPPES,0596801X,13,13,0,0,1,12,6 ème
NORD,FRESNES-SUR-ESCAUT,0593486U,83,83,0,0,42,41,6 ème
NORD,GOUZEAUCOURT,0590087Z,48,48,0,0,23,25,6 ème
NORD,GRANDE-SYNTHE,0594652L,0,0,0,0,0,0,6 ème
NORD,HALLUIN,0592850C,0,0,0,0,0,0,6 ème
NORD,HALLUIN,0593125B,112,112,0,0,60,52,6 ème
NORD,HAUBOURDIN,0594386X,91,91,0,0,41,50,6 ème
NORD,HAZEBROUCK,0590103S,163,157,6,0,72,91,6 ème
NORD,HEM,0594632P,151,141,8,2,88,63,6 ème
NORD,HONDSCHOOTE,0593130G,32,32,0,0,12,20,6 ème
NORD,HONDSCHOOTE,0594642A,95,95,0,0,45,50,6 ème
NORD,JEUMONT,0593132J,87,85,0,2,47,40,6 ème
NORD,JEUMONT,0594418G,78,78,0,0,49,29,6 ème
NORD,LA BASSEE,0590252D,0,0,0,0,0,0,6 ème
NORD,LA BASSEE,0593231S,226,223,3,0,111,115,6 ème
NORD,LALLAING,0593482P,103,89,12,2,57,46,6 ème
NORD,LAMBERSART,0593015G,0,0,0,0,0,0,6 ème
NORD,LAMBERSART,0593134L,202,202,0,0,106,96,6 ème
NORD,LILLE,0590271Z,91,84,7,0,46,45,6 ème
NORD,LILLE,0593177H,39,33,6,0,19,20,6 ème
NORD,LILLE,0593180L,212,202,8,2,99,113,6 ème
NORD,LILLE,0594881K,100,96,0,4,54,46,6 ème
NORD,LILLE,0595396V,104,100,0,4,50,54,6 ème
NORD,LOOS,0593030Y,0,0,0,0,0,0,6 ème
NORD,LYS-LEZ-LANNOY,0593240B,159,149,8,2,76,83,6 ème
NORD,LYS-LEZ-LANNOY,0594380R,6,0,6,0,2,4,6 ème
NORD,MARCHIENNES,0590142J,82,82,0,0,39,43,6 ème
NORD,MARCQ-EN-BAROEUL,0594287P,104,94,5,5,39,65,6 ème
NORD,MARLY,0594302F,0,0,0,0,0,0,6 ème
NORD,MORTAGNE-DU-NORD,0594410Y,74,74,0,0,40,34,6 ème
NORD,NEUVILLE-EN-FERRAIN,0594833H,141,141,0,0,69,72,6 ème
NORD,ORCHIES,0590159C,204,197,7,0,117,87,6 ème
NORD,OSTRICOURT,0594290T,79,76,3,0,33,46,6 ème
NORD,POIX-DU-NORD,0594876E,71,71,0,0,31,40,6 ème
NORD,ROUBAIX,0590187H,0,0,0,0,0,0,6 ème
NORD,ROUBAIX,0592907P,149,147,0,2,73,76,6 ème
NORD,ROUBAIX,0592964B,0,0,0,0,0,0,6 ème
NORD,SAINT-AMAND-LES-EAUX,0594304H,119,119,0,0,55,64,6 ème
NORD,SOLESMES,0594648G,175,164,8,3,81,94,6 ème
NORD,TOURCOING,0593140T,222,222,0,0,114,108,6 ème
NORD,TOURCOING,0594293W,122,122,0,0,56,66,6 ème
NORD,TOURCOING,0596846W,201,201,0,0,103,98,6 ème
NORD,TOURCOING,0596860L,139,130,4,5,68,71,6 ème
NORD,TRELON,0594308M,71,71,0,0,36,35,6 ème
NORD,TRITH-SAINT-LEGER,0594534H,51,50,0,1,30,21,6 ème
NORD,VALENCIENNES,0592715F,110,110,0,0,49,61,6 ème
NORD,WALINCOURT-SELVIGNY,0590228C,97,93,0,4,48,49,6 ème
NORD,WAVRIN,0593475G,140,138,0,2,76,64,6 ème
NORD,WORMHOUT,0593163T,70,70,0,0,26,44,6 ème
PAS-DE-CALAIS,ACHICOURT,0622863A,118,114,2,2,66,52,6 ème
PAS-DE-CALAIS,ARQUES,0622093N,130,130,0,0,70,60,6 ème
PAS-DE-CALAIS,ARRAS,0622082B,96,93,0,3,38,58,6 ème
PAS-DE-CALAIS,ARRAS,0622103Z,121,121,0,0,65,56,6 ème
PAS-DE-CALAIS,ARRAS,0623310L,68,68,0,0,37,31,6 ème
PAS-DE-CALAIS,AUCHY-LES-MINES,0622946R,104,104,0,0,52,52,6 ème
PAS-DE-CALAIS,AUDRUICQ,0620024P,132,128,1,3,62,70,6 ème
PAS-DE-CALAIS,BERCK,0622128B,73,73,0,0,25,48,6 ème
PAS-DE-CALAIS,BEUVRY,0622090K,194,184,7,3,95,99,6 ème
PAS-DE-CALAIS,BILLY-MONTIGNY,0622793Z,117,117,0,0,48,69,6 ème
PAS-DE-CALAIS,BOULOGNE-SUR-MER,0622130D,129,129,0,0,64,65,6 ème
PAS-DE-CALAIS,BRUAY-LA-BUISSIERE,0620192X,0,0,0,0,0,0,6 ème
PAS-DE-CALAIS,CALAIS,0620196B,98,96,0,2,54,44,6 ème
PAS-DE-CALAIS,CALAIS,0622273J,92,92,0,0,42,50,6 ème
PAS-DE-CALAIS,CALAIS,0623918X,130,130,0,0,59,71,6 ème
PAS-DE-CALAIS,CALONNE-RICOUART,0620068M,105,105,0,0,52,53,6 ème
PAS-DE-CALAIS,CARVIN,0620071R,108,101,7,0,50,58,6 ème
PAS-DE-CALAIS,CARVIN,0622134H,215,215,0,0,111,104,6 ème
PAS-DE-CALAIS,ETAPLES,0622136K,97,97,0,0,43,54,6 ème
PAS-DE-CALAIS,FAUQUEMBERGUES,0620082C,64,64,0,0,33,31,6 ème
PAS-DE-CALAIS,FREVENT,0622137L,52,52,0,0,25,27,6 ème
PAS-DE-CALAIS,GRENAY,0622424Y,121,112,9,0,67,54,6 ème
PAS-DE-CALAIS,GUINES,0620088J,120,120,0,0,66,54,6 ème
PAS-DE-CALAIS,HENIN-BEAUMONT,0622795B,158,147,9,2,77,81,6 ème
PAS-DE-CALAIS,HEUCHIN,0622866D,61,61,0,0,31,30,6 ème
PAS-DE-CALAIS,LENS,0622417R,108,108,0,0,45,63,6 ème
PAS-DE-CALAIS,LUMBRES,0622574L,200,196,1,3,100,100,6 ème
PAS-DE-CALAIS,OIGNIES,0620150B,0,0,0,0,0,0,6 ème
PAS-DE-CALAIS,OYE-PLAGE,0623759Z,135,135,0,0,72,63,6 ème
PAS-DE-CALAIS,SAINS-EN-GOHELLE,0622578R,97,97,0,0,46,51,6 ème
PAS-DE-CALAIS,SAINT-MARTIN-BOULOGNE,0623573X,113,113,0,0,54,59,6 ème
PAS-DE-CALAIS,SAINT-OMER,0620162P,0,0,0,0,0,0,6 ème
PAS-DE-CALAIS,SAINT-VENANT,0622091L,121,121,0,0,59,62,6 ème
PAS-DE-CALAIS,SALLAUMINES,0620220C,0,0,0,0,0,0,6 ème
PAS-DE-CALAIS,SAMER,0622950V,174,174,0,0,80,94,6 ème
SEINE-ET-MARNE,BRAY-SUR-SEINE,0770003K,154,154,0,0,80,74,6 ème
SEINE-ET-MARNE,BUSSY-SAINT-GEORGES,0772226B,137,137,0,0,73,64,6 ème
SEINE-ET-MARNE,BUSSY-SAINT-GEORGES,0772601J,91,91,0,0,44,47,6 ème
SEINE-ET-MARNE,CHAMPAGNE-SUR-SEINE,0770920G,0,0,0,0,0,0,6 ème
SEINE-ET-MARNE,CHELLES,0771471F,146,145,0,1,64,82,6 ème
SEINE-ET-MARNE,CHELLES,0771759U,149,133,16,0,74,75,6 ème
SEINE-ET-MARNE,COMBS-LA-VILLE,0771959L,163,163,0,0,75,88,6 ème
SEINE-ET-MARNE,COUILLY-PONT-AUX-DAMES,0771236A,56,56,0,0,32,24,6 ème
SEINE-ET-MARNE,COULOMMIERS,0771233X,62,62,0,0,29,33,6 ème
SEINE-ET-MARNE,CROUY-SUR-OURCQ,0772246Y,89,74,12,3,37,52,6 ème
SEINE-ET-MARNE,EMERAINVILLE,0772119K,80,80,0,0,31,49,6 ème
SEINE-ET-MARNE,FAREMOUTIERS,0771519H,137,137,0,0,69,68,6 ème
SEINE-ET-MARNE,FONTAINEBLEAU,0771200L,0,0,0,0,0,0,6 ème
SEINE-ET-MARNE,LA ROCHETTE,0770943G,0,0,0,0,0,0,6 ème
SEINE-ET-MARNE,LESIGNY,0771421B,203,199,0,4,97,106,6 ème
SEINE-ET-MARNE,LOGNES,0771992X,141,141,0,0,81,60,6 ème
SEINE-ET-MARNE,MEAUX,0770032S,159,157,0,2,69,90,6 ème
SEINE-ET-MARNE,MEAUX,0771880A,0,0,0,0,0,0,6 ème
SEINE-ET-MARNE,MEAUX,0772153X,0,0,0,0,0,0,6 ème
SEINE-ET-MARNE,MELUN,0771339M,197,165,31,1,88,109,6 ème
SEINE-ET-MARNE,MITRY-MORY,0772573D,191,191,0,0,101,90,6 ème
SEINE-ET-MARNE,MONTEREAU-FAULT-YONNE,0771761W,137,137,0,0,67,70,6 ème
SEINE-ET-MARNE,MORMANT,0771620T,203,202,0,1,93,110,6 ème
SEINE-ET-MARNE,NEMOURS,0771478N,119,101,16,2,63,56,6 ème
SEINE-ET-MARNE,OISSERY,0771912K,139,127,9,3,69,70,6 ème
SEINE-ET-MARNE,PONTAULT-COMBAULT,0772331R,112,112,0,0,50,62,6 ème
SEINE-ET-MARNE,PROVINS,0771216D,113,113,0,0,56,57,6 ème
SEINE-ET-MARNE,PROVINS,0772481D,92,88,0,4,34,58,6 ème
SEINE-ET-MARNE,ROISSY-EN-BRIE,0771657H,180,162,16,2,87,93,6 ème
SEINE-ET-MARNE,SAINT-MARD,0771615M,182,182,0,0,93,89,6 ème
SEINE-ET-MARNE,SAVIGNY-LE-TEMPLE,0771518G,184,183,0,1,102,82,6 ème
SEINE-ET-MARNE,TORCY,0771656G,147,129,15,3,76,71,6 ème
SEINE-ET-MARNE,TOURNAN-EN-BRIE,0770051M,209,193,13,3,105,104,6 ème
SEINE-ET-MARNE,VILLENEUVE-SUR-BELLOT,0770057U,113,111,0,2,52,61,6 ème
SEINE-ET-MARNE,VILLEPARISIS,0771333F,130,129,0,1,65,65,6 ème
SEINE-SAINT-DENIS,AUBERVILLIERS,0932043R,71,71,0,0,19,52,6 ème
SEINE-SAINT-DENIS,AULNAY-SOUS-BOIS,0931189M,169,167,0,2,75,94,6 ème
SEINE-SAINT-DENIS,BAGNOLET,0931181D,139,118,15,6,70,69,6 ème
SEINE-SAINT-DENIS,BAGNOLET,0931220W,98,98,0,0,53,45,6 ème
SEINE-SAINT-DENIS,BOBIGNY,0931195U,137,134,0,3,69,68,6 ème
SEINE-SAINT-DENIS,BOBIGNY,0931844Z,90,90,0,0,90,0,6 ème
SEINE-SAINT-DENIS,BOBIGNY,0932123C,0,0,0,0,0,0,6 ème
SEINE-SAINT-DENIS,BONDY,0930933J,0,0,0,0,0,0,6 ème
SEINE-SAINT-DENIS,BONDY,0931788N,143,136,0,7,61,82,6 ème
SEINE-SAINT-DENIS,CLICHY-SOUS-BOIS,0931221X,136,120,16,0,71,65,6 ème
SEINE-SAINT-DENIS,DRANCY,0930907F,92,92,0,0,47,45,6 ème
SEINE-SAINT-DENIS,DRANCY,0931202B,145,145,0,0,62,83,6 ème
SEINE-SAINT-DENIS,DRANCY,0931377S,149,139,10,0,68,81,6 ème
SEINE-SAINT-DENIS,GAGNY,0930858C,144,144,0,0,75,69,6 ème
SEINE-SAINT-DENIS,LA COURNEUVE,0931148T,163,147,11,5,67,96,6 ème
SEINE-SAINT-DENIS,LE BLANC-MESNIL,0931204D,205,203,0,2,87,118,6 ème
SEINE-SAINT-DENIS,LE BLANC-MESNIL,0931433C,179,175,4,0,99,80,6 ème
SEINE-SAINT-DENIS,LE BOURGET,0930963S,63,63,0,0,25,38,6 ème
SEINE-SAINT-DENIS,LE BOURGET,0931187K,185,185,0,0,84,101,6 ème
SEINE-SAINT-DENIS,LES PAVILLONS-SOUS-BOIS,0930100D,126,122,0,4,69,57,6 ème
SEINE-SAINT-DENIS,LES PAVILLONS-SOUS-BOIS,0930136T,0,0,0,0,0,0,6 ème
SEINE-SAINT-DENIS,LIVRY-GARGAN,0932695Z,169,166,0,3,65,104,6 ème
SEINE-SAINT-DENIS,MONTREUIL,0930912L,57,57,0,0,26,31,6 ème
SEINE-SAINT-DENIS,MONTREUIL,0930960N,0,0,0,0,0,0,6 ème
SEINE-SAINT-DENIS,MONTREUIL,0931209J,87,87,0,0,42,45,6 ème
SEINE-SAINT-DENIS,NOISY-LE-GRAND,0931978V,147,140,0,7,65,82,6 ème
SEINE-SAINT-DENIS,NOISY-LE-SEC,0930133P,0,0,0,0,0,0,6 ème
SEINE-SAINT-DENIS,PANTIN,0930135S,0,0,0,0,0,0,6 ème
SEINE-SAINT-DENIS,PANTIN,0931216S,144,144,0,0,69,75,6 ème
SEINE-SAINT-DENIS,PANTIN,0931528F,149,142,7,0,70,79,6 ème
SEINE-SAINT-DENIS,SAINT-DENIS,0931489N,94,84,10,0,49,45,6 ème
SEINE-SAINT-DENIS,SAINT-OUEN,0931143M,172,160,12,0,78,94,6 ème
SEINE-SAINT-DENIS,STAINS,0931226C,207,194,13,0,93,114,6 ème
SEINE-SAINT-DENIS,TREMBLAY-EN-FRANCE,0931191P,166,165,0,1,79,87,6 ème
SEINE-SAINT-DENIS,VILLEPINTE,0932263E,164,164,0,0,86,78,6 ème
SEINE-SAINT-DENIS,VILLETANEUSE,0932334G,115,115,0,0,58,57,6 ème
VAL-DE-MARNE,ALFORTVILLE,0941021Z,97,93,0,4,44,53,6 ème
VAL-DE-MARNE,BOISSY-SAINT-LEGER,0941478W,79,79,0,0,43,36,6 ème
VAL-DE-MARNE,CACHAN,0940823J,0,0,0,0,0,0,6 ème
VAL-DE-MARNE,CACHAN,0941100K,147,147,0,0,80,67,6 ème
VAL-DE-MARNE,CACHAN,0941101L,119,114,0,5,57,62,6 ème
VAL-DE-MARNE,CHAMPIGNY-SUR-MARNE,0940132H,0,0,0,0,0,0,6 ème
VAL-DE-MARNE,CHAMPIGNY-SUR-MARNE,0940807S,87,87,0,0,55,32,6 ème
VAL-DE-MARNE,CHAMPIGNY-SUR-MARNE,0941951K,0,0,0,0,0,0,6 ème
VAL-DE-MARNE,CHAMPIGNY-SUR-MARNE,0942499F,146,146,0,0,74,72,6 ème
VAL-DE-MARNE,CHENNEVIERES-SUR-MARNE,0941470M,0,0,0,0,0,0,6 ème
VAL-DE-MARNE,CHEVILLY-LARUE,0940071S,86,83,0,3,36,50,6 ème
VAL-DE-MARNE,CHEVILLY-LARUE,0940581W,118,118,0,0,59,59,6 ème
VAL-DE-MARNE,CHOISY-LE-ROI,0941231C,119,116,0,3,62,57,6 ème
VAL-DE-MARNE,CHOISY-LE-ROI,0941232D,0,0,0,0,0,0,6 ème
VAL-DE-MARNE,CRETEIL,0940114N,0,0,0,0,0,0,6 ème
VAL-DE-MARNE,CRETEIL,0941942A,33,33,0,0,0,33,6 ème
VAL-DE-MARNE,FONTENAY-SOUS-BOIS,0941090Z,121,121,0,0,55,66,6 ème
VAL-DE-MARNE,FRESNES,0940101Z,117,117,0,0,70,47,6 ème
VAL-DE-MARNE,IVRY-SUR-SEINE,0941026E,147,147,0,0,75,72,6 ème
VAL-DE-MARNE,JOINVILLE-LE-PONT,0940038F,89,89,0,0,39,50,6 ème
VAL-DE-MARNE,JOINVILLE-LE-PONT,0942355Z,0,0,0,0,0,0,6 ème
VAL-DE-MARNE,LA QUEUE-EN-BRIE,0941410X,188,188,0,0,92,96,6 ème
VAL-DE-MARNE,LIMEIL-BREVANNES,0941783C,146,146,0,0,72,74,6 ème
VAL-DE-MARNE,MANDRES-LES-ROSES,0942187S,88,88,0,0,46,42,6 ème
VAL-DE-MARNE,NOGENT-SUR-MARNE,0941599C,117,117,0,0,63,54,6 ème
VAL-DE-MARNE,ORLY,0940138P,0,0,0,0,0,0,6 ème
VAL-DE-MARNE,ORLY,0941042X,134,134,0,0,65,69,6 ème
VAL-DE-MARNE,ORLY,0941891V,22,20,0,2,8,14,6 ème
VAL-DE-MARNE,SUCY-EN-BRIE,0940617K,196,190,6,0,109,87,6 ème
VAL-DE-MARNE,SUCY-EN-BRIE,0941716E,184,184,0,0,112,72,6 ème
VAL-DE-MARNE,THIAIS,0940575P,155,123,28,4,73,82,6 ème
VAL-DE-MARNE,THIAIS,0942119T,9,9,0,0,5,4,6 ème
VAL-DE-MARNE,VILLEJUIF,0941036R,124,124,0,0,61,63,6 ème
VAL-DE-MARNE,VINCENNES,0941718G,148,148,0,0,81,67,6 ème
VAL-DE-MARNE,VITRY-SUR-SEINE,0940042K,110,109,0,1,57,53,6 ème
VAL-DE-MARNE,VITRY-SUR-SEINE,0940794C,100,100,0,0,47,53,6 ème
VAL-DE-MARNE,VITRY-SUR-SEINE,0941029H,166,161,0,5,81,85,6 ème
PARIS,PARIS,0752923V,178,178,0,0,82,96,6 ème
PARIS,PARIS,0750608D,116,113,0,3,61,55,6 ème
PARIS,PARIS,0754290F,72,71,0,1,21,51,6 ème
PARIS,PARIS,0752845K,0,0,0,0,0,0,6 ème
PARIS,PARIS,0750525N,109,107,0,2,57,52,6 ème
PARIS,PARIS,0751710B,0,0,0,0,0,0,6 ème
PARIS,PARIS,0752385K,93,78,12,3,45,48,6 ème
PARIS,PARIS,0752539C,113,111,0,2,57,56,6 ème
PARIS,PARIS,0751563S,93,92,0,1,37,56,6 ème
PARIS,PARIS,0752190Y,111,101,9,1,51,60,6 ème
PARIS,PARIS,0756020L,14,5,0,9,4,10,6 ème
PARIS,PARIS,0752551R,137,137,0,0,59,78,6 ème
PARIS,PARIS,0752917N,183,183,0,0,81,102,6 ème
PARIS,PARIS,0753217P,0,0,0,0,0,0,6 ème
PARIS,PARIS,0755192L,34,34,0,0,13,21,6 ème
PARIS,PARIS,0752319N,0,0,0,0,0,0,6 ème
PARIS,PARIS,0754239A,0,0,0,0,0,0,6 ème
PARIS,PARIS,0755030K,75,75,0,0,43,32,6 ème
PARIS,PARIS,0750484U,75,74,0,1,34,41,6 ème
PARIS,PARIS,0750507U,143,128,15,0,65,78,6 ème
PARIS,PARIS,0750802P,0,0,0,0,0,0,6 ème
PARIS,PARIS,0753345D,100,99,0,1,50,50,6 ème
PARIS,PARIS,0754003U,102,102,0,0,49,53,6 ème
PARIS,PARIS,0755095F,75,74,0,1,37,38,6 ème
PARIS,PARIS,0750550R,97,93,0,4,49,48,6 ème
PARIS,PARIS,0753387Z,5,5,0,0,1,4,6 ème
PARIS,PARIS,0750770E,0,0,0,0,0,0,6 ème
PARIS,PARIS,0752523K,72,70,0,2,30,42,6 ème
PARIS,PARIS,0752524L,63,63,0,0,29,34,6 ème
PARIS,PARIS,0752913J,89,89,0,0,44,45,6 ème
PARIS,PARIS,0753840S,0,0,0,0,0,0,6 ème
PARIS,PARIS,0754757N,99,99,0,0,55,44,6 ème
PARIS,PARIS,0752894N,148,148,0,0,69,79,6 ème
PARIS,PARIS,0752899U,122,122,0,0,61,61,6 ème
PARIS,PARIS,0752842G,270,268,0,2,146,124,6 ème
PARIS,PARIS,0752250N,80,77,0,3,38,42,6 ème
ESSONNE,BOUSSY-SAINT-ANTOINE,0911022S,209,209,0,0,109,100,6 ème
ESSONNE,BRETIGNY-SUR-ORGE,0910827E,140,140,0,0,77,63,6 ème
ESSONNE,BRIIS-SOUS-FORGES,0911920T,132,132,0,0,67,65,6 ème
ESSONNE,BRUNOY,0911746D,217,217,0,0,120,97,6 ème
ESSONNE,CHILLY-MAZARIN,0910777A,187,186,0,1,92,95,6 ème
ESSONNE,CORBEIL-ESSONNES,0910752Y,165,165,0,0,85,80,6 ème
ESSONNE,DOURDAN,0911015J,120,120,0,0,62,58,6 ème
ESSONNE,EVRY-COURCOURONNES,0911250P,133,129,0,4,68,65,6 ème
ESSONNE,EVRY-COURCOURONNES,0911729K,141,137,0,4,77,64,6 ème
ESSONNE,GIF-SUR-YVETTE,0910024G,139,135,0,4,78,61,6 ème
ESSONNE,GRIGNY,0912196T,155,152,0,3,77,78,6 ème
ESSONNE,GUIGNEVILLE-SUR-ESSONNE,0911574S,119,112,4,3,63,56,6 ème
ESSONNE,IGNY,0910969J,202,202,0,0,97,105,6 ème
ESSONNE,ITTEVILLE,0912109Y,148,148,0,0,72,76,6 ème
ESSONNE,MASSY,0910632T,0,0,0,0,0,0,6 ème
ESSONNE,MILLY-LA-FORET,0911404G,175,169,0,6,85,90,6 ème
ESSONNE,MONTGERON,0911396Y,153,144,9,0,74,79,6 ème
ESSONNE,MORANGIS,0910041A,191,189,0,2,100,91,6 ème
ESSONNE,ORSAY,0911749G,92,89,0,3,44,48,6 ème
ESSONNE,QUINCY-SOUS-SENART,0911493D,0,0,0,0,0,0,6 ème
ESSONNE,RIS-ORANGIS,0910049J,252,251,0,1,115,137,6 ème
ESSONNE,RIS-ORANGIS,0911025V,196,184,12,0,99,97,6 ème
ESSONNE,RIS-ORANGIS,0911578W,0,0,0,0,0,0,6 ème
ESSONNE,SAINTE-GENEVIEVE-DES-BOIS,0911042N,212,211,0,1,108,104,6 ème
ESSONNE,SAVIGNY-SUR-ORGE,0911889J,2,2,0,0,1,1,6 ème
ESSONNE,VIRY-CHATILLON,0910056S,102,102,0,0,48,54,6 ème
HAUTS-DE-SEINE,ANTONY,0921243B,112,112,0,0,60,52,6 ème
HAUTS-DE-SEINE,ANTONY,0921868F,78,78,0,0,42,36,6 ème
HAUTS-DE-SEINE,ANTONY,0921901S,380,379,0,1,188,192,6 ème
HAUTS-DE-SEINE,BAGNEUX,0921903U,60,60,0,0,27,33,6 ème
HAUTS-DE-SEINE,BOIS-COLOMBES,0922629H,183,183,0,0,89,94,6 ème
HAUTS-DE-SEINE,BOULOGNE-BILLANCOURT,0921236U,177,173,0,4,89,88,6 ème
HAUTS-DE-SEINE,BOULOGNE-BILLANCOURT,0921239X,138,131,7,0,58,80,6 ème
HAUTS-DE-SEINE,CHATILLON,0920880G,158,149,8,1,63,95,6 ème
HAUTS-DE-SEINE,CLICHY,0921228K,190,182,7,1,79,111,6 ème
HAUTS-DE-SEINE,CLICHY,0922595W,141,140,0,1,65,76,6 ème
HAUTS-DE-SEINE,COLOMBES,0921494Z,149,148,0,1,71,78,6 ème
HAUTS-DE-SEINE,COLOMBES,0921675W,145,139,3,3,68,77,6 ème
HAUTS-DE-SEINE,COLOMBES,0921908Z,211,202,9,0,103,108,6 ème
HAUTS-DE-SEINE,COLOMBES,0922662U,126,126,0,0,68,58,6 ème
HAUTS-DE-SEINE,COURBEVOIE,0921496B,183,176,7,0,82,101,6 ème
HAUTS-DE-SEINE,COURBEVOIE,0922482Y,53,53,0,0,0,53,6 ème
HAUTS-DE-SEINE,COURBEVOIE,0922523T,167,167,0,0,86,81,6 ème
HAUTS-DE-SEINE,GENNEVILLIERS,0921621M,180,175,0,5,88,92,6 ème
HAUTS-DE-SEINE,LEVALLOIS-PERRET,0922630J,134,132,0,2,61,73,6 ème
HAUTS-DE-SEINE,MALAKOFF,0920163C,0,0,0,0,0,0,6 ème
HAUTS-DE-SEINE,MEUDON,0921909A,78,78,0,0,38,40,6 ème
HAUTS-DE-SEINE,MEUDON,0922701L,169,163,6,0,90,79,6 ème
HAUTS-DE-SEINE,MONTROUGE,0920164D,0,0,0,0,0,0,6 ème
HAUTS-DE-SEINE,MONTROUGE,0921190U,79,75,0,4,40,39,6 ème
HAUTS-DE-SEINE,NANTERRE,0920077J,146,141,5,0,75,71,6 ème
HAUTS-DE-SEINE,NANTERRE,0920882J,137,137,0,0,70,67,6 ème
HAUTS-DE-SEINE,NANTERRE,0921353W,140,138,0,2,72,68,6 ème
HAUTS-DE-SEINE,NEUILLY-SUR-SEINE,0921015D,97,97,0,0,49,48,6 ème
HAUTS-DE-SEINE,PUTEAUX,0921500F,0,0,0,0,0,0,6 ème
HAUTS-DE-SEINE,RUEIL-MALMAISON,0921234S,122,122,0,0,63,59,6 ème
HAUTS-DE-SEINE,RUEIL-MALMAISON,0921502H,134,131,0,3,64,70,6 ème
HAUTS-DE-SEINE,SAINT-CLOUD,0922276Z,0,0,0,0,0,0,6 ème
HAUTS-DE-SEINE,SCEAUX,0921785R,155,155,0,0,71,84,6 ème
HAUTS-DE-SEINE,SURESNES,0920884L,128,127,0,1,68,60,6 ème
HAUTS-DE-SEINE,VAUCRESSON,0921935D,29,29,0,0,10,19,6 ème
HAUTS-DE-SEINE,VAUCRESSON,0922143E,70,70,0,0,38,32,6 ème
HAUTS-DE-SEINE,VILLENEUVE-LA-GARENNE,0922277A,0,0,0,0,0,0,6 ème
VAL-D'OISE,ARGENTEUIL,0950800D,0,0,0,0,0,0,6 ème
VAL-D'OISE,ARGENTEUIL,0951138W,170,165,0,5,83,87,6 ème
VAL-D'OISE,ARGENTEUIL,0951139X,112,109,0,3,53,59,6 ème
VAL-D'OISE,ARGENTEUIL,0951230W,175,163,11,1,88,87,6 ème
VAL-D'OISE,ARGENTEUIL,0952114G,173,171,0,2,84,89,6 ème
VAL-D'OISE,BEAUMONT-SUR-OISE,0950933Y,169,167,0,2,80,89,6 ème
VAL-D'OISE,BERNES-SUR-OISE,0952087C,136,136,0,0,66,70,6 ème
VAL-D'OISE,BEZONS,0950888Z,191,179,11,1,102,89,6 ème
VAL-D'OISE,BOUFFEMONT,0951822P,119,119,0,0,55,64,6 ème
VAL-D'OISE,ERMONT,0950657Y,0,0,0,0,0,0,6 ème
VAL-D'OISE,EZANVILLE,0952127W,144,143,0,1,67,77,6 ème
VAL-D'OISE,FRANCONVILLE,0950812S,0,0,0,0,0,0,6 ème
VAL-D'OISE,GOUSSAINVILLE,0950026M,173,152,17,4,75,98,6 ème
VAL-D'OISE,HERBLAY,0950932X,213,195,16,2,98,115,6 ème
VAL-D'OISE,LOUVRES,0950908W,144,140,0,4,70,74,6 ème
VAL-D'OISE,LUZARCHES,0951357J,159,157,0,2,75,84,6 ème
VAL-D'OISE,MERY-SUR-OISE,0951725J,150,148,0,2,66,84,6 ème
VAL-D'OISE,MONTIGNY-LES-CORMEILLES,0951800R,170,170,0,0,87,83,6 ème
VAL-D'OISE,PONTOISE,0950894F,162,157,0,5,80,82,6 ème
VAL-D'OISE,PONTOISE,0951507X,108,108,0,0,44,64,6 ème
VAL-D'OISE,SANNOIS,0951508Y,165,165,0,0,94,71,6 ème
VAL-D'OISE,SARCELLES,0950900M,93,91,0,2,47,46,6 ème
VAL-D'OISE,SARCELLES,0950943J,120,104,14,2,57,63,6 ème
VAL-D'OISE,SARCELLES,0951196J,161,159,0,2,87,74,6 ème
VAL-D'OISE,SOISY-SOUS-MONTMORENCY,0950046J,104,104,0,0,58,46,6 ème
VAL-D'OISE,TAVERNY,0951197K,203,198,0,5,93,110,6 ème
VAL-D'OISE,VILLIERS-LE-BEL,0950749Y,119,117,0,2,58,61,6 ème
YVELINES,ACHERES,0783636D,130,130,0,0,70,60,6 ème
YVELINES,BEYNES,0780713B,189,189,0,0,97,92,6 ème
YVELINES,BUC,0780715D,170,170,0,0,90,80,6 ème
YVELINES,BUC,0783546F,95,95,0,0,48,47,6 ème
YVELINES,CARRIERES-SOUS-POISSY,0780032L,165,165,0,0,75,90,6 ème
YVELINES,CARRIERES-SOUS-POISSY,0781817B,79,79,0,0,41,38,6 ème
YVELINES,CHANTELOUP-LES-VIGNES,0781108F,71,66,5,0,33,38,6 ème
YVELINES,CHATOU,0780575B,104,104,0,0,52,52,6 ème
YVELINES,ECQUEVILLY,0781915H,130,127,0,3,62,68,6 ème
YVELINES,ELANCOURT,0782114Z,130,130,0,0,66,64,6 ème
YVELINES,LE MESNIL-SAINT-DENIS,0780512H,145,145,0,0,63,82,6 ème
YVELINES,LES MUREAUX,0780180X,153,153,0,0,82,71,6 ème
YVELINES,MAISONS-LAFFITTE,0780112Y,114,114,0,0,62,52,6 ème
YVELINES,MANTES-LA-VILLE,0783533S,0,0,0,0,0,0,6 ème
YVELINES,MAUREPAS,0780720J,140,138,0,2,64,76,6 ème
YVELINES,MONTFORT-L'AMAURY,0781600R,161,161,0,0,79,82,6 ème
YVELINES,MONTIGNY-LE-BRETONNEUX,0781662H,254,247,7,0,128,126,6 ème
YVELINES,MONTIGNY-LE-BRETONNEUX,0782087V,116,114,0,2,54,62,6 ème
YVELINES,ORGERUS,0781864C,162,160,0,2,72,90,6 ème
YVELINES,POISSY,0781983G,0,0,0,0,0,0,6 ème
YVELINES,PORCHEVILLE,0781948U,0,0,0,0,0,0,6 ème
YVELINES,RAMBOUILLET,0780256E,147,137,10,0,60,87,6 ème
YVELINES,RAMBOUILLET,0781886B,178,176,0,2,87,91,6 ème
YVELINES,SAINT-GERMAIN-EN-LAYE,0780714C,192,192,0,0,85,107,6 ème
YVELINES,SAINT-GERMAIN-EN-LAYE,0781205L,197,197,0,0,102,95,6 ème
YVELINES,SARTROUVILLE,0783463R,135,135,0,0,60,75,6 ème
YVELINES,TRAPPES,0780187E,116,104,8,4,61,55,6 ème
YVELINES,VELIZY-VILLACOUBLAY,0780265P,164,150,14,0,73,91,6 ème
YVELINES,VERNEUIL-SUR-SEINE,0781537X,252,251,0,1,121,131,6 ème
YVELINES,VILLIERS-SAINT-FREDERIC,0782587N,0,0,0,0,0,0,6 ème
LA REUNION,ENTRE-DEUX,9740006N,107,104,0,3,49,58,6 ème
LA REUNION,LA POSSESSION,9740909V,254,211,32,11,129,125,6 ème
LA REUNION,LES TROIS-BASSINS,9740085Z,89,87,0,2,44,45,6 ème
LA REUNION,L'ETANG-SALE,9741387P,139,137,0,2,71,68,6 ème
LA REUNION,PETITE-ILE,9740654T,172,172,0,0,85,87,6 ème
LA REUNION,SAINT-ANDRE,9740703W,166,160,0,6,79,87,6 ème
LA REUNION,SAINT-DENIS,9740072K,370,370,0,0,180,190,6 ème
LA REUNION,SAINT-DENIS,9740595D,91,91,0,0,36,55,6 ème
LA REUNION,SAINT-DENIS,9740645H,273,256,15,2,129,144,6 ème
LA REUNION,SAINT-DENIS,9741308D,0,0,0,0,0,0,6 ème
LA REUNION,SAINTE-MARIE,9740735F,150,133,13,4,64,86,6 ème
LA REUNION,SAINTE-MARIE,9741323V,208,208,0,0,98,110,6 ème
LA REUNION,SAINTE-SUZANNE,9740679V,0,0,0,0,0,0,6 ème
LA REUNION,SAINT-LOUIS,9740841W,215,181,31,3,111,104,6 ème
LA REUNION,SAINT-PAUL,9741763Y,159,156,0,3,66,93,6 ème
LA REUNION,SAINT-PIERRE,9740027L,180,172,0,8,89,91,6 ème
LA REUNION,SAINT-PIERRE,9740835P,294,293,0,1,152,142,6 ème
LA REUNION,SAINT-PIERRE,9741049X,131,129,0,2,60,71,6 ème
LA REUNION,SALAZIE,9740651P,110,96,14,0,64,46,6 ème
MARTINIQUE,FORT-DE-FRANCE,9720007A,42,42,0,0,29,13,6 ème
MARTINIQUE,FORT-DE-FRANCE,9720515C,0,0,0,0,0,0,6 ème
MARTINIQUE,FORT-DE-FRANCE,9720682J,109,89,18,2,54,55,6 ème
MARTINIQUE,FORT-DE-FRANCE,9720897T,80,80,0,0,41,39,6 ème
MARTINIQUE,LA TRINITE,9720430K,0,0,0,0,0,0,6 ème
MARTINIQUE,LE FRANCOIS,9720428H,92,71,15,6,40,52,6 ème
MARTINIQUE,LE LAMENTIN,9720072W,103,103,0,0,64,39,6 ème
MARTINIQUE,LE LAMENTIN,9720083H,93,89,0,4,44,49,6 ème
MARTINIQUE,LE LAMENTIN,9720470D,157,127,27,3,74,83,6 ème
MARTINIQUE,LE LAMENTIN,9720848P,57,51,0,6,21,36,6 ème
MARTINIQUE,LE MARIGOT,9720028Y,28,28,0,0,12,16,6 ème
MARTINIQUE,LE MORNE-ROUGE,9720016K,29,29,0,0,15,14,6 ème
MARTINIQUE,LE ROBERT,9720043P,68,68,0,0,44,24,6 ème
MARTINIQUE,SAINTE-MARIE,9720006Z,52,51,0,1,27,25,6 ème
MARTINIQUE,SAINTE-MARIE,9720692V,0,0,0,0,0,0,6 ème
MARTINIQUE,SCHOELCHER,9720455M,100,100,0,0,34,66,6 ème
MAYOTTE,DZAOUDZI,9760008E,480,447,29,4,241,239,6 ème
MAYOTTE,MAMOUDZOU,9760314M,355,354,0,1,180,175,6 ème
MAYOTTE,MTSAMBORO,9760230W,427,411,13,3,220,207,6 ème
CALVADOS,CAEN,0141159J,131,130,0,1,70,61,6 ème
CALVADOS,CAEN,0141554N,133,133,0,0,68,65,6 ème
CALVADOS,CAEN,0141810S,155,151,0,4,79,76,6 ème
CALVADOS,CAEN,0141866C,0,0,0,0,0,0,6 ème
CALVADOS,CAUMONT-SUR-AURE,0140038R,105,101,0,4,45,60,6 ème
CALVADOS,DIVES-SUR-MER,0141599M,0,0,0,0,0,0,6 ème
CALVADOS,HEROUVILLE-SAINT-CLAIR,0142173L,44,44,0,0,22,22,6 ème
CALVADOS,IFS,0142271T,189,166,21,2,96,93,6 ème
CALVADOS,LE HOM,0141641H,133,133,0,0,72,61,6 ème
CALVADOS,LE MOLAY-LITTRY,0141642J,69,69,0,0,35,34,6 ème
CALVADOS,LISIEUX,0141197A,0,0,0,0,0,0,6 ème
CALVADOS,LISIEUX,0141219Z,25,24,0,1,11,14,6 ème
CALVADOS,LISIEUX,0141275K,0,0,0,0,0,0,6 ème
CALVADOS,LISIEUX,0141868E,0,0,0,0,0,0,6 ème
CALVADOS,MONDEVILLE,0141256P,148,146,0,2,77,71,6 ème
CALVADOS,NOUES DE SIENNE,0140079K,59,59,0,0,29,30,6 ème
CALVADOS,ORBEC,0141171X,31,31,0,0,16,15,6 ème
CALVADOS,OUISTREHAM,0141271F,148,148,0,0,76,72,6 ème
CALVADOS,TREVIERES,0140082N,47,47,0,0,22,25,6 ème
CALVADOS,VILLERS-BOCAGE,0140088V,131,128,0,3,60,71,6 ème
EURE,BEUZEVILLE,0270006K,133,128,0,5,64,69,6 ème
EURE,CORMEILLES,0270013T,115,115,0,0,54,61,6 ème
EURE,EVREUX,0270019Z,133,130,0,3,68,65,6 ème
EURE,EVREUX,0271104D,104,100,0,4,42,62,6 ème
EURE,EVREUX,0271231S,154,154,0,0,76,78,6 ème
EURE,LES ANDELYS,0271585B,0,0,0,0,0,0,6 ème
EURE,LOUVIERS,0271119V,133,127,0,6,62,71,6 ème
EURE,PACY-SUR-EURE,0271322R,144,144,0,0,75,69,6 ème
EURE,VERNON,0271447B,122,122,0,0,69,53,6 ème
MANCHE,CANISY,0500011R,71,70,0,1,34,37,6 ème
MANCHE,CHERBOURG-EN-COTENTIN,0500024E,76,71,0,5,33,43,6 ème
MANCHE,CHERBOURG-EN-COTENTIN,0500080R,136,120,10,6,71,65,6 ème
MANCHE,CHERBOURG-EN-COTENTIN,0500140F,132,132,0,0,76,56,6 ème
MANCHE,CHERBOURG-EN-COTENTIN,0501702D,143,138,0,5,65,78,6 ème
MANCHE,GRANVILLE,0500036T,0,0,0,0,0,0,6 ème
MANCHE,GRANVILLE,0501705G,143,143,0,0,66,77,6 ème
MANCHE,MARIGNY-LE-LOZON,0500046D,80,76,0,4,38,42,6 ème
MANCHE,MONTEBOURG,0500047E,48,48,0,0,22,26,6 ème
MANCHE,MORTAIN-BOCAGE,0500144K,32,32,0,0,13,19,6 ème
MANCHE,SAINT-HILAIRE-DU-HARCOUET,0500087Y,0,0,0,0,0,0,6 ème
MANCHE,SARTILLY-BAIE-BOCAGE,0500075K,83,83,0,0,41,42,6 ème
MANCHE,SOURDEVAL,0500153V,31,31,0,0,19,12,6 ème
MANCHE,VILLEDIEU-LES-POELES-ROUFFIGNY,0500083U,77,65,7,5,47,30,6 ème
ORNE,ALENCON,0610693X,78,78,0,0,36,42,6 ème
ORNE,ALENCON,0610918S,136,122,13,1,64,72,6 ème
ORNE,ALENCON,0611091E,87,87,0,0,38,49,6 ème
ORNE,ARGENTAN,0610721C,0,0,0,0,0,0,6 ème
ORNE,BELLEME,0610010E,55,54,0,1,24,31,6 ème
ORNE,FLERS,0610021S,0,0,0,0,0,0,6 ème
ORNE,FLERS,0610057F,114,109,5,0,59,55,6 ème
ORNE,FLERS,0611092F,151,151,0,0,81,70,6 ème
ORNE,LA FERTE MACE,0610800N,67,64,0,3,38,29,6 ème
ORNE,MORTAGNE-AU-PERCHE,0610033E,101,92,8,1,48,53,6 ème
ORNE,REMALARD EN PERCHE,0610740Y,72,72,0,0,28,44,6 ème
ORNE,SEES,0610040M,72,72,0,0,40,32,6 ème
ORNE,TINCHEBRAY-BOCAGE,0610714V,41,41,0,0,15,26,6 ème
SEINE MARITIME,AUMALE,0761722J,86,85,0,1,40,46,6 ème
SEINE MARITIME,BIHOREL,0761692B,100,97,0,3,50,50,6 ème
SEINE MARITIME,DEVILLE-LES-ROUEN,0761727P,143,143,0,0,72,71,6 ème
SEINE MARITIME,DEVILLE-LES-ROUEN,0762202F,94,94,0,0,54,40,6 ème
SEINE MARITIME,DIEPPE,0760026R,75,63,9,3,43,32,6 ème
SEINE MARITIME,DIEPPE,0762569E,102,102,0,0,44,58,6 ème
SEINE MARITIME,EU,0760032X,0,0,0,0,0,0,6 ème
SEINE MARITIME,EU,0761730T,37,37,0,0,14,23,6 ème
SEINE MARITIME,FECAMP,0761704P,64,63,0,1,37,27,6 ème
SEINE MARITIME,GOURNAY-EN-BRAY,0760046M,157,142,13,2,78,79,6 ème
SEINE MARITIME,GRAND-COURONNE,0762080Y,65,52,10,3,29,36,6 ème
SEINE MARITIME,HARFLEUR,0762129B,113,113,0,0,56,57,6 ème
SEINE MARITIME,LE HAVRE,0760058A,0,0,0,0,0,0,6 ème
SEINE MARITIME,LE HAVRE,0761325C,120,114,0,6,54,66,6 ème
SEINE MARITIME,LE HAVRE,0761697G,119,114,0,5,54,65,6 ème
SEINE MARITIME,LE HAVRE,0761698H,53,52,0,1,25,28,6 ème
SEINE MARITIME,LE HAVRE,0761783A,63,63,0,0,36,27,6 ème
SEINE MARITIME,LE HAVRE,0762765T,0,0,0,0,0,0,6 ème
SEINE MARITIME,LE TREPORT,0762087F,105,101,0,4,56,49,6 ème
SEINE MARITIME,LUNERAY,0762199C,90,90,0,0,49,41,6 ème
SEINE MARITIME,OFFRANVILLE,0762125X,124,119,0,5,60,64,6 ème
SEINE MARITIME,PORT-JEROME-SUR-SEINE,0762176C,168,165,0,3,86,82,6 ème
SEINE MARITIME,ROUEN,0760100W,67,62,0,5,30,37,6 ème
SEINE MARITIME,ROUEN,0761745J,106,106,0,0,51,55,6 ème
SEINE MARITIME,ROUEN,0761780X,97,93,0,4,55,42,6 ème
SEINE MARITIME,ROUEN,0762566B,134,134,0,0,72,62,6 ème
SEINE MARITIME,SAINT-ETIENNE-DU-ROUVRAY,0762133F,122,122,0,0,65,57,6 ème
SEINE MARITIME,SAINT-VALERY-EN-CAUX,0760108E,123,104,14,5,58,65,6 ème
SEINE MARITIME,SOTTEVILLE-LES-ROUEN,0762211R,12,0,12,0,2,10,6 ème
SEINE MARITIME,YVETOT,0761338S,265,265,0,0,122,143,6 ème
DORDOGNE,BERGERAC,0240119Z,104,97,7,0,55,49,6 ème
DORDOGNE,COULOUNIEIX-CHAMIERS,0240047W,83,76,5,2,42,41,6 ème
DORDOGNE,LA COQUILLE,0240045U,35,35,0,0,18,17,6 ème
DORDOGNE,MAREUIL EN PERIGORD,0240016M,41,41,0,0,20,21,6 ème
DORDOGNE,PAYS DE BELVES,0240962R,102,92,10,0,47,55,6 ème
DORDOGNE,PERIGUEUX,0240029B,126,122,0,4,65,61,6 ème
DORDOGNE,PERIGUEUX,0241042C,156,156,0,0,82,74,6 ème
DORDOGNE,SAINT AULAYE-PUYMANGOU,0240055E,36,36,0,0,14,22,6 ème
DORDOGNE,TOCANE-SAINT-APRE,0240073Z,67,67,0,0,30,37,6 ème
DORDOGNE,VELINES,0240106K,95,95,0,0,39,56,6 ème
GIRONDE,ARCACHON,0332487Z,142,142,0,0,77,65,6 ème
GIRONDE,BAZAS,0330011H,0,0,0,0,0,0,6 ème
GIRONDE,BLANQUEFORT,0333129X,25,25,0,0,8,17,6 ème
GIRONDE,BORDEAUX,0330033G,0,0,0,0,0,0,6 ème
GIRONDE,BORDEAUX,0330140Y,123,119,4,0,51,72,6 ème
GIRONDE,BORDEAUX,0332285E,104,93,8,3,56,48,6 ème
GIRONDE,BORDEAUX,0332488A,242,239,0,3,127,115,6 ème
GIRONDE,BORDEAUX,0332746F,114,114,0,0,48,66,6 ème
GIRONDE,BRUGES,0333274E,88,81,0,7,45,43,6 ème
GIRONDE,CADAUJAC,0333133B,165,165,0,0,96,69,6 ème
GIRONDE,CENON,0331885V,177,164,11,2,96,81,6 ème
GIRONDE,LACANAU,0333287U,142,142,0,0,62,80,6 ème
GIRONDE,LA REOLE,0332248P,155,153,0,2,81,74,6 ème
GIRONDE,LA TESTE-DE-BUCH,0330129L,185,182,0,3,94,91,6 ème
GIRONDE,LATRESNE,0331620G,253,251,0,2,121,132,6 ème
GIRONDE,LE BOUSCAT,0331669K,160,150,7,3,65,95,6 ème
GIRONDE,LEGE-CAP-FERRET,0332657J,155,155,0,0,77,78,6 ème
GIRONDE,LE HAILLAN,0333530H,137,137,0,0,70,67,6 ème
GIRONDE,LEOGNAN,0332244K,136,136,0,0,67,69,6 ème
GIRONDE,LORMONT,0331895F,110,104,0,6,51,59,6 ème
GIRONDE,PAUILLAC,0330102G,0,0,0,0,0,0,6 ème
GIRONDE,PESSAC,0331529H,154,154,0,0,81,73,6 ème
GIRONDE,PESSAC,0331623K,192,192,0,0,84,108,6 ème
GIRONDE,PESSAC,0332191C,120,100,16,4,60,60,6 ème
GIRONDE,PESSAC,0332345V,0,0,0,0,0,0,6 ème
GIRONDE,RAUZAN,0331433D,74,73,0,1,40,34,6 ème
GIRONDE,SAINT-AUBIN-DE-MEDOC,0333093H,187,187,0,0,92,95,6 ème
GIRONDE,SAINTE-FOY-LA-GRANDE,0330163Y,125,109,12,4,64,61,6 ème
GIRONDE,SALLES,0331666G,236,236,0,0,110,126,6 ème
GIRONDE,TALENCE,0331500B,111,111,0,0,55,56,6 ème
LANDES,CAPBRETON,0400071K,90,90,0,0,39,51,6 ème
LANDES,LABRIT,0401077D,76,76,0,0,36,40,6 ème
LANDES,LINXE,0401015L,96,94,0,2,57,39,6 ème
LANDES,MORCENX-LA-NOUVELLE,0400093J,70,68,0,2,35,35,6 ème
LANDES,PARENTIS-EN-BORN,0400046H,0,0,0,0,0,0,6 ème
LANDES,SAINT-PAUL-LES-DAX,0400096M,99,82,15,2,43,56,6 ème
LANDES,SAINT-PIERRE-DU-MONT,0400080V,0,0,0,0,0,0,6 ème
LANDES,SAINT-VINCENT-DE-PAUL,0400916D,0,0,0,0,0,0,6 ème
LANDES,VILLENEUVE-DE-MARSAN,0400043E,100,96,0,4,57,43,6 ème
LOT-ET-GARONNE,AGEN,0470677F,133,129,0,4,67,66,6 ème
LOT-ET-GARONNE,AIGUILLON,0470774L,115,111,0,4,61,54,6 ème
LOT-ET-GARONNE,FUMEL,0470046V,83,71,12,0,42,41,6 ème
LOT-ET-GARONNE,MONSEMPRON-LIBOS,0470048X,75,74,0,1,37,38,6 ème
LOT-ET-GARONNE,NERAC,0470029B,0,0,0,0,0,0,6 ème
LOT-ET-GARONNE,PENNE-D'AGENAIS,0470031D,132,131,0,1,56,76,6 ème
PYRENEES-ATLANTIQUES,ARETTE,0640004G,26,26,0,0,13,13,6 ème
PYRENEES-ATLANTIQUES,ARTIX,0640231D,128,124,0,4,62,66,6 ème
PYRENEES-ATLANTIQUES,BAYONNE,0640144J,14,14,0,0,7,7,6 ème
PYRENEES-ATLANTIQUES,BAYONNE,0641652Y,121,119,0,2,58,63,6 ème
PYRENEES-ATLANTIQUES,BIARRITZ,0640078M,175,174,0,1,97,78,6 ème
PYRENEES-ATLANTIQUES,BIDACHE,0640019Y,65,65,0,0,26,39,6 ème
PYRENEES-ATLANTIQUES,HASPARREN,0640119G,83,83,0,0,38,45,6 ème
PYRENEES-ATLANTIQUES,HASPARREN,0640181Z,0,0,0,0,0,0,6 ème
PYRENEES-ATLANTIQUES,JURANCON,0641411L,161,152,6,3,76,85,6 ème
PYRENEES-ATLANTIQUES,LARUNS,0640035R,24,24,0,0,13,11,6 ème
PYRENEES-ATLANTIQUES,NAY,0641509T,177,175,0,2,89,88,6 ème
PYRENEES-ATLANTIQUES,OLORON-SAINTE-MARIE,0640048E,82,81,0,1,50,32,6 ème
PYRENEES-ATLANTIQUES,ORTHEZ,0640128S,29,29,0,0,14,15,6 ème
PYRENEES-ATLANTIQUES,PAU,0640133X,145,145,0,0,75,70,6 ème
PYRENEES-ATLANTIQUES,SAINT-ETIENNE-DE-BAIGORRY,0640064X,13,13,0,0,7,6,6 ème
PYRENEES-ATLANTIQUES,SAINT-ETIENNE-DE-BAIGORRY,0640162D,17,17,0,0,6,11,6 ème
PYRENEES-ATLANTIQUES,SAINT-JEAN-DE-LUZ,0641559X,129,129,0,0,53,76,6 ème
PYRENEES-ATLANTIQUES,SALIES-DE-BEARN,0640170M,26,26,0,0,10,16,6 ème
PYRENEES-ATLANTIQUES,SAUVETERRE-DE-BEARN,0640171N,24,24,0,0,9,15,6 ème
PYRENEES-ATLANTIQUES,TARDETS-SORHOLUS,0640074H,22,22,0,0,11,11,6 ème
PYRENEES-ATLANTIQUES,USTARITZ,0640136A,116,116,0,0,64,52,6 ème
CORREZE,ARGENTAT-SUR-DORDOGNE,0190779U,43,41,0,2,19,24,6 ème
CORREZE,CORREZE,0190016P,41,41,0,0,17,24,6 ème
CORREZE,LARCHE,0190720E,150,150,0,0,79,71,6 ème
CORREZE,TULLE,0190613N,141,124,14,3,77,64,6 ème
CORREZE,UZERCHE,0190568P,90,90,0,0,44,46,6 ème
CREUSE,BOURGANEUF,0230507B,83,69,14,0,40,43,6 ème
CREUSE,CHATELUS-MALVALEIX,0230011M,39,27,12,0,20,19,6 ème
CREUSE,FELLETIN,0230019W,0,0,0,0,0,0,6 ème
HAUTE-VIENNE,AIXE-SUR-VIENNE,0870086W,38,32,0,6,18,20,6 ème
HAUTE-VIENNE,LE DORAT,0870819T,46,46,0,0,18,28,6 ème
HAUTE-VIENNE,LIMOGES,0870058R,0,0,0,0,0,0,6 ème
HAUTE-VIENNE,LIMOGES,0870071E,180,180,0,0,87,93,6 ème
HAUTE-VIENNE,LIMOGES,0870083T,123,123,0,0,64,59,6 ème
HAUTE-VIENNE,LIMOGES,0870729V,62,62,0,0,30,32,6 ème
HAUTE-VIENNE,LIMOGES,0870791M,111,93,15,3,52,59,6 ème
HAUTE-VIENNE,LIMOGES,0871030X,0,0,0,0,0,0,6 ème
HAUTE-VIENNE,NANTIAT,0870031L,128,128,0,0,63,65,6 ème
HAUTE-VIENNE,SAINT-JUNIEN,0870041X,0,0,0,0,0,0,6 ème
HAUTE-VIENNE,SAINT-JUNIEN,0870042Y,159,142,14,3,59,100,6 ème
HAUTE-VIENNE,SAINT-SULPICE-LAURIERE,0870048E,42,42,0,0,21,21,6 ème
HAUTE-VIENNE,SAINT-YRIEIX-LA-PERCHE,0870051H,0,0,0,0,0,0,6 ème
CHARENTE,ANGOULEME,0160884Z,81,81,0,0,36,45,6 ème
CHARENTE,BAIGNES-SAINTE-RADEGONDE,0160895L,45,45,0,0,24,21,6 ème
CHARENTE,COGNAC,0160119T,0,0,0,0,0,0,6 ème
CHARENTE,COGNAC,0160864C,101,85,16,0,40,61,6 ème
CHARENTE,COGNAC,0161050E,105,105,0,0,46,59,6 ème
CHARENTE,COTEAUX-DU-BLANZACAIS,0160012B,58,58,0,0,29,29,6 ème
CHARENTE,LA ROCHEFOUCAULD-EN-ANGOUMOIS,0160867F,113,113,0,0,59,54,6 ème
CHARENTE,PUYMOYEN,0160968R,16,0,16,0,8,8,6 ème
CHARENTE,RUELLE-SUR-TOUVRE,0160094R,164,163,0,1,81,83,6 ème
CHARENTE,RUFFEC,0160039F,69,60,8,1,29,40,6 ème
CHARENTE,SAINT-MICHEL,0160969S,125,125,0,0,69,56,6 ème
CHARENTE,TERRES-DE-HAUTE-CHARENTE,0160793A,43,43,0,0,16,27,6 ème
CHARENTE-MARITIME,ARCHIAC,0170002K,77,77,0,0,44,33,6 ème
CHARENTE-MARITIME,COZES,0170008S,100,100,0,0,50,50,6 ème
CHARENTE-MARITIME,LA ROCHELLE,0170077S,132,128,0,4,67,65,6 ème
CHARENTE-MARITIME,LA ROCHELLE,0170099R,217,212,0,5,97,120,6 ème
CHARENTE-MARITIME,PONS,0170389F,144,128,14,2,77,67,6 ème
CHARENTE-MARITIME,PONT-L'ABBE-D'ARNOULT,0171340P,149,149,0,0,87,62,6 ème
CHARENTE-MARITIME,ROCHEFORT,0170025K,0,0,0,0,0,0,6 ème
CHARENTE-MARITIME,ROCHEFORT,0171057G,116,110,0,6,58,58,6 ème
CHARENTE-MARITIME,SAINT-AGNANT,0170047J,126,126,0,0,63,63,6 ème
CHARENTE-MARITIME,SAINT-PIERRE-D'OLERON,0171215D,98,98,0,0,36,62,6 ème
CHARENTE-MARITIME,SURGERES,0170070J,0,0,0,0,0,0,6 ème
CHARENTE-MARITIME,SURGERES,0170071K,187,173,10,4,94,93,6 ème
DEUX-SEVRES,BRIOUX-SUR-BOUTONNE,0790010G,70,70,0,0,28,42,6 ème
DEUX-SEVRES,CHEF-BOUTONNE,0790015M,0,0,0,0,0,0,6 ème
DEUX-SEVRES,FRONTENAY-ROHAN-ROHAN,0790699F,164,164,0,0,78,86,6 ème
DEUX-SEVRES,MAZIERES-EN-GATINE,0790044U,63,62,0,1,32,31,6 ème
DEUX-SEVRES,NIORT,0790703K,132,130,0,2,55,77,6 ème
DEUX-SEVRES,NIORT,0790928E,0,0,0,0,0,0,6 ème
DEUX-SEVRES,SAINT-MAIXENT-L'ECOLE,0790072Z,80,80,0,0,34,46,6 ème
DEUX-SEVRES,SECONDIGNY,0790074B,41,41,0,0,23,18,6 ème
DEUX-SEVRES,THOUARS,0791002K,125,100,24,1,54,71,6 ème
VIENNE,CIVRAY,0860010U,0,0,0,0,0,0,6 ème
VIENNE,LENCLOITRE,0860020E,131,128,0,3,69,62,6 ème
VIENNE,LOUDUN,0860765P,74,74,0,0,35,39,6 ème
VIENNE,LUSSAC-LES-CHATEAUX,0860026L,103,99,0,4,57,46,6 ème
VIENNE,MONTMORILLON,0860029P,0,0,0,0,0,0,6 ème
VIENNE,MONTMORILLON,0860031S,95,95,0,0,45,50,6 ème
VIENNE,POITIERS,0860774Z,0,0,0,0,0,0,6 ème
VIENNE,POITIERS,0860789R,0,0,0,0,0,0,6 ème
VIENNE,POITIERS,0861447F,85,85,0,0,30,55,6 ème
VIENNE,VOUILLE,0860772X,110,110,0,0,51,59,6 ème
AUDE,CAPENDU,0110003U,84,80,0,4,43,41,6 ème
AUDE,CARCASSONNE,0110045P,0,0,0,0,0,0,6 ème
AUDE,CARCASSONNE,0110672W,148,129,15,4,79,69,6 ème
AUDE,CHALABRE,0110870L,29,29,0,0,13,16,6 ème
AUDE,LIMOUX,0110859Z,213,198,10,5,107,106,6 ème
AUDE,QUILLAN,0110027V,0,0,0,0,0,0,6 ème
GARD,ALES,0300002P,0,0,0,0,0,0,6 ème
GARD,ALES,0300028T,0,0,0,0,0,0,6 ème
GARD,ALES,0301013N,114,95,16,3,58,56,6 ème
GARD,ALES,0301014P,150,137,11,2,75,75,6 ème
GARD,ALES,0301354J,175,171,0,4,96,79,6 ème
GARD,ANDUZE,0300006U,132,132,0,0,78,54,6 ème
GARD,BAGNOLS-SUR-CEZE,0300950V,0,0,0,0,0,0,6 ème
GARD,BAGNOLS-SUR-CEZE,0301211D,171,141,24,6,74,97,6 ème
GARD,BEAUCAIRE,0300011Z,0,0,0,0,0,0,6 ème
GARD,CLARENSAC,0301723K,171,171,0,0,93,78,6 ème
GARD,NIMES,0300058A,0,0,0,0,0,0,6 ème
GARD,NIMES,0301284H,158,158,0,0,72,86,6 ème
GARD,PONT-SAINT-ESPRIT,0300031W,134,127,0,7,53,81,6 ème
GARD,PONT-SAINT-ESPRIT,0300098U,93,93,0,0,53,40,6 ème
GARD,SAINT-CHRISTOL-LES-ALES,0301778V,0,0,0,0,0,0,6 ème
GARD,SAINT-JEAN-DU-GARD,0300042H,35,35,0,0,14,21,6 ème
GARD,SALINDRES,0300043J,165,164,0,1,82,83,6 ème
GARD,SOMMIERES,0300101X,121,121,0,0,55,66,6 ème
GARD,UZES,0301244P,64,64,0,0,30,34,6 ème
GARD,VILLENEUVE-LES-AVIGNON,0300085E,83,83,0,0,44,39,6 ème
HERAULT,BEZIERS,0340012D,0,0,0,0,0,0,6 ème
HERAULT,BEZIERS,0340016H,124,124,0,0,52,72,6 ème
HERAULT,FLORENSAC,0340024S,90,90,0,0,36,54,6 ème
HERAULT,LA GRANDE-MOTTE,0341656R,79,78,0,1,36,43,6 ème
HERAULT,LANSARGUES,0342076X,210,196,14,0,91,119,6 ème
HERAULT,LATTES,0341028H,204,199,0,5,98,106,6 ème
HERAULT,LODEVE,0340117T,201,187,11,3,95,106,6 ème
HERAULT,MARAUSSAN,0342399Y,14,14,0,0,2,12,6 ème
HERAULT,MARSEILLAN,0342130F,119,117,0,2,63,56,6 ème
HERAULT,MARSILLARGUES,0340034C,81,80,0,1,36,45,6 ème
HERAULT,MAUGUIO,0341368C,235,231,0,4,119,116,6 ème
HERAULT,MONTARNAUD,0342051V,155,152,0,3,71,84,6 ème
HERAULT,MONTPELLIER,0340902W,132,130,0,2,54,78,6 ème
HERAULT,MONTPELLIER,0340904Y,121,121,0,0,53,68,6 ème
HERAULT,MONTPELLIER,0341364Y,106,100,0,6,48,58,6 ème
HERAULT,MONTPELLIER,0341385W,0,0,0,0,0,0,6 ème
HERAULT,MONTPELLIER,0342131G,158,152,0,6,83,75,6 ème
HERAULT,MONTPELLIER,0342147Z,4,4,0,0,0,4,6 ème
HERAULT,OLONZAC,0340057C,75,75,0,0,29,46,6 ème
HERAULT,PEROLS,0341537L,143,143,0,0,55,88,6 ème
HERAULT,PIGNAN,0341870Y,220,219,0,1,107,113,6 ème
HERAULT,ROUJAN,0342326U,138,138,0,0,60,78,6 ème
HERAULT,SAINT-CLEMENT-DE-RIVIERE,0340110K,226,223,0,3,112,114,6 ème
HERAULT,SAINT-GELY-DU-FESC,0341764H,191,187,0,4,83,108,6 ème
HERAULT,SAINT-MATHIEU-DE-TREVIERS,0341705U,127,127,0,0,56,71,6 ème
HERAULT,SERVIAN,0341387Y,158,158,0,0,86,72,6 ème
HERAULT,VENDRES,0342050U,174,174,0,0,76,98,6 ème
LOZERE,MENDE,0480019K,0,0,0,0,0,0,6 ème
LOZERE,SAINT-CHELY-D'APCHER,0480013D,97,91,0,6,47,50,6 ème
LOZERE,SAINT-CHELY-D'APCHER,0480688M,0,0,0,0,0,0,6 ème
LOZERE,SAINT-ETIENNE-VALLEE-FRANCAISE,0480015F,17,17,0,0,14,3,6 ème
LOZERE,VILLEFORT,0480017H,23,23,0,0,9,14,6 ème
PYRENEES-ORIENTALES,ARLES-SUR-TECH,0660480N,72,72,0,0,32,40,6 ème
PYRENEES-ORIENTALES,PERPIGNAN,0660051X,88,88,0,0,38,50,6 ème
PYRENEES-ORIENTALES,PERPIGNAN,0660063K,174,174,0,0,94,80,6 ème
PYRENEES-ORIENTALES,PERPIGNAN,0660522J,154,141,12,1,68,86,6 ème
PYRENEES-ORIENTALES,PRADES,0660068R,34,34,0,0,16,18,6 ème
PYRENEES-ORIENTALES,SAINT-ESTEVE,0660431K,219,200,16,3,89,130,6 ème
PYRENEES-ORIENTALES,SAINT-PAUL-DE-FENOUILLET,0660029Y,40,40,0,0,15,25,6 ème
ARIEGE,LE MAS-D'AZIL,0090010M,73,73,0,0,39,34,6 ème
ARIEGE,LEZAT-SUR-LEZE,0090009L,89,89,0,0,47,42,6 ème
ARIEGE,PAMIERS,0090045A,0,0,0,0,0,0,6 ème
ARIEGE,PAMIERS,0090055L,186,179,0,7,93,93,6 ème
ARIEGE,SAINT-GIRONS,0090038T,22,22,0,0,6,16,6 ème
ARIEGE,SAINT-GIRONS,0090574A,164,155,7,2,84,80,6 ème
ARIEGE,TARASCON-SUR-ARIEGE,0090546V,100,100,0,0,48,52,6 ème
AVEYRON,CRANSAC,0120004P,30,28,0,2,15,15,6 ème
AVEYRON,MARCILLAC-VALLON,0120092K,55,52,0,3,34,21,6 ème
AVEYRON,NAUCELLE,0120017D,47,47,0,0,25,22,6 ème
AVEYRON,NAUCELLE,0121174L,17,17,0,0,10,7,6 ème
AVEYRON,RODEZ,0121309H,0,0,0,0,0,0,6 ème
AVEYRON,SAINT-AFFRIQUE,0121256A,74,68,0,6,36,38,6 ème
GERS,AIGNAN,0320001C,19,19,0,0,13,6,6 ème
GERS,AUCH,0320563N,105,104,0,1,43,62,6 ème
GERS,AUCH,0320650H,97,92,3,2,47,50,6 ème
GERS,CONDOM,0320059R,46,46,0,0,24,22,6 ème
GERS,GIMONT,0320013R,79,76,0,3,34,45,6 ème
GERS,L'ISLE-JOURDAIN,0320014S,100,99,0,1,53,47,6 ème
GERS,L'ISLE-JOURDAIN,0320056M,83,83,0,0,37,46,6 ème
GERS,PLAISANCE,0320028G,37,37,0,0,13,24,6 ème
HAUTE-GARONNE,BAGNERES-DE-LUCHON,0310005M,50,47,0,3,24,26,6 ème
HAUTE-GARONNE,BESSIERES,0312799Z,165,165,0,0,74,91,6 ème
HAUTE-GARONNE,BLAGNAC,0311581A,120,116,0,4,70,50,6 ème
HAUTE-GARONNE,CINTEGABELLE,0313045S,77,77,0,0,42,35,6 ème
HAUTE-GARONNE,COLOMIERS,0311092U,0,0,0,0,0,0,6 ème
HAUTE-GARONNE,COLOMIERS,0312191N,0,0,0,0,0,0,6 ème
HAUTE-GARONNE,FENOUILLET,0312423R,150,148,0,2,70,80,6 ème
HAUTE-GARONNE,LE FOUSSERET,0310015Y,120,118,0,2,63,57,6 ème
HAUTE-GARONNE,MURET,0311319R,176,163,13,0,86,90,6 ème
HAUTE-GARONNE,PIBRAC,0311176K,153,153,0,0,63,90,6 ème
HAUTE-GARONNE,PIBRAC,0311263E,135,134,0,1,76,59,6 ème
HAUTE-GARONNE,PINS-JUSTARET,0312220V,207,202,0,5,93,114,6 ème
HAUTE-GARONNE,PLAISANCE-DU-TOUCH,0312071H,232,226,0,6,108,124,6 ème
HAUTE-GARONNE,PORTET-SUR-GARONNE,0311686P,177,169,0,8,78,99,6 ème
HAUTE-GARONNE,REVEL,0311209W,37,37,0,0,13,24,6 ème
HAUTE-GARONNE,RIEUMES,0310029N,103,103,0,0,56,47,6 ème
HAUTE-GARONNE,SAINT-JEAN,0311722D,196,192,0,4,87,109,6 ème
HAUTE-GARONNE,SAINT-JORY,0312842W,156,153,0,3,64,92,6 ème
HAUTE-GARONNE,SALIES-DU-SALAT,0310035V,112,109,0,3,55,57,6 ème
HAUTE-GARONNE,SEILH,0311967V,147,147,0,0,72,75,6 ème
HAUTE-GARONNE,TOULOUSE,0310037X,165,152,9,4,78,87,6 ème
HAUTE-GARONNE,TOULOUSE,0310052N,0,0,0,0,0,0,6 ème
HAUTE-GARONNE,TOULOUSE,0310054R,0,0,0,0,0,0,6 ème
HAUTE-GARONNE,TOULOUSE,0310056T,0,0,0,0,0,0,6 ème
HAUTE-GARONNE,TOULOUSE,0311111P,206,204,0,2,94,112,6 ème
HAUTE-GARONNE,TOULOUSE,0311265G,149,139,7,3,72,77,6 ème
HAUTE-GARONNE,TOULOUSE,0311630D,142,124,15,3,72,70,6 ème
HAUTE-GARONNE,TOULOUSE,0312064A,0,0,0,0,0,0,6 ème
HAUTE-GARONNE,TOULOUSE,0312759F,0,0,0,0,0,0,6 ème
HAUTE-GARONNE,TOULOUSE,0312885T,20,20,0,0,6,14,6 ème
HAUTE-GARONNE,TOULOUSE,0313080E,174,168,0,6,90,84,6 ème
HAUTE-GARONNE,VILLENEUVE-TOLOSANE,0312611V,150,150,0,0,75,75,6 ème
HAUTES-PYRENEES,BAGNERES-DE-BIGORRE,0650089U,126,123,0,3,62,64,6 ème
LOT,CAHORS,0460493L,0,0,0,0,0,0,6 ème
LOT,MARTEL,0460021Y,42,42,0,0,22,20,6 ème
LOT,PRAYSSAC,0460024B,37,37,0,0,19,18,6 ème
TARN,ALBI,0810004P,0,0,0,0,0,0,6 ème
TARN,ALBI,0810051R,107,106,0,1,53,54,6 ème
TARN,ALBI,0811070Y,0,0,0,0,0,0,6 ème
TARN,CARMAUX,0810787R,111,109,0,2,58,53,6 ème
TARN,CASTRES,0810960D,100,98,0,2,50,50,6 ème
TARN,CASTRES,0810961E,116,112,0,4,45,71,6 ème
TARN,GAILLAC,0811331G,126,126,0,0,56,70,6 ème
TARN,MAZAMET,0810108C,0,0,0,0,0,0,6 ème
TARN,MAZAMET,0810127Y,89,89,0,0,47,42,6 ème
TARN,RABASTENS,0810037A,132,130,0,2,68,64,6 ème
TARN-ET-GARONNE,CASTELSARRASIN,0820066B,191,173,15,3,83,108,6 ème
TARN-ET-GARONNE,GRISOLLES,0820683X,156,155,0,1,64,92,6 ème
TARN-ET-GARONNE,MOISSAC,0820753Y,59,58,0,1,24,35,6 ème
TARN-ET-GARONNE,MONTECH,0820891Y,165,162,0,3,79,86,6 ème
TARN-ET-GARONNE,VALENCE,0820029L,194,181,8,5,95,99,6 ème
TARN-ET-GARONNE,VALENCE,0820899G,0,0,0,0,0,0,6 ème
TARN-ET-GARONNE,VERDUN-SUR-GARONNE,0820922G,117,116,0,1,62,55,6 ème
LOIRE-ATLANTIQUE,ANCENIS-SAINT-GEREON,0441928G,220,216,0,4,103,117,6 ème
LOIRE-ATLANTIQUE,BOUAYE,0441858F,163,163,0,0,81,82,6 ème
LOIRE-ATLANTIQUE,CHATEAUBRIANT,0440005S,0,0,0,0,0,0,6 ème
LOIRE-ATLANTIQUE,CHATEAUBRIANT,0440293E,129,126,0,3,62,67,6 ème
LOIRE-ATLANTIQUE,CHATEAUBRIANT,0441929H,182,178,0,4,89,93,6 ème
LOIRE-ATLANTIQUE,CLISSON,0440008V,154,134,16,4,82,72,6 ème
LOIRE-ATLANTIQUE,CLISSON,0442781J,128,123,0,5,66,62,6 ème
LOIRE-ATLANTIQUE,CORDEMAIS,0442023K,173,171,0,2,83,90,6 ème
LOIRE-ATLANTIQUE,DONGES,0441727N,77,76,0,1,44,33,6 ème
LOIRE-ATLANTIQUE,LA CHAPELLE-SUR-ERDRE,0441547T,164,160,0,4,80,84,6 ème
LOIRE-ATLANTIQUE,LOIREAUXENCE,0442921L,123,123,0,0,61,62,6 ème
LOIRE-ATLANTIQUE,NANTES,0440025N,107,106,0,1,52,55,6 ème
LOIRE-ATLANTIQUE,NANTES,0440034Y,0,0,0,0,0,0,6 ème
LOIRE-ATLANTIQUE,NANTES,0440035Z,0,0,0,0,0,0,6 ème
LOIRE-ATLANTIQUE,NANTES,0440284V,138,138,0,0,61,77,6 ème
LOIRE-ATLANTIQUE,NANTES,0441931K,253,253,0,0,134,119,6 ème
LOIRE-ATLANTIQUE,NANTES,0441933M,210,210,0,0,91,119,6 ème
LOIRE-ATLANTIQUE,NANTES,0441935P,221,208,13,0,107,114,6 ème
LOIRE-ATLANTIQUE,NANTES,0441936R,160,158,0,2,74,86,6 ème
LOIRE-ATLANTIQUE,NANTES,0442775C,0,0,0,0,0,0,6 ème
LOIRE-ATLANTIQUE,PAIMBOEUF,0440056X,0,0,0,0,0,0,6 ème
LOIRE-ATLANTIQUE,PONTCHATEAU,0440541Z,0,0,0,0,0,0,6 ème
LOIRE-ATLANTIQUE,PONTCHATEAU,0442807M,147,147,0,0,70,77,6 ème
LOIRE-ATLANTIQUE,REZE,0440063E,0,0,0,0,0,0,6 ème
LOIRE-ATLANTIQUE,REZE,0440229K,184,184,0,0,88,96,6 ème
LOIRE-ATLANTIQUE,REZE,0440274J,0,0,0,0,0,0,6 ème
LOIRE-ATLANTIQUE,SAINTE-PAZANNE,0442625P,189,187,0,2,94,95,6 ème
LOIRE-ATLANTIQUE,SAINT-JOACHIM,0441728P,54,54,0,0,25,29,6 ème
LOIRE-ATLANTIQUE,SAINT-NAZAIRE,0441941W,202,202,0,0,98,104,6 ème
LOIRE-ATLANTIQUE,SAINT-PHILBERT-DE-GRAND-LIEU,0442186M,98,96,0,2,52,46,6 ème
LOIRE-ATLANTIQUE,SAINT-SEBASTIEN-SUR-LOIRE,0440291C,98,96,0,2,44,54,6 ème
LOIRE-ATLANTIQUE,SAVENAY,0440241Y,293,293,0,0,143,150,6 ème
LOIRE-ATLANTIQUE,SAVENAY,0441657M,122,122,0,0,56,66,6 ème
LOIRE-ATLANTIQUE,TRIGNAC,0441616T,134,116,16,2,68,66,6 ème
LOIRE-ATLANTIQUE,VALLET,0442052S,160,158,0,2,74,86,6 ème
LOIRE-ATLANTIQUE,VERTOU,0442595G,131,130,0,1,77,54,6 ème
MAINE-ET-LOIRE,ANGERS,0490843A,96,95,0,1,49,47,6 ème
MAINE-ET-LOIRE,ANGERS,0491825T,133,133,0,0,57,76,6 ème
MAINE-ET-LOIRE,BAUGE-EN-ANJOU,0490010V,99,96,0,3,51,48,6 ème
MAINE-ET-LOIRE,BEAUFORT-EN-ANJOU,0490922L,191,191,0,0,103,88,6 ème
MAINE-ET-LOIRE,BRISSAC LOIRE AUBANCE,0490853L,138,138,0,0,65,73,6 ème
MAINE-ET-LOIRE,CHEMILLE-EN-ANJOU,0491929F,62,62,0,0,31,31,6 ème
MAINE-ET-LOIRE,CHOLET,0490862W,180,180,0,0,96,84,6 ème
MAINE-ET-LOIRE,CHOLET,0490886X,0,0,0,0,0,0,6 ème
MAINE-ET-LOIRE,DURTAL,0490956Y,77,77,0,0,33,44,6 ème
MAINE-ET-LOIRE,LONGUE-JUMELLES,0490867B,119,119,0,0,52,67,6 ème
MAINE-ET-LOIRE,MAUGES-SUR-LOIRE,0490039B,50,46,0,4,24,26,6 ème
MAINE-ET-LOIRE,MONTREVAULT-SUR-EVRE,0490876L,150,150,0,0,75,75,6 ème
MAINE-ET-LOIRE,OREE D'ANJOU,0490057W,116,116,0,0,74,42,6 ème
MAINE-ET-LOIRE,OREE D'ANJOU,0490856P,137,137,0,0,79,58,6 ème
MAINE-ET-LOIRE,SAUMUR,0491648A,90,76,11,3,50,40,6 ème
MAINE-ET-LOIRE,SEGRE-EN-ANJOU BLEU,0490878N,193,193,0,0,101,92,6 ème
MAINE-ET-LOIRE,SEVREMOINE,0490875K,176,176,0,0,78,98,6 ème
MAINE-ET-LOIRE,SEVREMOINE,0491706N,81,81,0,0,43,38,6 ème
MAINE-ET-LOIRE,TRELAZE,0491646Y,0,0,0,0,0,0,6 ème
MAINE-ET-LOIRE,VERRIERES-EN-ANJOU,0491921X,123,120,0,3,50,73,6 ème
MAYENNE,CHATEAU-GONTIER-SUR-MAYENNE,0530779J,125,111,9,5,68,57,6 ème
MAYENNE,COSSE-LE-VIVIEN,0530030V,62,58,0,4,29,33,6 ème
MAYENNE,ERNEE,0530077W,85,66,15,4,51,34,6 ème
MAYENNE,LAVAL,0530015D,121,119,0,2,65,56,6 ème
MAYENNE,LAVAL,0530914F,74,71,0,3,33,41,6 ème
MAYENNE,MESLAY-DU-MAINE,0530063F,73,69,0,4,38,35,6 ème
MAYENNE,PORT-BRILLET,0530021K,97,97,0,0,45,52,6 ème
MAYENNE,PRE-EN-PAIL-SAINT-SAMSON,0530583W,69,69,0,0,31,38,6 ème
SARTHE,ARNAGE,0720903R,116,116,0,0,53,63,6 ème
SARTHE,BALLON-SAINT MARS,0720004N,99,78,16,5,43,56,6 ème
SARTHE,BEAUMONT-SUR-SARTHE,0720904S,68,66,0,2,24,44,6 ème
SARTHE,BONNETABLE,0721093X,131,131,0,0,62,69,6 ème
SARTHE,CHAMPAGNE,0721086P,134,132,0,2,65,69,6 ème
SARTHE,FRESNAY-SUR-SARTHE,0720019E,76,73,0,3,36,40,6 ème
SARTHE,LA FERTE-BERNARD,0720017C,0,0,0,0,0,0,6 ème
SARTHE,LA FERTE-BERNARD,0720806K,84,84,0,0,45,39,6 ème
SARTHE,LA FLECHE,0720062B,105,101,0,4,48,57,6 ème
SARTHE,LE GRAND-LUCE,0721044U,92,86,0,6,47,45,6 ème
SARTHE,LE LUDE,0721226S,79,79,0,0,38,41,6 ème
SARTHE,LE MANS,0720040C,99,99,0,0,49,50,6 ème
SARTHE,LE MANS,0720797A,107,91,16,0,55,52,6 ème
SARTHE,LE MANS,0720798B,111,108,0,3,53,58,6 ème
SARTHE,LE MANS,0720800D,76,74,0,2,39,37,6 ème
SARTHE,LE MANS,0720815V,113,113,0,0,67,46,6 ème
SARTHE,LE MANS,0720836T,108,98,0,10,63,45,6 ème
SARTHE,LE MANS,0720838V,148,148,0,0,85,63,6 ème
SARTHE,LE MANS,0720983C,67,67,0,0,32,35,6 ème
SARTHE,LE MANS,0721262F,77,73,0,4,39,38,6 ème
SARTHE,LOUE,0720024K,118,118,0,0,63,55,6 ème
SARTHE,MAMERS,0720027N,0,0,0,0,0,0,6 ème
SARTHE,MOULINS-LE-CARBONNEL,0720046J,67,67,0,0,30,37,6 ème
SARTHE,PONTVALLAIN,0721304B,85,81,0,4,46,39,6 ème
SARTHE,SABLE-SUR-SARTHE,0721408P,172,164,0,8,72,100,6 ème
SARTHE,SAINT-CALAIS,0720051P,45,42,0,3,21,24,6 ème
VENDEE,AIZENAY,0850090L,120,120,0,0,52,68,6 ème
VENDEE,AIZENAY,0851560J,164,162,0,2,80,84,6 ème
VENDEE,BELLEVIGNY,0851435Y,158,158,0,0,74,84,6 ème
VENDEE,CHANTONNAY,0851191H,218,217,0,1,102,116,6 ème
VENDEE,CHAVAGNES-EN-PAILLERS,0850073T,119,119,0,0,58,61,6 ème
VENDEE,FONTENAY-LE-COMTE,0850074U,173,160,11,2,73,100,6 ème
VENDEE,LA ROCHE-SUR-YON,0850605W,136,134,0,2,60,76,6 ème
VENDEE,LA ROCHE-SUR-YON,0851643Z,0,0,0,0,0,0,6 ème
VENDEE,LES SABLES-D'OLONNE,0850148Z,101,99,0,2,49,52,6 ème
VENDEE,LES SABLES-D'OLONNE,0850149A,96,77,15,4,48,48,6 ème
VENDEE,LUCON,0850069N,80,77,0,3,34,46,6 ème
VENDEE,MONTAIGU-VENDEE,0851662V,139,137,0,2,68,71,6 ème
VENDEE,MORTAGNE-SUR-SEVRE,0851388X,120,120,0,0,65,55,6 ème
VENDEE,SAINTE-HERMINE,0851146J,73,71,0,2,29,44,6 ème
VENDEE,SAINT-GILLES-CROIX-DE-VIE,0850065J,190,176,14,0,86,104,6 ème
VENDEE,TIFFAUGES,0850125Z,115,115,0,0,50,65,6 ème
ALPES-DE-HTE-PROVENCE,BARCELONNETTE,0040419J,93,89,0,4,47,46,6 ème
ALPES-DE-HTE-PROVENCE,LA MOTTE-DU-CAIRE,0040014U,27,27,0,0,16,11,6 ème
ALPES-DE-HTE-PROVENCE,MANOSQUE,0040055N,156,138,15,3,73,83,6 ème
ALPES-DE-HTE-PROVENCE,SISTERON,0040023D,0,0,0,0,0,0,6 ème
BOUCHES-DU-RHONE,AIX-EN-PROVENCE,0130001F,0,0,0,0,0,0,6 ème
BOUCHES-DU-RHONE,AIX-EN-PROVENCE,0131318M,64,61,0,3,33,31,6 ème
BOUCHES-DU-RHONE,AIX-EN-PROVENCE,0131712R,191,168,23,0,88,103,6 ème
BOUCHES-DU-RHONE,AIX-EN-PROVENCE,0132955S,60,60,0,0,29,31,6 ème
BOUCHES-DU-RHONE,AIX-EN-PROVENCE,0132973L,131,131,0,0,56,75,6 ème
BOUCHES-DU-RHONE,ALLAUCH,0133490Y,230,230,0,0,121,109,6 ème
BOUCHES-DU-RHONE,ARLES,0133274N,0,0,0,0,0,0,6 ème
BOUCHES-DU-RHONE,BOUC-BEL-AIR,0132833J,147,141,0,6,82,65,6 ème
BOUCHES-DU-RHONE,CASSIS,0132324F,182,182,0,0,95,87,6 ème
BOUCHES-DU-RHONE,GEMENOS,0133351X,191,191,0,0,90,101,6 ème
BOUCHES-DU-RHONE,ISTRES,0132318Z,179,179,0,0,94,85,6 ème
BOUCHES-DU-RHONE,ISTRES,0132409Y,182,162,20,0,75,107,6 ème
BOUCHES-DU-RHONE,LA CIOTAT,0130022D,153,151,0,2,67,86,6 ème
BOUCHES-DU-RHONE,LES PENNES-MIRABEAU,0131369T,160,158,0,2,82,78,6 ème
BOUCHES-DU-RHONE,MARSEILLE,0131424C,0,0,0,0,0,0,6 ème
BOUCHES-DU-RHONE,MARSEILLE,0131922U,142,142,0,0,86,56,6 ème
BOUCHES-DU-RHONE,MARSEILLE,0131750G,161,161,0,0,81,80,6 ème
BOUCHES-DU-RHONE,MARSEILLE,0131261A,96,93,0,3,50,46,6 ème
BOUCHES-DU-RHONE,MARSEILLE,0131445A,0,0,0,0,0,0,6 ème
BOUCHES-DU-RHONE,MARSEILLE,0132314V,178,170,0,8,78,100,6 ème
BOUCHES-DU-RHONE,MARSEILLE,0132907P,192,190,0,2,104,88,6 ème
BOUCHES-DU-RHONE,MARSEILLE,0132908R,39,39,0,0,16,23,6 ème
BOUCHES-DU-RHONE,MARSEILLE,0130056R,0,0,0,0,0,0,6 ème
BOUCHES-DU-RHONE,MARSEILLE,0132207D,142,139,0,3,66,76,6 ème
BOUCHES-DU-RHONE,MARSEILLE,0132730X,121,119,0,2,58,63,6 ème
BOUCHES-DU-RHONE,MARSEILLE,0131329Z,86,86,0,0,40,46,6 ème
BOUCHES-DU-RHONE,MARSEILLE,0132407W,131,109,14,8,50,81,6 ème
BOUCHES-DU-RHONE,MARSEILLE,0131757P,146,144,0,2,77,69,6 ème
BOUCHES-DU-RHONE,MARSEILLE,0131375Z,60,60,0,0,30,30,6 ème
BOUCHES-DU-RHONE,MARSEILLE,0131884C,163,163,0,0,79,84,6 ème
BOUCHES-DU-RHONE,MARSEILLE,0131935H,137,137,0,0,63,74,6 ème
BOUCHES-DU-RHONE,MARSEILLE,0131381F,141,141,0,0,64,77,6 ème
BOUCHES-DU-RHONE,MARSEILLE,0132315W,144,141,0,3,60,84,6 ème
BOUCHES-DU-RHONE,MARSEILLE,0132923G,138,136,0,2,73,65,6 ème
BOUCHES-DU-RHONE,MARSEILLE,0132946G,124,124,0,0,52,72,6 ème
BOUCHES-DU-RHONE,MARSEILLE,0131689R,75,56,19,0,32,43,6 ème
BOUCHES-DU-RHONE,MARSEILLE,0132909S,87,87,0,0,40,47,6 ème
BOUCHES-DU-RHONE,MARSEILLE,0133374X,45,45,0,0,24,21,6 ème
BOUCHES-DU-RHONE,MARSEILLE,0132205B,116,116,0,0,64,52,6 ème
BOUCHES-DU-RHONE,MARSEILLE,0131923V,261,261,0,0,132,129,6 ème
BOUCHES-DU-RHONE,MARSEILLE,0131382G,102,102,0,0,55,47,6 ème
BOUCHES-DU-RHONE,MARSEILLE,0133866G,47,47,0,0,22,25,6 ème
BOUCHES-DU-RHONE,MARTIGUES,0132496T,139,139,0,0,78,61,6 ème
BOUCHES-DU-RHONE,PORT-DE-BOUC,0130150T,0,0,0,0,0,0,6 ème
BOUCHES-DU-RHONE,PORT-DE-BOUC,0130151U,0,0,0,0,0,0,6 ème
BOUCHES-DU-RHONE,PORT-SAINT-LOUIS-DU-RHONE,0132323E,143,138,4,1,69,74,6 ème
BOUCHES-DU-RHONE,ROGNAC,0131706J,160,160,0,0,89,71,6 ème
BOUCHES-DU-RHONE,ROGNONAS,0131387M,93,93,0,0,51,42,6 ème
BOUCHES-DU-RHONE,SAINT-MARTIN-DE-CRAU,0132834K,252,246,0,6,111,141,6 ème
BOUCHES-DU-RHONE,SALON-DE-PROVENCE,0130161E,0,0,0,0,0,0,6 ème
BOUCHES-DU-RHONE,SIMIANE-COLLONGUE,0133789Y,128,128,0,0,52,76,6 ème
BOUCHES-DU-RHONE,TRETS,0130166K,135,135,0,0,64,71,6 ème
HAUTES-ALPES,EMBRUN,0050023Y,124,122,0,2,60,64,6 ème
HAUTES-ALPES,GUILLESTRE,0050013M,68,68,0,0,38,30,6 ème
HAUTES-ALPES,LA BATIE-NEUVE,0050639T,105,105,0,0,50,55,6 ème
HAUTES-ALPES,SAINT-BONNET-EN-CHAMPSAUR,0050019U,114,114,0,0,53,61,6 ème
HAUTES-ALPES,SAINT-JEAN-SAINT-NICOLAS,0050039R,0,0,0,0,0,0,6 ème
VAUCLUSE,AVIGNON,0840004Y,0,0,0,0,0,0,6 ème
VAUCLUSE,AVIGNON,0840058G,81,81,0,0,38,43,6 ème
VAUCLUSE,AVIGNON,0840060J,183,183,0,0,69,114,6 ème
VAUCLUSE,AVIGNON,0840064N,87,87,0,0,42,45,6 ème
VAUCLUSE,AVIGNON,0840082H,0,0,0,0,0,0,6 ème
VAUCLUSE,BEDARRIDES,0840011F,129,128,0,1,70,59,6 ème
VAUCLUSE,CADENET,0840014J,122,116,0,6,50,72,6 ème
VAUCLUSE,CARPENTRAS,0840114T,173,160,10,3,90,83,6 ème
VAUCLUSE,CARPENTRAS,0840760V,126,126,0,0,56,70,6 ème
VAUCLUSE,MONTEUX,0840066R,138,138,0,0,61,77,6 ème
VAUCLUSE,ORANGE,0840046U,0,0,0,0,0,0,6 ème
VAUCLUSE,ORANGE,0840762X,141,137,0,4,65,76,6 ème
VAUCLUSE,VALREAS,0840700E,0,0,0,0,0,0,6 ème
ALPES-MARITIMES,ANTIBES,0060823M,61,61,0,0,27,34,6 ème
ALPES-MARITIMES,BREIL-SUR-ROYA,0060008B,27,27,0,0,14,13,6 ème
ALPES-MARITIMES,CAGNES-SUR-MER,0060911H,120,115,5,0,60,60,6 ème
ALPES-MARITIMES,CAGNES-SUR-MER,0061280J,147,147,0,0,75,72,6 ème
ALPES-MARITIMES,CAGNES-SUR-MER,0061737F,125,123,0,2,59,66,6 ème
ALPES-MARITIMES,CANNES,0060720A,166,166,0,0,82,84,6 ème
ALPES-MARITIMES,CANNES,0060799L,211,194,9,8,93,118,6 ème
ALPES-MARITIMES,CONTES,0060019N,189,175,12,2,100,89,6 ème
ALPES-MARITIMES,GRASSE,0060023T,0,0,0,0,0,0,6 ème
ALPES-MARITIMES,LE CANNET,0061239P,171,157,8,6,69,102,6 ème
ALPES-MARITIMES,LE ROURET,0061853G,164,159,0,5,94,70,6 ème
ALPES-MARITIMES,MENTON,0061824A,192,175,13,4,84,108,6 ème
ALPES-MARITIMES,MOUGINS,0061068D,208,192,11,5,107,101,6 ème
ALPES-MARITIMES,NICE,0060038J,0,0,0,0,0,0,6 ème
ALPES-MARITIMES,NICE,0060715V,0,0,0,0,0,0,6 ème
ALPES-MARITIMES,NICE,0060753L,97,97,0,0,41,56,6 ème
ALPES-MARITIMES,NICE,0060838D,121,114,0,7,53,68,6 ème
ALPES-MARITIMES,NICE,0061127T,128,128,0,0,78,50,6 ème
ALPES-MARITIMES,PUGET-THENIERS,0060061J,51,51,0,0,22,29,6 ème
ALPES-MARITIMES,SAINT-LAURENT-DU-VAR,0061738G,155,146,9,0,70,85,6 ème
ALPES-MARITIMES,TENDE,0060072W,18,18,0,0,10,8,6 ème
ALPES-MARITIMES,TOURRETTE-LEVENS,0060068S,179,179,0,0,82,97,6 ème
ALPES-MARITIMES,VALBONNE,0061925K,203,203,0,0,96,107,6 ème
VAR,BORMES-LES-MIMOSAS,0830927G,91,91,0,0,46,45,6 ème
VAR,HYERES,0831014B,0,0,0,0,0,0,6 ème
VAR,HYERES,0831563Y,0,0,0,0,0,0,6 ème
VAR,LA CRAU,0830012M,212,212,0,0,107,105,6 ème
VAR,LA VALETTE-DU-VAR,0830182X,202,193,9,0,93,109,6 ème
VAR,LA VALETTE-DU-VAR,0831218Y,133,114,12,7,54,79,6 ème
VAR,LE MUY,0830958R,135,131,0,4,66,69,6 ème
VAR,PUGET-SUR-ARGENS,0830168G,164,164,0,0,76,88,6 ème
VAR,SAINTE-MAXIME,0830039S,133,133,0,0,73,60,6 ème
VAR,SAINT-RAPHAEL,0830108S,148,148,0,0,76,72,6 ème
VAR,SIX-FOURS-LES-PLAGES,0830051E,177,177,0,0,79,98,6 ème
VAR,SOLLIES-PONT,0831355X,76,76,0,0,48,28,6 ème
VAR,TOULON,0830148K,111,111,0,0,49,62,6 ème
MAYOTTE,M'TSANGAMOUJI,9760167C,309,291,16,2,170,139,6 ème
MAYOTTE,TSINGONI,9760274U,350,311,34,5,179,171,6 ème
CALVADOS,BAYEUX,0140006F,155,144,11,0,77,78,6 ème
CALVADOS,BAYEUX,0141762P,139,139,0,0,70,69,6 ème
CALVADOS,BRETTEVILLE-SUR-LAIZE,0141312A,123,123,0,0,62,61,6 ème
CALVADOS,CAEN,0140018U,0,0,0,0,0,0,6 ème
CALVADOS,CAEN,0141597K,122,114,8,0,64,58,6 ème
CALVADOS,CAEN,0141867D,0,0,0,0,0,0,6 ème
CALVADOS,CONDE-EN-NORMANDIE,0141214U,19,19,0,0,12,7,6 ème
CALVADOS,CONDE-EN-NORMANDIE,0141258S,77,74,0,3,34,43,6 ème
CALVADOS,DEAUVILLE,0141763R,81,81,0,0,38,43,6 ème
CALVADOS,FALAISE,0140052F,0,0,0,0,0,0,6 ème
CALVADOS,FALAISE,0141167T,52,52,0,0,22,30,6 ème
CALVADOS,HONFLEUR,0140056K,0,0,0,0,0,0,6 ème
CALVADOS,ISIGNY-SUR-MER,0141257R,51,49,0,2,28,23,6 ème
CALVADOS,LES MONTS D'AUNAY,0141662F,111,100,11,0,57,54,6 ème
CALVADOS,MEZIDON VALLEE D'AUGE,0140070A,108,108,0,0,54,54,6 ème
CALVADOS,MONDEVILLE,0141687H,0,0,0,0,0,0,6 ème
CALVADOS,POTIGNY,0140077H,91,87,0,4,42,49,6 ème
CALVADOS,SALINE,0141684E,134,133,0,1,66,68,6 ème
CALVADOS,SOULEUVRE EN BOCAGE,0140008H,104,104,0,0,50,54,6 ème
CALVADOS,TROUVILLE-SUR-MER,0141273H,71,65,5,1,29,42,6 ème
CALVADOS,VALDALLIERE,0140086T,70,70,0,0,38,32,6 ème
CALVADOS,VIRE NORMANDIE,0141767V,135,124,9,2,65,70,6 ème
EURE,BOURG-ACHARD,0270007L,233,233,0,0,120,113,6 ème
EURE,BRIONNE,0271606Z,0,0,0,0,0,0,6 ème
EURE,EVREUX,0270022C,150,150,0,0,75,75,6 ème
EURE,EVREUX,0270051J,0,0,0,0,0,0,6 ème
EURE,EVREUX,0271095U,152,135,16,1,71,81,6 ème
EURE,EVREUX,0271173D,161,149,8,4,88,73,6 ème
EURE,GRAND BOURGTHEROULDE,0271317K,231,213,14,4,125,106,6 ème
EURE,LE NEUBOURG,0270032N,137,117,16,4,64,73,6 ème
EURE,LE NEUBOURG,0271885C,152,152,0,0,60,92,6 ème
EURE,LE VAUDREUIL,0271632C,115,112,0,3,59,56,6 ème
EURE,LOUVIERS,0271065L,181,181,0,0,82,99,6 ème
EURE,MANNEVILLE-SUR-RISLE,0271284Z,143,127,16,0,72,71,6 ème
EURE,MONTFORT-SUR-RISLE,0270054M,107,107,0,0,58,49,6 ème
EURE,PONT-AUDEMER,0270036T,181,179,0,2,88,93,6 ème
EURE,PONT-DE-L'ARCHE,0270038V,194,188,0,6,93,101,6 ème
EURE,SAINT-ANDRE-DE-L'EURE,0270041Y,153,135,15,3,73,80,6 ème
EURE,SAINT-MARCEL,0271123Z,134,134,0,0,64,70,6 ème
MANCHE,AVRANCHES,0501525L,63,54,8,1,31,32,6 ème
MANCHE,AVRANCHES,0501704F,136,136,0,0,55,81,6 ème
MANCHE,AVRANCHES,0501787W,0,0,0,0,0,0,6 ème
MANCHE,BRECEY,0501302U,85,85,0,0,38,47,6 ème
MANCHE,BREHAL,0501239A,86,82,0,4,41,45,6 ème
MANCHE,CARENTAN-LES-MARAIS,0501941N,0,0,0,0,0,0,6 ème
MANCHE,CHERBOURG-EN-COTENTIN,0500032N,0,0,0,0,0,0,6 ème
MANCHE,CHERBOURG-EN-COTENTIN,0501677B,0,0,0,0,0,0,6 ème
MANCHE,COUTANCES,0501206P,111,100,9,2,51,60,6 ème
MANCHE,COUTANCES,0501703E,107,107,0,0,57,50,6 ème
MANCHE,COUTANCES,0502009M,0,0,0,0,0,0,6 ème
MANCHE,DUCEY-LES CHERIS,0501240B,79,73,0,6,37,42,6 ème
MANCHE,GRANVILLE,0500039W,130,122,7,1,64,66,6 ème
MANCHE,LA HAGUE,0500006K,108,108,0,0,55,53,6 ème
MANCHE,LESSAY,0501458N,76,75,0,1,36,40,6 ème
MANCHE,MORTAIN-BOCAGE,0500050H,78,75,0,3,38,40,6 ème
MANCHE,PERCY-EN-NORMANDIE,0500052K,53,53,0,0,22,31,6 ème
MANCHE,PERIERS,0500053L,75,75,0,0,38,37,6 ème
MANCHE,PONTORSON,0501241C,34,34,0,0,18,16,6 ème
MANCHE,SAINTE-MERE-EGLISE,0500068C,76,61,15,0,35,41,6 ème
MANCHE,SAINT-HILAIRE-DU-HARCOUET,0500061V,77,67,4,6,36,41,6 ème
MANCHE,VALOGNES,0500155X,86,86,0,0,40,46,6 ème
ORNE,ALENCON,0610003X,100,100,0,0,58,42,6 ème
ORNE,ALENCON,0610004Y,0,0,0,0,0,0,6 ème
ORNE,ALENCON,0611026J,67,67,0,0,35,32,6 ème
ORNE,ARGENTAN,0610006A,0,0,0,0,0,0,6 ème
ORNE,BRIOUZE,0611024G,37,37,0,0,17,20,6 ème
ORNE,LA FERTE MACE,0610019P,0,0,0,0,0,0,6 ème
ORNE,LA FERTE MACE,0610996B,7,0,7,0,3,4,6 ème
ORNE,L'AIGLE,0611156A,109,107,0,2,61,48,6 ème
ORNE,MORTAGNE-AU-PERCHE,0611094H,50,50,0,0,28,22,6 ème
ORNE,MOULINS-LA-MARCHE,0610036H,44,44,0,0,24,20,6 ème
ORNE,TINCHEBRAY-BOCAGE,0610042P,61,61,0,0,26,35,6 ème
SEINE MARITIME,CANTELEU,0760017F,104,86,14,4,50,54,6 ème
SEINE MARITIME,CAUDEBEC-LES-ELBEUF,0762919K,90,88,0,2,49,41,6 ème
SEINE MARITIME,CLERES,0762197A,131,131,0,0,60,71,6 ème
SEINE MARITIME,DOUDEVILLE,0762123V,101,97,0,4,46,55,6 ème
SEINE MARITIME,ELBEUF,0760030V,0,0,0,0,0,0,6 ème
SEINE MARITIME,ELBEUF,0762563Y,200,200,0,0,89,111,6 ème
SEINE MARITIME,FECAMP,0760036B,0,0,0,0,0,0,6 ème
SEINE MARITIME,FECAMP,0761731U,167,167,0,0,73,94,6 ème
SEINE MARITIME,FECAMP,0761785C,119,103,16,0,54,65,6 ème
SEINE MARITIME,FECAMP,0762287Y,73,73,0,0,37,36,6 ème
SEINE MARITIME,GRAND-COURONNE,0762461M,106,106,0,0,53,53,6 ème
SEINE MARITIME,GRUCHET-LE-VALASSE,0762861X,115,113,0,2,44,71,6 ème
SEINE MARITIME,LE HAVRE,0760050S,124,124,0,0,77,47,6 ème
SEINE MARITIME,LE HAVRE,0761739C,81,65,16,0,44,37,6 ème
SEINE MARITIME,LE HAVRE,0761782Z,108,90,16,2,52,56,6 ème
SEINE MARITIME,LE HAVRE,0762081Z,12,0,12,0,5,7,6 ème
SEINE MARITIME,LE HAVRE,0762128A,93,74,16,3,47,46,6 ème
SEINE MARITIME,LE PETIT-QUEVILLY,0761737A,100,100,0,0,49,51,6 ème
SEINE MARITIME,LE TRAIT,0762085D,101,101,0,0,62,39,6 ème
SEINE MARITIME,LILLEBONNE,0762738N,86,86,0,0,44,42,6 ème
SEINE MARITIME,MESNIERES-EN-BRAY,0761330H,29,29,0,0,15,14,6 ème
SEINE MARITIME,MONTIVILLIERS,0761331J,131,131,0,0,55,76,6 ème
SEINE MARITIME,MONTIVILLIERS,0762288Z,101,101,0,0,50,51,6 ème
SEINE MARITIME,MONTVILLE,0762090J,116,116,0,0,59,57,6 ème
SEINE MARITIME,NEUFCHATEL-EN-BRAY,0760079Y,135,118,13,4,64,71,6 ème
SEINE MARITIME,OFFRANVILLE,0760082B,0,0,0,0,0,0,6 ème
SEINE MARITIME,OISSEL,0760083C,152,151,0,1,69,83,6 ème
SEINE MARITIME,PETIT-COURONNE,0760086F,121,121,0,0,62,59,6 ème
SEINE MARITIME,ROUEN,0761337R,79,79,0,0,44,35,6 ème
SEINE MARITIME,ROUEN,0762568D,155,152,0,3,76,79,6 ème
SEINE MARITIME,ROUEN,0763406P,130,126,4,0,52,78,6 ème
SEINE MARITIME,SAINT-AUBIN-LES-ELBEUF,0760101X,87,83,0,4,40,47,6 ème
SEINE MARITIME,SAINT-ROMAIN-DE-COLBOSC,0761689Y,261,261,0,0,127,134,6 ème
SEINE MARITIME,VAL-DE-SCIE,0761956N,183,167,16,0,105,78,6 ème
DORDOGNE,BERGERAC,0240004Z,108,105,0,3,50,58,6 ème
DORDOGNE,BERGERAC,0240007C,0,0,0,0,0,0,6 ème
DORDOGNE,EXCIDEUIL,0241007P,78,73,0,5,36,42,6 ème
DORDOGNE,EYMET,0240014K,63,63,0,0,41,22,6 ème
DORDOGNE,MONTPON-MENESTEROL,0240117X,153,150,0,3,69,84,6 ème
DORDOGNE,PERIGUEUX,0240030C,161,150,7,4,75,86,6 ème
DORDOGNE,PERIGUEUX,0240077D,90,90,0,0,45,45,6 ème
DORDOGNE,PERIGUEUX,0240089S,0,0,0,0,0,0,6 ème
DORDOGNE,PERIGUEUX,0241075N,115,113,0,2,54,61,6 ème
DORDOGNE,PIEGUT-PLUVIERS,0240043S,45,45,0,0,21,24,6 ème
DORDOGNE,RIBERAC,0240086N,26,26,0,0,14,12,6 ème
DORDOGNE,RIBERAC,0241011U,106,89,12,5,51,55,6 ème
DORDOGNE,SAINT-ANTOINE-DE-BREUILH,0240087P,35,35,0,0,20,15,6 ème
DORDOGNE,SAINT-ASTIER,0240650B,139,126,12,1,76,63,6 ème
DORDOGNE,SARLAT-LA-CANEDA,0240048X,0,0,0,0,0,0,6 ème
DORDOGNE,SARLAT-LA-CANEDA,0241076P,52,52,0,0,23,29,6 ème
GIRONDE,AMBARES-ET-LAGRAVE,0331617D,231,228,0,3,110,121,6 ème
GIRONDE,ARSAC,0332704K,162,162,0,0,93,69,6 ème
GIRONDE,BEGLES,0331880P,146,133,11,2,69,77,6 ème
GIRONDE,BLANQUEFORT,0331754C,204,187,13,4,106,98,6 ème
GIRONDE,BLANQUEFORT,0332535B,0,0,0,0,0,0,6 ème
GIRONDE,BORDEAUX,0331492T,149,146,0,3,80,69,6 ème
GIRONDE,BORDEAUX,0331519X,60,60,0,0,35,25,6 ème
GIRONDE,BORDEAUX,0331753B,101,101,0,0,50,51,6 ème
GIRONDE,BORDEAUX,0332490C,307,307,0,0,150,157,6 ème
GIRONDE,CADILLAC,0330059K,140,138,0,2,62,78,6 ème
GIRONDE,CENON,0331464M,179,174,0,5,89,90,6 ème
GIRONDE,COUTRAS,0331621H,216,204,12,0,108,108,6 ème
GIRONDE,CREON,0332283C,239,233,4,2,108,131,6 ème
GIRONDE,LA BREDE,0332494G,144,144,0,0,68,76,6 ème
GIRONDE,LE BOUSCAT,0331523B,185,185,0,0,102,83,6 ème
GIRONDE,LE PIAN-MEDOC,0333529G,173,173,0,0,88,85,6 ème
GIRONDE,LESPARRE-MEDOC,0331528G,54,51,0,3,22,32,6 ème
GIRONDE,LE TEICH,0332982M,110,107,0,3,61,49,6 ème
GIRONDE,LIBOURNE,0330089T,0,0,0,0,0,0,6 ème
GIRONDE,MARTIGNAS-SUR-JALLE,0332743C,105,105,0,0,55,50,6 ème
GIRONDE,MERIGNAC,0331435F,196,196,0,0,94,102,6 ème
GIRONDE,PEUJARD,0332723F,149,147,0,2,65,84,6 ème
GIRONDE,SAINT-ANDRE-DE-CUBZAC,0331757F,179,163,11,5,85,94,6 ème
GIRONDE,SAINT-CIERS-SUR-GIRONDE,0330113U,171,166,0,5,81,90,6 ème
GIRONDE,SAINT-MEDARD-DE-GUIZIERES,0331569B,0,0,0,0,0,0,6 ème
GIRONDE,SAINT-MEDARD-EN-JALLES,0332187Y,219,206,10,3,93,126,6 ème
GIRONDE,SAINT-SYMPHORIEN,0330122D,99,95,0,4,40,59,6 ème
GIRONDE,SAUVETERRE-DE-GUYENNE,0331667H,108,91,12,5,53,55,6 ème
GIRONDE,VILLENAVE-D'ORNON,0332246M,165,146,12,7,91,74,6 ème
LANDES,GABARRET,0400010U,19,19,0,0,8,11,6 ème
LANDES,GABARRET,0400883T,0,0,0,0,0,0,6 ème
LANDES,GRENADE-SUR-L'ADOUR,0400012W,98,98,0,0,56,42,6 ème
LANDES,LABOUHEYRE,0400014Y,126,122,0,4,71,55,6 ème
LANDES,PEYREHORADE,0400027M,0,0,0,0,0,0,6 ème
LANDES,ROQUEFORT,0400034V,69,67,0,2,37,32,6 ème
LANDES,SAINT-MARTIN-DE-SEIGNANX,0400874H,127,127,0,0,60,67,6 ème
LANDES,SAINT-SEVER,0400075P,43,43,0,0,14,29,6 ème
LANDES,SAINT-VINCENT-DE-PAUL,0400068G,21,15,3,3,8,13,6 ème
LANDES,TARNOS,0400049L,0,0,0,0,0,0,6 ème
LANDES,TARTAS,0400042D,109,106,0,3,53,56,6 ème
LOT-ET-GARONNE,AGEN,0470004Z,0,0,0,0,0,0,6 ème
LOT-ET-GARONNE,AGEN,0470008D,132,132,0,0,61,71,6 ème
LOT-ET-GARONNE,BON-ENCONTRE,0470720C,189,177,8,4,95,94,6 ème
LOT-ET-GARONNE,CASSENEUIL,0470067T,86,79,7,0,38,48,6 ème
LOT-ET-GARONNE,CASTELJALOUX,0470012H,98,98,0,0,47,51,6 ème
LOT-ET-GARONNE,CASTELJALOUX,0470068U,36,35,0,1,15,21,6 ème
LOT-ET-GARONNE,DURAS,0470017N,67,67,0,0,35,32,6 ème
LOT-ET-GARONNE,MIRAMONT-DE-GUYENNE,0470024W,86,84,0,2,42,44,6 ème
LOT-ET-GARONNE,MONBAHUS,0470071X,25,22,0,3,13,12,6 ème
LOT-ET-GARONNE,PORT-SAINTE-MARIE,0470032E,65,63,0,2,33,32,6 ème
LOT-ET-GARONNE,TONNEINS,0470073Z,54,54,0,0,31,23,6 ème
LOT-ET-GARONNE,VILLENEUVE-SUR-LOT,0470811B,126,126,0,0,66,60,6 ème
PYRENEES-ATLANTIQUES,ANGLET,0640001D,0,0,0,0,0,0,6 ème
PYRENEES-ATLANTIQUES,ARUDY,0640007K,62,62,0,0,27,35,6 ème
PYRENEES-ATLANTIQUES,ARZACQ-ARRAZIGUET,0640008L,82,82,0,0,46,36,6 ème
PYRENEES-ATLANTIQUES,BAYONNE,0640112Z,165,160,0,5,84,81,6 ème
PYRENEES-ATLANTIQUES,BAYONNE,0640143H,93,93,0,0,42,51,6 ème
PYRENEES-ATLANTIQUES,BAYONNE,0640609P,139,129,8,2,79,60,6 ème
PYRENEES-ATLANTIQUES,BIARRITZ,0640146L,42,42,0,0,18,24,6 ème
PYRENEES-ATLANTIQUES,BOUCAU,0640023C,97,97,0,0,51,46,6 ème
PYRENEES-ATLANTIQUES,CIBOURE,0641941M,86,83,0,3,43,43,6 ème
PYRENEES-ATLANTIQUES,GARLIN,0640025E,81,79,0,2,40,41,6 ème
PYRENEES-ATLANTIQUES,HENDAYE,0640151S,75,75,0,0,31,44,6 ème
PYRENEES-ATLANTIQUES,JURANCON,0641405E,53,53,0,0,24,29,6 ème
PYRENEES-ATLANTIQUES,LEMBEYE,0640037T,55,55,0,0,32,23,6 ème
PYRENEES-ATLANTIQUES,LESCAR,0641391P,213,211,0,2,98,115,6 ème
PYRENEES-ATLANTIQUES,MAULEON-LICHARRE,0640039V,75,72,0,3,33,42,6 ème
PYRENEES-ATLANTIQUES,NAVARRENX,0640045B,56,56,0,0,26,30,6 ème
PYRENEES-ATLANTIQUES,OLORON-SAINTE-MARIE,0640049F,0,0,0,0,0,0,6 ème
PYRENEES-ATLANTIQUES,OLORON-SAINTE-MARIE,0641658E,78,78,0,0,43,35,6 ème
PYRENEES-ATLANTIQUES,PAU,0640132W,64,63,0,1,30,34,6 ème
PYRENEES-ATLANTIQUES,PAU,0642095E,56,56,0,0,33,23,6 ème
PYRENEES-ATLANTIQUES,PONTACQ,0640161C,47,47,0,0,19,28,6 ème
PYRENEES-ATLANTIQUES,SAINT-JEAN-PIED-DE-PORT,0640069C,41,36,5,0,19,22,6 ème
PYRENEES-ATLANTIQUES,SAINT-PEE-SUR-NIVELLE,0640169L,78,78,0,0,43,35,6 ème
CORREZE,ARGENTAT-SUR-DORDOGNE,0190002Z,76,76,0,0,38,38,6 ème
CORREZE,BORT-LES-ORGUES,0190009G,41,41,0,0,23,18,6 ème
CORREZE,BRIVE-LA-GAILLARDE,0190012K,0,0,0,0,0,0,6 ème
CORREZE,BRIVE-LA-GAILLARDE,0190014M,196,166,22,8,95,101,6 ème
CORREZE,USSEL,0190615R,166,149,15,2,91,75,6 ème
CREUSE,CHAMBON-SUR-VOUEIZE,0230010L,45,45,0,0,20,25,6 ème
CREUSE,DUN-LE-PALESTEL,0230408U,45,45,0,0,29,16,6 ème
CREUSE,GUERET,0230487E,100,81,16,3,59,41,6 ème
CREUSE,GUERET,0230488F,141,133,0,8,56,85,6 ème
CREUSE,SAINT-VAURY,0230027E,0,0,0,0,0,0,6 ème
HAUTE-VIENNE,CHATEAUPONSAC,0870009M,46,46,0,0,25,21,6 ème
HAUTE-VIENNE,COUZEIX,0870871Z,199,183,0,16,89,110,6 ème
HAUTE-VIENNE,ISLE,0870658T,166,166,0,0,79,87,6 ème
HAUTE-VIENNE,LIMOGES,0870023C,130,126,0,4,50,80,6 ème
HAUTE-VIENNE,LIMOGES,0870919B,0,0,0,0,0,0,6 ème
HAUTE-VIENNE,SAINT-GERMAIN-LES-BELLES,0870039V,59,59,0,0,29,30,6 ème
HAUTE-VIENNE,SAINT-YRIEIX-LA-PERCHE,0870821V,124,108,13,3,63,61,6 ème
CHARENTE,ANGOULEME,0160005U,106,106,0,0,66,40,6 ème
CHARENTE,ANGOULEME,0161106R,78,74,0,4,32,46,6 ème
CHARENTE,CHABANAIS,0160120U,63,58,5,0,31,32,6 ème
CHARENTE,CHATEAUNEUF-SUR-CHARENTE,0160863B,108,108,0,0,54,54,6 ème
CHARENTE,LA COURONNE,0160024P,157,149,0,8,82,75,6 ème
CHARENTE,MANSLE,0160029V,85,81,0,4,47,38,6 ème
CHARENTE,SAINT-AMANT-DE-BOIXE,0160040G,91,90,0,1,46,45,6 ème
CHARENTE,SAINT-YRIEIX-SUR-CHARENTE,0160083D,0,0,0,0,0,0,6 ème
CHARENTE,SOYAUX,0160894K,172,171,0,1,89,83,6 ème
CHARENTE,VILLEBOIS-LAVALETTE,0160043K,79,79,0,0,39,40,6 ème
CHARENTE-MARITIME,BURIE,0170004M,79,79,0,0,42,37,6 ème
CHARENTE-MARITIME,CHATELAILLON-PLAGE,0171211Z,164,162,0,2,74,90,6 ème
CHARENTE-MARITIME,JONZAC,0170011V,119,109,0,10,58,61,6 ème
CHARENTE-MARITIME,LA ROCHELLE,0170031S,0,0,0,0,0,0,6 ème
CHARENTE-MARITIME,LOULAY,0170012W,30,29,0,1,14,16,6 ème
CHARENTE-MARITIME,MARENNES-HIERS-BROUAGE,0170386C,133,119,11,3,66,67,6 ème
CHARENTE-MARITIME,MATHA,0171159T,100,96,0,4,49,51,6 ème
CHARENTE-MARITIME,MONTENDRE,0170390G,128,104,16,8,57,71,6 ème
CHARENTE-MARITIME,MONTGUYON,0171160U,64,64,0,0,32,32,6 ème
CHARENTE-MARITIME,ROCHEFORT,0170113F,60,60,0,0,31,29,6 ème
CHARENTE-MARITIME,ROCHEFORT,0171056F,163,154,0,9,81,82,6 ème
CHARENTE-MARITIME,ROYAN,0171120A,143,132,8,3,79,64,6 ème
CHARENTE-MARITIME,SAINTES,0170063B,198,181,14,3,92,106,6 ème
CHARENTE-MARITIME,SAINTES,0170102U,58,58,0,0,32,26,6 ème
CHARENTE-MARITIME,SAINTES,0170144P,208,203,0,5,113,95,6 ème
CHARENTE-MARITIME,SAINT-GENIS-DE-SAINTONGE,0170049L,72,69,0,3,38,34,6 ème
CHARENTE-MARITIME,SAINT-JEAN-D'ANGELY,0170052P,0,0,0,0,0,0,6 ème
CHARENTE-MARITIME,SAINT-MARTIN-DE-RE,0171034G,120,120,0,0,52,68,6 ème
CHARENTE-MARITIME,SAINT-PORCHAIRE,0170055T,135,129,0,6,68,67,6 ème
CHARENTE-MARITIME,SAUJON,0170387D,157,155,0,2,80,77,6 ème
DEUX-SEVRES,ARGENTONNAY,0790003Z,50,50,0,0,25,25,6 ème
DEUX-SEVRES,L'ABSIE,0790001X,23,23,0,0,17,6,6 ème
DEUX-SEVRES,LA MOTHE-SAINT-HERAY,0790021U,64,60,0,4,30,34,6 ème
DEUX-SEVRES,MONCOUTANT-SUR-SEVRE,0790966W,59,58,0,1,29,30,6 ème
DEUX-SEVRES,NIORT,0790052C,165,147,16,2,88,77,6 ème
DEUX-SEVRES,NIORT,0790089T,148,146,0,2,76,72,6 ème
DEUX-SEVRES,NIORT,0790709S,131,127,0,4,64,67,6 ème
DEUX-SEVRES,NUEIL-LES-AUBIERS,0790061M,80,75,0,5,47,33,6 ème
DEUX-SEVRES,PARTHENAY,0790071Y,75,73,0,2,41,34,6 ème
DEUX-SEVRES,PARTHENAY,0790090U,0,0,0,0,0,0,6 ème
DEUX-SEVRES,PRAHECQ,0790950D,120,116,0,4,52,68,6 ème
DEUX-SEVRES,SAUZE-VAUSSAIS,0790033G,38,38,0,0,20,18,6 ème
DEUX-SEVRES,THOUARS,0791017B,80,80,0,0,42,38,6 ème
VIENNE,BUXEROLLES,0860799B,138,135,0,3,61,77,6 ème
VIENNE,CHARROUX,0860002K,35,35,0,0,18,17,6 ème
VIENNE,CHATELLERAULT,0860702W,90,89,0,1,43,47,6 ème
VIENNE,CHATELLERAULT,0860753B,149,147,0,2,74,75,6 ème
VIENNE,DANGE-SAINT-ROMAIN,0860015Z,86,80,0,6,43,43,6 ème
VIENNE,LOUDUN,0860023H,123,114,9,0,52,71,6 ème
VIENNE,MONTMORILLON,0860768T,48,48,0,0,19,29,6 ème
VIENNE,POITIERS,0860723U,173,169,0,4,87,86,6 ème
VIENNE,POITIERS,0860758G,149,147,0,2,67,82,6 ème
VIENNE,POITIERS,0860791T,137,135,0,2,58,79,6 ème
VIENNE,VOUNEUIL-SOUS-BIARD,0861457S,247,243,0,4,112,135,6 ème
VIENNE,VOUNEUIL-SUR-VIENNE,0860049L,141,138,0,3,65,76,6 ème
AUDE,CARCASSONNE,0110010B,84,84,0,0,40,44,6 ème
AUDE,CARCASSONNE,0110810W,223,204,13,6,103,120,6 ème
AUDE,COURSAN,0110067N,163,157,0,6,78,85,6 ème
AUDE,CUXAC-CABARDES,0110721Z,76,76,0,0,41,35,6 ème
AUDE,LEZIGNAN-CORBIERES,0110686L,182,173,0,9,77,105,6 ème
AUDE,NARBONNE,0110049U,188,185,0,3,93,95,6 ème
AUDE,PORT-LA-NOUVELLE,0110725D,96,89,0,7,49,47,6 ème
AUDE,QUILLAN,0110675Z,51,51,0,0,21,30,6 ème
AUDE,SAINT-NAZAIRE-D'AUDE,0111015U,194,194,0,0,97,97,6 ème
AUDE,SIGEAN,0110724C,149,149,0,0,72,77,6 ème
GARD,ALES,0300125Y,0,0,0,0,0,0,6 ème
GARD,ALES,0300947S,167,148,12,7,80,87,6 ème
GARD,ALES,0300949U,169,168,0,1,75,94,6 ème
GARD,BEAUCAIRE,0301282F,152,134,16,2,72,80,6 ème
GARD,BELLEGARDE,0301827Y,138,135,0,3,74,64,6 ème
GARD,LA GRAND-COMBE,0301012M,82,82,0,0,44,38,6 ème
GARD,LE GRAU-DU-ROI,0301751R,123,121,0,2,65,58,6 ème
GARD,LE VIGAN,0301326D,123,111,12,0,60,63,6 ème
GARD,NIMES,0300025P,83,82,0,1,38,45,6 ème
GARD,NIMES,0300093N,232,212,16,4,100,132,6 ème
GARD,NIMES,0301356L,271,269,0,2,130,141,6 ème
GARD,UZES,0301283G,161,148,13,0,87,74,6 ème
GARD,UZES,0301721H,114,114,0,0,52,62,6 ème
GARD,VAUVERT,0301096D,230,214,15,1,114,116,6 ème
HERAULT,BEZIERS,0340891J,46,46,0,0,26,20,6 ème
HERAULT,BEZIERS,0341321B,150,136,8,6,82,68,6 ème
HERAULT,CAPESTANG,0341367B,170,168,0,2,90,80,6 ème
HERAULT,CLAPIERS,0341826A,166,162,0,4,85,81,6 ème
HERAULT,CLERMONT-L'HERAULT,0341366A,212,209,0,3,106,106,6 ème
HERAULT,FRONTIGNAN,0342052W,138,136,0,2,69,69,6 ème
HERAULT,GANGES,0340896P,58,58,0,0,28,30,6 ème
HERAULT,LOUPIAN,0342224H,155,140,15,0,80,75,6 ème
HERAULT,LUNEL,0340031Z,159,158,0,1,77,82,6 ème
HERAULT,MONTPELLIER,0340874R,221,221,0,0,108,113,6 ème
HERAULT,MONTPELLIER,0340876T,124,124,0,0,52,72,6 ème
HERAULT,MONTPELLIER,0340996Y,183,166,15,2,111,72,6 ème
HERAULT,MONTPELLIER,0340998A,120,115,0,5,63,57,6 ème
HERAULT,MONTPELLIER,0342012C,44,44,0,0,17,27,6 ème
HERAULT,PAULHAN,0340974Z,161,161,0,0,82,79,6 ème
HERAULT,PEZENAS,0340061G,0,0,0,0,0,0,6 ème
HERAULT,PEZENAS,0340907B,89,89,0,0,40,49,6 ème
HERAULT,SAINT-CHINIAN,0340065L,106,99,0,7,44,62,6 ème
HERAULT,SETE,0340076Y,0,0,0,0,0,0,6 ème
HERAULT,SETE,0341065Y,109,102,5,2,54,55,6 ème
LOZERE,MARVEJOLS,0480024R,78,78,0,0,50,28,6 ème
LOZERE,SAINT-CHELY-D'APCHER,0480038F,48,48,0,0,23,25,6 ème
LOZERE,VIALAS,0480016G,0,0,0,0,0,0,6 ème
PYRENEES-ORIENTALES,ARGELES-SUR-MER,0660001T,148,134,9,5,75,73,6 ème
PYRENEES-ORIENTALES,CERET,0660004W,0,0,0,0,0,0,6 ème
PYRENEES-ORIENTALES,ESTAGEL,0660007Z,89,89,0,0,42,47,6 ème
PYRENEES-ORIENTALES,ILLE-SUR-TET,0660008A,124,121,0,3,65,59,6 ème
PYRENEES-ORIENTALES,LE SOLER,0660653B,157,157,0,0,81,76,6 ème
PYRENEES-ORIENTALES,MILLAS,0660925X,181,178,0,3,93,88,6 ème
PYRENEES-ORIENTALES,PERPIGNAN,0660012E,180,161,16,3,89,91,6 ème
PYRENEES-ORIENTALES,PERPIGNAN,0660017K,113,113,0,0,55,58,6 ème
PYRENEES-ORIENTALES,PERPIGNAN,0660018L,163,156,0,7,77,86,6 ème
PYRENEES-ORIENTALES,PERPIGNAN,0660019M,143,128,12,3,70,73,6 ème
PYRENEES-ORIENTALES,PERPIGNAN,0660049V,170,166,0,4,65,105,6 ème
PYRENEES-ORIENTALES,PERPIGNAN,0660061H,160,156,0,4,82,78,6 ème
PYRENEES-ORIENTALES,PERPIGNAN,0660809W,0,0,0,0,0,0,6 ème
PYRENEES-ORIENTALES,SAINT-CYPRIEN,0660848N,203,191,0,12,98,105,6 ème
PYRENEES-ORIENTALES,TOULOUGES,0660864F,180,180,0,0,92,88,6 ème
ARIEGE,PAMIERS,0090056M,148,146,0,2,74,74,6 ème
ARIEGE,PAMIERS,0090591U,92,92,0,0,52,40,6 ème
ARIEGE,SAVERDUN,0090023B,74,71,0,3,45,29,6 ème
AVEYRON,BARAQUEVILLE,0120032V,107,104,0,3,50,57,6 ème
AVEYRON,BARAQUEVILLE,0120080X,18,18,0,0,6,12,6 ème
AVEYRON,BELMONT-SUR-RANCE,0120081Y,44,44,0,0,20,24,6 ème
AVEYRON,CAPDENAC-GARE,0120002M,60,60,0,0,33,27,6 ème
AVEYRON,CASSAGNES-BEGONHES,0120084B,24,24,0,0,11,13,6 ème
AVEYRON,LAGUIOLE,0120091J,24,24,0,0,16,8,6 ème
AVEYRON,MILLAU,0121259D,165,159,0,6,81,84,6 ème
AVEYRON,MUR-DE-BARREZ,0120016C,26,26,0,0,12,14,6 ème
AVEYRON,REQUISTA,0120019F,36,36,0,0,19,17,6 ème
AVEYRON,REQUISTA,0120068J,8,8,0,0,4,4,6 ème
AVEYRON,RODEZ,0120038B,0,0,0,0,0,0,6 ème
AVEYRON,RODEZ,0120101V,194,192,0,2,101,93,6 ème
AVEYRON,RODEZ,0121430P,197,182,5,10,80,117,6 ème
AVEYRON,SAINT-AMANS-DES-COTS,0121295T,42,42,0,0,22,20,6 ème
AVEYRON,SAINT GENIEZ D'OLT ET D'AUBRAC,0120028R,36,36,0,0,13,23,6 ème
AVEYRON,SALLES-CURAN,0120077U,43,43,0,0,21,22,6 ème
GERS,AUCH,0320006H,104,100,0,4,43,61,6 ème
GERS,EAUZE,0320011N,92,89,0,3,47,45,6 ème
GERS,LECTOURE,0320015T,0,0,0,0,0,0,6 ème
GERS,MIELAN,0320074G,34,34,0,0,18,16,6 ème
HAUTE-GARONNE,ASPET,0310001H,52,46,0,6,28,24,6 ème
HAUTE-GARONNE,BLAGNAC,0311237B,139,133,0,6,74,65,6 ème
HAUTE-GARONNE,BLAGNAC,0311965T,150,150,0,0,75,75,6 ème
HAUTE-GARONNE,CADOURS,0310008R,191,191,0,0,104,87,6 ème
HAUTE-GARONNE,COLOMIERS,0311160T,123,123,0,0,63,60,6 ème
HAUTE-GARONNE,COLOMIERS,0312092F,85,80,0,5,43,42,6 ème
HAUTE-GARONNE,CUGNAUX,0311093V,229,224,0,5,118,111,6 ème
HAUTE-GARONNE,FRONTON,0311721C,223,219,0,4,119,104,6 ème
HAUTE-GARONNE,GRATENTOUR,0312478A,181,179,0,2,89,92,6 ème
HAUTE-GARONNE,GRENADE,0311769E,198,182,13,3,103,95,6 ème
HAUTE-GARONNE,L'ISLE-EN-DODON,0310019C,33,33,0,0,18,15,6 ème
HAUTE-GARONNE,L'UNION,0311094W,238,224,10,4,119,119,6 ème
HAUTE-GARONNE,MONTASTRUC-LA-CONSEILLERE,0310021E,167,162,0,5,84,83,6 ème
HAUTE-GARONNE,MONTESQUIEU-VOLVESTRE,0310022F,85,85,0,0,43,42,6 ème
HAUTE-GARONNE,MURET,0312822Z,0,0,0,0,0,0,6 ème
HAUTE-GARONNE,REVEL,0311846N,123,123,0,0,62,61,6 ème
HAUTE-GARONNE,SAINT-GAUDENS,0310033T,0,0,0,0,0,0,6 ème
HAUTE-GARONNE,SAINT-ORENS-DE-GAMEVILLE,0312140H,178,178,0,0,88,90,6 ème
HAUTE-GARONNE,TOULOUSE,0310093H,95,93,0,2,43,52,6 ème
HAUTE-GARONNE,TOULOUSE,0311112R,165,151,9,5,81,84,6 ème
HAUTE-GARONNE,TOULOUSE,0311144A,121,118,0,3,52,69,6 ème
HAUTE-GARONNE,TOULOUSE,0311150G,90,90,0,0,48,42,6 ème
HAUTE-GARONNE,TOULOUSE,0311169C,96,94,0,2,49,47,6 ème
HAUTE-GARONNE,TOULOUSE,0311171E,113,113,0,0,61,52,6 ème
HAUTE-GARONNE,TOULOUSE,0311219G,0,0,0,0,0,0,6 ème
HAUTE-GARONNE,TOULOUSE,0311327Z,85,74,6,5,41,44,6 ème
HAUTE-GARONNE,TOULOUSE,0311582B,88,88,0,0,38,50,6 ème
HAUTE-GARONNE,TOULOUSE,0311972A,272,262,10,0,130,142,6 ème
HAUTE-GARONNE,TOURNEFEUILLE,0312746S,0,0,0,0,0,0,6 ème
HAUTE-GARONNE,VILLEFRANCHE-DE-LAURAGAIS,0311634H,174,170,0,4,91,83,6 ème
HAUTE-GARONNE,VILLEMUR-SUR-TARN,0311689T,127,118,9,0,59,68,6 ème
HAUTES-PYRENEES,PIERREFITTE-NESTALAS,0650020U,29,29,0,0,13,16,6 ème
HAUTES-PYRENEES,SEMEAC,0650088T,145,142,0,3,67,78,6 ème
HAUTES-PYRENEES,TARBES,0650029D,0,0,0,0,0,0,6 ème
HAUTES-PYRENEES,TRIE-SUR-BAISE,0650037M,59,59,0,0,38,21,6 ème
HAUTES-PYRENEES,VIC-EN-BIGORRE,0650075D,29,29,0,0,17,12,6 ème
LOT,CAHORS,0460006G,176,172,0,4,82,94,6 ème
LOT,CAHORS,0460528Z,140,122,15,3,62,78,6 ème
LOT,CAJARC,0460001B,52,52,0,0,29,23,6 ème
LOT,CASTELNAU MONTRATIER-STE ALAUZIE,0460008J,73,73,0,0,37,36,6 ème
LOT,FIGEAC,0460621A,100,99,0,1,42,58,6 ème
LOT,GOURDON,0460013P,0,0,0,0,0,0,6 ème
LOT,LUZECH,0460020X,95,95,0,0,47,48,6 ème
LOT,MONTCUQ-EN-QUERCY-BLANC,0460022Z,29,29,0,0,11,18,6 ème
LOT,PUY-L'EVEQUE,0460530B,45,45,0,0,25,20,6 ème
LOT,SAINT-CERE,0460593V,113,94,15,4,56,57,6 ème
LOT,SALVIAC,0460027E,37,37,0,0,16,21,6 ème
TARN,ALBI,0810100U,0,0,0,0,0,0,6 ème
TARN,CASTRES,0811064S,108,105,0,3,57,51,6 ème
TARN,GAILLAC,0810993P,195,183,12,0,108,87,6 ème
TARN,GRAULHET,0810995S,0,0,0,0,0,0,6 ème
TARN,LABRUGUIERE,0810026N,104,102,0,2,50,54,6 ème
TARN,LISLE-SUR-TARN,0811340S,93,88,0,5,33,60,6 ème
TARN,MAZAMET,0811324Z,0,0,0,0,0,0,6 ème
TARN,VALENCE-D'ALBIGEOIS,0810043G,63,63,0,0,33,30,6 ème
TARN,VIELMUR-SUR-AGOUT,0810044H,110,110,0,0,61,49,6 ème
TARN-ET-GARONNE,BEAUMONT-DE-LOMAGNE,0820001F,0,0,0,0,0,0,6 ème
TARN-ET-GARONNE,BEAUMONT-DE-LOMAGNE,0820067C,146,138,0,8,74,72,6 ème
TARN-ET-GARONNE,CASTELSARRASIN,0820004J,0,0,0,0,0,0,6 ème
TARN-ET-GARONNE,CAUSSADE,0820048G,94,88,0,6,47,47,6 ème
TARN-ET-GARONNE,LAFRANCAISE,0820011S,127,122,0,5,67,60,6 ème
TARN-ET-GARONNE,LAUZERTE,0820014V,60,60,0,0,29,31,6 ème
LOIRE-ATLANTIQUE,ANCENIS-SAINT-GEREON,0440001M,0,0,0,0,0,0,6 ème
LOIRE-ATLANTIQUE,ANCENIS-SAINT-GEREON,0440147W,186,167,14,5,73,113,6 ème
LOIRE-ATLANTIQUE,BLAIN,0440182J,172,170,0,2,85,87,6 ème
LOIRE-ATLANTIQUE,BLAIN,0440308W,141,118,18,5,63,78,6 ème
LOIRE-ATLANTIQUE,CARQUEFOU,0440422V,205,202,0,3,107,98,6 ème
LOIRE-ATLANTIQUE,CHATEAUBRIANT,0440348P,131,120,7,4,70,61,6 ème
LOIRE-ATLANTIQUE,COUERON,0440010X,228,228,0,0,108,120,6 ème
LOIRE-ATLANTIQUE,COUERON,0440190T,174,174,0,0,90,84,6 ème
LOIRE-ATLANTIQUE,GUEMENE-PENFAO,0440013A,115,114,0,1,45,70,6 ème
LOIRE-ATLANTIQUE,GUEMENE-PENFAO,0440192V,78,78,0,0,42,36,6 ème
LOIRE-ATLANTIQUE,GUERANDE,0440538W,157,157,0,0,70,87,6 ème
LOIRE-ATLANTIQUE,HAUTE-GOULAINE,0440153C,83,83,0,0,41,42,6 ème
LOIRE-ATLANTIQUE,LA MONTAGNE,0440347N,127,122,0,5,54,73,6 ème
LOIRE-ATLANTIQUE,LEGE,0441612N,71,71,0,0,42,29,6 ème
LOIRE-ATLANTIQUE,MACHECOUL-SAINT-MEME,0440352U,0,0,0,0,0,0,6 ème
LOIRE-ATLANTIQUE,NANTES,0440023L,197,180,13,4,99,98,6 ème
LOIRE-ATLANTIQUE,NANTES,0440203G,38,38,0,0,15,23,6 ème
LOIRE-ATLANTIQUE,NANTES,0440206K,33,33,0,0,15,18,6 ème
LOIRE-ATLANTIQUE,NANTES,0440207L,31,31,0,0,10,21,6 ème
LOIRE-ATLANTIQUE,NANTES,0441820P,82,82,0,0,35,47,6 ème
LOIRE-ATLANTIQUE,NANTES,0441821R,48,48,0,0,17,31,6 ème
LOIRE-ATLANTIQUE,NORT-SUR-ERDRE,0441654J,171,169,0,2,92,79,6 ème
LOIRE-ATLANTIQUE,PONTCHATEAU,0440224E,186,186,0,0,101,85,6 ème
LOIRE-ATLANTIQUE,PONTCHATEAU,0440540Y,114,80,32,2,54,60,6 ème
LOIRE-ATLANTIQUE,PORNIC,0440226G,173,173,0,0,97,76,6 ème
LOIRE-ATLANTIQUE,PORNIC,0440289A,158,158,0,0,84,74,6 ème
LOIRE-ATLANTIQUE,REZE,0440534S,114,94,16,4,54,60,6 ème
LOIRE-ATLANTIQUE,RIAILLE,0440232N,120,120,0,0,55,65,6 ème
LOIRE-ATLANTIQUE,SAINT-BREVIN-LES-PINS,0440066H,141,138,0,3,67,74,6 ème
LOIRE-ATLANTIQUE,SAINT-HERBLAIN,0440287Y,109,105,0,4,51,58,6 ème
LOIRE-ATLANTIQUE,SAINT-HERBLAIN,0440311Z,131,112,14,5,70,61,6 ème
LOIRE-ATLANTIQUE,SAINT-HERBLAIN,0441610L,141,123,16,2,70,71,6 ème
LOIRE-ATLANTIQUE,SAINT-NAZAIRE,0442759K,160,159,0,1,75,85,6 ème
LOIRE-ATLANTIQUE,SAINT-SEBASTIEN-SUR-LOIRE,0441548U,199,183,16,0,95,104,6 ème
LOIRE-ATLANTIQUE,SAINT-SEBASTIEN-SUR-LOIRE,0441653H,0,0,0,0,0,0,6 ème
LOIRE-ATLANTIQUE,VALLET,0440242Z,144,144,0,0,81,63,6 ème
MAINE-ET-LOIRE,ANGERS,0490003M,0,0,0,0,0,0,6 ème
MAINE-ET-LOIRE,ANGERS,0492432C,0,0,0,0,0,0,6 ème
MAINE-ET-LOIRE,AVRILLE,0491674D,182,160,16,6,84,98,6 ème
MAINE-ET-LOIRE,BEAUPREAU-EN-MAUGES,0490865Z,80,80,0,0,33,47,6 ème
MAINE-ET-LOIRE,CHEMILLE-EN-ANJOU,0490017C,109,106,0,3,47,62,6 ème
MAINE-ET-LOIRE,CHOLET,0490022H,87,84,0,3,37,50,6 ème
MAINE-ET-LOIRE,CHOLET,0490054T,0,0,0,0,0,0,6 ème
MAINE-ET-LOIRE,CHOLET,0490860U,155,125,30,0,62,93,6 ème
MAINE-ET-LOIRE,CHOLET,0491859E,111,91,14,6,57,54,6 ème
MAINE-ET-LOIRE,LOIRE-AUTHION,0490013Y,0,0,0,0,0,0,6 ème
MAINE-ET-LOIRE,MAUGES-SUR-LOIRE,0491928E,250,232,15,3,118,132,6 ème
MAINE-ET-LOIRE,MONTREUIL-BELLAY,0491262F,106,97,6,3,49,57,6 ème
MAINE-ET-LOIRE,SAINT-BARTHELEMY-D'ANJOU,0490957Z,184,183,0,1,89,95,6 ème
MAINE-ET-LOIRE,SAUMUR,0490910Y,0,0,0,0,0,0,6 ème
MAINE-ET-LOIRE,SEICHES-SUR-LE-LOIR,0491024X,191,188,0,3,96,95,6 ème
MAINE-ET-LOIRE,SEVREMOINE,0490842Z,137,137,0,0,63,74,6 ème
MAINE-ET-LOIRE,VERRIERES-EN-ANJOU,0492420P,0,0,0,0,0,0,6 ème
MAYENNE,CHATEAU-GONTIER-SUR-MAYENNE,0530827L,114,114,0,0,57,57,6 ème
MAYENNE,COSSE-LE-VIVIEN,0530054W,117,117,0,0,55,62,6 ème
MAYENNE,CRAON,0530005T,88,72,16,0,47,41,6 ème
MAYENNE,CRAON,0530055X,83,81,0,2,39,44,6 ème
MAYENNE,EVRON,0530949U,0,0,0,0,0,0,6 ème
MAYENNE,LANDIVY,0530804L,48,48,0,0,22,26,6 ème
MAYENNE,LAVAL,0530068L,0,0,0,0,0,0,6 ème
MAYENNE,LAVAL,0530790W,96,88,0,8,48,48,6 ème
MAYENNE,MAYENNE,0530078X,123,105,17,1,44,79,6 ème
MAYENNE,MAYENNE,0530079Y,0,0,0,0,0,0,6 ème
MAYENNE,VILLAINES-LA-JUHEL,0530066J,58,58,0,0,29,29,6 ème
SARTHE,ARNAGE,0720003M,0,0,0,0,0,0,6 ème
SARTHE,BOULOIRE,0720007S,115,104,11,0,51,64,6 ème
SARTHE,COULAINES,0720906U,106,105,0,1,50,56,6 ème
SARTHE,LA SUZE-SUR-SARTHE,0720905T,117,114,0,3,57,60,6 ème
SARTHE,LE MANS,0720822C,0,0,0,0,0,0,6 ème
SARTHE,LE MANS,0720825F,0,0,0,0,0,0,6 ème
SARTHE,LE MANS,0721090U,105,92,13,0,49,56,6 ème
SARTHE,LOUE,0720808M,79,79,0,0,42,37,6 ème
SARTHE,MAMERS,0720069J,94,79,15,0,50,44,6 ème
SARTHE,MAMERS,0721657K,34,34,0,0,16,18,6 ème
SARTHE,SABLE-SUR-SARTHE,0720070K,102,102,0,0,51,51,6 ème
SARTHE,SABLE-SUR-SARTHE,0720843A,0,0,0,0,0,0,6 ème
SARTHE,SAINT-CALAIS,0720803G,20,20,0,0,13,7,6 ème
VENDEE,CHALLANS,0850146X,0,0,0,0,0,0,6 ème
VENDEE,ESSARTS EN BOCAGE,0850099W,179,179,0,0,79,100,6 ème
VENDEE,FONTENAY-LE-COMTE,0850067L,132,113,15,4,68,64,6 ème
VENDEE,LA CHATAIGNERAIE,0851163C,74,74,0,0,39,35,6 ème
VENDEE,LA ROCHE-SUR-YON,0850028U,0,0,0,0,0,0,6 ème
VENDEE,LA ROCHE-SUR-YON,0850114M,163,163,0,0,93,70,6 ème
VENDEE,LA ROCHE-SUR-YON,0851304F,144,132,10,2,74,70,6 ème
VENDEE,LES BROUZILS,0850091M,93,93,0,0,42,51,6 ème
VENDEE,LES HERBIERS,0851159Y,387,364,16,7,194,193,6 ème
VENDEE,LES SABLES-D'OLONNE,0850043K,0,0,0,0,0,0,6 ème
VENDEE,L'ILE-D'YEU,0850015E,33,33,0,0,20,13,6 ème
VENDEE,L'ILE-D'YEU,0850103A,10,10,0,0,8,2,6 ème
VENDEE,POUZAUGES,0851160Z,179,175,0,4,79,100,6 ème
VENDEE,SAINTE-HERMINE,0850122W,86,86,0,0,39,47,6 ème
VENDEE,SAINT-LAURENT-SUR-SEVRE,0851504Y,0,0,0,0,0,0,6 ème
ALPES-DE-HTE-PROVENCE,DIGNE-LES-BAINS,0040022C,152,133,16,3,64,88,6 ème
ALPES-DE-HTE-PROVENCE,DIGNE-LES-BAINS,0040461E,67,67,0,0,30,37,6 ème
BOUCHES-DU-RHONE,AIX-EN-PROVENCE,0130007M,125,95,30,0,61,64,6 ème
BOUCHES-DU-RHONE,AIX-EN-PROVENCE,0132009N,126,122,0,4,56,70,6 ème
BOUCHES-DU-RHONE,AUBAGNE,0131266F,147,145,0,2,77,70,6 ème
BOUCHES-DU-RHONE,AURIOL,0133510V,218,213,0,5,111,107,6 ème
BOUCHES-DU-RHONE,CARNOUX-EN-PROVENCE,0133335E,117,117,0,0,53,64,6 ème
BOUCHES-DU-RHONE,CHATEAURENARD,0131366P,124,124,0,0,63,61,6 ème
BOUCHES-DU-RHONE,CHATEAURENARD,0131881Z,268,263,0,5,111,157,6 ème
BOUCHES-DU-RHONE,GARDANNE,0131701D,105,102,0,3,57,48,6 ème
BOUCHES-DU-RHONE,ISTRES,0133203L,173,173,0,0,80,93,6 ème
BOUCHES-DU-RHONE,MALLEMORT,0130032P,129,129,0,0,69,60,6 ème
BOUCHES-DU-RHONE,MARSEILLE,0134022B,138,120,17,1,74,64,6 ème
BOUCHES-DU-RHONE,MARSEILLE,0132403S,96,96,0,0,57,39,6 ème
BOUCHES-DU-RHONE,MARSEILLE,0133881Y,126,122,0,4,69,57,6 ème
BOUCHES-DU-RHONE,MARSEILLE,0131260Z,107,104,0,3,49,58,6 ème
BOUCHES-DU-RHONE,MARSEILLE,0131262B,125,108,16,1,60,65,6 ème
BOUCHES-DU-RHONE,MARSEILLE,0132313U,118,115,0,3,54,64,6 ème
BOUCHES-DU-RHONE,MARSEILLE,0130065A,0,0,0,0,0,0,6 ème
BOUCHES-DU-RHONE,MARSEILLE,0131704G,156,142,13,1,73,83,6 ème
BOUCHES-DU-RHONE,MARSEILLE,0131887F,96,92,0,4,45,51,6 ème
BOUCHES-DU-RHONE,MARSEILLE,0130039X,0,0,0,0,0,0,6 ème
BOUCHES-DU-RHONE,MARSEILLE,0131931D,97,97,0,0,44,53,6 ème
BOUCHES-DU-RHONE,MARSEILLE,0132283L,64,64,0,0,31,33,6 ème
BOUCHES-DU-RHONE,MARSEILLE,0130110Z,111,111,0,0,52,59,6 ème
BOUCHES-DU-RHONE,MARSEILLE,0131403E,0,0,0,0,0,0,6 ème
BOUCHES-DU-RHONE,MARSEILLE,0132958V,131,131,0,0,60,71,6 ème
BOUCHES-DU-RHONE,MARSEILLE,0133396W,0,0,0,0,0,0,6 ème
BOUCHES-DU-RHONE,MARSEILLE,0130049H,0,0,0,0,0,0,6 ème
BOUCHES-DU-RHONE,MARSEILLE,0130071G,0,0,0,0,0,0,6 ème
BOUCHES-DU-RHONE,MARSEILLE,0131371V,59,59,0,0,27,32,6 ème
BOUCHES-DU-RHONE,MARSEILLE,0131548M,159,143,13,3,76,83,6 ème
BOUCHES-DU-RHONE,MARSEILLE,0131602W,149,149,0,0,59,90,6 ème
BOUCHES-DU-RHONE,MARSEILLE,0132310R,140,138,0,2,67,73,6 ème
BOUCHES-DU-RHONE,MARSEILLE,0132951M,117,117,0,0,55,62,6 ème
BOUCHES-DU-RHONE,MARTIGUES,0131789Z,127,119,0,8,61,66,6 ème
BOUCHES-DU-RHONE,MARTIGUES,0132210G,0,0,0,0,0,0,6 ème
BOUCHES-DU-RHONE,MIRAMAS,0130146N,0,0,0,0,0,0,6 ème
BOUCHES-DU-RHONE,MIRAMAS,0132326H,108,106,0,2,51,57,6 ème
BOUCHES-DU-RHONE,MIRAMAS,0132327J,97,83,14,0,51,46,6 ème
BOUCHES-DU-RHONE,MIRAMAS,0134245U,69,69,0,0,35,34,6 ème
BOUCHES-DU-RHONE,PORT-DE-BOUC,0132212J,89,79,10,0,50,39,6 ème
BOUCHES-DU-RHONE,SAINT-CHAMAS,0130157A,0,0,0,0,0,0,6 ème
BOUCHES-DU-RHONE,SALON-DE-PROVENCE,0131265E,128,128,0,0,61,67,6 ème
BOUCHES-DU-RHONE,SAUSSET-LES-PINS,0133449D,181,181,0,0,98,83,6 ème
BOUCHES-DU-RHONE,SEPTEMES-LES-VALLONS,0131675A,0,0,0,0,0,0,6 ème
BOUCHES-DU-RHONE,SEPTEMES-LES-VALLONS,0133765X,134,133,0,1,79,55,6 ème
BOUCHES-DU-RHONE,TARASCON,0131388N,55,55,0,0,30,25,6 ème
HAUTES-ALPES,BRIANCON,0050043V,104,103,0,1,51,53,6 ème
HAUTES-ALPES,GAP,0050009H,0,0,0,0,0,0,6 ème
HAUTES-ALPES,GAP,0050562J,153,153,0,0,62,91,6 ème
VAUCLUSE,AVIGNON,0840006A,81,78,0,3,50,31,6 ème
VAUCLUSE,AVIGNON,0840108L,140,117,22,1,63,77,6 ème
VAUCLUSE,AVIGNON,0840697B,101,95,0,6,51,50,6 ème
VAUCLUSE,CARPENTRAS,0840015K,0,0,0,0,0,0,6 ème
VAUCLUSE,LE THOR,0840915N,161,158,0,3,75,86,6 ème
VAUCLUSE,MORIERES-LES-AVIGNON,0841116G,205,197,0,8,108,97,6 ème
VAUCLUSE,ORANGE,0840116V,187,165,17,5,95,92,6 ème
VAUCLUSE,ORANGE,0840853W,205,205,0,0,98,107,6 ème
VAUCLUSE,PERNES-LES-FONTAINES,0840028Z,147,143,0,4,81,66,6 ème
VAUCLUSE,SAULT,0840032D,33,28,0,5,16,17,6 ème
VAUCLUSE,SORGUES,0840068T,172,155,16,1,91,81,6 ème
ALPES-MARITIMES,ANTIBES,0060002V,0,0,0,0,0,0,6 ème
ALPES-MARITIMES,ANTIBES,0060842H,185,174,6,5,86,99,6 ème
ALPES-MARITIMES,ANTIBES,0061119J,156,156,0,0,76,80,6 ème
ALPES-MARITIMES,BEAULIEU-SUR-MER,0061209G,142,140,0,2,60,82,6 ème
ALPES-MARITIMES,BIOT,0061670H,196,196,0,0,97,99,6 ème
ALPES-MARITIMES,CAGNES-SUR-MER,0061635V,0,0,0,0,0,0,6 ème
ALPES-MARITIMES,CANNES,0061279H,125,125,0,0,59,66,6 ème
ALPES-MARITIMES,CANNES,0061342B,109,109,0,0,55,54,6 ème
ALPES-MARITIMES,CANNES,0062122Z,16,16,0,0,6,10,6 ème
ALPES-MARITIMES,GRASSE,0060021R,104,102,0,2,49,55,6 ème
ALPES-MARITIMES,LE CANNET,0061723R,116,116,0,0,61,55,6 ème
ALPES-MARITIMES,MOUANS-SARTOUX,0061795U,179,179,0,0,83,96,6 ème
ALPES-MARITIMES,NICE,0060032C,157,150,0,7,82,75,6 ème
ALPES-MARITIMES,NICE,0060042N,0,0,0,0,0,0,6 ème
ALPES-MARITIMES,NICE,0060050X,239,230,0,9,128,111,6 ème
ALPES-MARITIMES,NICE,0061002G,150,146,0,4,75,75,6 ème
ALPES-MARITIMES,NICE,0061006L,264,264,0,0,144,120,6 ème
ALPES-MARITIMES,NICE,0061129V,114,113,0,1,49,65,6 ème
ALPES-MARITIMES,NICE,0061277F,181,164,14,3,83,98,6 ème
ALPES-MARITIMES,NICE,0061694J,193,190,0,3,91,102,6 ème
ALPES-MARITIMES,PEYMEINADE,0061796V,177,177,0,0,97,80,6 ème
ALPES-MARITIMES,ROQUEBRUNE-CAP-MARTIN,0061458C,136,136,0,0,68,68,6 ème
ALPES-MARITIMES,SAINT-ETIENNE-DE-TINEE,0060063L,50,50,0,0,23,27,6 ème
ALPES-MARITIMES,SAINT-LAURENT-DU-VAR,0061134A,174,172,0,2,80,94,6 ème
ALPES-MARITIMES,SAINT-MARTIN-DU-VAR,0061400P,134,129,0,5,68,66,6 ème
ALPES-MARITIMES,VILLENEUVE-LOUBET,0061825B,122,121,0,1,58,64,6 ème
VAR,CARCES,0831709G,121,117,0,4,59,62,6 ème
VAR,CARQUEIRANNE,0830836H,175,175,0,0,85,90,6 ème
VAR,COGOLIN,0831424X,104,104,0,0,47,57,6 ème
VAR,CUERS,0830013N,186,167,16,3,84,102,6 ème
VAR,CUERS,0830114Y,0,0,0,0,0,0,6 ème
VAR,DRAGUIGNAN,0830016S,0,0,0,0,0,0,6 ème
VAR,DRAGUIGNAN,0831274J,157,140,13,4,77,80,6 ème
VAR,FAYENCE,0830019V,160,157,0,3,67,93,6 ème
VAR,FIGANIERES,0831609Y,114,114,0,0,62,52,6 ème
VAR,FREJUS,0830023Z,169,169,0,0,89,80,6 ème
VAR,FREJUS,0830834F,144,137,0,7,77,67,6 ème
VAR,GASSIN,0831537V,144,144,0,0,76,68,6 ème
VAR,LA FARLEDE,0831514V,111,108,0,3,50,61,6 ème
VAR,LE CASTELLET,0831644L,89,89,0,0,49,40,6 ème
VAR,LE LUC,0830163B,244,227,16,1,117,127,6 ème
VAR,OLLIOULES,0830922B,119,119,0,0,57,62,6 ème
VAR,SAINT-CYR-SUR-MER,0830106P,96,96,0,0,53,43,6 ème
VAR,SAINT-TROPEZ,0830996G,41,41,0,0,16,25,6 ème
VAR,SIX-FOURS-LES-PLAGES,0831354W,0,0,0,0,0,0,6 ème
VAR,TOULON,0830069Z,231,216,12,3,97,134,6 ème
VAR,TOULON,0830181W,146,130,10,6,65,81,6 ème
VAR,TOULON,0830661T,0,0,0,0,0,0,6 ème
VAR,TOULON,0830954L,121,121,0,0,67,54,6 ème
CALVADOS,BAYEUX,0141274J,0,0,0,0,0,0,6 ème
CALVADOS,CAEN,0140025B,127,125,0,2,78,49,6 ème
CALVADOS,CAEN,0141163N,137,137,0,0,70,67,6 ème
CALVADOS,CAEN,0141268C,159,153,0,6,87,72,6 ème
CALVADOS,CAEN,0142133T,0,0,0,0,0,0,6 ème
CALVADOS,DOUVRES-LA-DELIVRANDE,0141193W,0,0,0,0,0,0,6 ème
CALVADOS,FALAISE,0141764S,212,195,13,4,102,110,6 ème
CALVADOS,GIBERVILLE,0141964J,118,113,0,5,56,62,6 ème
CALVADOS,HEROUVILLE-SAINT-CLAIR,0141136J,69,64,0,5,31,38,6 ème
CALVADOS,HEROUVILLE-SAINT-CLAIR,0141363F,82,77,0,5,39,43,6 ème
CALVADOS,LE HOM,0141228J,74,69,0,5,26,48,6 ème
CALVADOS,LIVAROT-PAYS-D'AUGE,0140067X,65,65,0,0,36,29,6 ème
CALVADOS,MERVILLE-FRANCEVILLE-PLAGE,0140069Z,93,93,0,0,37,56,6 ème
CALVADOS,TROUVILLE-SUR-MER,0141863Z,144,144,0,0,63,81,6 ème
EURE,BEAUMONT-LE-ROGER,0271056B,42,42,0,0,12,30,6 ème
EURE,EVREUX,0270018Y,0,0,0,0,0,0,6 ème
EURE,EZY-SUR-EURE,0271238Z,143,140,0,3,69,74,6 ème
EURE,FLEURY-SUR-ANDELLE,0271098X,168,151,15,2,92,76,6 ème
EURE,GISORS,0271321P,140,129,11,0,70,70,6 ème
EURE,GISORS,0271631B,137,137,0,0,62,75,6 ème
EURE,GRAVIGNY,0271172C,180,179,0,1,91,89,6 ème
EURE,LA SAUSSAYE,0271105E,159,159,0,0,75,84,6 ème
EURE,LES ANDELYS,0271320N,167,165,0,2,75,92,6 ème
EURE,MESNIL-EN-OUCHE,0271121X,66,64,0,2,27,39,6 ème
EURE,PONT-AUDEMER,0271097W,0,0,0,0,0,0,6 ème
EURE,ROUTOT,0271285A,96,96,0,0,50,46,6 ème
EURE,RUGLES,0270040X,72,68,0,4,34,38,6 ème
EURE,VAL-DE-REUIL,0271286B,125,110,13,2,65,60,6 ème
EURE,VERNEUIL D'AVRE ET D'ITON,0271319M,0,0,0,0,0,0,6 ème
EURE,VERNON,0271073V,0,0,0,0,0,0,6 ème
EURE,VERNON,0271288D,84,84,0,0,37,47,6 ème
MANCHE,AGNEAUX,0501825M,0,0,0,0,0,0,6 ème
MANCHE,CHERBOURG-EN-COTENTIN,0500132X,0,0,0,0,0,0,6 ème
MANCHE,FLAMANVILLE,0501799J,71,71,0,0,28,43,6 ème
MANCHE,LA HAYE-PESNEL,0500042Z,86,86,0,0,39,47,6 ème
MANCHE,LES PIEUX,0501220E,126,121,0,5,48,78,6 ème
MANCHE,MONTMARTIN-SUR-MER,0500048F,87,77,0,10,39,48,6 ème
MANCHE,SAINT-JAMES,0500149R,14,14,0,0,3,11,6 ème
MANCHE,SAINT-JAMES,0501242D,70,62,8,0,39,31,6 ème
MANCHE,SAINT-LO,0500095G,97,77,16,4,53,44,6 ème
MANCHE,SAINT-LO,0500121K,87,87,0,0,44,43,6 ème
MANCHE,SAINT-SAUVEUR-LE-VICOMTE,0500152U,72,72,0,0,38,34,6 ème
MANCHE,TESSY-BOCAGE,0500078N,88,88,0,0,42,46,6 ème
MANCHE,VILLEDIEU-LES-POELES-ROUFFIGNY,0500123M,49,49,0,0,28,21,6 ème
ORNE,ALENCON,0610692W,0,0,0,0,0,0,6 ème
ORNE,CARROUGES,0610012G,31,31,0,0,12,19,6 ème
ORNE,CEAUCE,0611220V,51,51,0,0,22,29,6 ème
ORNE,FLERS,0610023U,114,113,0,1,63,51,6 ème
ORNE,GACE,0610710R,15,15,0,0,6,9,6 ème
ORNE,L'AIGLE,0610745D,78,68,9,1,39,39,6 ème
ORNE,TRUN,0610044S,79,78,0,1,46,33,6 ème
ORNE,VIMOUTIERS,0610045T,49,49,0,0,24,25,6 ème
SEINE MARITIME,BIHOREL,0761724L,80,80,0,0,36,44,6 ème
SEINE MARITIME,BLANGY-SUR-BRESLE,0760009X,112,102,8,2,67,45,6 ème
SEINE MARITIME,BOIS-GUILLAUME,0761950G,109,97,11,1,48,61,6 ème
SEINE MARITIME,BONSECOURS,0760010Y,111,111,0,0,50,61,6 ème
SEINE MARITIME,BOOS,0762816Y,134,134,0,0,68,66,6 ème
SEINE MARITIME,CANTELEU,0762089H,108,108,0,0,49,59,6 ème
SEINE MARITIME,CANY-BARVILLE,0762126Y,113,108,0,5,56,57,6 ème
SEINE MARITIME,CLEON,0762679Z,113,98,7,8,58,55,6 ème
SEINE MARITIME,CRIQUETOT-L'ESNEVAL,0761784B,246,243,0,3,114,132,6 ème
SEINE MARITIME,DARNETAL,0761778V,115,107,7,1,54,61,6 ème
SEINE MARITIME,DUCLAIR,0760136K,166,164,0,2,86,80,6 ème
SEINE MARITIME,ELBEUF,0761347B,0,0,0,0,0,0,6 ème
SEINE MARITIME,ELBEUF,0762459K,165,151,13,1,73,92,6 ème
SEINE MARITIME,FORGES-LES-EAUX,0761695E,134,127,7,0,67,67,6 ème
SEINE MARITIME,GONFREVILLE-L'ORCHER,0761954L,132,117,12,3,62,70,6 ème
SEINE MARITIME,GOURNAY-EN-BRAY,0761734X,46,46,0,0,19,27,6 ème
SEINE MARITIME,LE GRAND-QUEVILLY,0761690Z,111,108,0,3,45,66,6 ème
SEINE MARITIME,LE HAVRE,0760053V,159,151,0,8,73,86,6 ème
SEINE MARITIME,LE HAVRE,0760069M,86,86,0,0,43,43,6 ème
SEINE MARITIME,LE HAVRE,0761696F,122,122,0,0,60,62,6 ème
SEINE MARITIME,LE HAVRE,0761711X,181,173,0,8,83,98,6 ème
SEINE MARITIME,LE HAVRE,0762226G,82,82,0,0,42,40,6 ème
SEINE MARITIME,LE MESNIL-ESNARD,0761343X,0,0,0,0,0,0,6 ème
SEINE MARITIME,LE MESNIL-ESNARD,0762229K,179,179,0,0,94,85,6 ème
SEINE MARITIME,LONDINIERES,0760137L,72,72,0,0,36,36,6 ème
SEINE MARITIME,LONGUEVILLE-SUR-SCIE,0762086E,124,121,0,3,52,72,6 ème
SEINE MARITIME,MAROMME,0760022L,0,0,0,0,0,0,6 ème
SEINE MARITIME,MONT-SAINT-AIGNAN,0760077W,109,104,0,5,54,55,6 ème
SEINE MARITIME,PAVILLY,0761694D,143,139,0,4,69,74,6 ème
SEINE MARITIME,ROUEN,0761356L,0,0,0,0,0,0,6 ème
SEINE MARITIME,ROUEN,0761720G,124,122,0,2,70,54,6 ème
SEINE MARITIME,ROUEN,0762091K,232,210,16,6,140,92,6 ème
SEINE MARITIME,ROUEN,0762602R,0,0,0,0,0,0,6 ème
SEINE MARITIME,SAINTE-ADRESSE,0762405B,75,75,0,0,33,42,6 ème
SEINE MARITIME,SAINT-ETIENNE-DU-ROUVRAY,0761777U,125,125,0,0,65,60,6 ème
SEINE MARITIME,SAINT-ETIENNE-DU-ROUVRAY,0762964J,0,0,0,0,0,0,6 ème
SEINE MARITIME,SAINT-NICOLAS-D'ALIERMONT,0760105B,189,179,9,1,97,92,6 ème
SEINE MARITIME,SAINT-PIERRE-LES-ELBEUF,0761776T,115,115,0,0,41,74,6 ème
SEINE MARITIME,SAINT-SAENS,0761953K,98,98,0,0,54,44,6 ème
SEINE MARITIME,VALMONT,0760116N,104,104,0,0,51,53,6 ème
SEINE MARITIME,YERVILLE,0761951H,177,165,12,0,84,93,6 ème
SEINE MARITIME,YVETOT,0760118R,189,172,16,1,98,91,6 ème
DORDOGNE,BRANTOME EN PERIGORD,0240010F,78,78,0,0,42,36,6 ème
DORDOGNE,LA ROCHE-CHALAIS,0240083K,32,32,0,0,12,20,6 ème
DORDOGNE,NONTRON,0241041B,82,75,3,4,45,37,6 ème
DORDOGNE,PERIGUEUX,0240984P,0,0,0,0,0,0,6 ème
DORDOGNE,THIVIERS,0240039M,0,0,0,0,0,0,6 ème
DORDOGNE,VERGT,0240056F,95,95,0,0,55,40,6 ème
GIRONDE,ANDERNOS-LES-BAINS,0331890A,193,177,11,5,98,95,6 ème
GIRONDE,ARVEYRES,0332085M,160,155,0,5,86,74,6 ème
GIRONDE,AUDENGE,0330008E,133,133,0,0,66,67,6 ème
GIRONDE,BASSENS,0331884U,119,106,11,2,57,62,6 ème
GIRONDE,BAZAS,0332288H,195,177,10,8,109,86,6 ème
GIRONDE,BLAYE,0332781U,0,0,0,0,0,0,6 ème
GIRONDE,BORDEAUX,0330065S,134,130,0,4,69,65,6 ème
GIRONDE,BORDEAUX,0331461J,181,179,0,2,83,98,6 ème
GIRONDE,BORDEAUX,0331618E,78,75,0,3,38,40,6 ème
GIRONDE,BORDEAUX,0332489B,50,50,0,0,26,24,6 ème
GIRONDE,BORDEAUX,0332493F,245,244,0,1,128,117,6 ème
GIRONDE,BORDEAUX,0332768E,130,129,0,1,62,68,6 ème
GIRONDE,BORDEAUX,0332806W,81,77,0,4,32,49,6 ème
GIRONDE,BORDEAUX,0333532K,51,51,0,0,20,31,6 ème
GIRONDE,CADILLAC,0331524C,60,60,0,0,26,34,6 ème
GIRONDE,CARIGNAN-DE-BORDEAUX,0331490R,129,127,0,2,67,62,6 ème
GIRONDE,CASTELNAU-DE-MEDOC,0330062N,197,193,0,4,102,95,6 ème
GIRONDE,EYSINES,0330076D,0,0,0,0,0,0,6 ème
GIRONDE,EYSINES,0332084L,174,174,0,0,85,89,6 ème
GIRONDE,FLOIRAC,0332189A,118,118,0,0,56,62,6 ème
GIRONDE,FLOIRAC,0332486Y,181,180,0,1,85,96,6 ème
GIRONDE,GRADIGNAN,0331622J,219,219,0,0,98,121,6 ème
GIRONDE,GUITRES,0330138W,131,127,0,4,68,63,6 ème
GIRONDE,GUJAN-MESTRAS,0332870R,0,0,0,0,0,0,6 ème
GIRONDE,LA BREDE,0332343T,138,138,0,0,76,62,6 ème
GIRONDE,LE BOUSCAT,0333108Z,90,90,0,0,49,41,6 ème
GIRONDE,LE HAILLAN,0332437V,106,106,0,0,50,56,6 ème
GIRONDE,LIBOURNE,0333213N,154,138,13,3,75,79,6 ème
GIRONDE,LORMONT,0331619F,116,102,11,3,60,56,6 ème
GIRONDE,LORMONT,0332441Z,0,0,0,0,0,0,6 ème
GIRONDE,MERIGNAC,0330146E,150,150,0,0,71,79,6 ème
GIRONDE,MERIGNAC,0332090T,195,182,8,5,107,88,6 ème
GIRONDE,MIOS,0333329P,213,213,0,0,119,94,6 ème
GIRONDE,PELLEGRUE,0330105K,37,37,0,0,20,17,6 ème
GIRONDE,SAINT-ANDRE-DE-CUBZAC,0332346W,0,0,0,0,0,0,6 ème
GIRONDE,SAINTE-EULALIE,0332705L,101,98,0,3,49,52,6 ème
GIRONDE,SAINT-JEAN-D'ILLAC,0333134C,144,144,0,0,75,69,6 ème
GIRONDE,SAINT-MEDARD-EN-JALLES,0331664E,134,133,0,1,51,83,6 ème
GIRONDE,SAINT-YZAN-DE-SOUDIAC,0331888Y,146,145,0,1,76,70,6 ème
GIRONDE,VERAC,0332706M,178,174,0,4,94,84,6 ème
LANDES,AIRE-SUR-L'ADOUR,0400002K,0,0,0,0,0,0,6 ème
LANDES,BISCARROSSE,0400092H,102,102,0,0,51,51,6 ème
LANDES,CAPBRETON,0400004M,0,0,0,0,0,0,6 ème
LANDES,GABARRET,0400072L,41,41,0,0,23,18,6 ème
LANDES,MIMIZAN,0400105X,135,135,0,0,66,69,6 ème
LANDES,PEYREHORADE,0400028N,153,149,0,4,72,81,6 ème
LANDES,SAINT-GEOURS-DE-MAREMNE,0401070W,143,142,0,1,77,66,6 ème
LANDES,SAINT-PIERRE-DU-MONT,0400103V,131,105,23,3,62,69,6 ème
LANDES,SAINT-SEVER,0400038Z,120,115,0,5,57,63,6 ème
LANDES,TARTAS,0400077S,39,39,0,0,20,19,6 ème
LOT-ET-GARONNE,AGEN,0470005A,126,122,0,4,65,61,6 ème
LOT-ET-GARONNE,AGEN,0470066S,158,147,8,3,84,74,6 ème
LOT-ET-GARONNE,CASTELMORON-SUR-LOT,0470732R,53,53,0,0,26,27,6 ème
LOT-ET-GARONNE,CASTILLONNES,0470014K,50,50,0,0,25,25,6 ème
LOT-ET-GARONNE,FUMEL,0470641S,0,0,0,0,0,0,6 ème
LOT-ET-GARONNE,MARMANDE,0470020S,0,0,0,0,0,0,6 ème
LOT-ET-GARONNE,MARMANDE,0470103G,165,148,15,2,82,83,6 ème
LOT-ET-GARONNE,MEZIN,0470023V,28,28,0,0,15,13,6 ème
LOT-ET-GARONNE,MONFLANQUIN,0470026Y,97,97,0,0,56,41,6 ème
LOT-ET-GARONNE,SAINTE-LIVRADE-SUR-LOT,0470102F,88,87,0,1,44,44,6 ème
LOT-ET-GARONNE,TONNEINS,0470104H,159,140,16,3,73,86,6 ème
LOT-ET-GARONNE,VILLENEUVE-SUR-LOT,0470678G,107,91,15,1,43,64,6 ème
PYRENEES-ATLANTIQUES,BAYONNE,0640179X,0,0,0,0,0,0,6 ème
PYRENEES-ATLANTIQUES,BAYONNE,0641907A,0,0,0,0,0,0,6 ème
PYRENEES-ATLANTIQUES,BAYONNE,0642114A,61,61,0,0,35,26,6 ème
PYRENEES-ATLANTIQUES,CAMBO-LES-BAINS,0640147M,87,87,0,0,39,48,6 ème
PYRENEES-ATLANTIQUES,JURANCON,0640031L,0,0,0,0,0,0,6 ème
PYRENEES-ATLANTIQUES,MORLAAS,0641412M,181,177,0,4,85,96,6 ème
PYRENEES-ATLANTIQUES,NAY,0641657D,107,107,0,0,56,51,6 ème
PYRENEES-ATLANTIQUES,PAU,0640184C,0,0,0,0,0,0,6 ème
PYRENEES-ATLANTIQUES,PAU,0641653Z,136,132,0,4,77,59,6 ème
PYRENEES-ATLANTIQUES,SAINT-JEAN-PIED-DE-PORT,0640165G,39,39,0,0,24,15,6 ème
PYRENEES-ATLANTIQUES,SAINT-JEAN-PIED-DE-PORT,0641844G,0,0,0,0,0,0,6 ème
PYRENEES-ATLANTIQUES,SAINT-PIERRE-D'IRUBE,0642038T,181,181,0,0,91,90,6 ème
CORREZE,BRIVE-LA-GAILLARDE,0190740B,109,103,0,6,62,47,6 ème
CORREZE,LUBERSAC,0190695C,83,83,0,0,32,51,6 ème
CORREZE,MEYMAC,0190089U,0,0,0,0,0,0,6 ème
CORREZE,NEUVIC,0190821P,43,43,0,0,23,20,6 ème
CORREZE,TULLE,0190034J,0,0,0,0,0,0,6 ème
CREUSE,BOURGANEUF,0230008J,0,0,0,0,0,0,6 ème
CREUSE,CHENERAILLES,0230012N,39,39,0,0,22,17,6 ème
CREUSE,CROCQ,0230014R,35,35,0,0,19,16,6 ème
CREUSE,LA SOUTERRAINE,0230032K,96,84,7,5,53,43,6 ème
CREUSE,PARSAC-RIMONDEIX,0230023A,36,36,0,0,19,17,6 ème
HAUTE-VIENNE,AIXE-SUR-VIENNE,0870001D,183,183,0,0,89,94,6 ème
HAUTE-VIENNE,BELLAC,0870120H,93,74,15,4,36,57,6 ème
HAUTE-VIENNE,BESSINES-SUR-GARTEMPE,0870006J,49,49,0,0,21,28,6 ème
HAUTE-VIENNE,CHATEAUNEUF-LA-FORET,0870008L,44,44,0,0,26,18,6 ème
HAUTE-VIENNE,LIMOGES,0870072F,162,157,0,5,84,78,6 ème
HAUTE-VIENNE,LIMOGES,0870960W,70,69,0,1,34,36,6 ème
HAUTE-VIENNE,LIMOGES,0875087G,62,62,0,0,27,35,6 ème
HAUTE-VIENNE,SAINT-LEONARD-DE-NOBLAT,0870820U,124,124,0,0,57,67,6 ème
HAUTE-VIENNE,SAINT-SULPICE-LES-FEUILLES,0870049F,41,41,0,0,25,16,6 ème
CHARENTE,ANGOULEME,0160049S,0,0,0,0,0,0,6 ème
CHARENTE,ANGOULEME,0161048C,162,162,0,0,72,90,6 ème
CHARENTE,ANGOULEME,0161075G,97,93,0,4,51,46,6 ème
CHARENTE,BARBEZIEUX-SAINT-HILAIRE,0160866E,112,94,14,4,54,58,6 ème
CHARENTE,CHASSENEUIL-SUR-BONNIEURE,0160882X,88,74,13,1,46,42,6 ème
CHARENTE,COGNAC,0160116P,122,122,0,0,65,57,6 ème
CHARENTE,CONFOLENS,0160944P,68,68,0,0,34,34,6 ème
CHARENTE,LA ROCHEFOUCAULD-EN-ANGOUMOIS,0160076W,53,53,0,0,25,28,6 ème
CHARENTE,MONTBRON,0160030W,39,39,0,0,21,18,6 ème
CHARENTE-MARITIME,AULNAY,0171213B,59,59,0,0,28,31,6 ème
CHARENTE-MARITIME,COZES,0170111D,32,32,0,0,13,19,6 ème
CHARENTE-MARITIME,JONZAC,0170135E,0,0,0,0,0,0,6 ème
CHARENTE-MARITIME,LA ROCHELLE,0170035W,197,179,13,5,101,96,6 ème
CHARENTE-MARITIME,LA ROCHELLE,0170100S,0,0,0,0,0,0,6 ème
CHARENTE-MARITIME,LA ROCHELLE,0170142M,81,67,11,3,36,45,6 ème
CHARENTE-MARITIME,LA ROCHELLE,0171117X,142,140,0,2,71,71,6 ème
CHARENTE-MARITIME,MARANS,0171022U,154,154,0,0,77,77,6 ème
CHARENTE-MARITIME,MIRAMBEAU,0170016A,74,74,0,0,36,38,6 ème
CHARENTE-MARITIME,ROYAN,0171122C,167,158,0,9,69,98,6 ème
CHARENTE-MARITIME,ROYAN,0171571R,0,0,0,0,0,0,6 ème
CHARENTE-MARITIME,SAINTES,0170059X,178,171,0,7,88,90,6 ème
CHARENTE-MARITIME,SAINTES,0170078T,0,0,0,0,0,0,6 ème
CHARENTE-MARITIME,SAINTES,0170392J,14,0,14,0,5,9,6 ème
CHARENTE-MARITIME,SAINT-HILAIRE-DE-VILLEFRANCHE,0170050M,77,74,0,3,26,51,6 ème
CHARENTE-MARITIME,SAINT-JEAN-D'ANGELY,0171118Y,140,121,13,6,73,67,6 ème
CHARENTE-MARITIME,SAINT-SAVINIEN,0170056U,111,111,0,0,59,52,6 ème
CHARENTE-MARITIME,SURGERES,0170120N,67,67,0,0,34,33,6 ème
CHARENTE-MARITIME,TONNAY-BOUTONNE,0170082X,69,69,0,0,27,42,6 ème
DEUX-SEVRES,ARGENTONNAY,0790060L,41,41,0,0,19,22,6 ème
DEUX-SEVRES,CHAMPDENIERS-SAINT-DENIS,0790013K,60,60,0,0,34,26,6 ème
DEUX-SEVRES,LA CRECHE,0790965V,168,168,0,0,95,73,6 ème
DEUX-SEVRES,LEZAY,0790017P,67,67,0,0,37,30,6 ème
DEUX-SEVRES,NIORT,0790027A,130,128,0,2,62,68,6 ème
DEUX-SEVRES,NIORT,0790710T,125,107,16,2,63,62,6 ème
DEUX-SEVRES,NIORT,0791134D,131,122,9,0,56,75,6 ème
DEUX-SEVRES,SAINT-AUBIN-LE-CLOUD,0790979K,16,0,16,0,9,7,6 ème
DEUX-SEVRES,SAINT-VARENT,0790032F,68,68,0,0,37,31,6 ème
VIENNE,CHATELLERAULT,0860876K,156,147,9,0,74,82,6 ème
VIENNE,CHATELLERAULT,0860984C,135,123,9,3,64,71,6 ème
VIENNE,CIVRAY,0860053R,68,53,15,0,39,29,6 ème
VIENNE,JAUNAY-MARIGNY,0860764N,92,92,0,0,34,58,6 ème
VIENNE,LA ROCHE-POSAY,0860043E,80,80,0,0,50,30,6 ème
VIENNE,MIREBEAU,0860027M,82,80,0,2,33,49,6 ème
VIENNE,POITIERS,0860039A,0,0,0,0,0,0,6 ème
VIENNE,POITIERS,0860756E,118,118,0,0,62,56,6 ème
VIENNE,POITIERS,0861072Y,153,138,14,1,81,72,6 ème
VIENNE,SAINT-GERVAIS-LES-TROIS-CLOCHERS,0860044F,71,71,0,0,34,37,6 ème
VIENNE,SAINT-SAVIN,0860046H,40,40,0,0,14,26,6 ème
AUDE,CARCASSONNE,0110037F,130,130,0,0,60,70,6 ème
AUDE,CARCASSONNE,0110044N,137,137,0,0,72,65,6 ème
AUDE,CARCASSONNE,0110666P,145,136,0,9,73,72,6 ème
AUDE,CARCASSONNE,0110823K,0,0,0,0,0,0,6 ème
AUDE,CASTELNAUDARY,0110825M,180,165,12,3,84,96,6 ème
AUDE,LEZIGNAN-CORBIERES,0111048E,0,0,0,0,0,0,6 ème
AUDE,NARBONNE,0110025T,130,130,0,0,72,58,6 ème
AUDE,NARBONNE,0110068P,144,144,0,0,73,71,6 ème
GARD,AIGUES-MORTES,0300001N,163,154,0,9,86,77,6 ème
GARD,ALES,0300922P,154,154,0,0,88,66,6 ème
GARD,ALES,0301728R,25,25,0,0,8,17,6 ème
GARD,CALVISSON,0301671D,174,167,0,7,81,93,6 ème
GARD,LE VIGAN,0300052U,0,0,0,0,0,0,6 ème
GARD,MANDUEL,0301746K,121,121,0,0,51,70,6 ème
GARD,NIMES,0300062E,135,129,0,6,61,74,6 ème
GARD,NIMES,0300096S,99,99,0,0,42,57,6 ème
GARD,NIMES,0300929X,142,131,11,0,67,75,6 ème
GARD,NIMES,0300945P,212,212,0,0,105,107,6 ème
GARD,NIMES,0301357M,123,123,0,0,62,61,6 ème
GARD,REMOULINS,0300033Y,144,144,0,0,74,70,6 ème
GARD,ROQUEMAURE,0301213F,204,204,0,0,97,107,6 ème
GARD,SAINT-GILLES,0300037C,226,208,15,3,118,108,6 ème
GARD,SAINT-HIPPOLYTE-DU-FORT,0300039E,81,78,0,3,43,38,6 ème
GARD,SAINT-JEAN-DU-GARD,0300041G,0,0,0,0,0,0,6 ème
GARD,VILLENEUVE-LES-AVIGNON,0301214G,201,201,0,0,93,108,6 ème
HERAULT,AGDE,0341032M,140,138,0,2,63,77,6 ème
HERAULT,BEZIERS,0340869K,182,180,0,2,96,86,6 ème
HERAULT,BEZIERS,0340872N,125,125,0,0,49,76,6 ème
HERAULT,CASTRIES,0341280G,175,175,0,0,84,91,6 ème
HERAULT,FRONTIGNAN,0340025T,176,157,15,4,79,97,6 ème
HERAULT,FRONTIGNAN,0340894M,96,96,0,0,54,42,6 ème
HERAULT,LODEVE,0340028W,0,0,0,0,0,0,6 ème
HERAULT,LUNEL,0340897R,120,120,0,0,65,55,6 ème
HERAULT,MAGALAS,0340032A,132,130,0,2,56,76,6 ème
HERAULT,MONTFERRIER-SUR-LEZ,0342297M,60,60,0,0,27,33,6 ème
HERAULT,MONTPELLIER,0340045P,0,0,0,0,0,0,6 ème
HERAULT,MONTPELLIER,0340883A,114,112,0,2,56,58,6 ème
HERAULT,MONTPELLIER,0340955D,142,133,8,1,78,64,6 ème
HERAULT,MONTPELLIER,0341030K,104,104,0,0,46,58,6 ème
HERAULT,MONTPELLIER,0341592W,144,127,15,2,72,72,6 ème
HERAULT,POUSSAN,0340062H,187,183,0,4,96,91,6 ème
HERAULT,SETE,0340078A,0,0,0,0,0,0,6 ème
HERAULT,SETE,0340885C,129,129,0,0,55,74,6 ème
HERAULT,SETE,0340972X,114,108,0,6,41,73,6 ème
HERAULT,VILLENEUVE-LES-MAGUELONE,0342078Z,145,145,0,0,62,83,6 ème
LOZERE,LANGOGNE,0480004U,40,40,0,0,13,27,6 ème
LOZERE,LANGOGNE,0480678B,21,21,0,0,10,11,6 ème
LOZERE,MENDE,0480032Z,70,70,0,0,34,36,6 ème
LOZERE,SAINT-CHELY-D'APCHER,0480680D,0,0,0,0,0,0,6 ème
PYRENEES-ORIENTALES,ARGELES-SUR-MER,0660924W,0,0,0,0,0,0,6 ème
PYRENEES-ORIENTALES,ELNE,0660523K,269,267,0,2,152,117,6 ème
PYRENEES-ORIENTALES,FONT-ROMEU-ODEILLO-VIA,0660057D,0,0,0,0,0,0,6 ème
PYRENEES-ORIENTALES,PERPIGNAN,0660016J,143,137,0,6,76,67,6 ème
PYRENEES-ORIENTALES,PERPIGNAN,0660058E,284,284,0,0,139,145,6 ème
PYRENEES-ORIENTALES,PERPIGNAN,0660077A,0,0,0,0,0,0,6 ème
PYRENEES-ORIENTALES,PERPIGNAN,0660078B,14,0,14,0,3,11,6 ème
PYRENEES-ORIENTALES,PERPIGNAN,0660520G,0,0,0,0,0,0,6 ème
PYRENEES-ORIENTALES,PIA,0660866H,202,196,0,6,104,98,6 ème
PYRENEES-ORIENTALES,PORT-VENDRES,0660038H,70,70,0,0,34,36,6 ème
PYRENEES-ORIENTALES,THUIR,0660030Z,260,244,13,3,123,137,6 ème
ARIEGE,FERRIERES-SUR-ARIEGE,0090003E,0,0,0,0,0,0,6 ème
ARIEGE,PAMIERS,0090015T,0,0,0,0,0,0,6 ème
ARIEGE,SEIX,0090025D,28,28,0,0,6,22,6 ème
AVEYRON,CAPDENAC-GARE,0120082Z,35,35,0,0,19,16,6 ème
AVEYRON,DECAZEVILLE,0120622L,109,96,13,0,55,54,6 ème
AVEYRON,DECAZEVILLE,0121257B,40,36,0,4,18,22,6 ème
AVEYRON,ESPALION,0121176N,94,91,0,3,52,42,6 ème
AVEYRON,ESPALION,0121258C,67,67,0,0,42,25,6 ème
AVEYRON,LA FOUILLADE,0120090H,30,30,0,0,13,17,6 ème
AVEYRON,MARCILLAC-VALLON,0120011X,80,78,0,2,44,36,6 ème
AVEYRON,MILLAU,0120105Z,0,0,0,0,0,0,6 ème
AVEYRON,ONET-LE-CHATEAU,0121500R,89,89,0,0,40,49,6 ème
AVEYRON,RIEUPEYROUX,0120055V,22,22,0,0,11,11,6 ème
AVEYRON,RODEZ,0120037A,0,0,0,0,0,0,6 ème
AVEYRON,SAINT-AFFRIQUE,0120025M,0,0,0,0,0,0,6 ème
AVEYRON,SAINT-AFFRIQUE,0121297V,129,123,2,4,62,67,6 ème
AVEYRON,SEVERAC D'AVEYRON,0120029S,60,60,0,0,26,34,6 ème
AVEYRON,VILLEFRANCHE-DE-ROUERGUE,0121178R,8,0,8,0,2,6,6 ème
GERS,AUCH,0320067Z,0,0,0,0,0,0,6 ème
GERS,CONDOM,0320010M,90,87,0,3,47,43,6 ème
GERS,LECTOURE,0320651J,42,42,0,0,18,24,6 ème
GERS,L'ISLE-JOURDAIN,0320740F,119,114,2,3,60,59,6 ème
GERS,MASSEUBE,0320004F,23,23,0,0,7,16,6 ème
HAUTE-GARONNE,AUSSONNE,0312729Y,193,187,0,6,90,103,6 ème
HAUTE-GARONNE,BAGNERES-DE-LUCHON,0311334G,0,0,0,0,0,0,6 ème
HAUTE-GARONNE,CARBONNE,0311580Z,140,126,9,5,65,75,6 ème
HAUTE-GARONNE,COLOMIERS,0311325X,94,94,0,0,56,38,6 ème
HAUTE-GARONNE,LA SALVETAT-SAINT-GILLES,0312612W,164,154,4,6,77,87,6 ème
HAUTE-GARONNE,LEGUEVIN,0312063Z,0,0,0,0,0,0,6 ème
HAUTE-GARONNE,LHERM,0312697N,131,127,0,4,68,63,6 ème
HAUTE-GARONNE,MONTRABE,0312698P,98,95,0,3,46,52,6 ème
HAUTE-GARONNE,MURET,0310025J,206,201,0,5,108,98,6 ème
HAUTE-GARONNE,PECHBONNIEU,0312700S,209,206,0,3,102,107,6 ème
HAUTE-GARONNE,RAMONVILLE-SAINT-AGNE,0311633G,138,125,7,6,56,82,6 ème
HAUTE-GARONNE,REVEL,0310088C,0,0,0,0,0,0,6 ème
HAUTE-GARONNE,SAINT-BEAT-LEZ,0310031R,22,22,0,0,15,7,6 ème
HAUTE-GARONNE,SAINT-GAUDENS,0311131L,0,0,0,0,0,0,6 ème
HAUTE-GARONNE,SAINT-JORY,0311162V,121,121,0,0,65,56,6 ème
HAUTE-GARONNE,SEYSSES,0313081F,152,146,0,6,69,83,6 ème
HAUTE-GARONNE,TOULOUSE,0310051M,0,0,0,0,0,0,6 ème
HAUTE-GARONNE,TOULOUSE,0310085Z,168,163,0,5,76,92,6 ème
HAUTE-GARONNE,TOULOUSE,0310086A,116,114,0,2,52,64,6 ème
HAUTE-GARONNE,TOULOUSE,0311148E,79,79,0,0,32,47,6 ème
HAUTE-GARONNE,TOULOUSE,0311332E,95,94,0,1,41,54,6 ème
HAUTE-GARONNE,TOULOUSE,0311338L,119,114,0,5,62,57,6 ème
HAUTE-GARONNE,TOULOUSE,0311584D,85,82,0,3,46,39,6 ème
HAUTE-GARONNE,TOULOUSE,0311718Z,138,128,0,10,73,65,6 ème
HAUTE-GARONNE,TOULOUSE,0311963R,116,116,0,0,31,85,6 ème
HAUTE-GARONNE,TOULOUSE,0311964S,188,188,0,0,103,85,6 ème
HAUTE-GARONNE,VERNET,0312610U,114,110,0,4,54,60,6 ème
HAUTES-PYRENEES,LUZ-SAINT-SAUVEUR,0650018S,25,25,0,0,9,16,6 ème
HAUTES-PYRENEES,MONLEON-MAGNOAC,0650885J,0,0,0,0,0,0,6 ème
HAUTES-PYRENEES,TARBES,0650740B,126,111,15,0,67,59,6 ème
HAUTES-PYRENEES,TARBES,0650835E,169,164,0,5,85,84,6 ème
HAUTES-PYRENEES,TARBES,0650880D,150,149,0,1,71,79,6 ème
LOT,GRAMAT,0460565P,74,74,0,0,50,24,6 ème
LOT,LACAPELLE-MARIVAL,0460015S,55,54,0,1,26,29,6 ème
LOT,VAYRAC,0460030H,42,42,0,0,20,22,6 ème
TARN,ALBI,0810003N,0,0,0,0,0,0,6 ème
TARN,ALBI,0810052S,153,146,0,7,77,76,6 ème
TARN,CARMAUX,0810012Y,0,0,0,0,0,0,6 ème
TARN,CASTRES,0811063R,161,149,12,0,74,87,6 ème
TARN,GAILLAC,0811065T,93,93,0,0,38,55,6 ème
TARN,LABASTIDE-ROUAIROUX,0810025M,46,46,0,0,25,21,6 ème
TARN,LACAUNE,0810027P,57,56,1,0,25,32,6 ème
TARN,MASSAC-SERAN,0811066U,56,56,0,0,26,30,6 ème
TARN,RABASTENS,0810092K,48,48,0,0,17,31,6 ème
TARN,SAINT-JUERY,0810124V,161,159,0,2,88,73,6 ème
TARN,SAINT-SULPICE-LA-POINTE,0810122T,57,46,11,0,24,33,6 ème
TARN-ET-GARONNE,BEAUMONT-DE-LOMAGNE,0820047F,44,44,0,0,23,21,6 ème
TARN-ET-GARONNE,CASTELSARRASIN,0820713E,85,82,0,3,45,40,6 ème
TARN-ET-GARONNE,MONTAUBAN,0820684Y,158,156,0,2,72,86,6 ème
TARN-ET-GARONNE,MONTAUBAN,0820755A,114,114,0,0,67,47,6 ème
TARN-ET-GARONNE,NEGREPELISSE,0820824A,160,158,0,2,73,87,6 ème
TARN-ET-GARONNE,SAINT-ANTONIN-NOBLE-VAL,0820704V,66,66,0,0,26,40,6 ème
LOIRE-ATLANTIQUE,AIGREFEUILLE-SUR-MAINE,0440179F,145,143,0,2,75,70,6 ème
LOIRE-ATLANTIQUE,CARQUEFOU,0442029S,194,194,0,0,98,96,6 ème
LOIRE-ATLANTIQUE,COUERON,0440310Y,0,0,0,0,0,0,6 ème
LOIRE-ATLANTIQUE,DERVAL,0440423W,76,76,0,0,36,40,6 ème
LOIRE-ATLANTIQUE,GUERANDE,0440193W,202,197,0,5,99,103,6 ème
LOIRE-ATLANTIQUE,HERIC,0442728B,188,186,0,2,93,95,6 ème
LOIRE-ATLANTIQUE,LA BAULE-ESCOUBLAC,0441859G,115,100,15,0,56,59,6 ème
LOIRE-ATLANTIQUE,LA CHAPELLE-SUR-ERDRE,0442011X,140,139,0,1,76,64,6 ème
LOIRE-ATLANTIQUE,LA CHAPELLE-SUR-ERDRE,0442388G,0,0,0,0,0,0,6 ème
LOIRE-ATLANTIQUE,LEGE,0440196Z,82,82,0,0,41,41,6 ème
LOIRE-ATLANTIQUE,LIGNE,0442691L,169,166,0,3,79,90,6 ème
LOIRE-ATLANTIQUE,LOIREAUXENCE,0440243A,79,79,0,0,40,39,6 ème
LOIRE-ATLANTIQUE,MACHECOUL-SAINT-MEME,0440018F,99,78,16,5,48,51,6 ème
LOIRE-ATLANTIQUE,MACHECOUL-SAINT-MEME,0441930J,180,168,12,0,92,88,6 ème
LOIRE-ATLANTIQUE,NANTES,0440211R,55,54,0,1,24,31,6 ème
LOIRE-ATLANTIQUE,NANTES,0440283U,93,83,10,0,44,49,6 ème
LOIRE-ATLANTIQUE,NANTES,0440285W,107,107,0,0,44,63,6 ème
LOIRE-ATLANTIQUE,NANTES,0440286X,74,74,0,0,37,37,6 ème
LOIRE-ATLANTIQUE,NANTES,0441932L,189,185,0,4,94,95,6 ème
LOIRE-ATLANTIQUE,NANTES,0441937S,101,101,0,0,43,58,6 ème
LOIRE-ATLANTIQUE,NANTES,0442119P,17,17,0,0,6,11,6 ème
LOIRE-ATLANTIQUE,NANTES,0442835T,118,117,0,1,57,61,6 ème
LOIRE-ATLANTIQUE,PORNICHET,0440228J,119,119,0,0,54,65,6 ème
LOIRE-ATLANTIQUE,SAINTE-PAZANNE,0440236T,137,137,0,0,70,67,6 ème
LOIRE-ATLANTIQUE,SAINT-GILDAS-DES-BOIS,0441939U,165,165,0,0,92,73,6 ème
LOIRE-ATLANTIQUE,SAINT-HERBLAIN,0440016D,191,190,0,1,95,96,6 ème
LOIRE-ATLANTIQUE,SAINT-HERBLAIN,0442637C,24,24,0,0,12,12,6 ème
LOIRE-ATLANTIQUE,SAINT-NAZAIRE,0440074S,0,0,0,0,0,0,6 ème
LOIRE-ATLANTIQUE,SAINT-NAZAIRE,0440235S,143,127,16,0,80,63,6 ème
LOIRE-ATLANTIQUE,SAINT-NAZAIRE,0440314C,173,156,14,3,74,99,6 ème
LOIRE-ATLANTIQUE,SAINT-NAZAIRE,0441613P,115,98,14,3,55,60,6 ème
LOIRE-ATLANTIQUE,SAVENAY,0442806L,103,103,0,0,47,56,6 ème
LOIRE-ATLANTIQUE,VALLONS-DE-L'ERDRE,0441655K,78,78,0,0,38,40,6 ème
MAINE-ET-LOIRE,ANGERS,0490004N,134,132,0,2,85,49,6 ème
MAINE-ET-LOIRE,ANGERS,0490061A,87,85,0,2,41,46,6 ème
MAINE-ET-LOIRE,ANGERS,0490783K,97,92,0,5,50,47,6 ème
MAINE-ET-LOIRE,ANGERS,0490844B,202,190,9,3,95,107,6 ème
MAINE-ET-LOIRE,ANGERS,0491703K,86,74,10,2,41,45,6 ème
MAINE-ET-LOIRE,ANGERS,0491922Y,179,179,0,0,79,100,6 ème
MAINE-ET-LOIRE,ANGERS,0491924A,214,214,0,0,98,116,6 ème
MAINE-ET-LOIRE,BAUGE-EN-ANJOU,0490849G,120,120,0,0,50,70,6 ème
MAINE-ET-LOIRE,BELLEVIGNE-EN-LAYON,0490046J,113,113,0,0,56,57,6 ème
MAINE-ET-LOIRE,BRISSAC LOIRE AUBANCE,0490014Z,120,120,0,0,63,57,6 ème
MAINE-ET-LOIRE,CANDE,0490854M,108,108,0,0,47,61,6 ème
MAINE-ET-LOIRE,CHOLET,0490829K,152,150,0,2,75,77,6 ème
MAINE-ET-LOIRE,DOUE-EN-ANJOU,0490023J,100,97,0,3,55,45,6 ème
MAINE-ET-LOIRE,LE LION-D'ANGERS,0490027N,181,173,0,8,83,98,6 ème
MAINE-ET-LOIRE,LE MAY-SUR-EVRE,0490869D,92,92,0,0,44,48,6 ème
MAINE-ET-LOIRE,LES HAUTS-D'ANJOU,0491705M,165,160,0,5,82,83,6 ème
MAINE-ET-LOIRE,LES PONTS-DE-CE,0491260D,151,147,0,4,68,83,6 ème
MAINE-ET-LOIRE,LONGUE-JUMELLES,0490028P,85,70,14,1,34,51,6 ème
MAINE-ET-LOIRE,SAINT-BARTHELEMY-D'ANJOU,0490925P,0,0,0,0,0,0,6 ème
MAINE-ET-LOIRE,SAINT-GEORGES-SUR-LOIRE,0491645X,147,147,0,0,70,77,6 ème
MAINE-ET-LOIRE,SAUMUR,0491826U,56,56,0,0,26,30,6 ème
MAINE-ET-LOIRE,SEGRE-EN-ANJOU BLEU,0490782J,0,0,0,0,0,0,6 ème
MAINE-ET-LOIRE,SEGRE-EN-ANJOU BLEU,0490840X,0,0,0,0,0,0,6 ème
MAINE-ET-LOIRE,SEGRE-EN-ANJOU BLEU,0491927D,20,20,0,0,11,9,6 ème
MAYENNE,BAIS,0530003R,49,49,0,0,16,33,6 ème
MAYENNE,EVRON,0530007V,93,75,14,4,45,48,6 ème
MAYENNE,GREZ-EN-BOUERE,0530031W,78,78,0,0,42,36,6 ème
MAYENNE,LAVAL,0530041G,126,108,15,3,78,48,6 ème
MAYENNE,LAVAL,0530051T,228,227,0,1,118,110,6 ème
MAYENNE,LAVAL,0530082B,154,148,0,6,72,82,6 ème
MAYENNE,LAVAL,0530778H,0,0,0,0,0,0,6 ème
MAYENNE,LAVAL,0530904V,0,0,0,0,0,0,6 ème
MAYENNE,MAYENNE,0530053V,195,177,17,1,94,101,6 ème
MAYENNE,SAINT-PIERRE-LA-COUR,0530065H,85,85,0,0,38,47,6 ème
SARTHE,ANCINNES,0720002L,90,90,0,0,44,46,6 ème
SARTHE,BEAUMONT-SUR-SARTHE,0721655H,46,46,0,0,22,24,6 ème
SARTHE,BESSE-SUR-BRAYE,0721089T,33,33,0,0,20,13,6 ème
SARTHE,LA FERTE-BERNARD,0721364S,177,160,15,2,97,80,6 ème
SARTHE,LE MANS,0720068H,60,60,0,0,32,28,6 ème
SARTHE,LE MANS,0720081X,96,96,0,0,46,50,6 ème
SARTHE,LE MANS,0720799C,130,125,0,5,67,63,6 ème
SARTHE,LE MANS,0720835S,77,77,0,0,41,36,6 ème
SARTHE,LE MANS,0720984D,147,144,0,3,77,70,6 ème
SARTHE,LE MANS,0720987G,88,85,0,3,46,42,6 ème
SARTHE,LE MANS,0721363R,121,121,0,0,69,52,6 ème
SARTHE,MAYET,0720988H,54,54,0,0,29,25,6 ème
SARTHE,MONTVAL-SUR-LOIR,0720013Y,0,0,0,0,0,0,6 ème
SARTHE,MONTVAL-SUR-LOIR,0720067G,120,104,13,3,69,51,6 ème
SARTHE,MULSANNE,0721281B,96,96,0,0,38,58,6 ème
SARTHE,NOYEN-SUR-SARTHE,0721263G,105,105,0,0,63,42,6 ème
SARTHE,SABLE-SUR-SARTHE,0720989J,125,109,15,1,57,68,6 ème
SARTHE,SAINT-COSME-EN-VAIRAIS,0720053S,54,52,0,2,23,31,6 ème
SARTHE,VIBRAYE,0720058X,64,64,0,0,35,29,6 ème
VENDEE,AUBIGNY-LES CLOUZEAUX,0851620Z,154,151,0,3,82,72,6 ème
VENDEE,FONTENAY-LE-COMTE,0850068M,0,0,0,0,0,0,6 ème
VENDEE,FONTENAY-LE-COMTE,0851344Z,0,0,0,0,0,0,6 ème
VENDEE,LA ROCHE-SUR-YON,0850063G,148,134,13,1,72,76,6 ème
VENDEE,LA ROCHE-SUR-YON,0850082C,207,173,30,4,91,116,6 ème
VENDEE,LE POIRE-SUR-VIE,0850111J,184,184,0,0,88,96,6 ème
VENDEE,LES SABLES-D'OLONNE,0850084E,106,106,0,0,59,47,6 ème
VENDEE,LES SABLES-D'OLONNE,0851220P,156,156,0,0,65,91,6 ème
VENDEE,L'ILE-D'ELLE,0850014D,66,66,0,0,32,34,6 ème
VENDEE,LUCON,0850607Y,81,67,14,0,43,38,6 ème
VENDEE,POUZAUGES,0850024P,104,102,0,2,39,65,6 ème
VENDEE,ROCHESERVIERE,0850113L,139,139,0,0,71,68,6 ème
VENDEE,SAINTE-CECILE,0851295W,17,17,0,0,1,16,6 ème
VENDEE,SAINT-GILLES-CROIX-DE-VIE,0851181X,273,271,0,2,139,134,6 ème
ALPES-DE-HTE-PROVENCE,BEVONS,0040378P,12,0,12,0,2,10,6 ème
ALPES-DE-HTE-PROVENCE,CASTELLANE,0040004H,33,33,0,0,13,20,6 ème
ALPES-DE-HTE-PROVENCE,DIGNE-LES-BAINS,0040034R,0,0,0,0,0,0,6 ème
ALPES-DE-HTE-PROVENCE,DIGNE-LES-BAINS,0040044B,90,84,0,6,36,54,6 ème
ALPES-DE-HTE-PROVENCE,ORAISON,0040051J,81,79,0,2,33,48,6 ème
ALPES-DE-HTE-PROVENCE,SISTERON,0040420K,151,147,0,4,76,75,6 ème
ALPES-DE-HTE-PROVENCE,VOLX,0040535K,131,126,0,5,66,65,6 ème
BOUCHES-DU-RHONE,AIX-EN-PROVENCE,0132568W,186,186,0,0,101,85,6 ème
BOUCHES-DU-RHONE,AIX-EN-PROVENCE,0132915Y,184,184,0,0,92,92,6 ème
BOUCHES-DU-RHONE,ARLES,0130171R,0,0,0,0,0,0,6 ème
BOUCHES-DU-RHONE,AUBAGNE,0131622T,178,175,0,3,91,87,6 ème
BOUCHES-DU-RHONE,BERRE-L'ETANG,0131705H,179,163,16,0,75,104,6 ème
BOUCHES-DU-RHONE,CHATEAUNEUF-LES-MARTIGUES,0132494R,248,242,0,6,116,132,6 ème
BOUCHES-DU-RHONE,GARDANNE,0131700C,164,164,0,0,73,91,6 ème
BOUCHES-DU-RHONE,GARDANNE,0133244F,0,0,0,0,0,0,6 ème
BOUCHES-DU-RHONE,GIGNAC-LA-NERTHE,0133381E,196,194,0,2,107,89,6 ème
BOUCHES-DU-RHONE,LA FARE-LES-OLIVIERS,0133016H,162,159,0,3,80,82,6 ème
BOUCHES-DU-RHONE,LES PENNES-MIRABEAU,0132565T,182,182,0,0,87,95,6 ème
BOUCHES-DU-RHONE,MARIGNANE,0132921E,217,214,0,3,116,101,6 ème
BOUCHES-DU-RHONE,MARSEILLE,0130072H,0,0,0,0,0,0,6 ème
BOUCHES-DU-RHONE,MARSEILLE,0132732Z,179,179,0,0,88,91,6 ème
BOUCHES-DU-RHONE,MARSEILLE,0132947H,167,167,0,0,76,91,6 ème
BOUCHES-DU-RHONE,MARSEILLE,0132404T,120,120,0,0,61,59,6 ème
BOUCHES-DU-RHONE,MARSEILLE,0131606A,0,0,0,0,0,0,6 ème
BOUCHES-DU-RHONE,MARSEILLE,0130058T,0,0,0,0,0,0,6 ème
BOUCHES-DU-RHONE,MARSEILLE,0130136C,64,55,0,9,28,36,6 ème
BOUCHES-DU-RHONE,MARSEILLE,0132954R,89,89,0,0,49,40,6 ème
BOUCHES-DU-RHONE,MARSEILLE,0130093F,128,128,0,0,65,63,6 ème
BOUCHES-DU-RHONE,MARSEILLE,0131336G,94,94,0,0,42,52,6 ème
BOUCHES-DU-RHONE,MARSEILLE,0131434N,0,0,0,0,0,0,6 ème
BOUCHES-DU-RHONE,MARSEILLE,0132561N,96,93,0,3,46,50,6 ème
BOUCHES-DU-RHONE,MARSEILLE,0130063Y,0,0,0,0,0,0,6 ème
BOUCHES-DU-RHONE,MARTIGUES,0132208E,131,116,15,0,64,67,6 ème
BOUCHES-DU-RHONE,MIRAMAS,0132497U,110,110,0,0,48,62,6 ème
BOUCHES-DU-RHONE,ORGON,0132217P,193,177,16,0,98,95,6 ème
BOUCHES-DU-RHONE,PELISSANNE,0133114P,147,144,0,3,71,76,6 ème
BOUCHES-DU-RHONE,PORT-SAINT-LOUIS-DU-RHONE,0132280H,0,0,0,0,0,0,6 ème
BOUCHES-DU-RHONE,SAINT-VICTORET,0132007L,166,162,0,4,81,85,6 ème
BOUCHES-DU-RHONE,SALON-DE-PROVENCE,0131485U,0,0,0,0,0,0,6 ème
HAUTES-ALPES,BRIANCON,0050519M,133,115,11,7,64,69,6 ème
HAUTES-ALPES,GAP,0050010J,107,103,0,4,41,66,6 ème
HAUTES-ALPES,GAP,0050025A,113,93,16,4,55,58,6 ème
VAUCLUSE,APT,0840070V,63,63,0,0,30,33,6 ème
VAUCLUSE,AVIGNON,0840041N,0,0,0,0,0,0,6 ème
VAUCLUSE,AVIGNON,0840051Z,102,102,0,0,48,54,6 ème
VAUCLUSE,AVIGNON,0840073Y,109,105,0,4,58,51,6 ème
VAUCLUSE,AVIGNON,0840738W,102,99,0,3,48,54,6 ème
VAUCLUSE,AVIGNON,0840758T,147,147,0,0,63,84,6 ème
VAUCLUSE,AVIGNON,0840970Y,120,116,0,4,63,57,6 ème
VAUCLUSE,BOLLENE,0840699D,153,153,0,0,69,84,6 ème
VAUCLUSE,CABRIERES-D'AVIGNON,0841019B,188,188,0,0,85,103,6 ème
VAUCLUSE,CARPENTRAS,0840016L,0,0,0,0,0,0,6 ème
VAUCLUSE,CAVAILLON,0840020R,137,135,0,2,51,86,6 ème
VAUCLUSE,ORANGE,0840763Y,0,0,0,0,0,0,6 ème
VAUCLUSE,PERTUIS,0840029A,132,115,17,0,69,63,6 ème
VAUCLUSE,PERTUIS,0840918S,0,0,0,0,0,0,6 ème
VAUCLUSE,VAISON-LA-ROMAINE,0840035G,198,198,0,0,108,90,6 ème
ALPES-MARITIMES,ANTIBES,0060076A,112,106,0,6,57,55,6 ème
ALPES-MARITIMES,ANTIBES,0061133Z,88,88,0,0,34,54,6 ème
ALPES-MARITIMES,GRASSE,0061240R,108,108,0,0,57,51,6 ème
ALPES-MARITIMES,GRASSE,0061459D,217,214,0,3,104,113,6 ème
ALPES-MARITIMES,L'ESCARENE,0061826C,113,111,0,2,49,64,6 ème
ALPES-MARITIMES,MENTON,0060028Y,0,0,0,0,0,0,6 ème
ALPES-MARITIMES,MENTON,0060744B,84,82,0,2,37,47,6 ème
ALPES-MARITIMES,NICE,0060045S,116,109,0,7,59,57,6 ème
ALPES-MARITIMES,NICE,0060048V,239,233,0,6,123,116,6 ème
ALPES-MARITIMES,NICE,0060776L,0,0,0,0,0,0,6 ème
ALPES-MARITIMES,NICE,0060841G,181,167,14,0,88,93,6 ème
ALPES-MARITIMES,NICE,0061131X,187,170,10,7,89,98,6 ème
ALPES-MARITIMES,NICE,0061461F,148,148,0,0,68,80,6 ème
ALPES-MARITIMES,NICE,0061722P,23,23,0,0,10,13,6 ème
ALPES-MARITIMES,NICE,0061772U,23,23,0,0,15,8,6 ème
ALPES-MARITIMES,SAINT-SAUVEUR-SUR-TINEE,0060066P,37,37,0,0,15,22,6 ème
ALPES-MARITIMES,SAINT-VALLIER-DE-THIEY,0061986B,120,120,0,0,59,61,6 ème
ALPES-MARITIMES,SOSPEL,0060067R,52,52,0,0,22,30,6 ème
ALPES-MARITIMES,VALDEBLORE,0061987C,0,0,0,0,0,0,6 ème
ALPES-MARITIMES,VENCE,0061135B,161,161,0,0,88,73,6 ème
VAR,COGOLIN,0830837J,193,177,11,5,101,92,6 ème
VAR,LA LONDE-LES-MAURES,0830031H,79,79,0,0,39,40,6 ème
VAR,LA SEYNE-SUR-MER,0830180V,175,151,21,3,80,95,6 ème
VAR,LA SEYNE-SUR-MER,0830925E,181,180,0,1,80,101,6 ème
VAR,MONTAUROUX,0831610Z,172,161,8,3,86,86,6 ème
VAR,OLLIOULES,0831187P,0,0,0,0,0,0,6 ème
VAR,SAINT-MAXIMIN-LA-SAINTE-BAUME,0831442S,237,235,0,2,115,122,6 ème
VAR,SAINT-MAXIMIN-LA-SAINTE-BAUME,0831559U,0,0,0,0,0,0,6 ème
VAR,SAINT-RAPHAEL,0830075F,119,119,0,0,56,63,6 ème
VAR,SIX-FOURS-LES-PLAGES,0831012Z,173,158,13,2,85,88,6 ème
VAR,SOLLIES-PONT,0830831C,172,172,0,0,79,93,6 ème
VAR,TOULON,0830116A,0,0,0,0,0,0,6 ème
VAR,TOULON,0830128N,0,0,0,0,0,0,6 ème
VAR,TOULON,0830955M,77,76,0,1,48,29,6 ème
VAR,TOULON,0831053U,147,135,10,2,68,79,6 ème
ALLIER,CUSSET,0030010V,155,134,15,6,74,81,6 ème
ALLIER,DOMERAT,0030956Y,102,99,0,3,53,49,6 ème
ALLIER,GANNAT,0030905T,0,0,0,0,0,0,6 ème
ALLIER,LE DONJON,0030014Z,31,31,0,0,15,16,6 ème
ALLIER,MONTLUCON,0030026M,0,0,0,0,0,0,6 ème
ALLIER,MONTLUCON,0030105Y,0,0,0,0,0,0,6 ème
ALLIER,MOULINS,0030062B,128,125,0,3,68,60,6 ème
ALLIER,TRONGET,0030046J,44,44,0,0,23,21,6 ème
ALLIER,VALLON-EN-SULLY,0030047K,51,51,0,0,28,23,6 ème
CANTAL,AURILLAC,0150005Z,113,111,0,2,55,58,6 ème
CANTAL,AURILLAC,0150006A,0,0,0,0,0,0,6 ème
CANTAL,MURAT,0150023U,30,30,0,0,19,11,6 ème
CANTAL,NEUSSARGUES EN PINATELLE,0150065P,17,17,0,0,10,7,6 ème
CANTAL,PLEAUX,0150025W,25,25,0,0,12,13,6 ème
CANTAL,SAINT-CERNIN,0150028Z,53,48,0,5,22,31,6 ème
CANTAL,SAINT-FLOUR,0150030B,0,0,0,0,0,0,6 ème
CANTAL,SAINT-FLOUR,0150666T,64,64,0,0,32,32,6 ème
HAUTE-LOIRE,AUREC-SUR-LOIRE,0430052Y,56,56,0,0,26,30,6 ème
HAUTE-LOIRE,BLESLE,0430002U,18,18,0,0,11,7,6 ème
HAUTE-LOIRE,BRIVES-CHARENSAC,0430899U,93,82,7,4,44,49,6 ème
HAUTE-LOIRE,LANDOS,0430012E,38,38,0,0,20,18,6 ème
HAUTE-LOIRE,LE PUY-EN-VELAY,0431009N,112,112,0,0,48,64,6 ème
HAUTE-LOIRE,PAULHAGUET,0430019M,19,19,0,0,12,7,6 ème
HAUTE-LOIRE,SAUGUES,0430092S,16,16,0,0,4,12,6 ème
HAUTE-LOIRE,TENCE,0430034D,24,24,0,0,11,13,6 ème
PUY-DE-DOME,AIGUEPERSE,0630079U,162,162,0,0,83,79,6 ème
PUY-DE-DOME,AIGUEPERSE,0631084L,25,25,0,0,12,13,6 ème
PUY-DE-DOME,BILLOM,0631080G,62,60,0,2,27,35,6 ème
PUY-DE-DOME,BRASSAC-LES-MINES,0630012W,0,0,0,0,0,0,6 ème
PUY-DE-DOME,BRASSAC-LES-MINES,0631503S,52,52,0,0,25,27,6 ème
PUY-DE-DOME,CHAMALIERES,0631125F,184,178,0,6,84,100,6 ème
PUY-DE-DOME,CLERMONT-FERRAND,0631099C,64,64,0,0,37,27,6 ème
PUY-DE-DOME,CLERMONT-FERRAND,0631199L,109,106,0,3,56,53,6 ème
PUY-DE-DOME,CLERMONT-FERRAND,0631408N,0,0,0,0,0,0,6 ème
PUY-DE-DOME,CLERMONT-FERRAND,0631411S,111,111,0,0,55,56,6 ème
PUY-DE-DOME,ISSOIRE,0631448G,104,102,0,2,54,50,6 ème
PUY-DE-DOME,LA MONNERIE-LE-MONTEL,0631762Y,82,82,0,0,43,39,6 ème
PUY-DE-DOME,MURAT-LE-QUAIRE,0630010U,36,32,0,4,16,20,6 ème
PUY-DE-DOME,RIOM,0631735U,144,136,0,8,62,82,6 ème
PUY-DE-DOME,RIOM,0631985R,0,0,0,0,0,0,6 ème
PUY-DE-DOME,SAINT-GERMAIN-L'HERM,0630064C,33,33,0,0,15,18,6 ème
PUY-DE-DOME,THIERS,0631407M,45,45,0,0,13,32,6 ème
ARDECHE,ANNONAY,0070059B,185,184,0,1,87,98,6 ème
ARDECHE,ANNONAY,0070060C,201,201,0,0,95,106,6 ème
ARDECHE,ANNONAY,0071300A,133,129,0,4,64,69,6 ème
ARDECHE,AUBENAS,0071245R,62,56,0,6,35,27,6 ème
ARDECHE,BOURG-SAINT-ANDEOL,0070860X,140,137,0,3,78,62,6 ème
ARDECHE,CHOMERAC,0070009X,0,0,0,0,0,0,6 ème
ARDECHE,LARGENTIERE,0070080Z,58,56,0,2,34,24,6 ème
ARDECHE,LE CHEYLARD,0070861Y,26,26,0,0,7,19,6 ème
ARDECHE,PRIVAS,0070114L,0,0,0,0,0,0,6 ème
ARDECHE,PRIVAS,0071246S,254,249,0,5,140,114,6 ème
ARDECHE,PRIVAS,0071281E,62,62,0,0,31,31,6 ème
ARDECHE,SAINT-AGREVE,0070023M,23,23,0,0,8,15,6 ème
ARDECHE,TOURNON-SUR-RHONE,0070031W,0,0,0,0,0,0,6 ème
DROME,CHABEUIL,0260003M,138,132,0,6,66,72,6 ème
DROME,CHATEAUNEUF-DE-GALAURE,0261134S,44,44,0,0,0,44,6 ème
DROME,CREST,0260006R,0,0,0,0,0,0,6 ème
DROME,CREST,0260945L,103,103,0,0,45,58,6 ème
DROME,CREST,0261030D,166,143,16,7,94,72,6 ème
DROME,LE GRAND-SERRE,0260011W,81,81,0,0,37,44,6 ème
DROME,LIVRON-SUR-DROME,0260096N,156,156,0,0,77,79,6 ème
DROME,NYONS,0261089T,134,131,0,3,67,67,6 ème
DROME,PIERRELATTE,0260098R,115,115,0,0,57,58,6 ème
DROME,PIERRELATTE,0261010G,130,105,15,10,57,73,6 ème
DROME,ROMANS-SUR-ISERE,0260067G,100,100,0,0,49,51,6 ème
DROME,SAINT-DONAT-SUR-L'HERBASSE,0260099S,99,99,0,0,41,58,6 ème
DROME,SAINT-JEAN-EN-ROYANS,0260027N,72,72,0,0,33,39,6 ème
DROME,VALENCE,0260117L,97,97,0,0,55,42,6 ème
HAUTE SAVOIE,ABONDANCE,0740001Z,52,52,0,0,31,21,6 ème
HAUTE SAVOIE,ANNECY,0740083N,124,122,0,2,54,70,6 ème
HAUTE SAVOIE,ANNECY,0740274W,160,156,0,4,82,78,6 ème
HAUTE SAVOIE,ANNECY,0741101V,0,0,0,0,0,0,6 ème
HAUTE SAVOIE,ANNECY,0741164N,0,0,0,0,0,0,6 ème
HAUTE SAVOIE,ANNECY,0741285V,0,0,0,0,0,0,6 ème
HAUTE SAVOIE,ANNEMASSE,0741165P,270,261,0,9,147,123,6 ème
HAUTE SAVOIE,EVIAN-LES-BAINS,0740021W,202,182,16,4,98,104,6 ème
HAUTE SAVOIE,FAVERGES-SEYTHENEX,0740023Y,125,124,0,1,74,51,6 ème
HAUTE SAVOIE,MARIGNIER,0741501E,142,142,0,0,66,76,6 ème
HAUTE SAVOIE,SAINT-JEAN-D'AULPS,0740034K,121,121,0,0,58,63,6 ème
HAUTE SAVOIE,SALLANCHES,0740155S,0,0,0,0,0,0,6 ème
HAUTE SAVOIE,SEYSSEL,0740041T,136,136,0,0,65,71,6 ème
ISERE,BEAUREPAIRE,0382101C,160,157,0,3,82,78,6 ème
ISERE,CROLLES,0382781S,148,148,0,0,72,76,6 ème
ISERE,EYBENS,0383494S,141,140,0,1,72,69,6 ème
ISERE,GRENOBLE,0381696M,109,109,0,0,61,48,6 ème
ISERE,GRENOBLE,0382035F,147,133,12,2,66,81,6 ème
ISERE,GRENOBLE,0382111N,138,138,0,0,65,73,6 ème
ISERE,JARRIE,0382782T,158,154,0,4,74,84,6 ème
ISERE,LA COTE-SAINT-ANDRE,0381689E,164,164,0,0,80,84,6 ème
ISERE,LE BOURG-D'OISANS,0380007B,103,103,0,0,46,57,6 ème
ISERE,LE PONT-DE-BEAUVOISIN,0381703V,119,119,0,0,59,60,6 ème
ISERE,L'ISLE-D'ABEAU,0382786X,122,103,16,3,57,65,6 ème
ISERE,MENS,0380039L,46,46,0,0,20,26,6 ème
ISERE,PONT-DE-CHERUY,0381602K,0,0,0,0,0,0,6 ème
ISERE,SAINT-CHEF,0383301G,176,176,0,0,92,84,6 ème
ISERE,SAINT-MARTIN-D'HERES,0380065P,108,108,0,0,51,57,6 ème
ISERE,SAINT-MARTIN-D'HERES,0381812N,127,125,0,2,59,68,6 ème
ISERE,SAINT-QUENTIN-FALLAVIER,0382706K,130,124,0,6,61,69,6 ème
ISERE,SAINT-SIMEON-DE-BRESSIEUX,0380068T,112,109,0,3,48,64,6 ème
ISERE,TULLINS,0380067S,134,134,0,0,75,59,6 ème
ISERE,VIENNE,0381907S,153,135,16,2,75,78,6 ème
ISERE,VILLEFONTAINE,0382864G,108,108,0,0,47,61,6 ème
ISERE,VOIRON,0380092U,0,0,0,0,0,0,6 ème
ISERE,VOIRON,0381710C,174,174,0,0,105,69,6 ème
ISERE,VOREPPE,0381805F,0,0,0,0,0,0,6 ème
ISERE,VOREPPE,0382663N,103,103,0,0,45,58,6 ème
SAVOIE,AIX-LES-BAINS,0731041K,119,119,0,0,49,70,6 ème
SAVOIE,AIX-LES-BAINS,0731271K,11,11,0,0,11,0,6 ème
SAVOIE,ALBERTVILLE,0731224J,88,84,0,4,42,46,6 ème
SAVOIE,CHAMBERY,0730764J,256,252,0,4,124,132,6 ème
SAVOIE,CHAMBERY,0730901H,155,155,0,0,93,62,6 ème
SAVOIE,CHAMBERY,0731042L,163,160,0,3,76,87,6 ème
SAVOIE,ENTRELACS,0730004H,98,94,0,4,40,58,6 ème
SAVOIE,LA MOTTE-SERVOLEX,0731441V,163,160,0,3,81,82,6 ème
SAVOIE,LA RAVOIRE,0730032N,0,0,0,0,0,0,6 ème
SAVOIE,LA RAVOIRE,0730765K,92,86,6,0,44,48,6 ème
SAVOIE,MOUTIERS,0730029K,0,0,0,0,0,0,6 ème
SAVOIE,NOVALAISE,0730031M,82,82,0,0,30,52,6 ème
SAVOIE,SAINT-MICHEL-DE-MAURIENNE,0730984Y,66,66,0,0,33,33,6 ème
AIN,AMBERIEU-EN-BUGEY,0010002X,185,182,0,3,96,89,6 ème
AIN,AMBERIEU-EN-BUGEY,0010076C,105,103,0,2,56,49,6 ème
AIN,BOURG-EN-BRESSE,0010021T,0,0,0,0,0,0,6 ème
AIN,BOURG-EN-BRESSE,0010082J,198,196,0,2,102,96,6 ème
AIN,BOURG-EN-BRESSE,0010823P,106,106,0,0,55,51,6 ème
AIN,MARBOZ,0010089S,31,31,0,0,18,13,6 ème
AIN,MIRIBEL,0010964T,123,111,12,0,47,76,6 ème
AIN,MONTREAL-LA-CLUSE,0011325K,152,148,0,4,70,82,6 ème
AIN,NANTUA,0010032E,0,0,0,0,0,0,6 ème
AIN,OYONNAX,0010034G,0,0,0,0,0,0,6 ème
AIN,OYONNAX,0010035H,149,145,0,4,71,78,6 ème
AIN,PERON,0011388D,201,199,0,2,108,93,6 ème
AIN,PONT-DE-VEYLE,0010820L,148,145,0,3,80,68,6 ème
AIN,SAINT-DIDIER-SUR-CHALARONNE,0010095Y,135,135,0,0,71,64,6 ème
AIN,SAINT-GENIS-POUILLY,0010975E,174,171,0,3,83,91,6 ème
AIN,SAINT-TRIVIER-DE-COURTES,0010040N,64,62,0,2,29,35,6 ème
AIN,THOISSEY,0010042R,139,132,0,7,67,72,6 ème
AIN,VALSERHONE,0010008D,149,139,8,2,80,69,6 ème
AIN,VALSERHONE,0011066D,159,157,0,2,89,70,6 ème
AIN,VILLARS-LES-DOMBES,0010939R,156,153,0,3,75,81,6 ème
LOIRE,ANDREZIEUX-BOUTHEON,0421487N,238,224,14,0,125,113,6 ème
LOIRE,BOEN-SUR-LIGNON,0421085B,131,125,0,6,58,73,6 ème
LOIRE,BOURG-ARGENTAL,0421043F,36,36,0,0,16,20,6 ème
LOIRE,CHARLIEU,0420008F,0,0,0,0,0,0,6 ème
LOIRE,CHARLIEU,0421800D,95,95,0,0,57,38,6 ème
LOIRE,FEURS,0421057W,112,112,0,0,57,55,6 ème
LOIRE,LA GRAND-CROIX,0421086C,208,206,0,2,111,97,6 ème
LOIRE,LA RICAMARIE,0421689H,67,67,0,0,30,37,6 ème
LOIRE,LA TALAUDIERE,0421171V,226,223,0,3,117,109,6 ème
LOIRE,LE COTEAU,0421489R,0,0,0,0,0,0,6 ème
LOIRE,MABLY,0421852K,122,102,16,4,62,60,6 ème
LOIRE,MONTBRISON,0421032U,159,156,0,3,74,85,6 ème
LOIRE,RENAISON,0421735H,128,128,0,0,61,67,6 ème
LOIRE,RIVE-DE-GIER,0420029D,0,0,0,0,0,0,6 ème
LOIRE,RIVE-DE-GIER,0421014Z,156,156,0,0,77,79,6 ème
LOIRE,RIVE-DE-GIER,0421680Y,117,113,0,4,59,58,6 ème
LOIRE,ROANNE,0420076E,0,0,0,0,0,0,6 ème
LOIRE,ROANNE,0420978K,119,119,0,0,49,70,6 ème
LOIRE,SAINT-CHAMOND,0420078G,0,0,0,0,0,0,6 ème
LOIRE,SAINT-CHAMOND,0420996E,0,0,0,0,0,0,6 ème
LOIRE,SAINT-CHAMOND,0421799C,312,308,0,4,152,160,6 ème
LOIRE,SAINT-ETIENNE,0420916T,119,109,10,0,60,59,6 ème
LOIRE,SAINT-ETIENNE,0420958N,0,0,0,0,0,0,6 ème
LOIRE,SAINT-ETIENNE,0420991Z,0,0,0,0,0,0,6 ème
LOIRE,SAINT-ETIENNE,0421016B,63,63,0,0,31,32,6 ème
LOIRE,SAINT-ETIENNE,0421678W,245,245,0,0,121,124,6 ème
LOIRE,SAINT-ETIENNE,0421679X,141,139,0,2,76,65,6 ème
LOIRE,SAINT-HEAND,0421565Y,205,205,0,0,97,108,6 ème
LOIRE,SORBIERS,0421608V,0,0,0,0,0,0,6 ème
RHONE,AMPLEPUIS,0690001B,74,73,0,1,36,38,6 ème
RHONE,BRIGNAIS,0690008J,0,0,0,0,0,0,6 ème
RHONE,BRON,0690010L,0,0,0,0,0,0,6 ème
RHONE,CLAVEISOLLES,0690585L,12,12,0,0,4,8,6 ème
RHONE,CONDRIEU,0690015S,147,145,0,2,73,74,6 ème
RHONE,DARDILLY,0693504J,0,0,0,0,0,0,6 ème
RHONE,DECINES-CHARPIEU,0691495A,166,165,0,1,70,96,6 ème
RHONE,DECINES-CHARPIEU,0692800U,0,0,0,0,0,0,6 ème
RHONE,ECULLY,0690510E,187,182,0,5,96,91,6 ème
RHONE,FONTAINES-SUR-SAONE,0691736M,164,161,0,3,75,89,6 ème
RHONE,GIVORS,0690210D,102,102,0,0,49,53,6 ème
RHONE,LA MULATIERE,0692923C,130,130,0,0,53,77,6 ème
RHONE,LENTILLY,0693286X,189,187,0,2,94,95,6 ème
RHONE,LIMAS,0692420F,180,170,8,2,85,95,6 ème
RHONE,LYON,0692928H,187,187,0,0,97,90,6 ème
RHONE,LYON,0690053H,179,165,14,0,92,87,6 ème
RHONE,LYON,0690131T,111,109,0,2,60,51,6 ème
RHONE,LYON,0692411W,150,148,0,2,67,83,6 ème
RHONE,LYON,0692921A,430,426,0,4,207,223,6 ème
RHONE,LYON,0692936S,175,175,0,0,82,93,6 ème
RHONE,LYON,0693371P,0,0,0,0,0,0,6 ème
RHONE,LYON,0690046A,0,0,0,0,0,0,6 ème
RHONE,LYON,0692578C,137,134,0,3,72,65,6 ème
RHONE,LYON,0690092A,0,0,0,0,0,0,6 ème
RHONE,MEYZIEU,0692704P,146,143,0,3,80,66,6 ème
RHONE,RILLIEUX-LA-PAPE,0691626T,0,0,0,0,0,0,6 ème
RHONE,RILLIEUX-LA-PAPE,0691651V,152,148,0,4,63,89,6 ème
RHONE,SAINTE-FOY-L'ARGENTIERE,0690078K,112,110,0,2,55,57,6 ème
RHONE,SAINT-GENIS-LAVAL,0693287Y,72,72,0,0,33,39,6 ème
RHONE,SAINT-PRIEST,0693094N,0,0,0,0,0,0,6 ème
RHONE,SOUCIEU-EN-JARREST,0693046L,161,157,0,4,86,75,6 ème
RHONE,TARARE,0690085T,0,0,0,0,0,0,6 ème
RHONE,VAULX-EN-VELIN,0693045K,0,0,0,0,0,0,6 ème
RHONE,VENISSIEUX,0690094C,187,183,0,4,85,102,6 ème
RHONE,VENISSIEUX,0691480J,175,171,0,4,78,97,6 ème
RHONE,VENISSIEUX,0691730F,194,192,0,2,95,99,6 ème
RHONE,VENISSIEUX,0692343X,172,154,16,2,85,87,6 ème
RHONE,VILLEURBANNE,0690103M,0,0,0,0,0,0,6 ème
RHONE,VILLEURBANNE,0690109U,0,0,0,0,0,0,6 ème
RHONE,VILLEURBANNE,0690280E,130,129,0,1,62,68,6 ème
RHONE,VILLEURBANNE,0692390Y,10,8,0,2,3,7,6 ème
RHONE,VILLEURBANNE,0694497N,145,145,0,0,61,84,6 ème
DOUBS,BESANCON,0251573Z,234,233,0,1,117,117,6 ème
DOUBS,BETHONCOURT,0251209D,73,73,0,0,30,43,6 ème
DOUBS,CHATILLON-LE-DUC,0251857H,149,148,0,1,75,74,6 ème
DOUBS,LES FONTENELLES,0251064W,15,15,0,0,4,11,6 ème
DOUBS,MONTBELIARD,0250035C,107,104,0,3,48,59,6 ème
DOUBS,MONTBELIARD,0251057N,129,129,0,0,68,61,6 ème
DOUBS,MORTEAU,0251067Z,107,107,0,0,54,53,6 ème
DOUBS,PAYS-DE-CLERVAL,0250016G,39,39,0,0,16,23,6 ème
DOUBS,POUILLEY-LES-VIGNES,0251673H,167,156,0,11,77,90,6 ème
DOUBS,VOUJEAUCOURT,0251130T,179,159,16,4,89,90,6 ème
HAUTE-SAONE,FAVERNEY,0700006B,79,75,0,4,46,33,6 ème
HAUTE-SAONE,HERICOURT,0700063N,89,89,0,0,43,46,6 ème
HAUTE-SAONE,LURE,0700065R,69,69,0,0,31,38,6 ème
HAUTE-SAONE,SCEY-SUR-SAONE-ET-SAINT-ALBIN,0700894S,124,121,0,3,63,61,6 ème
JURA,CHAMPAGNOLE,0390075V,61,61,0,0,33,28,6 ème
JURA,CROTENAY,0390055Y,5,0,5,0,2,3,6 ème
JURA,HAUTS DE BIENNE,0390028U,82,76,5,1,33,49,6 ème
JURA,HAUTS DE BIENNE,0390081B,49,49,0,0,18,31,6 ème
JURA,LONS-LE-SAUNIER,0391003D,63,63,0,0,29,34,6 ème
JURA,MOIRANS-EN-MONTAGNE,0390024P,0,0,0,0,0,0,6 ème
JURA,POLIGNY,0390072S,19,19,0,0,5,14,6 ème
JURA,POLIGNY,0390798F,124,107,12,5,56,68,6 ème
JURA,SAINT-LAURENT-EN-GRANDVAUX,0390916J,71,67,0,4,35,36,6 ème
TERRITOIRE DE BELFORT,BELFORT,0900006T,154,152,0,2,77,77,6 ème
TERRITOIRE DE BELFORT,BELFORT,0900425Y,0,0,0,0,0,0,6 ème
TERRITOIRE DE BELFORT,GIROMAGNY,0900009W,97,95,0,2,47,50,6 ème
COTE D'OR,AUXONNE,0211452P,166,147,15,4,84,82,6 ème
COTE D'OR,BEAUNE,0211230Y,147,131,12,4,69,78,6 ème
COTE D'OR,BRAZEY-EN-PLAINE,0211756V,125,109,16,0,56,69,6 ème
COTE D'OR,CHENOVE,0211096C,83,83,0,0,38,45,6 ème
COTE D'OR,CHENOVE,0211356K,0,0,0,0,0,0,6 ème
COTE D'OR,DIJON,0211151M,237,235,0,2,129,108,6 ème
COTE D'OR,DIJON,0211526V,104,104,0,0,50,54,6 ème
COTE D'OR,FONTAINE-FRANCAISE,0210027R,42,42,0,0,31,11,6 ème
COTE D'OR,IS-SUR-TILLE,0210029T,166,148,15,3,67,99,6 ème
COTE D'OR,LAIGNES,0210030U,13,13,0,0,7,6,6 ème
COTE D'OR,POUILLY-EN-AUXOIS,0210041F,62,62,0,0,29,33,6 ème
COTE D'OR,SELONGEY,0211557D,57,57,0,0,26,31,6 ème
COTE D'OR,SEMUR-EN-AUXOIS,0211527W,132,110,16,6,61,71,6 ème
NIEVRE,COSNE-COURS-SUR-LOIRE,0580014A,0,0,0,0,0,0,6 ème
NIEVRE,COSNE-COURS-SUR-LOIRE,0580066G,72,72,0,0,31,41,6 ème
NIEVRE,DECIZE,0580017D,95,71,16,8,46,49,6 ème
NIEVRE,DECIZE,0580761M,0,0,0,0,0,0,6 ème
NIEVRE,DONZY,0580018E,47,47,0,0,24,23,6 ème
NIEVRE,LORMES,0580026N,19,19,0,0,7,12,6 ème
NIEVRE,NEVERS,0580061B,155,153,0,2,74,81,6 ème
NIEVRE,POUILLY-SUR-LOIRE,0580035Y,40,40,0,0,17,23,6 ème
NIEVRE,SAINT-AMAND-EN-PUISAYE,0580037A,29,29,0,0,14,15,6 ème
NIEVRE,VARZY,0581009G,37,29,7,1,22,15,6 ème
SAONE-ET-LOIRE,AUTUN,0711350G,80,75,0,5,36,44,6 ème
SAONE-ET-LOIRE,BLANZY,0711384U,0,0,0,0,0,0,6 ème
SAONE-ET-LOIRE,CHALON-SUR-SAONE,0710106E,233,232,0,1,101,132,6 ème
SAONE-ET-LOIRE,CHALON-SUR-SAONE,0710537Y,80,76,0,4,42,38,6 ème
SAONE-ET-LOIRE,CHALON-SUR-SAONE,0711448N,144,144,0,0,80,64,6 ème
SAONE-ET-LOIRE,CHARNAY-LES-MACON,0711050F,12,0,12,0,3,9,6 ème
SAONE-ET-LOIRE,CUISERY,0710034B,124,124,0,0,74,50,6 ème
SAONE-ET-LOIRE,ETANG-SUR-ARROUX,0710038F,54,54,0,0,20,34,6 ème
SAONE-ET-LOIRE,LA CLAYETTE,0710022N,50,50,0,0,29,21,6 ème
SAONE-ET-LOIRE,LOUHANS,0711925G,3,3,0,0,1,2,6 ème
SAONE-ET-LOIRE,MACON,0710110J,179,179,0,0,88,91,6 ème
SAONE-ET-LOIRE,MACON,0711052H,196,195,0,1,95,101,6 ème
SAONE-ET-LOIRE,MACON,0711053J,133,133,0,0,66,67,6 ème
SAONE-ET-LOIRE,SAINT-GERMAIN-DU-PLAIN,0710067M,149,145,0,4,74,75,6 ème
SAONE-ET-LOIRE,SAINT-MARTIN-EN-BRESSE,0711451S,82,78,0,4,38,44,6 ème
SAONE-ET-LOIRE,SAINT-VALLIER,0711296Y,143,143,0,0,59,84,6 ème
SAONE-ET-LOIRE,SENNECEY-LE-GRAND,0710070R,85,85,0,0,42,43,6 ème
YONNE,AVALLON,0890009B,65,60,0,5,33,32,6 ème
YONNE,AVALLON,0891053L,46,46,0,0,16,30,6 ème
YONNE,CHARNY OREE DE PUISAYE,0890014G,49,49,0,0,27,22,6 ème
YONNE,SAINT-FARGEAU,0890022R,101,97,0,4,55,46,6 ème
YONNE,SAINT-GEORGES-SUR-BAULCHE,0891043A,184,181,0,3,91,93,6 ème
YONNE,SENS,0890053Z,0,0,0,0,0,0,6 ème
YONNE,SENS,0890067P,0,0,0,0,0,0,6 ème
YONNE,TOUCY,0890035E,111,99,12,0,59,52,6 ème
COTES D'ARMOR,BROONS,0221127F,131,130,0,1,64,67,6 ème
COTES D'ARMOR,CHATELAUDREN-PLOUAGAT,0220006M,177,170,0,7,84,93,6 ème
COTES D'ARMOR,GUERLEDAN,0220032R,54,54,0,0,32,22,6 ème
COTES D'ARMOR,GUINGAMP,0220098M,155,151,0,4,75,80,6 ème
COTES D'ARMOR,LANNION,0220082V,126,114,12,0,64,62,6 ème
COTES D'ARMOR,LANVOLLON,0220144M,67,67,0,0,32,35,6 ème
COTES D'ARMOR,LOUDEAC,0221509W,178,150,26,2,90,88,6 ème
COTES D'ARMOR,LOUDEAC,0221747E,89,88,0,1,37,52,6 ème
COTES D'ARMOR,MATIGNON,0220029M,63,63,0,0,26,37,6 ème
COTES D'ARMOR,PLEMET,0221037H,60,59,0,1,31,29,6 ème
COTES D'ARMOR,PLESTIN-LES-GREVES,0221541F,68,68,0,0,30,38,6 ème
COTES D'ARMOR,PLOEUC-L'HERMITAGE,0220157B,46,46,0,0,20,26,6 ème
COTES D'ARMOR,PLOEUC-L'HERMITAGE,0221568K,78,75,0,3,42,36,6 ème
COTES D'ARMOR,PLOUARET,0220045E,54,54,0,0,32,22,6 ème
COTES D'ARMOR,PONTRIEUX,0221542G,55,53,0,2,29,26,6 ème
COTES D'ARMOR,SAINT-BRIEUC,0220117H,0,0,0,0,0,0,6 ème
COTES D'ARMOR,SAINT-BRIEUC,0221999D,45,41,0,4,17,28,6 ème
FINISTERE,BREST,0290243G,95,92,0,3,50,45,6 ème
FINISTERE,BREST,0291089B,93,73,16,4,41,52,6 ème
FINISTERE,BREST,0291103S,22,22,0,0,13,9,6 ème
FINISTERE,BREST,0291595B,124,124,0,0,64,60,6 ème
FINISTERE,BREST,0291866W,47,47,0,0,24,23,6 ème
FINISTERE,BRIEC,0290019N,148,148,0,0,81,67,6 ème
FINISTERE,CHATEAULIN,0291590W,110,107,0,3,53,57,6 ème
FINISTERE,CHATEAULIN,0291872C,101,98,0,3,53,48,6 ème
FINISTERE,CHATEAUNEUF-DU-FAOU,0292006Y,72,71,0,1,34,38,6 ème
FINISTERE,GUILERS,0291716H,90,90,0,0,45,45,6 ème
FINISTERE,GUILVINEC,0291631R,57,57,0,0,31,26,6 ème
FINISTERE,MORLAIX,0290105G,0,0,0,0,0,0,6 ème
FINISTERE,MORLAIX,0290163V,61,61,0,0,30,31,6 ème
FINISTERE,PLEYBEN,0290288F,25,25,0,0,9,16,6 ème
FINISTERE,PLOUGASTEL-DAOULAS,0290297R,115,115,0,0,56,59,6 ème
FINISTERE,PONT-L'ABBE,0290064M,212,196,16,0,103,109,6 ème
FINISTERE,PONT-L'ABBE,0291877H,115,112,0,3,52,63,6 ème
FINISTERE,QUIMPER,0291878J,165,163,0,2,80,85,6 ème
FINISTERE,QUIMPER,0291880L,210,192,16,2,108,102,6 ème
FINISTERE,QUIMPERLE,0290078C,0,0,0,0,0,0,6 ème
FINISTERE,QUIMPERLE,0290307B,16,16,0,0,6,10,6 ème
FINISTERE,QUIMPERLE,0291635V,132,115,16,1,63,69,6 ème
FINISTERE,QUIMPERLE,0291881M,141,141,0,0,61,80,6 ème
FINISTERE,SAINT-RENAN,0290314J,213,210,0,3,101,112,6 ème
FINISTERE,SAINT-THEGONNEC LOC-EGUINER,0290316L,43,43,0,0,18,25,6 ème
ILLE-ET-VILAINE,FOUGERES,0350762N,136,136,0,0,54,82,6 ème
ILLE-ET-VILAINE,REDON,0350732F,5,0,5,0,2,3,6 ème
ILLE-ET-VILAINE,REDON,0350969N,109,96,13,0,52,57,6 ème
ILLE-ET-VILAINE,RENNES,0350033W,125,120,0,5,56,69,6 ème
ILLE-ET-VILAINE,RENNES,0350747X,13,0,13,0,6,7,6 ème
ILLE-ET-VILAINE,RENNES,0350895H,138,123,15,0,71,67,6 ème
ILLE-ET-VILAINE,RENNES,0351796M,133,133,0,0,58,75,6 ème
ILLE-ET-VILAINE,RENNES,0351851X,156,141,14,1,75,81,6 ème
ILLE-ET-VILAINE,RENNES,0352070K,202,201,0,1,113,89,6 ème
ILLE-ET-VILAINE,SAINT-GEORGES-DE-REINTEMBAULT,0350041E,32,32,0,0,13,19,6 ème
ILLE-ET-VILAINE,SAINT-GREGOIRE,0350780H,234,231,0,3,124,110,6 ème
ILLE-ET-VILAINE,SAINT-MALO,0350773A,115,113,0,2,61,54,6 ème
ILLE-ET-VILAINE,SAINT-MALO,0350896J,103,102,0,1,52,51,6 ème
ILLE-ET-VILAINE,SAINT-MEEN-LE-GRAND,0350887Z,67,67,0,0,35,32,6 ème
ILLE-ET-VILAINE,SAINT-MEEN-LE-GRAND,0351850W,81,81,0,0,45,36,6 ème
ILLE-ET-VILAINE,TINTENIAC,0350051R,138,136,0,2,72,66,6 ème
ILLE-ET-VILAINE,VAL-COUESNON,0350052S,31,31,0,0,19,12,6 ème
ILLE-ET-VILAINE,VITRE,0350892E,118,117,0,1,57,61,6 ème
ILLE-ET-VILAINE,VITRE,0351785A,270,270,0,0,112,158,6 ème
MORBIHAN,ARRADON,0560122D,57,57,0,0,29,28,6 ème
MORBIHAN,GRAND-CHAMP,0560132P,130,130,0,0,57,73,6 ème
MORBIHAN,GUEMENE-SUR-SCORFF,0561358X,122,117,5,0,70,52,6 ème
MORBIHAN,HENNEBONT,0560214D,141,123,16,2,68,73,6 ème
MORBIHAN,LANESTER,0560215E,87,73,14,0,38,49,6 ème
MORBIHAN,LA ROCHE-BERNARD,0560169E,176,176,0,0,92,84,6 ème
MORBIHAN,LE FAOUET,0560158T,38,38,0,0,16,22,6 ème
MORBIHAN,LOCMINE,0561377T,148,148,0,0,82,66,6 ème
MORBIHAN,LORIENT,0560181T,0,0,0,0,0,0,6 ème
MORBIHAN,MALESTROIT,0560150J,155,155,0,0,73,82,6 ème
MORBIHAN,PLOERMEL,0560105K,0,0,0,0,0,0,6 ème
MORBIHAN,QUESTEMBERT,0560166B,135,125,3,7,66,69,6 ème
MORBIHAN,ROHAN,0560171G,91,91,0,0,54,37,6 ème
MORBIHAN,SAINT-JEAN-BREVELAY,0560063P,43,43,0,0,17,26,6 ème
MORBIHAN,SAINT-JEAN-BREVELAY,0560172H,97,97,0,0,42,55,6 ème
MORBIHAN,THEIX-NOYALO,0561940E,125,125,0,0,72,53,6 ème
MORBIHAN,VANNES,0560223N,116,105,11,0,59,57,6 ème
MORBIHAN,VANNES,0561544Z,208,208,0,0,88,120,6 ème
CHER,BOURGES,0180568V,21,20,0,1,7,14,6 ème
CHER,BOURGES,0180571Y,0,0,0,0,0,0,6 ème
CHER,BOURGES,0180721L,148,148,0,0,69,79,6 ème
CHER,HENRICHEMONT,0180019Y,88,84,0,4,45,43,6 ème
CHER,LIGNIERES,0180020Z,53,53,0,0,26,27,6 ème
CHER,SAINT-DOULCHARD,0180643B,167,163,0,4,88,79,6 ème
CHER,VIERZON,0180037T,123,121,0,2,55,68,6 ème
EURE-ET-LOIR,CHATEAUDUN,0280679L,58,58,0,0,28,30,6 ème
EURE-ET-LOIR,CHATEAUDUN,0280957N,86,86,0,0,50,36,6 ème
EURE-ET-LOIR,JANVILLE-EN-BEAUCE,0280680M,90,90,0,0,46,44,6 ème
EURE-ET-LOIR,LA LOUPE,0280869T,129,120,9,0,58,71,6 ème
EURE-ET-LOIR,LUCE,0280803W,119,116,0,3,61,58,6 ème
EURE-ET-LOIR,MAINVILLIERS,0280034K,109,106,0,3,54,55,6 ème
EURE-ET-LOIR,NOGENT-LE-ROTROU,0280903E,95,84,9,2,45,50,6 ème
EURE-ET-LOIR,NOGENT-LE-ROTROU,0281021H,0,0,0,0,0,0,6 ème
INDRE,ARDENTES,0360573C,70,70,0,0,32,38,6 ème
INDRE,CHATEAUROUX,0360050J,12,0,12,0,4,8,6 ème
INDRE,CHATEAUROUX,0360690E,108,105,0,3,64,44,6 ème
INDRE,ISSOUDUN,0360544W,101,98,0,3,49,52,6 ème
INDRE,SAINT-BENOIT-DU-SAULT,0360033R,43,43,0,0,28,15,6 ème
INDRE,SAINTE-SEVERE-SUR-INDRE,0360037V,26,26,0,0,14,12,6 ème
INDRE,TOURNON-SAINT-MARTIN,0360038W,27,27,0,0,11,16,6 ème
INDRE-ET-LOIRE,AVOINE,0370994E,126,123,0,3,63,63,6 ème
INDRE-ET-LOIRE,BALLAN-MIRE,0371403Z,132,132,0,0,62,70,6 ème
INDRE-ET-LOIRE,CHINON,0371100V,0,0,0,0,0,0,6 ème
INDRE-ET-LOIRE,JOUE-LES-TOURS,0370740D,189,189,0,0,89,100,6 ème
INDRE-ET-LOIRE,JOUE-LES-TOURS,0370791J,58,54,0,4,33,25,6 ème
INDRE-ET-LOIRE,JOUE-LES-TOURS,0370888P,0,0,0,0,0,0,6 ème
INDRE-ET-LOIRE,MONTBAZON,0370793L,170,167,0,3,86,84,6 ème
INDRE-ET-LOIRE,MONTLOUIS-SUR-LOIRE,0370799T,186,184,0,2,77,109,6 ème
INDRE-ET-LOIRE,MONTS,0370993D,159,159,0,0,80,79,6 ème
INDRE-ET-LOIRE,RICHELIEU,0370739C,51,51,0,0,19,32,6 ème
INDRE-ET-LOIRE,SAVIGNE-SUR-LATHAN,0370034L,78,78,0,0,34,44,6 ème
INDRE-ET-LOIRE,TOURS,0370033K,114,97,16,1,60,54,6 ème
INDRE-ET-LOIRE,TOURS,0370039S,46,46,0,0,35,11,6 ème
INDRE-ET-LOIRE,TOURS,0370886M,127,126,0,1,61,66,6 ème
INDRE-ET-LOIRE,TOURS,0371327S,144,144,0,0,69,75,6 ème
LOIRET,BEAUGENCY,0450759F,0,0,0,0,0,0,6 ème
LOIRET,BRIARE,0450008P,107,99,4,4,55,52,6 ème
LOIRET,CHALETTE-SUR-LOING,0450840U,169,153,15,1,79,90,6 ème
LOIRET,CHALETTE-SUR-LOING,0451442Y,0,0,0,0,0,0,6 ème
LOIRET,FLEURY-LES-AUBRAIS,0451544J,149,149,0,0,75,74,6 ème
LOIRET,GIEN,0451331C,83,83,0,0,40,43,6 ème
LOIRET,INGRE,0451068S,216,215,0,1,113,103,6 ème
LOIRET,MEUNG-SUR-LOIRE,0451735S,45,45,0,0,21,24,6 ème
LOIRET,MONTARGIS,0450789N,86,84,0,2,38,48,6 ème
LOIRET,OLIVET,0450118J,155,155,0,0,83,72,6 ème
LOIRET,OLIVET,0451499K,137,136,0,1,66,71,6 ème
LOIRET,ORLEANS,0450758E,0,0,0,0,0,0,6 ème
LOIRET,ORLEANS,0451333E,124,124,0,0,68,56,6 ème
LOIRET,POILLY-LEZ-GIEN,0451286D,118,97,16,5,55,63,6 ème
LOIRET,SAINT-JEAN-DE-BRAYE,0451072W,203,185,15,3,95,108,6 ème
LOIRET,SAINT-JEAN-DE-LA-RUELLE,0450066C,0,0,0,0,0,0,6 ème
LOIRET,SAINT-JEAN-DE-LA-RUELLE,0450069F,126,115,0,11,63,63,6 ème
LOIR-ET-CHER,BEAUCE LA ROMAINE,0410016V,102,99,0,3,53,49,6 ème
LOIR-ET-CHER,BLOIS,0410832G,0,0,0,0,0,0,6 ème
LOIR-ET-CHER,MER,0410631N,111,107,0,4,48,63,6 ème
LOIR-ET-CHER,MONTRICHARD VAL DE CHER,0410632P,106,101,0,5,52,54,6 ème
LOIR-ET-CHER,MOREE,0410013S,92,87,0,5,41,51,6 ème
LOIR-ET-CHER,ROMORANTIN-LANTHENAY,0410684W,79,79,0,0,34,45,6 ème
LOIR-ET-CHER,SAINT-AMAND-LONGPRE,0410024D,79,75,0,4,41,38,6 ème
LOIR-ET-CHER,VEUZAIN-SUR-LOIRE,0410716F,125,122,0,3,63,62,6 ème
LOIR-ET-CHER,VINEUIL,0410715E,192,189,0,3,104,88,6 ème
CORSE-DU-SUD,PORTO-VECCHIO,6200040Z,160,160,0,0,73,87,6 ème
CORSE-DU-SUD,PROPRIANO,6200041A,70,64,5,1,36,34,6 ème
CORSE-DU-SUD,SANTA-MARIA-SICHE,6200045E,42,42,0,0,15,27,6 ème
CORSE-DU-SUD,SARTENE,6200055R,26,26,0,0,15,11,6 ème
HAUTE-CORSE,BASTIA,7200013B,181,169,11,1,95,86,6 ème
HAUTE-CORSE,LURI,7200027S,24,24,0,0,15,9,6 ème
HAUTE-CORSE,MOLTIFAO,7200028T,29,29,0,0,18,11,6 ème
HAUTE-CORSE,PRUNELLI-DI-FIUMORBO,7200086F,200,193,4,3,109,91,6 ème
MEURTHE-ET-MOSELLE,AUDUN-LE-ROMAN,0541470E,71,71,0,0,39,32,6 ème
MEURTHE-ET-MOSELLE,BLAINVILLE-SUR-L'EAU,0540005M,116,101,13,2,48,68,6 ème
MEURTHE-ET-MOSELLE,DOMBASLE-SUR-MEURTHE,0541325X,94,94,0,0,38,56,6 ème
MEURTHE-ET-MOSELLE,ESSEY-LES-NANCY,0541211Y,144,144,0,0,73,71,6 ème
MEURTHE-ET-MOSELLE,LAXOU,0540047H,84,80,0,4,51,33,6 ème
MEURTHE-ET-MOSELLE,LAXOU,0541469D,66,64,0,2,36,30,6 ème
MEURTHE-ET-MOSELLE,LONGWY,0541334G,99,95,0,4,59,40,6 ème
MEURTHE-ET-MOSELLE,LUNEVILLE,0541329B,118,95,19,4,55,63,6 ème
MEURTHE-ET-MOSELLE,LUNEVILLE,0542293Z,0,0,0,0,0,0,6 ème
MEURTHE-ET-MOSELLE,MONT-SAINT-MARTIN,0540088C,58,58,0,0,33,25,6 ème
MEURTHE-ET-MOSELLE,NANCY,0541339M,148,148,0,0,56,92,6 ème
MEURTHE-ET-MOSELLE,NANCY,0541568L,80,80,0,0,35,45,6 ème
MEURTHE-ET-MOSELLE,NANCY,0541778P,109,108,0,1,56,53,6 ème
MEURTHE-ET-MOSELLE,NANCY,0541994Z,62,62,0,0,28,34,6 ème
MEURTHE-ET-MOSELLE,POMPEY,0540085Z,0,0,0,0,0,0,6 ème
MEURTHE-ET-MOSELLE,PONT-SAINT-VINCENT,0540060X,0,0,0,0,0,0,6 ème
MEURTHE-ET-MOSELLE,PULNOY,0541956H,143,139,0,4,68,75,6 ème
MEURTHE-ET-MOSELLE,THIAUCOURT-REGNIEVILLE,0540064B,53,53,0,0,29,24,6 ème
MEURTHE-ET-MOSELLE,TOMBLAINE,0541569M,162,162,0,0,76,86,6 ème
MEURTHE-ET-MOSELLE,VAL DE BRIEY,0540008R,81,81,0,0,45,36,6 ème
MEUSE,BAR-LE-DUC,0550890U,84,78,0,6,45,39,6 ème
MEUSE,BOULIGNY,0550006H,52,52,0,0,24,28,6 ème
MEUSE,DAMVILLERS,0550009L,48,48,0,0,23,25,6 ème
MEUSE,ETAIN,0550011N,117,114,0,3,59,58,6 ème
MEUSE,FRESNES-EN-WOEVRE,0550012P,81,76,0,5,33,48,6 ème
MEUSE,GONDRECOURT-LE-CHATEAU,0550013R,42,42,0,0,16,26,6 ème
MEUSE,LIGNY-EN-BARROIS,0550014S,110,95,0,15,51,59,6 ème
MEUSE,VAUBECOURT,0550022A,43,43,0,0,19,24,6 ème
MEUSE,VERDUN,0550891V,0,0,0,0,0,0,6 ème
MOSELLE,ALGRANGE,0572169Y,70,70,0,0,36,34,6 ème
MOSELLE,ARS-SUR-MOSELLE,0572015F,109,107,0,2,53,56,6 ème
MOSELLE,BITCHE,0573361U,127,118,7,2,65,62,6 ème
MOSELLE,BOULAY-MOSELLE,0570010B,167,159,7,1,88,79,6 ème
MOSELLE,BOUZONVILLE,0570248K,0,0,0,0,0,0,6 ème
MOSELLE,COCHEREN,0572490X,108,106,0,2,55,53,6 ème
MOSELLE,CREUTZWALD,0572690P,121,111,6,4,59,62,6 ème
MOSELLE,FAULQUEMONT,0570026U,101,101,0,0,51,50,6 ème
MOSELLE,FORBACH,0572813Y,124,116,0,8,55,69,6 ème
MOSELLE,HOMBOURG-HAUT,0572491Y,58,58,0,0,30,28,6 ème
MOSELLE,L'HOPITAL,0572487U,93,93,0,0,46,47,6 ème
MOSELLE,MARANGE-SILVANGE,0572586B,120,120,0,0,65,55,6 ème
MOSELLE,METZ,0570055A,84,80,0,4,42,42,6 ème
MOSELLE,METZ,0570124A,0,0,0,0,0,0,6 ème
MOSELLE,METZ,0572640K,83,83,0,0,27,56,6 ème
MOSELLE,METZ,0572923T,116,116,0,0,60,56,6 ème
MOSELLE,MONTIGNY-LES-METZ,0572927X,238,238,0,0,123,115,6 ème
MOSELLE,MOUSSEY,0570074W,38,38,0,0,12,26,6 ème
MOSELLE,MOYEUVRE-GRANDE,0572017H,75,72,2,1,36,39,6 ème
MOSELLE,PHALSBOURG,0572929Z,93,93,0,0,42,51,6 ème
MOSELLE,ROHRBACH-LES-BITCHE,0572496D,126,122,0,4,63,63,6 ème
MOSELLE,ROMBAS,0570146Z,0,0,0,0,0,0,6 ème
MOSELLE,SAINT-AVOLD,0570223H,59,59,0,0,31,28,6 ème
MOSELLE,SAINTE-MARIE-AUX-CHENES,0570091P,167,164,0,3,87,80,6 ème
MOSELLE,SARREBOURG,0570095U,0,0,0,0,0,0,6 ème
MOSELLE,SARREGUEMINES,0570099Y,0,0,0,0,0,0,6 ème
MOSELLE,SIERCK-LES-BAINS,0572026T,142,142,0,0,66,76,6 ème
MOSELLE,THIONVILLE,0572355A,98,82,10,6,41,57,6 ème
MOSELLE,THIONVILLE,0572932C,295,295,0,0,150,145,6 ème
MOSELLE,VIGY,0572354Z,97,97,0,0,47,50,6 ème
MOSELLE,YUTZ,0570115R,211,209,0,2,91,120,6 ème
VOSGES,CHATENOIS,0880011J,60,60,0,0,33,27,6 ème
VOSGES,CONTREXEVILLE,0880013L,0,0,0,0,0,0,6 ème
VOSGES,CORCIEUX,0880014M,46,45,0,1,21,25,6 ème
VOSGES,CORNIMONT,0881397R,75,75,0,0,39,36,6 ème
VOSGES,EPINAL,0881530K,0,0,0,0,0,0,6 ème
VOSGES,GERARDMER,0881446U,118,118,0,0,63,55,6 ème
VOSGES,MIRECOURT,0880035K,126,121,0,5,65,61,6 ème
VOSGES,NEUFCHATEAU,0880041S,126,117,2,7,59,67,6 ème
VOSGES,NEUFCHATEAU,0880112U,20,20,0,0,9,11,6 ème
VOSGES,REMIREMONT,0880096B,44,41,0,3,20,24,6 ème
VOSGES,REMIREMONT,0880155R,105,102,0,3,60,45,6 ème
VOSGES,SAINT-DIE-DES-VOSGES,0880098D,90,90,0,0,49,41,6 ème
VOSGES,SAINT-DIE-DES-VOSGES,0881099S,111,108,0,3,50,61,6 ème
ARDENNES,ATTIGNY,0081100C,76,76,0,0,37,39,6 ème
ARDENNES,CHARLEVILLE-MEZIERES,0080894D,89,75,14,0,45,44,6 ème
ARDENNES,CHARLEVILLE-MEZIERES,0080954U,77,77,0,0,40,37,6 ème
ARDENNES,MONTHERME,0080827F,51,51,0,0,25,26,6 ème
ARDENNES,NOUVION-SUR-MEUSE,0080896F,96,93,0,3,56,40,6 ème
ARDENNES,RETHEL,0080039Z,0,0,0,0,0,0,6 ème
ARDENNES,REVIN,0080040A,0,0,0,0,0,0,6 ème
ARDENNES,SEDAN,0080046G,67,65,0,2,29,38,6 ème
ARDENNES,SEDAN,0080047H,0,0,0,0,0,0,6 ème
ARDENNES,SIGNY-LE-PETIT,0081105H,65,65,0,0,25,40,6 ème
ARDENNES,VILLERS-SEMEUSE,0081001V,76,75,0,1,33,43,6 ème
ARDENNES,VOUZIERS,0080089D,43,43,0,0,24,19,6 ème
AUBE,ARCIS-SUR-AUBE,0100665U,142,142,0,0,72,70,6 ème
AUBE,BAR-SUR-AUBE,0100003Z,0,0,0,0,0,0,6 ème
AUBE,CHAOURCE,0100008E,47,47,0,0,23,24,6 ème
AUBE,ERVY-LE-CHATEL,0100010G,57,57,0,0,28,29,6 ème
AUBE,LA CHAPELLE-SAINT-LUC,0100807Y,155,136,15,4,58,97,6 ème
AUBE,TROYES,0100078F,0,0,0,0,0,0,6 ème
AUBE,TROYES,0100962S,123,123,0,0,51,72,6 ème
AUBE,VENDEUVRE-SUR-BARSE,0100028B,60,60,0,0,30,30,6 ème
HAUTE-MARNE,BOURMONT-ENTRE-MEUSE-ET-MOUZON,0520004X,44,44,0,0,25,19,6 ème
HAUTE-MARNE,FAYL-BILLOT,0520017L,44,44,0,0,13,31,6 ème
HAUTE-MARNE,LE MONTSAUGEONNAIS,0520026W,61,61,0,0,30,31,6 ème
HAUTE-MARNE,NOGENT,0520025V,81,80,0,1,32,49,6 ème
HAUTE-MARNE,SAINT-DIZIER,0520029Z,0,0,0,0,0,0,6 ème
HAUTE-MARNE,SAINT-DIZIER,0520049W,105,88,15,2,49,56,6 ème
HAUTE-MARNE,WASSY,0520709N,7,0,7,0,2,5,6 ème
MARNE,AVIZE,0510002A,95,95,0,0,42,53,6 ème
MARNE,AY-CHAMPAGNE,0511432E,116,116,0,0,56,60,6 ème
MARNE,CHALONS-EN-CHAMPAGNE,0510007F,0,0,0,0,0,0,6 ème
MARNE,CORMONTREUIL,0511961E,142,142,0,0,66,76,6 ème
MARNE,EPERNAY,0510016R,115,115,0,0,54,61,6 ème
MARNE,EPERNAY,0511173Y,144,144,0,0,72,72,6 ème
MARNE,EPERNAY,0511189R,116,106,8,2,56,60,6 ème
MARNE,FRIGNICOURT,0511474A,93,93,0,0,45,48,6 ème
MARNE,MAREUIL-LE-PORT,0510028D,74,74,0,0,26,48,6 ème
MARNE,MOURMELON-LE-GRAND,0510029E,125,120,5,0,66,59,6 ème
MARNE,REIMS,0510037N,0,0,0,0,0,0,6 ème
MARNE,REIMS,0510044W,111,109,0,2,50,61,6 ème
MARNE,REIMS,0511085C,169,165,0,4,89,80,6 ème
MARNE,REIMS,0511108C,131,112,15,4,61,70,6 ème
MARNE,REIMS,0511139L,160,160,0,0,65,95,6 ème
MARNE,REIMS,0511531M,112,112,0,0,61,51,6 ème
MARNE,SAINTE-MENEHOULD,0511191T,114,104,4,6,55,59,6 ème
MARNE,VITRY-LE-FRANCOIS,0511476C,127,125,0,2,63,64,6 ème
BAS-RHIN,BARR,0672133E,118,118,0,0,68,50,6 ème
BAS-RHIN,BRUMATH,0670009W,174,173,0,1,75,99,6 ème
BAS-RHIN,DETTWILLER,0672197Z,70,70,0,0,28,42,6 ème
BAS-RHIN,ECKBOLSHEIM,0670016D,114,114,0,0,57,57,6 ème
BAS-RHIN,LINGOLSHEIM,0672765S,140,138,0,2,76,64,6 ème
BAS-RHIN,MARCKOLSHEIM,0671600A,132,129,0,3,78,54,6 ème
BAS-RHIN,MUNDOLSHEIM,0672013Z,161,154,7,0,68,93,6 ème
BAS-RHIN,OBERNAI,0672078V,138,129,9,0,66,72,6 ème
BAS-RHIN,SARRE-UNION,0672614C,0,0,0,0,0,0,6 ème
BAS-RHIN,SAVERNE,0670058Z,0,0,0,0,0,0,6 ème
BAS-RHIN,SCHILTIGHEIM,0670065G,118,118,0,0,58,60,6 ème
BAS-RHIN,SELESTAT,0671696E,0,0,0,0,0,0,6 ème
BAS-RHIN,SELTZ,0671597X,114,102,10,2,55,59,6 ème
BAS-RHIN,STRASBOURG,0670105A,140,131,7,2,66,74,6 ème
BAS-RHIN,STRASBOURG,0671608J,295,295,0,0,166,129,6 ème
BAS-RHIN,STRASBOURG,0671691Z,140,121,16,3,71,69,6 ème
BAS-RHIN,STRASBOURG,0672303P,93,93,0,0,36,57,6 ème
BAS-RHIN,WISSEMBOURG,0670114K,0,0,0,0,0,0,6 ème
HAUT-RHIN,CERNAY,0681810Y,0,0,0,0,0,0,6 ème
HAUT-RHIN,COLMAR,0680132Z,130,128,0,2,72,58,6 ème
HAUT-RHIN,DANNEMARIE,0680012U,95,92,0,3,51,44,6 ème
HAUT-RHIN,FESSENHEIM,0681965S,120,120,0,0,62,58,6 ème
HAUT-RHIN,GUEBWILLER,0680016Y,0,0,0,0,0,0,6 ème
HAUT-RHIN,ILLFURTH,0681932F,90,90,0,0,53,37,6 ème
HAUT-RHIN,MASEVAUX-NIEDERBRUCK,0680027K,0,0,0,0,0,0,6 ème
HAUT-RHIN,MULHOUSE,0681661L,175,175,0,0,98,77,6 ème
HAUT-RHIN,OTTMARSHEIM,0680056S,111,111,0,0,57,54,6 ème
HAUT-RHIN,RIBEAUVILLE,0680137E,24,24,0,0,8,16,6 ème
HAUT-RHIN,SAINT-LOUIS,0680065B,115,113,0,2,54,61,6 ème
HAUT-RHIN,ZILLISHEIM,0681663N,196,196,0,0,114,82,6 ème
GUADELOUPE,BOUILLANTE,9710026B,60,48,10,2,30,30,6 ème
GUADELOUPE,CAPESTERRE-BELLE-EAU,9711231L,86,84,0,2,51,35,6 ème
GUADELOUPE,GOYAVE,9710644Y,62,62,0,0,33,29,6 ème
GUADELOUPE,LA DESIRADE,9710033J,9,9,0,0,2,7,6 ème
GUADELOUPE,LE MOULE,9710064T,84,84,0,0,43,41,6 ème
GUADELOUPE,LE MOULE,9711218X,156,156,0,0,80,76,6 ème
GUADELOUPE,LES ABYMES,9710405N,158,147,5,6,69,89,6 ème
GUADELOUPE,LES ABYMES,9710710V,172,151,13,8,80,92,6 ème
GUADELOUPE,PORT-LOUIS,9710584H,51,51,0,0,25,26,6 ème
GUADELOUPE,SAINT-MARTIN,9711087E,100,85,11,4,37,63,6 ème
GUYANE,APATOU,9730337D,149,137,12,0,64,85,6 ème
GUYANE,CAYENNE,9730130D,145,142,0,3,54,91,6 ème
GUYANE,KOUROU,9730306V,130,124,0,6,60,70,6 ème
GUYANE,MACOURIA,9730374U,238,217,14,7,118,120,6 ème
GUYANE,MARIPASOULA,9730193X,129,112,12,5,67,62,6 ème
GUYANE,MATOURY,9730182K,224,220,0,4,108,116,6 ème
GUYANE,MATOURY,9730218Z,143,139,0,4,68,75,6 ème
GUYANE,SAINT-LAURENT-DU-MARONI,9730248G,247,244,0,3,119,128,6 ème
AISNE,CHARLY-SUR-MARNE,0020011B,181,178,0,3,83,98,6 ème
AISNE,CHAUNY,0020015F,109,109,0,0,52,57,6 ème
AISNE,CONDE-EN-BRIE,0020016G,100,100,0,0,51,49,6 ème
AISNE,COUCY-LE-CHATEAU-AUFFRIQUE,0020018J,90,88,0,2,46,44,6 ème
AISNE,LA FERE,0021518P,93,88,0,5,44,49,6 ème
AISNE,LAON,0020090M,159,143,13,3,81,78,6 ème
AISNE,MONTCORNET,0021489H,55,55,0,0,29,26,6 ème
AISNE,ROZOY-SUR-SERRE,0020043L,39,39,0,0,22,17,6 ème
AISNE,SAINT-QUENTIN,0020054Y,86,83,0,3,40,46,6 ème
AISNE,SAINT-QUENTIN,0021823W,113,109,0,4,50,63,6 ème
AISNE,TERGNIER,0022113L,29,25,0,4,16,13,6 ème
AISNE,VAILLY-SUR-AISNE,0020065K,71,71,0,0,39,32,6 ème
AISNE,VERMAND,0020066L,92,92,0,0,42,50,6 ème
AISNE,VIC-SUR-AISNE,0021722L,100,100,0,0,48,52,6 ème
OISE,BEAUVAIS,0600003C,0,0,0,0,0,0,6 ème
OISE,BRETEUIL,0601406C,109,107,0,2,49,60,6 ème
OISE,COMPIEGNE,0600016S,0,0,0,0,0,0,6 ème
OISE,COMPIEGNE,0600018U,121,121,0,0,64,57,6 ème
OISE,COMPIEGNE,0601142R,267,265,0,2,115,152,6 ème
OISE,COMPIEGNE,0601501F,83,83,0,0,40,43,6 ème
OISE,CREPY-EN-VALOIS,0601833S,126,123,0,3,63,63,6 ème
OISE,FROISSY,0601176C,111,111,0,0,61,50,6 ème
OISE,GRANDVILLIERS,0601897L,0,0,0,0,0,0,6 ème
OISE,LACROIX-SAINT-OUEN,0601937E,167,164,0,3,85,82,6 ème
OISE,LIANCOURT,0600032J,161,159,0,2,73,88,6 ème
OISE,MARSEILLE-EN-BEAUVAISIS,0601365H,166,166,0,0,86,80,6 ème
OISE,MERU,0601157G,107,107,0,0,53,54,6 ème
OISE,MERU,0601470X,0,0,0,0,0,0,6 ème
OISE,MONTATAIRE,0601870G,0,0,0,0,0,0,6 ème
OISE,NEUILLY-EN-THELLE,0601847G,257,245,12,0,100,157,6 ème
OISE,NOGENT-SUR-OISE,0601846F,53,53,0,0,30,23,6 ème
OISE,PONT-SAINTE-MAXENCE,0601896K,0,0,0,0,0,0,6 ème
OISE,RESSONS-SUR-MATZ,0600045Y,124,124,0,0,65,59,6 ème
SOMME,AILLY-SUR-SOMME,0801325F,133,133,0,0,70,63,6 ème
SOMME,AMIENS,0801210F,115,110,0,5,40,75,6 ème
SOMME,AMIENS,0801264P,87,85,0,2,38,49,6 ème
SOMME,AMIENS,0801437C,190,188,0,2,101,89,6 ème
SOMME,AMIENS,0801616X,100,80,16,4,53,47,6 ème
SOMME,BERNAVILLE,0800022P,75,74,0,1,42,33,6 ème
SOMME,DOMART-EN-PONTHIEU,0801485E,105,86,16,3,42,63,6 ème
SOMME,DOULLENS,0801213J,43,43,0,0,24,19,6 ème
SOMME,FEUQUIERES-EN-VIMEU,0801371F,117,101,16,0,62,55,6 ème
SOMME,FRIVILLE-ESCARBOTIN,0801864S,0,0,0,0,0,0,6 ème
SOMME,LONGUEAU,0800038G,77,72,0,5,37,40,6 ème
SOMME,MONTDIDIER,0800041K,127,119,8,0,68,59,6 ème
SOMME,MOREUIL,0801439E,130,129,0,1,68,62,6 ème
SOMME,PERONNE,0801537L,180,158,16,6,89,91,6 ème
SOMME,RIVERY,0801373H,172,165,6,1,76,96,6 ème
SOMME,ROYE,0801227Z,96,96,0,0,48,48,6 ème
SOMME,RUE,0801228A,35,30,0,5,14,21,6 ème
SOMME,SAINT-VALERY-SUR-SOMME,0801490K,82,82,0,0,40,42,6 ème
SOMME,VILLERS-BRETONNEUX,0800057C,121,119,0,2,49,72,6 ème
NORD,BAILLEUL,0592930P,205,205,0,0,103,102,6 ème
NORD,BOUCHAIN,0593672W,196,189,7,0,88,108,6 ème
NORD,BOURBOURG,0594640Y,94,86,8,0,39,55,6 ème
NORD,BRAY-DUNES,0590030M,113,107,1,5,53,60,6 ème
NORD,CAMBRAI,0592611T,0,0,0,0,0,0,6 ème
NORD,CAMBRAI,0595174D,137,137,0,0,61,76,6 ème
NORD,CASSEL,0594872A,140,138,0,2,74,66,6 ème
NORD,COMINES,0593244F,69,64,3,2,27,42,6 ème
NORD,COUSOLRE,0590055P,44,44,0,0,22,22,6 ème
NORD,CROCHTE,0595595L,74,74,0,0,30,44,6 ème
NORD,DENAIN,0590062X,143,137,6,0,70,73,6 ème
NORD,DENAIN,0594299C,109,109,0,0,54,55,6 ème
NORD,DENAIN,0594300D,80,75,4,1,46,34,6 ème
NORD,DOUAI,0592733A,100,91,6,3,31,69,6 ème
NORD,DOUAI,0593071T,0,0,0,0,0,0,6 ème
NORD,DUNKERQUE,0590179Z,102,99,0,3,50,52,6 ème
NORD,DUNKERQUE,0592713D,114,114,0,0,43,71,6 ème
NORD,DUNKERQUE,0595389M,155,155,0,0,85,70,6 ème
NORD,DUNKERQUE,0595918M,0,0,0,0,0,0,6 ème
NORD,ESCAUDAIN,0592751V,139,139,0,0,59,80,6 ème
NORD,FEIGNIES,0594168K,79,75,0,4,37,42,6 ème
NORD,GONDECOURT,0595166V,111,111,0,0,48,63,6 ème
NORD,GRANDE-SYNTHE,0590088A,101,101,0,0,55,46,6 ème
NORD,GRAVELINES,0590090C,107,103,0,4,55,52,6 ème
NORD,HAUBOURDIN,0596059R,170,156,10,4,93,77,6 ème
NORD,HAZEBROUCK,0590102R,0,0,0,0,0,0,6 ème
NORD,HOUPLINES,0594638W,134,125,5,4,62,72,6 ème
NORD,LAMBERSART,0593226L,108,106,0,2,40,68,6 ème
NORD,LAMBERSART,0595393S,169,167,0,2,85,84,6 ème
NORD,LILLE,0592890W,108,108,0,0,57,51,6 ème
NORD,LILLE,0593168Y,154,154,0,0,78,76,6 ème
NORD,LILLE,0595286A,220,220,0,0,101,119,6 ème
NORD,LILLE,0595394T,56,56,0,0,22,34,6 ème
NORD,LILLE,0595397W,172,172,0,0,102,70,6 ème
NORD,LILLE,0595483P,4,0,4,0,2,2,6 ème
NORD,LILLE,0596833G,116,112,0,4,50,66,6 ème
NORD,LOUVROIL,0593034C,0,0,0,0,0,0,6 ème
NORD,MARCQ-EN-BAROEUL,0595993U,68,68,0,0,31,37,6 ème
NORD,MARLY,0593674Y,150,140,5,5,76,74,6 ème
NORD,MARQUETTE-LEZ-LILLE,0593474F,141,141,0,0,67,74,6 ème
NORD,MAUBEUGE,0590150T,90,90,0,0,39,51,6 ème
NORD,MERVILLE,0594294X,85,73,9,3,38,47,6 ème
NORD,NEUVILLE-EN-FERRAIN,0594537L,75,73,0,2,46,29,6 ème
NORD,NIEPPE,0594505B,84,84,0,0,41,43,6 ème
NORD,PERENCHIES,0592901H,79,79,0,0,35,44,6 ème
NORD,PETITE-FORET,0590007M,130,130,0,0,58,72,6 ème
NORD,PROVIN,0595758N,106,106,0,0,53,53,6 ème
NORD,RONCHIN,0593237Y,135,128,6,1,66,69,6 ème
NORD,ROUBAIX,0590183D,98,97,0,1,48,50,6 ème
NORD,ROUBAIX,0592973L,0,0,0,0,0,0,6 ème
NORD,ROUBAIX,0594389A,131,120,11,0,64,67,6 ème
NORD,ROUBAIX,0595168X,126,126,0,0,63,63,6 ème
NORD,SAINS-DU-NORD,0594538M,56,52,0,4,27,29,6 ème
NORD,SECLIN,0593145Y,194,192,0,2,78,116,6 ème
NORD,SOLESMES,0595401A,93,93,0,0,48,45,6 ème
NORD,SOMAIN,0590248Z,163,159,0,4,83,80,6 ème
NORD,SOMAIN,0594405T,156,140,11,5,74,82,6 ème
NORD,STEENVOORDE,0593147A,49,49,0,0,20,29,6 ème
NORD,STEENVOORDE,0593992U,119,119,0,0,60,59,6 ème
NORD,TOURCOING,0594394F,132,121,7,4,59,73,6 ème
NORD,VALENCIENNES,0590270Y,0,0,0,0,0,0,6 ème
NORD,VILLERS-OUTREAUX,0593157L,66,66,0,0,29,37,6 ème
NORD,WALLERS,0593678C,138,138,0,0,74,64,6 ème
NORD,WASQUEHAL,0593241C,85,85,0,0,39,46,6 ème
NORD,WATTEN,0594650J,128,128,0,0,60,68,6 ème
NORD,WATTIGNIES,0594524X,92,76,12,4,47,45,6 ème
PAS-DE-CALAIS,ANNEZIN,0622797D,151,151,0,0,64,87,6 ème
PAS-DE-CALAIS,ARRAS,0622083C,130,130,0,0,64,66,6 ème
PAS-DE-CALAIS,ARRAS,0622864B,102,102,0,0,49,53,6 ème
PAS-DE-CALAIS,AUCHEL,0620021L,106,91,12,3,51,55,6 ème
PAS-DE-CALAIS,BAPAUME,0620030W,0,0,0,0,0,0,6 ème
PAS-DE-CALAIS,BAPAUME,0620031X,162,159,0,3,89,73,6 ème
PAS-DE-CALAIS,BAPAUME,0622104A,109,109,0,0,61,48,6 ème
PAS-DE-CALAIS,BARLIN,0622268D,125,120,5,0,71,54,6 ème
PAS-DE-CALAIS,BEAURAINVILLE,0622435K,115,115,0,0,65,50,6 ème
PAS-DE-CALAIS,BERCK,0620036C,199,196,0,3,101,98,6 ème
PAS-DE-CALAIS,BETHUNE,0622425Z,142,140,0,2,60,82,6 ème
PAS-DE-CALAIS,BETHUNE,0623569T,180,178,0,2,91,89,6 ème
PAS-DE-CALAIS,BIACHE-SAINT-VAAST,0620047P,160,160,0,0,77,83,6 ème
PAS-DE-CALAIS,BOULOGNE-SUR-MER,0620051U,100,95,2,3,52,48,6 ème
PAS-DE-CALAIS,BOULOGNE-SUR-MER,0620055Y,79,79,0,0,43,36,6 ème
PAS-DE-CALAIS,BOURLON,0622132F,70,70,0,0,29,41,6 ème
PAS-DE-CALAIS,BRUAY-LA-BUISSIERE,0622428C,113,99,11,3,50,63,6 ème
PAS-DE-CALAIS,BULLY-LES-MINES,0620197C,182,178,0,4,82,100,6 ème
PAS-DE-CALAIS,CALAIS,0623570U,130,130,0,0,60,70,6 ème
PAS-DE-CALAIS,COURRIERES,0622264Z,129,120,7,2,59,70,6 ème
PAS-DE-CALAIS,DAINVILLE,0620014D,171,159,11,1,82,89,6 ème
PAS-DE-CALAIS,DOURGES,0623322Z,147,147,0,0,74,73,6 ème
PAS-DE-CALAIS,ETAPLES,0622572J,140,139,1,0,71,69,6 ème
PAS-DE-CALAIS,HENIN-BEAUMONT,0622581U,104,104,0,0,54,50,6 ème
PAS-DE-CALAIS,HOUDAIN,0622871J,126,112,12,2,63,63,6 ème
PAS-DE-CALAIS,LEFOREST,0622085E,156,156,0,0,84,72,6 ème
PAS-DE-CALAIS,LIEVIN,0620119T,155,146,9,0,82,73,6 ème
PAS-DE-CALAIS,LILLERS,0622799F,119,117,0,2,63,56,6 ème
PAS-DE-CALAIS,LONGUENESSE,0622575M,118,114,0,4,48,70,6 ème
PAS-DE-CALAIS,MARQUION,0620130E,157,142,8,7,75,82,6 ème
PAS-DE-CALAIS,NOEUX-LES-MINES,0622269E,174,162,7,5,75,99,6 ème
PAS-DE-CALAIS,OIGNIES,0623018U,117,108,9,0,62,55,6 ème
PAS-DE-CALAIS,SAINT-ETIENNE-AU-MONT,0623115Z,116,113,0,3,54,62,6 ème
PAS-DE-CALAIS,SAINT-MARTIN-BOULOGNE,0622434J,95,92,0,3,59,36,6 ème
PAS-DE-CALAIS,SAINT-OMER,0623574Y,60,60,0,0,28,32,6 ème
PAS-DE-CALAIS,SAINT-POL-SUR-TERNOISE,0620167V,0,0,0,0,0,0,6 ème
PAS-DE-CALAIS,SALLAUMINES,0620170Y,92,90,2,0,42,50,6 ème
PAS-DE-CALAIS,VENDIN-LE-VIEIL,0622792Y,152,149,0,3,76,76,6 ème
SEINE-ET-MARNE,BAILLY-ROMAINVILLIERS,0772548B,104,104,0,0,52,52,6 ème
SEINE-ET-MARNE,BRIE-COMTE-ROBERT,0771225N,52,52,0,0,18,34,6 ème
SEINE-ET-MARNE,BROU-SUR-CHANTEREINE,0770005M,66,62,0,4,30,36,6 ème
SEINE-ET-MARNE,CHAMPS-SUR-MARNE,0772090D,95,82,12,1,49,46,6 ème
SEINE-ET-MARNE,CHELLES,0772923J,144,144,0,0,85,59,6 ème
SEINE-ET-MARNE,CLAYE-SOUILLY,0770014X,139,139,0,0,73,66,6 ème
SEINE-ET-MARNE,CLAYE-SOUILLY,0771911J,125,122,0,3,66,59,6 ème
SEINE-ET-MARNE,CLAYE-SOUILLY,0771995A,0,0,0,0,0,0,6 ème
SEINE-ET-MARNE,COMBS-LA-VILLE,0771997C,0,0,0,0,0,0,6 ème
SEINE-ET-MARNE,CONGIS-SUR-THEROUANNE,0771658J,0,0,0,0,0,0,6 ème
SEINE-ET-MARNE,COULOMMIERS,0771760V,123,122,0,1,64,59,6 ème
SEINE-ET-MARNE,DAMMARIE-LES-LYS,0771027Y,0,0,0,0,0,0,6 ème
SEINE-ET-MARNE,DAMMARIE-LES-LYS,0771476L,156,156,0,0,88,68,6 ème
SEINE-ET-MARNE,DAMMARTIN-EN-GOELE,0772190M,182,180,0,2,100,82,6 ème
SEINE-ET-MARNE,DONNEMARIE-DONTILLY,0770020D,116,115,0,1,54,62,6 ème
SEINE-ET-MARNE,FONTAINEBLEAU,0770928R,194,194,0,0,87,107,6 ème
SEINE-ET-MARNE,FONTENAY-TRESIGNY,0772227C,122,122,0,0,61,61,6 ème
SEINE-ET-MARNE,LAGNY-SUR-MARNE,0770027L,159,157,0,2,67,92,6 ème
SEINE-ET-MARNE,LIZY-SUR-OURCQ,0771362M,124,124,0,0,68,56,6 ème
SEINE-ET-MARNE,MEAUX,0771172F,144,138,6,0,82,62,6 ème
SEINE-ET-MARNE,MEAUX,0771921V,345,343,0,2,185,160,6 ème
SEINE-ET-MARNE,MELUN,0770033T,121,121,0,0,64,57,6 ème
SEINE-ET-MARNE,MOISSY-CRAMAYEL,0771618R,176,176,0,0,84,92,6 ème
SEINE-ET-MARNE,MONTEVRAIN,0772819W,164,157,0,7,84,80,6 ème
SEINE-ET-MARNE,NANDY,0772126T,120,119,0,1,62,58,6 ème
SEINE-ET-MARNE,NOISIEL,0771841H,106,106,0,0,54,52,6 ème
SEINE-ET-MARNE,OZOIR-LA-FERRIERE,0771217E,239,239,0,0,114,125,6 ème
SEINE-ET-MARNE,PONTAULT-COMBAULT,0771175J,221,219,0,2,115,106,6 ème
SEINE-ET-MARNE,REBAIS,0771770F,108,107,0,1,49,59,6 ème
SEINE-ET-MARNE,ROZAY-EN-BRIE,0771514C,171,171,0,0,87,84,6 ème
SEINE-ET-MARNE,SAINT-PIERRE-LES-NEMOURS,0771218F,103,103,0,0,51,52,6 ème
SEINE-ET-MARNE,SOUPPES-SUR-LOING,0770048J,65,65,0,0,28,37,6 ème
SEINE-ET-MARNE,TORCY,0771991W,105,102,0,3,43,62,6 ème
SEINE-ET-MARNE,TOURNAN-EN-BRIE,0772342C,0,0,0,0,0,0,6 ème
SEINE-ET-MARNE,VARENNES-SUR-SEINE,0770945J,0,0,0,0,0,0,6 ème
SEINE-ET-MARNE,VERT-SAINT-DENIS,0771365R,220,217,0,3,121,99,6 ème
SEINE-ET-MARNE,VILLENEUVE-LE-COMTE,0772650M,11,11,0,0,7,4,6 ème
SEINE-ET-MARNE,VILLEPARISIS,0772868Z,133,133,0,0,62,71,6 ème
SEINE-SAINT-DENIS,AUBERVILLIERS,0931024H,0,0,0,0,0,0,6 ème
SEINE-SAINT-DENIS,AUBERVILLIERS,0931185H,166,166,0,0,107,59,6 ème
SEINE-SAINT-DENIS,AUBERVILLIERS,0931709C,96,96,0,0,51,45,6 ème
SEINE-SAINT-DENIS,AUBERVILLIERS,0932694Y,127,125,0,2,65,62,6 ème
SEINE-SAINT-DENIS,AUBERVILLIERS,0932726H,119,118,0,1,63,56,6 ème
SEINE-SAINT-DENIS,AULNAY-SOUS-BOIS,0930859D,211,211,0,0,103,108,6 ème
SEINE-SAINT-DENIS,AULNAY-SOUS-BOIS,0930891N,145,135,5,5,78,67,6 ème
SEINE-SAINT-DENIS,AULNAY-SOUS-BOIS,0931843Y,208,208,0,0,123,85,6 ème
SEINE-SAINT-DENIS,AULNAY-SOUS-BOIS,0932578X,150,150,0,0,66,84,6 ème
SEINE-SAINT-DENIS,BOBIGNY,0931196V,115,115,0,0,53,62,6 ème
SEINE-SAINT-DENIS,BONDY,0930906E,117,117,0,0,61,56,6 ème
SEINE-SAINT-DENIS,DRANCY,0931200Z,171,161,10,0,86,85,6 ème
SEINE-SAINT-DENIS,DUGNY,0931573E,0,0,0,0,0,0,6 ème
SEINE-SAINT-DENIS,EPINAY-SUR-SEINE,0930893R,206,191,13,2,97,109,6 ème
SEINE-SAINT-DENIS,LA COURNEUVE,0931429Y,175,169,0,6,68,107,6 ème
SEINE-SAINT-DENIS,LE BLANC-MESNIL,0930611J,132,132,0,0,56,76,6 ème
SEINE-SAINT-DENIS,LE BLANC-MESNIL,0930831Y,0,0,0,0,0,0,6 ème
SEINE-SAINT-DENIS,LE BLANC-MESNIL,0930884F,198,196,0,2,89,109,6 ème
SEINE-SAINT-DENIS,L'ILE-SAINT-DENIS,0931765N,78,73,0,5,37,41,6 ème
SEINE-SAINT-DENIS,LIVRY-GARGAN,0930620U,199,185,14,0,95,104,6 ème
SEINE-SAINT-DENIS,MONTFERMEIL,0931707A,158,146,12,0,76,82,6 ème
SEINE-SAINT-DENIS,MONTREUIL,0931151W,145,130,15,0,65,80,6 ème
SEINE-SAINT-DENIS,MONTREUIL,0931448U,153,151,0,2,71,82,6 ème
SEINE-SAINT-DENIS,MONTREUIL,0931712F,92,92,0,0,52,40,6 ème
SEINE-SAINT-DENIS,MONTREUIL,0932696A,102,98,0,4,60,42,6 ème
SEINE-SAINT-DENIS,NEUILLY-SUR-MARNE,0931485J,198,191,0,7,115,83,6 ème
SEINE-SAINT-DENIS,NOISY-LE-GRAND,0931214P,188,169,16,3,96,92,6 ème
SEINE-SAINT-DENIS,NOISY-LE-SEC,0932725G,163,160,0,3,69,94,6 ème
SEINE-SAINT-DENIS,ROMAINVILLE,0931381W,214,198,16,0,117,97,6 ème
SEINE-SAINT-DENIS,ROSNY-SOUS-BOIS,0930586G,150,147,0,3,70,80,6 ème
SEINE-SAINT-DENIS,SAINT-DENIS,0931490P,114,106,0,8,65,49,6 ème
SEINE-SAINT-DENIS,SAINT-OUEN,0931144N,91,85,0,6,44,47,6 ème
SEINE-SAINT-DENIS,SEVRAN,0930897V,158,156,0,2,88,70,6 ème
SEINE-SAINT-DENIS,STAINS,0930920V,126,126,0,0,51,75,6 ème
SEINE-SAINT-DENIS,STAINS,0931147S,119,118,0,1,63,56,6 ème
SEINE-SAINT-DENIS,TREMBLAY-EN-FRANCE,0931497X,188,164,16,8,81,107,6 ème
SEINE-SAINT-DENIS,VILLEMOMBLE,0930043S,135,135,0,0,72,63,6 ème
SEINE-SAINT-DENIS,VILLEMOMBLE,0931846B,235,235,0,0,128,107,6 ème
SEINE-SAINT-DENIS,VILLEPINTE,0932260B,0,0,0,0,0,0,6 ème
SEINE-SAINT-DENIS,VILLETANEUSE,0931206F,133,129,0,4,69,64,6 ème
VAL-DE-MARNE,ABLON-SUR-SEINE,0941709X,113,113,0,0,59,54,6 ème
VAL-DE-MARNE,ALFORTVILLE,0941020Y,116,113,0,3,65,51,6 ème
VAL-DE-MARNE,BRY-SUR-MARNE,0940887D,123,123,0,0,61,62,6 ème
VAL-DE-MARNE,BRY-SUR-MARNE,0941014S,194,194,0,0,95,99,6 ème
VAL-DE-MARNE,CACHAN,0940806R,86,86,0,0,41,45,6 ème
VAL-DE-MARNE,CHAMPIGNY-SUR-MARNE,0940786U,118,118,0,0,64,54,6 ème
VAL-DE-MARNE,CHOISY-LE-ROI,0941040V,113,113,0,0,61,52,6 ème
VAL-DE-MARNE,FONTENAY-SOUS-BOIS,0941298A,0,0,0,0,0,0,6 ème
VAL-DE-MARNE,FRESNES,0940094S,102,102,0,0,49,53,6 ème
VAL-DE-MARNE,FRESNES,0940582X,109,109,0,0,39,70,6 ème
VAL-DE-MARNE,IVRY-SUR-SEINE,0941972H,0,0,0,0,0,0,6 ème
VAL-DE-MARNE,L'HAY-LES-ROSES,0940551N,164,149,15,0,86,78,6 ème
VAL-DE-MARNE,MAISONS-ALFORT,0941023B,79,79,0,0,37,42,6 ème
VAL-DE-MARNE,MAISONS-ALFORT,0941712A,176,176,0,0,87,89,6 ème
VAL-DE-MARNE,NOGENT-SUR-MARNE,0940137N,0,0,0,0,0,0,6 ème
VAL-DE-MARNE,NOGENT-SUR-MARNE,0940810V,84,84,0,0,36,48,6 ème
VAL-DE-MARNE,NOGENT-SUR-MARNE,0941091A,149,145,0,4,76,73,6 ème
VAL-DE-MARNE,NOGENT-SUR-MARNE,0941713B,152,148,0,4,72,80,6 ème
VAL-DE-MARNE,SAINT-MAUR-DES-FOSSES,0941093C,236,236,0,0,106,130,6 ème
VAL-DE-MARNE,SAINT-MAUR-DES-FOSSES,0941220R,186,177,7,2,78,108,6 ème
VAL-DE-MARNE,SANTENY,0941782B,129,126,0,3,64,65,6 ème
VAL-DE-MARNE,THIAIS,0940853S,0,0,0,0,0,0,6 ème
VAL-DE-MARNE,THIAIS,0941233E,113,113,0,0,59,54,6 ème
VAL-DE-MARNE,VALENTON,0942482M,160,160,0,0,76,84,6 ème
VAL-DE-MARNE,VILLEJUIF,0941037S,119,119,0,0,68,51,6 ème
VAL-DE-MARNE,VINCENNES,0941598B,117,117,0,0,63,54,6 ème
PARIS,PARIS,0750584C,91,91,0,0,48,43,6 ème
PARIS,PARIS,0750609E,111,111,0,0,63,48,6 ème
PARIS,PARIS,0752189X,113,113,0,0,58,55,6 ème
PARIS,PARIS,0752542F,97,95,0,2,49,48,6 ème
PARIS,PARIS,0753936W,84,75,9,0,36,48,6 ème
PARIS,PARIS,0750553U,0,0,0,0,0,0,6 ème
PARIS,PARIS,0752694W,85,85,0,0,45,40,6 ème
PARIS,PARIS,0752906B,160,160,0,0,80,80,6 ème
PARIS,PARIS,0752799K,0,0,0,0,0,0,6 ème
PARIS,PARIS,0752901W,88,88,0,0,46,42,6 ème
PARIS,PARIS,0752935H,200,200,0,0,105,95,6 ème
PARIS,PARIS,0753256G,0,0,0,0,0,0,6 ème
PARIS,PARIS,0750588G,0,0,0,0,0,0,6 ème
PARIS,PARIS,0752547L,87,84,0,3,48,39,6 ème
PARIS,PARIS,0752550P,195,195,0,0,103,92,6 ème
PARIS,PARIS,0752926Y,162,162,0,0,58,104,6 ème
PARIS,PARIS,0752553T,199,199,0,0,112,87,6 ème
PARIS,PARIS,0752927Z,186,186,0,0,87,99,6 ème
PARIS,PARIS,0750546L,78,78,0,0,46,32,6 ème
PARIS,PARIS,0752252R,177,157,13,7,93,84,6 ème
PARIS,PARIS,0753206C,46,44,0,2,46,0,6 ème
PARIS,PARIS,0753381T,193,193,0,0,104,89,6 ème
PARIS,PARIS,0755433Y,85,67,14,4,37,48,6 ème
PARIS,PARIS,0752695X,93,93,0,0,46,47,6 ème
PARIS,PARIS,0753369E,92,92,0,0,70,22,6 ème
PARIS,PARIS,0755747P,90,88,0,2,50,40,6 ème
PARIS,PARIS,0751703U,74,71,0,3,26,48,6 ème
PARIS,PARIS,0750478M,100,92,8,0,50,50,6 ème
PARIS,PARIS,0750508V,0,0,0,0,0,0,6 ème
PARIS,PARIS,0750591K,135,131,0,4,59,76,6 ème
PARIS,PARIS,0750808W,0,0,0,0,0,0,6 ème
PARIS,PARIS,0750828T,0,0,0,0,0,0,6 ème
PARIS,PARIS,0752557X,80,80,0,0,44,36,6 ème
PARIS,PARIS,0752696Y,140,136,0,4,69,71,6 ème
PARIS,PARIS,0754007Y,128,128,0,0,50,78,6 ème
PARIS,PARIS,0754355B,113,100,7,6,49,64,6 ème
PARIS,PARIS,0751790N,144,142,0,2,56,88,6 ème
PARIS,PARIS,0752187V,58,55,0,3,25,33,6 ème
PARIS,PARIS,0752874S,168,168,0,0,85,83,6 ème
PARIS,PARIS,0754025T,0,0,0,0,0,0,6 ème
PARIS,PARIS,0752534X,93,91,0,2,45,48,6 ème
ESSONNE,ATHIS-MONS,0910025H,161,161,0,0,75,86,6 ème
ESSONNE,BRETIGNY-SUR-ORGE,0911490A,131,120,11,0,67,64,6 ème
ESSONNE,BRUNOY,0910009R,177,159,15,3,91,86,6 ème
ESSONNE,BURES-SUR-YVETTE,0910967G,127,127,0,0,56,71,6 ème
ESSONNE,CORBEIL-ESSONNES,0910829G,250,249,0,1,122,128,6 ème
ESSONNE,CORBEIL-ESSONNES,0911024U,147,144,0,3,66,81,6 ème
ESSONNE,DRAVEIL,0910016Y,183,183,0,0,92,91,6 ème
ESSONNE,EPINAY-SUR-ORGE,0910017Z,178,178,0,0,78,100,6 ème
ESSONNE,ETRECHY,0911447D,143,140,0,3,75,68,6 ème
ESSONNE,EVRY-COURCOURONNES,0911444A,116,112,0,4,61,55,6 ème
ESSONNE,EVRY-COURCOURONNES,0911865H,152,150,0,2,74,78,6 ème
ESSONNE,GIF-SUR-YVETTE,0911354C,193,193,0,0,85,108,6 ème
ESSONNE,JUVISY-SUR-ORGE,0911028Y,150,150,0,0,71,79,6 ème
ESSONNE,LA NORVILLE,0911152H,203,203,0,0,107,96,6 ème
ESSONNE,LARDY,0912276E,132,130,0,2,66,66,6 ème
ESSONNE,LA VILLE-DU-BOIS,0911751J,256,254,0,2,139,117,6 ème
ESSONNE,LIMOURS,0910028L,191,191,0,0,92,99,6 ème
ESSONNE,MARCOUSSIS,0911032C,111,109,0,2,55,56,6 ème
ESSONNE,MAROLLES-EN-HUREPOIX,0911572P,150,147,0,3,70,80,6 ème
ESSONNE,MONTGERON,0910817U,170,170,0,0,79,91,6 ème
ESSONNE,MONTLHERY,0911345T,223,221,0,2,117,106,6 ème
ESSONNE,MORSANG-SUR-ORGE,0911488Y,134,134,0,0,67,67,6 ème
ESSONNE,ORSAY,0911143Y,165,165,0,0,73,92,6 ème
ESSONNE,PALAISEAU,0911034E,172,168,0,4,87,85,6 ème
ESSONNE,SAINT-GERMAIN-LES-ARPAJON,0911899V,173,173,0,0,90,83,6 ème
ESSONNE,SAVIGNY-SUR-ORGE,0910716J,83,83,0,0,46,37,6 ème
ESSONNE,SAVIGNY-SUR-ORGE,0911252S,240,227,11,2,117,123,6 ème
ESSONNE,SAVIGNY-SUR-ORGE,0912142J,0,0,0,0,0,0,6 ème
ESSONNE,SOISY-SUR-SEINE,0912086Y,126,122,0,4,65,61,6 ème
ESSONNE,VIGNEUX-SUR-SEINE,0911146B,189,178,11,0,88,101,6 ème
ESSONNE,VILLABE,0912257J,143,140,0,3,68,75,6 ème
ESSONNE,VILLEBON-SUR-YVETTE,0911750H,129,129,0,0,74,55,6 ème
HAUTS-DE-SEINE,ASNIERES-SUR-SEINE,0921622N,187,187,0,0,92,95,6 ème
HAUTS-DE-SEINE,BAGNEUX,0921778H,95,95,0,0,47,48,6 ème
HAUTS-DE-SEINE,BOULOGNE-BILLANCOURT,0920905J,214,214,0,0,125,89,6 ème
HAUTS-DE-SEINE,BOULOGNE-BILLANCOURT,0922443F,0,0,0,0,0,0,6 ème
HAUTS-DE-SEINE,CHATENAY-MALABRY,0921181J,136,135,0,1,67,69,6 ème
HAUTS-DE-SEINE,CLAMART,0920068Z,207,207,0,0,101,106,6 ème
HAUTS-DE-SEINE,CLAMART,0920854D,155,155,0,0,76,79,6 ème
HAUTS-DE-SEINE,COLOMBES,0920592U,129,125,0,4,62,67,6 ème
HAUTS-DE-SEINE,COURBEVOIE,0921625S,0,0,0,0,0,0,6 ème
HAUTS-DE-SEINE,GARCHES,0920810F,0,0,0,0,0,0,6 ème
HAUTS-DE-SEINE,GARCHES,0920881H,152,149,0,3,89,63,6 ème
HAUTS-DE-SEINE,GENNEVILLIERS,0921541A,188,179,9,0,87,101,6 ème
HAUTS-DE-SEINE,ISSY-LES-MOULINEAUX,0920877D,129,123,0,6,58,71,6 ème
HAUTS-DE-SEINE,ISSY-LES-MOULINEAUX,0921396T,134,130,0,4,57,77,6 ème
HAUTS-DE-SEINE,ISSY-LES-MOULINEAUX,0922610M,117,111,0,6,62,55,6 ème
HAUTS-DE-SEINE,LA GARENNE-COLOMBES,0921162N,154,149,0,5,76,78,6 ème
HAUTS-DE-SEINE,LEVALLOIS-PERRET,0921007V,242,241,0,1,117,125,6 ème
HAUTS-DE-SEINE,LEVALLOIS-PERRET,0922751R,23,23,0,0,0,23,6 ème
HAUTS-DE-SEINE,MEUDON,0921554P,108,103,0,5,54,54,6 ème
HAUTS-DE-SEINE,MEUDON,0922340U,11,11,0,0,1,10,6 ème
HAUTS-DE-SEINE,MONTROUGE,0920855E,106,102,4,0,45,61,6 ème
HAUTS-DE-SEINE,NANTERRE,0921589C,121,121,0,0,57,64,6 ème
HAUTS-DE-SEINE,NEUILLY-SUR-SEINE,0921781L,122,120,0,2,50,72,6 ème
HAUTS-DE-SEINE,NEUILLY-SUR-SEINE,0921912D,111,111,0,0,111,0,6 ème
HAUTS-DE-SEINE,RUEIL-MALMAISON,0921915G,290,290,0,0,0,290,6 ème
HAUTS-DE-SEINE,SAINT-CLOUD,0920700L,98,96,0,2,49,49,6 ème
HAUTS-DE-SEINE,SAINT-CLOUD,0921020J,36,36,0,0,0,36,6 ème
HAUTS-DE-SEINE,SCEAUX,0921918K,152,152,0,0,88,64,6 ème
HAUTS-DE-SEINE,SEVRES,0921244C,235,235,0,0,133,102,6 ème
HAUTS-DE-SEINE,VANVES,0921240Y,113,111,0,2,68,45,6 ème
HAUTS-DE-SEINE,VANVES,0921783N,133,133,0,0,66,67,6 ème
VAL-D'OISE,ARGENTEUIL,0950884V,103,98,0,5,44,59,6 ème
VAL-D'OISE,ARGENTEUIL,0951094Y,171,171,0,0,81,90,6 ème
VAL-D'OISE,ARGENTEUIL,0951356H,159,153,0,6,72,87,6 ème
VAL-D'OISE,ARNOUVILLE,0951143B,163,159,0,4,83,80,6 ème
VAL-D'OISE,AUVERS-SUR-OISE,0951823R,114,113,0,1,48,66,6 ème
VAL-D'OISE,BEAUCHAMP,0952086B,124,124,0,0,65,59,6 ème
VAL-D'OISE,BEZONS,0950887Y,202,197,0,5,101,101,6 ème
VAL-D'OISE,BEZONS,0952173W,0,0,0,0,0,0,6 ème
VAL-D'OISE,CERGY,0951617S,119,116,0,3,59,60,6 ème
VAL-D'OISE,CERGY,0952282P,88,88,0,0,36,52,6 ème
VAL-D'OISE,COURDIMANCHE,0951724H,189,189,0,0,94,95,6 ème
VAL-D'OISE,DEUIL-LA-BARRE,0950682A,145,141,0,4,73,72,6 ème
VAL-D'OISE,DEUIL-LA-BARRE,0952140K,129,120,0,9,62,67,6 ème
VAL-D'OISE,ECOUEN,0950752B,120,120,0,0,49,71,6 ème
VAL-D'OISE,ENGHIEN-LES-BAINS,0951504U,265,265,0,0,132,133,6 ème
VAL-D'OISE,ERMONT,0950739M,159,150,9,0,85,74,6 ème
VAL-D'OISE,FRANCONVILLE,0950022H,126,120,0,6,63,63,6 ème
VAL-D'OISE,FRANCONVILLE,0951100E,205,185,15,5,80,125,6 ème
VAL-D'OISE,FRANCONVILLE,0952088D,129,126,0,3,49,80,6 ème
VAL-D'OISE,GARGES-LES-GONESSE,0950023J,148,135,7,6,76,72,6 ème
VAL-D'OISE,GARGES-LES-GONESSE,0950711G,150,144,0,6,71,79,6 ème
VAL-D'OISE,GARGES-LES-GONESSE,0951098C,196,190,6,0,102,94,6 ème
VAL-D'OISE,GARGES-LES-GONESSE,0951787B,0,0,0,0,0,0,6 ème
VAL-D'OISE,GONESSE,0951920W,110,105,0,5,51,59,6 ème
VAL-D'OISE,GOUSSAINVILLE,0951050A,134,132,0,2,61,73,6 ème
VAL-D'OISE,GOUSSAINVILLE,0952128X,137,134,0,3,66,71,6 ème
VAL-D'OISE,HERBLAY,0951696C,139,134,0,5,58,81,6 ème
VAL-D'OISE,HERBLAY,0952205F,121,121,0,0,63,58,6 ème
VAL-D'OISE,MARGENCY,0951505V,204,204,0,0,120,84,6 ème
VAL-D'OISE,MERIEL,0951991Y,148,147,0,1,83,65,6 ème
VAL-D'OISE,MONTIGNY-LES-CORMEILLES,0951154N,154,152,0,2,83,71,6 ème
VAL-D'OISE,MONTMAGNY,0951909J,138,135,0,3,78,60,6 ème
VAL-D'OISE,MONTMORENCY,0951799P,124,124,0,0,65,59,6 ème
VAL-D'OISE,PERSAN,0950934Z,214,194,14,6,102,112,6 ème
VAL-D'OISE,PISCOP,0951817J,48,48,0,0,25,23,6 ème
VAL-D'OISE,SAINT-OUEN-L'AUMONE,0951195H,188,169,15,4,76,112,6 ème
VAL-D'OISE,SANNOIS,0950722U,161,158,0,3,65,96,6 ème
VAL-D'OISE,SANNOIS,0952136F,0,0,0,0,0,0,6 ème
VAL-D'OISE,SARCELLES,0950045H,162,143,17,2,80,82,6 ème
VAL-D'OISE,SARCELLES,0950947N,0,0,0,0,0,0,6 ème
VAL-D'OISE,SARCELLES,0951682M,31,31,0,0,31,0,6 ème
VAL-D'OISE,SARCELLES,0951945Y,127,124,0,3,64,63,6 ème
VAL-D'OISE,VAUREAL,0951636M,117,117,0,0,55,62,6 ème
VAL-D'OISE,VILLIERS-LE-BEL,0951916S,50,50,0,0,30,20,6 ème
YVELINES,AUBERGENVILLE,0780506B,201,195,6,0,112,89,6 ème
YVELINES,BONNELLES,0781846H,76,76,0,0,34,42,6 ème
YVELINES,CHAMBOURCY,0781683F,139,139,0,0,65,74,6 ème
YVELINES,CROISSY-SUR-SEINE,0780847X,131,127,0,4,64,67,6 ème
YVELINES,FONTENAY-LE-FLEURY,0780185C,171,153,15,3,81,90,6 ème
YVELINES,GUYANCOURT,0780581H,127,126,0,1,53,74,6 ème
YVELINES,GUYANCOURT,0783378Y,88,86,0,2,41,47,6 ème
YVELINES,HOUILLES,0780269U,212,212,0,0,97,115,6 ème
YVELINES,HOUILLES,0783253M,171,171,0,0,73,98,6 ème
YVELINES,LA CELLE-SAINT-CLOUD,0780036R,137,133,0,4,69,68,6 ème
YVELINES,LE CHESNAY-ROCQUENCOURT,0781586A,257,257,0,0,121,136,6 ème
YVELINES,LES ESSARTS-LE-ROI,0780574A,176,174,0,2,95,81,6 ème
YVELINES,LES MUREAUX,0780572Y,148,134,14,0,74,74,6 ème
YVELINES,LES MUREAUX,0781914G,160,157,0,3,82,78,6 ème
YVELINES,LE VESINET,0781105C,145,145,0,0,68,77,6 ème
YVELINES,LIMAY,0782115A,142,130,9,3,68,74,6 ème
YVELINES,MANTES-LA-JOLIE,0781896M,94,94,0,0,51,43,6 ème
YVELINES,MANTES-LA-JOLIE,0783774D,140,131,9,0,64,76,6 ème
YVELINES,MARLY-LE-ROI,0780119F,223,223,0,0,113,110,6 ème
YVELINES,MAUREPAS,0780419G,174,164,9,1,83,91,6 ème
YVELINES,MEULAN-EN-YVELINES,0780571X,146,136,10,0,72,74,6 ème
YVELINES,MONTIGNY-LE-BRETONNEUX,0781263Z,118,118,0,0,54,64,6 ème
YVELINES,MONTIGNY-LE-BRETONNEUX,0783592F,30,30,0,0,17,13,6 ème
YVELINES,POISSY,0783358B,204,203,0,1,96,108,6 ème
YVELINES,RAMBOUILLET,0780846W,63,63,0,0,33,30,6 ème
YVELINES,RAMBOUILLET,0783338E,181,181,0,0,105,76,6 ème
YVELINES,ROSNY-SUR-SEINE,0781916J,131,129,0,2,63,68,6 ème
YVELINES,SAINT-GERMAIN-EN-LAYE,0781204K,234,234,0,0,124,110,6 ème
YVELINES,SAINT-GERMAIN-EN-LAYE,0781620M,229,226,0,3,118,111,6 ème
YVELINES,SARTROUVILLE,0780577D,87,87,0,0,34,53,6 ème
YVELINES,SARTROUVILLE,0780579F,139,137,0,2,75,64,6 ème
YVELINES,TRAPPES,0781618K,115,114,0,1,60,55,6 ème
YVELINES,VELIZY-VILLACOUBLAY,0780210E,148,146,0,2,65,83,6 ème
YVELINES,VERSAILLES,0781106D,120,120,0,0,60,60,6 ème
YVELINES,VERSAILLES,0781298M,71,69,0,2,34,37,6 ème
YVELINES,VILLEPREUX,0780260J,169,169,0,0,93,76,6 ème
YVELINES,VOISINS-LE-BRETONNEUX,0781789W,110,108,0,2,58,52,6 ème
LA REUNION,LA POSSESSION,9740084Y,182,180,0,2,85,97,6 ème
LA REUNION,SAINT-ANDRE,9740598G,273,239,32,2,126,147,6 ème
LA REUNION,SAINT-BENOIT,9740065C,138,136,0,2,79,59,6 ème
LA REUNION,SAINTE-MARIE,9741649Z,104,104,0,0,54,50,6 ème
LA REUNION,SAINTE-SUZANNE,9740094J,161,146,12,3,68,93,6 ème
LA REUNION,SAINT-JOSEPH,9740577J,242,208,32,2,110,132,6 ème
LA REUNION,SAINT-LEU,9740546A,263,257,0,6,131,132,6 ème
LA REUNION,SAINT-PAUL,9740069G,137,133,0,4,80,57,6 ème
LA REUNION,SAINT-PAUL,9740469S,192,192,0,0,100,92,6 ème
LA REUNION,SAINT-PAUL,9740596E,141,128,10,3,65,76,6 ème
LA REUNION,SAINT-PIERRE,9741346V,203,181,16,6,83,120,6 ème
MARTINIQUE,BASSE-POINTE,9720472F,48,45,3,0,27,21,6 ème
MARTINIQUE,FORT-DE-FRANCE,9720411P,87,81,0,6,41,46,6 ème
MARTINIQUE,FORT-DE-FRANCE,9720708M,77,73,0,4,47,30,6 ème
MARTINIQUE,FORT-DE-FRANCE,9720774J,140,140,0,0,123,17,6 ème
MARTINIQUE,LE DIAMANT,9720035F,70,69,0,1,32,38,6 ème
MARTINIQUE,LE LAMENTIN,9720091S,0,0,0,0,0,0,6 ème
MARTINIQUE,LE LORRAIN,9720445B,57,53,0,4,27,30,6 ème
MARTINIQUE,LES TROIS-ILETS,9720498J,61,61,0,0,34,27,6 ème
MARTINIQUE,LE VAUCLIN,9720031B,78,78,0,0,35,43,6 ème
MARTINIQUE,SCHOELCHER,9720424D,0,0,0,0,0,0,6 ème
MARTINIQUE,SCHOELCHER,9720684L,55,55,0,0,30,25,6 ème
MAYOTTE,BANDRABOUA,9760094Y,381,380,0,1,193,188,6 ème
MAYOTTE,KANI-KELI,9760166B,193,192,0,1,90,103,6 ème
MAYOTTE,KOUNGOU,9760244L,474,449,20,5,248,226,6 ème
MAYOTTE,MAMOUDZOU,9760219J,442,433,0,9,251,191,6 ème
ALLIER,COSNE-D'ALLIER,0030009U,48,45,0,3,19,29,6 ème
ALLIER,CUSSET,0031082K,0,0,0,0,0,0,6 ème
ALLIER,DESERTINES,0030860U,126,112,12,2,60,66,6 ème
ALLIER,GANNAT,0030980Z,38,38,0,0,17,21,6 ème
ALLIER,LURCY-LEVIS,0030021G,50,50,0,0,31,19,6 ème
ALLIER,MONTLUCON,0030119N,50,47,0,3,19,31,6 ème
ALLIER,MOULINS,0030112F,0,0,0,0,0,0,6 ème
ALLIER,NERIS-LES-BAINS,0030042E,60,60,0,0,31,29,6 ème
ALLIER,YZEURE,0030038A,0,0,0,0,0,0,6 ème
CANTAL,AURILLAC,0150613K,0,0,0,0,0,0,6 ème
CANTAL,AURILLAC,0150708N,75,75,0,0,31,44,6 ème
CANTAL,AURILLAC,0150729L,118,96,18,4,52,66,6 ème
CANTAL,AURILLAC,0150760V,0,0,0,0,0,0,6 ème
CANTAL,CHAUDES-AIGUES,0150010E,29,29,0,0,15,14,6 ème
CANTAL,LAROQUEBROU,0150013H,41,41,0,0,24,17,6 ème
CANTAL,MAURS,0150018N,36,35,0,1,13,23,6 ème
CANTAL,SAINT-MAMET-LA-SALVETAT,0150581A,55,52,0,3,28,27,6 ème
HAUTE-LOIRE,ALLEGRE,0430001T,52,52,0,0,33,19,6 ème
HAUTE-LOIRE,AUREC-SUR-LOIRE,0430987P,58,58,0,0,33,25,6 ème
HAUTE-LOIRE,BRIOUDE,0430003V,0,0,0,0,0,0,6 ème
HAUTE-LOIRE,DUNIERES,0430069S,45,45,0,0,23,22,6 ème
HAUTE-LOIRE,LE PUY-EN-VELAY,0430020N,0,0,0,0,0,0,6 ème
HAUTE-LOIRE,LE PUY-EN-VELAY,0430024T,0,0,0,0,0,0,6 ème
HAUTE-LOIRE,LE PUY-EN-VELAY,0430043N,126,123,0,3,70,56,6 ème
HAUTE-LOIRE,SAINT-DIDIER-EN-VELAY,0430084H,102,102,0,0,56,46,6 ème
HAUTE-LOIRE,SAINT-JULIEN-CHAPTEUIL,0430030Z,111,105,0,6,61,50,6 ème
HAUTE-LOIRE,TENCE,0430093T,32,32,0,0,12,20,6 ème
PUY-DE-DOME,AMBERT,0631083K,38,38,0,0,12,26,6 ème
PUY-DE-DOME,AMBERT,0631153L,99,83,11,5,54,45,6 ème
PUY-DE-DOME,AUBIERE,0631451K,203,189,13,1,109,94,6 ème
PUY-DE-DOME,BOURG-LASTIC,0630011V,29,29,0,0,15,14,6 ème
PUY-DE-DOME,CHAMALIERES,0631730N,115,115,0,0,52,63,6 ème
PUY-DE-DOME,CHAMPEIX,0630016A,88,87,0,1,43,45,6 ème
PUY-DE-DOME,CLERMONT-FERRAND,0630022G,0,0,0,0,0,0,6 ème
PUY-DE-DOME,LES ANCIZES-COMPS,0631482U,54,54,0,0,27,27,6 ème
PUY-DE-DOME,MARINGUES,0631097A,32,32,0,0,19,13,6 ème
PUY-DE-DOME,PIONSAT,0630046H,20,20,0,0,10,10,6 ème
PUY-DE-DOME,PONT-DU-CHATEAU,0631101E,70,70,0,0,35,35,6 ème
PUY-DE-DOME,ROCHEFORT-MONTAGNE,0630056U,60,60,0,0,30,30,6 ème
PUY-DE-DOME,SAINT-AMANT-ROCHE-SAVINE,0630057V,0,0,0,0,0,0,6 ème
PUY-DE-DOME,SAINT-GERMAIN-LEMBRON,0630062A,96,93,0,3,56,40,6 ème
PUY-DE-DOME,SAINT-GERVAIS-D'AUVERGNE,0630065D,31,26,0,5,17,14,6 ème
PUY-DE-DOME,THIERS,0630078T,0,0,0,0,0,0,6 ème
PUY-DE-DOME,VIC-LE-COMTE,0630072L,112,107,0,5,56,56,6 ème
ARDECHE,ANNONAY,0070001N,0,0,0,0,0,0,6 ème
ARDECHE,CRUAS,0070010Y,79,79,0,0,33,46,6 ème
ARDECHE,LAMASTRE,0070872K,39,39,0,0,21,18,6 ème
ARDECHE,LARGENTIERE,0070016E,0,0,0,0,0,0,6 ème
ARDECHE,LA VOULTE-SUR-RHONE,0070042H,166,151,15,0,86,80,6 ème
ARDECHE,LE CHEYLARD,0070849K,60,60,0,0,24,36,6 ème
ARDECHE,LE TEIL,0070847H,162,160,0,2,84,78,6 ème
ARDECHE,MONTPEZAT-SOUS-BAUZON,0070018G,59,59,0,0,22,37,6 ème
ARDECHE,SAINT-CIRGUES-EN-MONTAGNE,0070024N,23,23,0,0,11,12,6 ème
ARDECHE,SAINT-SAUVEUR-DE-MONTAGUT,0070025P,46,46,0,0,32,14,6 ème
ARDECHE,TOURNON-SUR-RHONE,0070092M,138,138,0,0,69,69,6 ème
ARDECHE,VALS-LES-BAINS,0070846G,88,81,0,7,42,46,6 ème
ARDECHE,VERNOUX-EN-VIVARAIS,0070890E,61,61,0,0,27,34,6 ème
DROME,BOURG-LES-VALENCE,0260766S,193,171,22,0,88,105,6 ème
DROME,BUIS-LES-BARONNIES,0260002L,53,53,0,0,23,30,6 ème
DROME,CHATEAUNEUF-DE-GALAURE,0261133R,39,39,0,0,39,0,6 ème
DROME,LA CHAPELLE-EN-VERCORS,0260004N,51,51,0,0,19,32,6 ème
DROME,LORIOL-SUR-DROME,0260012X,110,110,0,0,54,56,6 ème
DROME,MONTELIMAR,0261135T,120,120,0,0,51,69,6 ème
DROME,PIERRELATTE,0261090U,100,100,0,0,43,57,6 ème
DROME,ROMANS-SUR-ISERE,0260850H,178,161,14,3,93,85,6 ème
DROME,ROMANS-SUR-ISERE,0260997T,179,163,12,4,90,89,6 ème
DROME,SAINT-PAUL-TROIS-CHATEAUX,0261032F,173,173,0,0,77,96,6 ème
DROME,SAINT-SORLIN-EN-VALLOIRE,0260030S,112,112,0,0,53,59,6 ème
DROME,VALENCE,0261095Z,135,131,0,4,65,70,6 ème
DROME,VALENCE,0261137V,156,156,0,0,84,72,6 ème
HAUTE SAVOIE,ALBY-SUR-CHERAN,0740002A,145,145,0,0,74,71,6 ème
HAUTE SAVOIE,ANNECY,0740071A,183,161,20,2,82,101,6 ème
HAUTE SAVOIE,ANNECY,0740105M,179,179,0,0,66,113,6 ème
HAUTE SAVOIE,CLUSES,0740112V,170,170,0,0,88,82,6 ème
HAUTE SAVOIE,CLUSES,0740911N,231,225,0,6,111,120,6 ème
HAUTE SAVOIE,COLLONGES-SOUS-SALEVE,0740144E,0,0,0,0,0,0,6 ème
HAUTE SAVOIE,DOUVAINE,0740020V,191,191,0,0,76,115,6 ème
HAUTE SAVOIE,RUMILLY,0740126K,179,179,0,0,94,85,6 ème
HAUTE SAVOIE,RUMILLY,0741757H,153,150,0,3,69,84,6 ème
HAUTE SAVOIE,SAINT-PAUL-EN-CHABLAIS,0741308V,124,122,0,2,57,67,6 ème
HAUTE SAVOIE,SAMOENS,0740040S,50,50,0,0,30,20,6 ème
HAUTE SAVOIE,THONES,0741187N,155,155,0,0,66,89,6 ème
HAUTE SAVOIE,THONON-LES-BAINS,0740059M,0,0,0,0,0,0,6 ème
HAUTE SAVOIE,VILLE-LA-GRAND,0741284U,237,235,0,2,118,119,6 ème
ISERE,BOURGOIN-JALLIEU,0382271M,0,0,0,0,0,0,6 ème
ISERE,CORENC,0382041M,113,110,0,3,50,63,6 ème
ISERE,CORENC,0382579X,179,176,0,3,83,96,6 ème
ISERE,COUBLEVIE,0382495F,182,165,14,3,85,97,6 ème
ISERE,ECHIROLLES,0382031B,0,0,0,0,0,0,6 ème
ISERE,FONTAINE,0380356F,122,122,0,0,53,69,6 ème
ISERE,GIERES,0381694K,137,134,0,3,64,73,6 ème
ISERE,GONCELIN,0383300F,147,143,0,4,75,72,6 ème
ISERE,GRENOBLE,0383370G,130,130,0,0,68,62,6 ème
ISERE,LA COTE-SAINT-ANDRE,0382147C,121,101,17,3,53,68,6 ème
ISERE,LA MURE,0381701T,78,78,0,0,41,37,6 ème
ISERE,LA TOUR-DU-PIN,0380278W,208,174,30,4,109,99,6 ème
ISERE,LA TOUR-DU-PIN,0381706Y,161,159,0,2,86,75,6 ème
ISERE,LE TOUVET,0382204P,163,163,0,0,94,69,6 ème
ISERE,L'ISLE-D'ABEAU,0383455Z,149,148,0,1,73,76,6 ème
ISERE,MEYLAN,0381777A,104,100,0,4,52,52,6 ème
ISERE,MOIRANS,0381908T,138,135,0,3,79,59,6 ème
ISERE,SAINT-GEORGES-D'ESPERANCHE,0383141H,118,118,0,0,55,63,6 ème
ISERE,SAINT-JEAN-DE-MOIRANS,0381704W,88,88,0,0,51,37,6 ème
ISERE,SAINT-JEAN-DE-SOUDAIN,0382621T,156,156,0,0,79,77,6 ème
ISERE,SAINT-MARCELLIN,0380063M,0,0,0,0,0,0,6 ème
ISERE,TIGNIEU-JAMEYZIEU,0382705J,165,160,0,5,81,84,6 ème
ISERE,VIENNE,0380083J,0,0,0,0,0,0,6 ème
ISERE,VILLEFONTAINE,0382104F,145,117,24,4,70,75,6 ème
ISERE,VILLEFONTAINE,0382506T,120,118,0,2,58,62,6 ème
ISERE,VILLEMOIRIEU,0383475W,125,125,0,0,58,67,6 ème
ISERE,VIZILLE,0381779C,164,158,4,2,90,74,6 ème
ISERE,VOIRON,0382169B,0,0,0,0,0,0,6 ème
ISERE,VOIRON,0382584C,85,85,0,0,39,46,6 ème
SAVOIE,ALBERTVILLE,0730904L,171,154,13,4,84,87,6 ème
SAVOIE,ALBERTVILLE,0731045P,12,0,12,0,4,8,6 ème
SAVOIE,BOURG-SAINT-MAURICE,0730009N,161,161,0,0,76,85,6 ème
SAVOIE,BOZEL,0730010P,75,75,0,0,34,41,6 ème
SAVOIE,CHAMBERY,0730016W,0,0,0,0,0,0,6 ème
SAVOIE,CHAMBERY,0730762G,53,53,0,0,20,33,6 ème
SAVOIE,CHAMBERY,0730855H,79,77,0,2,42,37,6 ème
SAVOIE,LA MOTTE-SERVOLEX,0730028J,98,95,0,3,33,65,6 ème
SAVOIE,LA RAVOIRE,0730982W,103,91,9,3,59,44,6 ème
SAVOIE,MODANE,0730049G,87,87,0,0,42,45,6 ème
SAVOIE,SAINT-JEAN-DE-MAURIENNE,0730037U,0,0,0,0,0,0,6 ème
SAVOIE,SAINT-JEAN-DE-MAURIENNE,0730903K,166,156,8,2,79,87,6 ème
SAVOIE,SAINT-PIERRE-D'ALBIGNY,0730042Z,128,125,0,3,54,74,6 ème
SAVOIE,VAL-D'ARC,0730001E,83,81,0,2,37,46,6 ème
AIN,BELLEY,0011067E,206,192,12,2,93,113,6 ème
AIN,BEYNOST,0011360Y,131,128,0,3,62,69,6 ème
AIN,BOURG-EN-BRESSE,0010079F,108,105,0,3,44,64,6 ème
AIN,BOURG-EN-BRESSE,0010099C,0,0,0,0,0,0,6 ème
AIN,BOURG-EN-BRESSE,0010966V,13,0,13,0,6,7,6 ème
AIN,BRIORD,0011429Y,147,142,0,5,67,80,6 ème
AIN,CESSY,0010878Z,0,0,0,0,0,0,6 ème
AIN,CEYZERIAT,0011387C,146,143,0,3,66,80,6 ème
AIN,CHATILLON-SUR-CHALARONNE,0010084L,66,66,0,0,34,32,6 ème
AIN,DAGNEUX,0010083K,184,184,0,0,105,79,6 ème
AIN,DIVONNE-LES-BAINS,0011011U,165,165,0,0,81,84,6 ème
AIN,GEX,0010088R,239,239,0,0,125,114,6 ème
AIN,MONTCEAUX,0011415H,161,161,0,0,72,89,6 ème
AIN,MONTREVEL-EN-BRESSE,0010895T,202,196,0,6,100,102,6 ème
AIN,OYONNAX,0010092V,127,125,0,2,69,58,6 ème
AIN,OYONNAX,0010802S,163,150,11,2,75,88,6 ème
AIN,PONT-D'AIN,0010037K,146,145,0,1,72,74,6 ème
AIN,PREVESSIN-MOENS,0011301J,205,203,0,2,96,109,6 ème
LOIRE,CHARLIEU,0421572F,202,202,0,0,101,101,6 ème
LOIRE,FIRMINY,0420073B,0,0,0,0,0,0,6 ème
LOIRE,MONTBRISON,0420075D,0,0,0,0,0,0,6 ème
LOIRE,PELUSSIN,0421049M,57,57,0,0,31,26,6 ème
LOIRE,REGNY,0421490S,91,91,0,0,51,40,6 ème
LOIRE,RIVE-DE-GIER,0420982P,0,0,0,0,0,0,6 ème
LOIRE,ROANNE,0420035K,157,142,10,5,75,82,6 ème
LOIRE,ROANNE,0420077F,0,0,0,0,0,0,6 ème
LOIRE,ROANNE,0421683B,101,96,0,5,42,59,6 ème
LOIRE,ROANNE,0421684C,74,74,0,0,40,34,6 ème
LOIRE,ROANNE,0421797A,180,166,10,4,75,105,6 ème
LOIRE,ROCHE-LA-MOLIERE,0421174Y,144,140,0,4,60,84,6 ème
LOIRE,SAINT-BONNET-LE-CHATEAU,0420038N,150,150,0,0,69,81,6 ème
LOIRE,SAINT-CHAMOND,0421006R,0,0,0,0,0,0,6 ème
LOIRE,SAINT-ETIENNE,0420058K,201,201,0,0,98,103,6 ème
LOIRE,SAINT-ETIENNE,0421452A,195,194,0,1,113,82,6 ème
LOIRE,SAINT-ETIENNE,0421677V,119,119,0,0,60,59,6 ème
LOIRE,SAINT-ETIENNE,0421798B,112,99,13,0,47,65,6 ème
LOIRE,SAINT-ETIENNE,0421980Z,0,0,0,0,0,0,6 ème
LOIRE,SAINT-GENEST-MALIFAUX,0421059Y,100,100,0,0,53,47,6 ème
LOIRE,SAINT-GERMAIN-LAVAL,0420060M,60,60,0,0,26,34,6 ème
LOIRE,SAINT-ROMAIN-LE-PUY,0422136U,184,183,0,1,85,99,6 ème
LOIRE,UNIEUX,0421068H,164,163,0,1,89,75,6 ème
LOIRE,VEAUCHE,0422293P,203,201,0,2,103,100,6 ème
RHONE,AMPLEPUIS,0690672F,108,108,0,0,57,51,6 ème
RHONE,BRINDAS,0693890D,205,203,0,2,104,101,6 ème
RHONE,BRON,0692576A,133,122,5,6,54,79,6 ème
RHONE,BRON,0693834T,139,138,0,1,65,74,6 ème
RHONE,CHASSIEU,0691614E,142,141,0,1,63,79,6 ème
RHONE,DECINES-CHARPIEU,0691649T,123,123,0,0,60,63,6 ème
RHONE,DECINES-CHARPIEU,0692157V,155,138,16,1,78,77,6 ème
RHONE,FEYZIN,0692520P,118,112,0,6,59,59,6 ème
RHONE,GIVORS,0692583H,132,121,8,3,64,68,6 ème
RHONE,GRIGNY,0692419E,160,147,8,5,84,76,6 ème
RHONE,L'ARBRESLE,0691482L,163,153,10,0,85,78,6 ème
RHONE,LYON,0692932M,177,173,0,4,86,91,6 ème
RHONE,LYON,0690597Z,90,90,0,0,44,46,6 ème
RHONE,LYON,0692933N,311,307,0,4,157,154,6 ème
RHONE,LYON,0692694D,86,83,0,3,38,48,6 ème
RHONE,LYON,0692934P,89,86,0,3,48,41,6 ème
RHONE,LYON,0690534F,175,175,0,0,88,87,6 ème
RHONE,LYON,0692338S,163,158,0,5,82,81,6 ème
RHONE,LYON,0690040U,0,0,0,0,0,0,6 ème
RHONE,LYON,0690651H,0,0,0,0,0,0,6 ème
RHONE,LYON,0693374T,0,0,0,0,0,0,6 ème
RHONE,LYON,0690036P,116,111,4,1,62,54,6 ème
RHONE,MIONS,0692579D,143,141,0,2,70,73,6 ème
RHONE,MORNANT,0690611P,134,134,0,0,61,73,6 ème
RHONE,MORNANT,0692346A,163,163,0,0,81,82,6 ème
RHONE,OULLINS,0690281F,0,0,0,0,0,0,6 ème
RHONE,OULLINS,0690653K,0,0,0,0,0,0,6 ème
RHONE,OULLINS,0692942Y,60,60,0,0,30,30,6 ème
RHONE,PIERRE-BENITE,0690076H,90,89,0,1,51,39,6 ème
RHONE,SAINT-FONS,0692342W,237,219,15,3,110,127,6 ème
RHONE,SAINT-GENIS-LAVAL,0692521R,85,83,0,2,37,48,6 ème
RHONE,SAINT-GEORGES-DE-RENEINS,0690080M,185,169,12,4,88,97,6 ème
RHONE,SAINT-LAURENT-DE-CHAMOUSSET,0690614T,94,94,0,0,36,58,6 ème
RHONE,SAINT-MARTIN-EN-HAUT,0690615U,99,99,0,0,55,44,6 ème
RHONE,SAINT-PRIEST,0692160Y,145,130,12,3,67,78,6 ème
RHONE,SAINT-SYMPHORIEN-D'OZON,0691496B,206,203,0,3,98,108,6 ème
RHONE,SAINT-SYMPHORIEN-SUR-COISE,0692925E,109,108,0,1,54,55,6 ème
RHONE,TARARE,0690618X,114,109,0,5,55,59,6 ème
RHONE,TARARE,0692700K,201,184,15,2,95,106,6 ème
RHONE,VAULX-EN-VELIN,0691793Z,127,126,0,1,55,72,6 ème
RHONE,VILLEURBANNE,0692155T,180,162,16,2,80,100,6 ème
RHONE,VILLEURBANNE,0693491V,28,28,0,0,9,19,6 ème
RHONE,VILLIE-MORGON,0690117C,116,113,0,3,54,62,6 ème
DOUBS,BAUME-LES-DAMES,0250005V,129,113,15,1,59,70,6 ème
DOUBS,BESANCON,0250011B,0,0,0,0,0,0,6 ème
DOUBS,BESANCON,0250012C,92,92,0,0,55,37,6 ème
DOUBS,BESANCON,0251208C,128,111,15,2,60,68,6 ème
DOUBS,FRASNE,0250018J,73,73,0,0,49,24,6 ème
DOUBS,HERIMONCOURT,0251375J,80,80,0,0,41,39,6 ème
DOUBS,LE RUSSEY,0251058P,30,30,0,0,16,14,6 ème
DOUBS,MAICHE,0251053J,120,120,0,0,59,61,6 ème
DOUBS,MONTBELIARD,0251395F,152,129,16,7,70,82,6 ème
DOUBS,MORTEAU,0251090Z,173,161,10,2,87,86,6 ème
DOUBS,PIREY,0251063V,109,109,0,0,51,58,6 ème
DOUBS,PONTARLIER,0251112Y,0,0,0,0,0,0,6 ème
DOUBS,SANCEY,0250055Z,46,46,0,0,24,22,6 ème
HAUTE-SAONE,HERICOURT,0700787A,193,177,13,3,95,98,6 ème
HAUTE-SAONE,LUXEUIL-LES-BAINS,0701192R,120,103,16,1,57,63,6 ème
HAUTE-SAONE,PESMES,0700027Z,90,90,0,0,42,48,6 ème
HAUTE-SAONE,VESOUL,0700038L,0,0,0,0,0,0,6 ème
HAUTE-SAONE,VESOUL,0700785Y,142,140,0,2,79,63,6 ème
JURA,CLAIRVAUX-LES-LACS,0390009Y,51,51,0,0,25,26,6 ème
JURA,DOLE,0390013C,0,0,0,0,0,0,6 ème
JURA,DOLE,0390800H,107,102,0,5,52,55,6 ème
JURA,DOLE,0390883Y,141,126,15,0,58,83,6 ème
JURA,LAVANS-LES-SAINT-CLAUDE,0391035N,57,57,0,0,28,29,6 ème
JURA,LONS-LE-SAUNIER,0390020K,0,0,0,0,0,0,6 ème
JURA,MOIRANS-EN-MONTAGNE,0390025R,48,46,0,2,25,23,6 ème
JURA,SAINT-CLAUDE,0390786T,0,0,0,0,0,0,6 ème
JURA,SALINS-LES-BAINS,0390962J,83,81,0,2,36,47,6 ème
JURA,TAVAUX,0390823H,74,74,0,0,39,35,6 ème
TERRITOIRE DE BELFORT,BELFORT,0900236T,0,0,0,0,0,0,6 ème
TERRITOIRE DE BELFORT,BELFORT,0900351T,89,71,18,0,49,40,6 ème
TERRITOIRE DE BELFORT,ROUGEMONT-LE-CHATEAU,0900013A,64,64,0,0,38,26,6 ème
COTE D'OR,BEAUNE,0210006T,0,0,0,0,0,0,6 ème
COTE D'OR,BEAUNE,0211626D,135,134,0,1,61,74,6 ème
COTE D'OR,CHATILLON-SUR-SEINE,0210014B,118,104,14,0,64,54,6 ème
COTE D'OR,DIJON,0210024M,128,128,0,0,65,63,6 ème
COTE D'OR,DIJON,0211089V,0,0,0,0,0,0,6 ème
COTE D'OR,DIJON,0211091X,0,0,0,0,0,0,6 ème
COTE D'OR,DIJON,0211357L,137,133,0,4,73,64,6 ème
COTE D'OR,DIJON,0211389W,178,178,0,0,78,100,6 ème
COTE D'OR,DIJON,0211525U,143,143,0,0,74,69,6 ème
COTE D'OR,DIJON,0211986V,0,0,0,0,0,0,6 ème
COTE D'OR,DIJON,0212119P,166,166,0,0,84,82,6 ème
COTE D'OR,ECHENON,0211358M,106,106,0,0,62,44,6 ème
COTE D'OR,LIERNAIS,0211524T,18,18,0,0,7,11,6 ème
COTE D'OR,MIREBEAU-SUR-BEZE,0210033X,114,111,0,3,59,55,6 ème
COTE D'OR,NUITS-SAINT-GEORGES,0210038C,157,155,0,2,79,78,6 ème
COTE D'OR,QUETIGNY,0211477S,175,159,16,0,80,95,6 ème
COTE D'OR,RECEY-SUR-OURCE,0210043H,31,31,0,0,10,21,6 ème
COTE D'OR,SEURRE,0210050R,92,92,0,0,41,51,6 ème
COTE D'OR,VENAREY-LES-LAUMES,0211184Y,68,68,0,0,32,36,6 ème
NIEVRE,CERCY-LA-TOUR,0580002M,26,26,0,0,14,12,6 ème
NIEVRE,CHATEAU-CHINON (VILLE),0580005R,46,36,8,2,25,21,6 ème
NIEVRE,FOURCHAMBAULT,0580020G,0,0,0,0,0,0,6 ème
NIEVRE,FOURCHAMBAULT,0580553L,150,135,13,2,81,69,6 ème
NIEVRE,LA CHARITE-SUR-LOIRE,0580610Y,110,93,16,1,55,55,6 ème
NIEVRE,MONTSAUCHE-LES-SETTONS,0580029S,25,25,0,0,13,12,6 ème
NIEVRE,NEVERS,0580034X,73,70,0,3,40,33,6 ème
NIEVRE,NEVERS,0580542Z,82,79,0,3,44,38,6 ème
NIEVRE,NEVERS,0580682B,79,78,0,1,23,56,6 ème
NIEVRE,PREMERY,0580036Z,47,47,0,0,17,30,6 ème
NIEVRE,SAINT-BENIN-D'AZY,0580038B,34,34,0,0,15,19,6 ème
NIEVRE,SAINT-SAULGE,0580040D,25,25,0,0,11,14,6 ème
SAONE-ET-LOIRE,BOURBON-LANCY,0710005V,76,76,0,0,37,39,6 ème
SAONE-ET-LOIRE,CHALON-SUR-SAONE,0710536X,130,111,15,4,61,69,6 ème
SAONE-ET-LOIRE,CHATENOY-LE-ROYAL,0711585M,77,75,0,2,37,40,6 ème
SAONE-ET-LOIRE,CHAUFFAILLES,0710121W,33,33,0,0,14,19,6 ème
SAONE-ET-LOIRE,GENELARD,0710039G,76,76,0,0,39,37,6 ème
SAONE-ET-LOIRE,LE CREUSOT,0710026T,0,0,0,0,0,0,6 ème
SAONE-ET-LOIRE,LE CREUSOT,0711324D,96,94,0,2,51,45,6 ème
SAONE-ET-LOIRE,MACON,0710048S,0,0,0,0,0,0,6 ème
SAONE-ET-LOIRE,MACON,0711249X,0,0,0,0,0,0,6 ème
SAONE-ET-LOIRE,MONTCHANIN,0710060E,111,108,0,3,64,47,6 ème
SAONE-ET-LOIRE,PARAY-LE-MONIAL,0710087J,0,0,0,0,0,0,6 ème
SAONE-ET-LOIRE,PIERRE-DE-BRESSE,0710063H,54,54,0,0,23,31,6 ème
SAONE-ET-LOIRE,SAINT-REMY,0711293V,168,149,16,3,97,71,6 ème
SAONE-ET-LOIRE,SANVIGNES-LES-MINES,0710069P,74,74,0,0,39,35,6 ème
YONNE,AUXERRE,0890005X,0,0,0,0,0,0,6 ème
YONNE,AUXERRE,0891054M,189,181,0,8,85,104,6 ème
YONNE,CHABLIS,0890013F,92,92,0,0,37,55,6 ème
YONNE,MIGENNES,0890977D,113,100,13,0,57,56,6 ème
YONNE,NOYERS,0890019M,39,39,0,0,19,20,6 ème
YONNE,PARON,0891235J,168,165,0,3,85,83,6 ème
YONNE,SAINT-FLORENTIN,0890024T,130,128,0,2,70,60,6 ème
YONNE,SENS,0890790A,223,207,16,0,115,108,6 ème
COTES D'ARMOR,BEGARD,0221518F,120,120,0,0,62,58,6 ème
COTES D'ARMOR,BELLE-ISLE-EN-TERRE,0221539D,51,51,0,0,24,27,6 ème
COTES D'ARMOR,BOURBRIAC,0220003J,38,38,0,0,27,11,6 ème
COTES D'ARMOR,CALLAC,0221540E,35,35,0,0,15,20,6 ème
COTES D'ARMOR,DINAN,0221743A,108,108,0,0,54,54,6 ème
COTES D'ARMOR,ERQUY,0220015X,34,34,0,0,23,11,6 ème
COTES D'ARMOR,GUINGAMP,0220019B,0,0,0,0,0,0,6 ème
COTES D'ARMOR,LANNION,0220104U,232,214,15,3,109,123,6 ème
COTES D'ARMOR,LANNION,0221931E,108,102,0,6,50,58,6 ème
COTES D'ARMOR,MERDRIGNAC,0220149T,22,22,0,0,13,9,6 ème
COTES D'ARMOR,PAIMPOL,0220151V,86,85,0,1,38,48,6 ème
COTES D'ARMOR,PLENEE-JUGON,0220154Y,19,19,0,0,6,13,6 ème
COTES D'ARMOR,PLENEUF-VAL-ANDRE,0221126E,57,57,0,0,30,27,6 ème
COTES D'ARMOR,PLEUMEUR-BODOU,0221819H,60,60,0,0,26,34,6 ème
COTES D'ARMOR,PLOUASNE,0220046F,47,47,0,0,23,24,6 ème
COTES D'ARMOR,PLOUBAZLANEC,0221866J,0,0,0,0,0,0,6 ème
COTES D'ARMOR,PLOUER-SUR-RANCE,0220047G,144,144,0,0,71,73,6 ème
COTES D'ARMOR,PONTRIEUX,0220166L,13,13,0,0,4,9,6 ème
COTES D'ARMOR,QUINTIN,0221028Y,93,93,0,0,49,44,6 ème
COTES D'ARMOR,QUINTIN,0221748F,190,182,8,0,85,105,6 ème
COTES D'ARMOR,ROSTRENEN,0221038J,72,72,0,0,34,38,6 ème
COTES D'ARMOR,SAINT-BRIEUC,0220185G,163,162,0,1,82,81,6 ème
COTES D'ARMOR,SAINT-BRIEUC,0221867K,0,0,0,0,0,0,6 ème
FINISTERE,BREST,0290131K,58,56,0,2,25,33,6 ème
FINISTERE,CROZON,0290256W,52,52,0,0,27,25,6 ème
FINISTERE,FOUESNANT,0291101P,204,204,0,0,106,98,6 ème
FINISTERE,GUILVINEC,0290674A,32,32,0,0,15,17,6 ème
FINISTERE,GUIPAVAS,0291968G,118,115,0,3,58,60,6 ème
FINISTERE,LE CONQUET,0290106H,42,42,0,0,24,18,6 ème
FINISTERE,LE RELECQ-KERHUON,0290151G,93,85,8,0,41,52,6 ème
FINISTERE,PLOUDALMEZEAU,0291638Y,55,55,0,0,30,25,6 ème
FINISTERE,PLOUESCAT,0290293L,65,65,0,0,31,34,6 ème
FINISTERE,PLOUZANE,0291656T,88,88,0,0,40,48,6 ème
FINISTERE,PLOUZANE,0291929P,100,100,0,0,55,45,6 ème
FINISTERE,PONT-DE-BUIS-LES-QUIMERCH,0290093U,73,73,0,0,39,34,6 ème
FINISTERE,POULDREUZIC,0290304Y,55,55,0,0,34,21,6 ème
FINISTERE,QUIMPER,0290306A,110,110,0,0,37,73,6 ème
FINISTERE,QUIMPER,0290347V,10,0,10,0,5,5,6 ème
FINISTERE,ROSPORDEN,0290310E,66,66,0,0,28,38,6 ème
ILLE-ET-VILAINE,ARGENTRE-DU-PLESSIS,0350849H,171,171,0,0,87,84,6 ème
ILLE-ET-VILAINE,BAIN-DE-BRETAGNE,0350851K,192,187,0,5,85,107,6 ème
ILLE-ET-VILAINE,BAIN-DE-BRETAGNE,0350970P,139,109,26,4,70,69,6 ème
ILLE-ET-VILAINE,BRUZ,0350002M,141,117,24,0,69,72,6 ème
ILLE-ET-VILAINE,BRUZ,0350852L,326,326,0,0,153,173,6 ème
ILLE-ET-VILAINE,CANCALE,0350003N,111,111,0,0,65,46,6 ème
ILLE-ET-VILAINE,CESSON-SEVIGNE,0350793X,0,0,0,0,0,0,6 ème
ILLE-ET-VILAINE,CHATEAUGIRON,0350855P,157,154,0,3,70,87,6 ème
ILLE-ET-VILAINE,COMBOURG,0350857S,108,108,0,0,49,59,6 ème
ILLE-ET-VILAINE,FOUGERES,0350761M,0,0,0,0,0,0,6 ème
ILLE-ET-VILAINE,GUIPRY-MESSAC,0352957Z,130,130,0,0,63,67,6 ème
ILLE-ET-VILAINE,JANZE,0350866B,180,180,0,0,89,91,6 ème
ILLE-ET-VILAINE,LA RICHARDAIS,0353036K,153,153,0,0,87,66,6 ème
ILLE-ET-VILAINE,LIFFRE,0351790F,207,207,0,0,89,118,6 ème
ILLE-ET-VILAINE,MAEN ROCH,0350040D,68,68,0,0,37,31,6 ème
ILLE-ET-VILAINE,MONTAUBAN-DE-BRETAGNE,0352247C,184,184,0,0,87,97,6 ème
ILLE-ET-VILAINE,MORDELLES,0350874K,211,211,0,0,98,113,6 ème
ILLE-ET-VILAINE,MORDELLES,0352030S,134,132,0,2,71,63,6 ème
ILLE-ET-VILAINE,NOYAL-SUR-VILAINE,0352167R,148,148,0,0,76,72,6 ème
ILLE-ET-VILAINE,PACE,0352274G,181,180,0,1,94,87,6 ème
ILLE-ET-VILAINE,RENNES,0350030T,0,0,0,0,0,0,6 ème
ILLE-ET-VILAINE,RENNES,0350032V,0,0,0,0,0,0,6 ème
ILLE-ET-VILAINE,RENNES,0350839X,113,112,0,1,59,54,6 ème
ILLE-ET-VILAINE,RENNES,0350913C,99,85,14,0,47,52,6 ème
ILLE-ET-VILAINE,RENNES,0350965J,139,139,0,0,54,85,6 ème
ILLE-ET-VILAINE,SAINT-AUBIN-DU-CORMIER,0350882U,96,96,0,0,46,50,6 ème
ILLE-ET-VILAINE,SAINT-MALO,0350062C,0,0,0,0,0,0,6 ème
ILLE-ET-VILAINE,SAINT-MALO,0350889B,60,60,0,0,21,39,6 ème
ILLE-ET-VILAINE,SAINT-MALO,0352072M,0,0,0,0,0,0,6 ème
ILLE-ET-VILAINE,TINTENIAC,0350891D,225,208,17,0,119,106,6 ème
ILLE-ET-VILAINE,VAL D'ANAST,0350869E,49,49,0,0,20,29,6 ème
MORBIHAN,BRECH,0560023W,217,217,0,0,109,108,6 ème
MORBIHAN,CAUDAN,0560128K,66,66,0,0,29,37,6 ème
MORBIHAN,ELVEN,0561965G,138,138,0,0,70,68,6 ème
MORBIHAN,ETEL,0560008E,0,0,0,0,0,0,6 ème
MORBIHAN,GUIDEL,0560136U,179,173,0,6,84,95,6 ème
MORBIHAN,HENNEBONT,0560018R,171,171,0,0,78,93,6 ème
MORBIHAN,HENNEBONT,0561401U,170,166,0,4,77,93,6 ème
MORBIHAN,JOSSELIN,0561378U,66,66,0,0,30,36,6 ème
MORBIHAN,LANGUIDIC,0560143B,95,95,0,0,40,55,6 ème
MORBIHAN,MALANSAC,0561410D,73,71,0,2,41,32,6 ème
MORBIHAN,MALESTROIT,0560058J,92,92,0,0,40,52,6 ème
MORBIHAN,MAURON,0560152L,47,47,0,0,20,27,6 ème
MORBIHAN,MUZILLAC,0560033G,123,123,0,0,59,64,6 ème
MORBIHAN,MUZILLAC,0560153M,90,90,0,0,54,36,6 ème
MORBIHAN,PLOEMEUR,0560104J,120,120,0,0,59,61,6 ème
MORBIHAN,PLOERMEL,0560226S,75,59,10,6,26,49,6 ème
MORBIHAN,PLOUAY,0560037L,94,94,0,0,42,52,6 ème
MORBIHAN,PONTIVY,0560110R,254,230,16,8,130,124,6 ème
MORBIHAN,PONTIVY,0560182U,0,0,0,0,0,0,6 ème
MORBIHAN,PORT-LOUIS,0561379V,135,135,0,0,60,75,6 ème
MORBIHAN,PRIZIAC,0560197K,0,0,0,0,0,0,6 ème
MORBIHAN,QUIBERON,0561329R,38,38,0,0,19,19,6 ème
MORBIHAN,ROHAN,0560047X,59,59,0,0,34,25,6 ème
MORBIHAN,VANNES,0560198L,0,0,0,0,0,0,6 ème
CHER,AUBIGNY-SUR-NERE,0180002E,115,109,6,0,57,58,6 ème
CHER,AVORD,0180004G,88,88,0,0,38,50,6 ème
CHER,BOURGES,0180010N,0,0,0,0,0,0,6 ème
CHER,BOURGES,0180591V,146,145,0,1,70,76,6 ème
CHER,SAINT-AMAND-MONTROND,0180646E,86,85,0,1,44,42,6 ème
CHER,SAINT-AMAND-MONTROND,0180769N,116,105,10,1,55,61,6 ème
CHER,SANCERRE,0180031L,100,91,5,4,53,47,6 ème
CHER,VIERZON,0180644C,128,123,0,5,59,69,6 ème
EURE-ET-LOIR,ANET,0281038B,129,128,0,1,70,59,6 ème
EURE-ET-LOIR,AUNEAU-BLEURY-SAINT-SYMPHORIEN,0280001Z,152,138,14,0,62,90,6 ème
EURE-ET-LOIR,BONNEVAL,0280866P,165,159,0,6,85,80,6 ème
EURE-ET-LOIR,BREZOLLES,0280005D,76,74,0,2,35,41,6 ème
EURE-ET-LOIR,CHARTRES,0280044W,0,0,0,0,0,0,6 ème
EURE-ET-LOIR,CHARTRES,0280751P,117,101,15,1,51,66,6 ème
EURE-ET-LOIR,CHARTRES,0280883H,100,96,0,4,48,52,6 ème
EURE-ET-LOIR,CHATEAUDUN,0280656L,59,57,0,2,27,32,6 ème
EURE-ET-LOIR,CHATEAUNEUF-EN-THYMERAIS,0280016R,127,124,0,3,55,72,6 ème
EURE-ET-LOIR,DREUX,0280865N,102,92,10,0,50,52,6 ème
EURE-ET-LOIR,EPERNON,0280889P,143,143,0,0,81,62,6 ème
EURE-ET-LOIR,MAINTENON,0280033J,124,121,0,3,59,65,6 ème
EURE-ET-LOIR,NOGENT-LE-ROTROU,0280924C,88,86,0,2,47,41,6 ème
EURE-ET-LOIR,SAINT-MAURICE-SAINT-GERMAIN,0280741D,23,23,0,0,10,13,6 ème
EURE-ET-LOIR,VERNOUILLET,0280024Z,124,121,0,3,58,66,6 ème
INDRE,CHATEAUROUX,0360016X,106,103,0,3,52,54,6 ème
INDRE,CHATEAUROUX,0360567W,105,103,0,2,50,55,6 ème
INDRE,EGUZON-CHANTOME,0360023E,47,47,0,0,25,22,6 ème
INDRE,ISSOUDUN,0360568X,43,43,0,0,21,22,6 ème
INDRE,SAINT-GAULTIER,0360546Y,46,46,0,0,21,25,6 ème
INDRE-ET-LOIRE,AMBOISE,0371248F,111,110,0,1,60,51,6 ème
INDRE-ET-LOIRE,BOURGUEIL,0370733W,19,19,0,0,7,12,6 ème
INDRE-ET-LOIRE,BOURGUEIL,0370995F,100,100,0,0,47,53,6 ème
INDRE-ET-LOIRE,CHAMBRAY-LES-TOURS,0370741E,83,83,0,0,37,46,6 ème
INDRE-ET-LOIRE,CHATEAU-LA-VALLIERE,0370006F,55,46,9,0,24,31,6 ème
INDRE-ET-LOIRE,DESCARTES,0371192V,50,47,0,3,26,24,6 ème
INDRE-ET-LOIRE,LIGUEIL,0370015R,82,79,0,3,49,33,6 ème
INDRE-ET-LOIRE,L'ILE-BOUCHARD,0370013N,53,53,0,0,33,20,6 ème
INDRE-ET-LOIRE,LOCHES,0371329U,49,49,0,0,23,26,6 ème
INDRE-ET-LOIRE,NEUILLE-PONT-PIERRE,0370022Y,139,136,0,3,74,65,6 ème
INDRE-ET-LOIRE,NOUATRE,0370024A,29,29,0,0,14,15,6 ème
INDRE-ET-LOIRE,PREUILLY-SUR-CLAISE,0370026C,41,41,0,0,21,20,6 ème
INDRE-ET-LOIRE,SAINT-AVERTIN,0370887N,139,139,0,0,63,76,6 ème
INDRE-ET-LOIRE,SAINT-CYR-SUR-LOIRE,0370792K,74,71,0,3,38,36,6 ème
INDRE-ET-LOIRE,SAINT-PIERRE-DES-CORPS,0370767H,87,72,15,0,43,44,6 ème
INDRE-ET-LOIRE,TOURS,0370729S,194,181,10,3,103,91,6 ème
INDRE-ET-LOIRE,TOURS,0370745J,133,133,0,0,66,67,6 ème
INDRE-ET-LOIRE,TOURS,0370769K,100,100,0,0,51,49,6 ème
INDRE-ET-LOIRE,TOURS,0370771M,0,0,0,0,0,0,6 ème
INDRE-ET-LOIRE,TOURS,0371099U,0,0,0,0,0,0,6 ème
LOIRET,BEAUGENCY,0450005L,167,167,0,0,93,74,6 ème
LOIRET,CHALETTE-SUR-LOING,0451148D,136,136,0,0,67,69,6 ème
LOIRET,FLEURY-LES-AUBRAIS,0451067R,0,0,0,0,0,0,6 ème
LOIRET,JARGEAU,0451069T,153,153,0,0,76,77,6 ème
LOIRET,MEUNG-SUR-LOIRE,0450038X,127,111,15,1,66,61,6 ème
LOIRET,ORLEANS,0450936Y,175,162,10,3,96,79,6 ème
LOIRET,ORLEANS,0451070U,171,164,5,2,84,87,6 ème
LOIRET,ORLEANS,0451334F,230,230,0,0,107,123,6 ème
LOIRET,ORLEANS,0451421A,132,132,0,0,81,51,6 ème
LOIRET,PUISEAUX,0450063Z,108,107,0,1,54,54,6 ème
LOIRET,SAINTE-GENEVIEVE-DES-BOIS,0450016Y,121,112,0,9,52,69,6 ème
LOIRET,SAINT-JEAN-DE-BRAYE,0450064A,0,0,0,0,0,0,6 ème
LOIRET,SAINT-JEAN-DE-LA-RUELLE,0451241E,112,99,13,0,53,59,6 ème
LOIRET,SAINT-JEAN-LE-BLANC,0451074Y,105,101,0,4,52,53,6 ème
LOIRET,SARAN,0451038J,135,133,0,2,62,73,6 ème
LOIRET,SULLY-SUR-LOIRE,0450790P,102,101,0,1,45,57,6 ème
LOIR-ET-CHER,BLOIS,0410001D,0,0,0,0,0,0,6 ème
LOIR-ET-CHER,BLOIS,0410593X,167,154,11,2,85,82,6 ème
LOIR-ET-CHER,MER,0410681T,54,51,0,3,21,33,6 ème
LOIR-ET-CHER,ROMORANTIN-LANTHENAY,0410019Y,197,183,10,4,99,98,6 ème
LOIR-ET-CHER,SAINT-AIGNAN,0410718H,0,0,0,0,0,0,6 ème
LOIR-ET-CHER,VENDOME,0410688A,75,75,0,0,39,36,6 ème
CORSE-DU-SUD,AJACCIO,6200185G,75,75,0,0,40,35,6 ème
HAUTE-CORSE,BASTIA,7200624R,118,118,0,0,63,55,6 ème
HAUTE-CORSE,CORTE,7200004S,97,95,0,2,53,44,6 ème
HAUTE-CORSE,LUCCIANA,7200053V,208,200,0,8,109,99,6 ème
HAUTE-CORSE,PENTA-DI-CASINCA,7200160L,118,115,3,0,44,74,6 ème
HAUTE-CORSE,SAINT-FLORENT,7200044K,62,62,0,0,36,26,6 ème
MEURTHE-ET-MOSELLE,ART-SUR-MEURTHE,0542449U,18,18,0,0,6,12,6 ème
MEURTHE-ET-MOSELLE,BAYON,0541852V,125,125,0,0,69,56,6 ème
MEURTHE-ET-MOSELLE,FLAVIGNY-SUR-MOSELLE,0541268K,17,17,0,0,5,12,6 ème
MEURTHE-ET-MOSELLE,FROUARD,0541326Y,77,74,0,3,29,48,6 ème
MEURTHE-ET-MOSELLE,HOMECOURT,0541471F,146,146,0,0,65,81,6 ème
MEURTHE-ET-MOSELLE,JARNY,0541331D,92,92,0,0,53,39,6 ème
MEURTHE-ET-MOSELLE,LONGLAVILLE,0541605B,0,0,0,0,0,0,6 ème
MEURTHE-ET-MOSELLE,LONGWY,0540030P,0,0,0,0,0,0,6 ème
MEURTHE-ET-MOSELLE,NANCY,0540081V,0,0,0,0,0,0,6 ème
MEURTHE-ET-MOSELLE,NANCY,0540110B,136,120,16,0,53,83,6 ème
MEURTHE-ET-MOSELLE,NANCY,0541327Z,77,77,0,0,33,44,6 ème
MEURTHE-ET-MOSELLE,NANCY,0541501N,93,91,0,2,47,46,6 ème
MEURTHE-ET-MOSELLE,NANCY,0541995A,185,185,0,0,87,98,6 ème
MEURTHE-ET-MOSELLE,NANCY,0542409A,22,20,0,2,14,8,6 ème
MEURTHE-ET-MOSELLE,NOMENY,0540054R,81,81,0,0,39,42,6 ème
MEURTHE-ET-MOSELLE,PAGNY-SUR-MOSELLE,0541567K,88,88,0,0,42,46,6 ème
MEURTHE-ET-MOSELLE,PIENNES,0541332E,82,82,0,0,38,44,6 ème
MEURTHE-ET-MOSELLE,PONT-A-MOUSSON,0540112D,138,135,0,3,65,73,6 ème
MEURTHE-ET-MOSELLE,TOMBLAINE,0540061Y,0,0,0,0,0,0,6 ème
MEURTHE-ET-MOSELLE,TOUL,0540067E,0,0,0,0,0,0,6 ème
MEURTHE-ET-MOSELLE,TUCQUEGNIEUX,0541333F,90,86,0,4,43,47,6 ème
MEURTHE-ET-MOSELLE,VAL DE BRIEY,0541985P,95,95,0,0,46,49,6 ème
MEURTHE-ET-MOSELLE,VILLERUPT,0542418K,201,185,14,2,97,104,6 ème
MEUSE,BAR-LE-DUC,0550701N,69,58,8,3,35,34,6 ème
MEUSE,REVIGNY-SUR-ORNAIN,0550018W,77,75,0,2,30,47,6 ème
MEUSE,VERDUN,0550024C,122,120,0,2,76,46,6 ème
MEUSE,VERDUN,0550758A,63,63,0,0,34,29,6 ème
MOSELLE,ALBESTROFF,0572691R,75,75,0,0,35,40,6 ème
MOSELLE,BEHREN-LES-FORBACH,0573268T,87,86,1,0,39,48,6 ème
MOSELLE,CATTENOM,0571994H,90,90,0,0,39,51,6 ème
MOSELLE,DIEUZE,0570279U,0,0,0,0,0,0,6 ème
MOSELLE,DIEUZE,0572814Z,107,98,0,9,54,53,6 ème
MOSELLE,FAMECK,0573269U,217,216,0,1,117,100,6 ème
MOSELLE,FLORANGE,0570317K,133,122,8,3,67,66,6 ème
MOSELLE,FONTOY,0572009Z,122,120,0,2,63,59,6 ème
MOSELLE,HETTANGE-GRANDE,0572025S,167,159,0,8,73,94,6 ème
MOSELLE,LE BAN-SAINT-MARTIN,0570128E,150,148,0,2,73,77,6 ème
MOSELLE,LEMBERG,0572020L,65,65,0,0,31,34,6 ème
MOSELLE,MAIZIERES-LES-METZ,0572164T,220,215,4,1,101,119,6 ème
MOSELLE,METZ,0570061G,0,0,0,0,0,0,6 ème
MOSELLE,METZ,0572348T,120,113,6,1,58,62,6 ème
MOSELLE,METZ,0572350V,102,87,7,8,44,58,6 ème
MOSELLE,MORHANGE,0570073V,114,97,6,11,61,53,6 ème
MOSELLE,PETITE-ROSSELLE,0572493A,65,65,0,0,35,30,6 ème
MOSELLE,PHALSBOURG,0572815A,130,127,0,3,54,76,6 ème
MOSELLE,SAINT-AVOLD,0570143W,101,98,0,3,54,47,6 ème
MOSELLE,SARREBOURG,0570097W,113,100,12,1,60,53,6 ème
MOSELLE,SARREGUEMINES,0572930A,100,100,0,0,49,51,6 ème
MOSELLE,STIRING-WENDEL,0570104D,116,112,0,4,64,52,6 ème
MOSELLE,WOIPPY,0572579U,103,100,0,3,48,55,6 ème
VOSGES,BRUYERES,0880005C,108,101,2,5,55,53,6 ème
VOSGES,BRUYERES,0880133S,0,0,0,0,0,0,6 ème
VOSGES,EPINAL,0880021V,0,0,0,0,0,0,6 ème
VOSGES,EPINAL,0880150K,153,153,0,0,70,83,6 ème
VOSGES,EPINAL,0881496Y,177,177,0,0,93,84,6 ème
VOSGES,FRAIZE,0881410E,77,74,0,3,29,48,6 ème
VOSGES,LA BRESSE,0880105L,31,31,0,0,13,18,6 ème
VOSGES,LE THOLY,0881148V,40,40,0,0,21,19,6 ème
VOSGES,MARTIGNY-LES-BAINS,0880108P,20,20,0,0,8,12,6 ème
VOSGES,RUPT-SUR-MOSELLE,0880054F,40,40,0,0,21,19,6 ème
VOSGES,SAINT-DIE-DES-VOSGES,0880057J,0,0,0,0,0,0,6 ème
VOSGES,SAINT-DIE-DES-VOSGES,0880100F,60,56,0,4,29,31,6 ème
VOSGES,XERTIGNY,0881369K,95,83,7,5,44,51,6 ème
ARDENNES,CHARLEVILLE-MEZIERES,0080028M,0,0,0,0,0,0,6 ème
ARDENNES,CHARLEVILLE-MEZIERES,0080079T,52,50,2,0,22,30,6 ème
ARDENNES,CHARLEVILLE-MEZIERES,0080925M,69,64,0,5,38,31,6 ème
ARDENNES,DOUZY,0080016Z,79,79,0,0,39,40,6 ème
ARDENNES,GIVET,0080948M,84,84,0,0,42,42,6 ème
ARDENNES,RETHEL,0080088C,56,56,0,0,31,25,6 ème
ARDENNES,REVIN,0080949N,87,84,0,3,42,45,6 ème
ARDENNES,ROCROI,0081098A,57,57,0,0,20,37,6 ème
ARDENNES,VOUZIERS,0081097Z,82,70,12,0,44,38,6 ème
AUBE,BAR-SUR-AUBE,0100902B,115,103,9,3,54,61,6 ème
AUBE,ROMILLY-SUR-SEINE,0100054E,86,86,0,0,45,41,6 ème
AUBE,SAINTE-SAVINE,0100055F,64,64,0,0,30,34,6 ème
AUBE,TROYES,0100081J,221,203,13,5,91,130,6 ème
AUBE,TROYES,0100945Y,0,0,0,0,0,0,6 ème
AUBE,TROYES,0100961R,101,101,0,0,45,56,6 ème
HAUTE-MARNE,LANGRES,0520040L,144,128,14,2,70,74,6 ème
MARNE,CHALONS-EN-CHAMPAGNE,0510010J,126,125,0,1,64,62,6 ème
MARNE,CHALONS-EN-CHAMPAGNE,0511129A,202,202,0,0,101,101,6 ème
MARNE,EPERNAY,0511327R,123,107,11,5,60,63,6 ème
MARNE,FISMES,0511188P,129,127,2,0,61,68,6 ème
MARNE,REIMS,0511145T,0,0,0,0,0,0,6 ème
MARNE,REIMS,0511178D,158,156,0,2,86,72,6 ème
MARNE,REIMS,0511179E,132,132,0,0,64,68,6 ème
MARNE,REIMS,0511180F,128,128,0,0,73,55,6 ème
MARNE,REIMS,0511214T,95,86,8,1,45,50,6 ème
MARNE,REIMS,0511470W,156,134,15,7,73,83,6 ème
MARNE,SAINT-THIERRY,0510051D,131,131,0,0,65,66,6 ème
MARNE,SUIPPES,0510056J,98,95,0,3,43,55,6 ème
MARNE,VERZY,0510060N,101,101,0,0,43,58,6 ème
BAS-RHIN,ACHENHEIM,0671686U,124,121,0,3,75,49,6 ème
BAS-RHIN,BENFELD,0670003P,188,185,0,3,96,92,6 ème
BAS-RHIN,DAMBACH-LA-VILLE,0670011Y,86,85,0,1,36,50,6 ème
BAS-RHIN,DRUSENHEIM,0672074R,114,114,0,0,58,56,6 ème
BAS-RHIN,DUTTLENHEIM,0672896J,123,119,0,4,63,60,6 ème
BAS-RHIN,HAGUENAU,0672136H,147,146,0,1,68,79,6 ème
BAS-RHIN,HAGUENAU,0672298J,127,127,0,0,64,63,6 ème
BAS-RHIN,HERRLISHEIM,0671911N,96,96,0,0,38,58,6 ème
BAS-RHIN,ILLKIRCH-GRAFFENSTADEN,0670087F,0,0,0,0,0,0,6 ème
BAS-RHIN,MERTZWILLER,0671912P,71,64,0,7,34,37,6 ème
BAS-RHIN,MOLSHEIM,0672131C,81,78,0,3,41,40,6 ème
BAS-RHIN,MUTZIG,0671828Y,165,159,0,6,76,89,6 ème
BAS-RHIN,OBERNAI,0672132D,111,109,0,2,52,59,6 ème
BAS-RHIN,OSTWALD,0672072N,142,139,0,3,69,73,6 ème
BAS-RHIN,ROSHEIM,0671913R,151,151,0,0,69,82,6 ème
BAS-RHIN,SARRE-UNION,0670056X,114,107,5,2,47,67,6 ème
BAS-RHIN,SAVERNE,0671986V,126,103,15,8,54,72,6 ème
BAS-RHIN,SCHILTIGHEIM,0670066H,188,169,13,6,96,92,6 ème
BAS-RHIN,SCHIRMECK,0670068K,87,86,0,1,38,49,6 ème
BAS-RHIN,SCHWEIGHOUSE-SUR-MODER,0671960S,118,116,0,2,69,49,6 ème
BAS-RHIN,SELESTAT,0672134F,110,109,0,1,52,58,6 ème
BAS-RHIN,STRASBOURG,0671590P,185,174,10,1,75,110,6 ème
BAS-RHIN,STRASBOURG,0671825V,142,142,0,0,77,65,6 ème
BAS-RHIN,STRASBOURG,0671909L,104,99,0,5,54,50,6 ème
BAS-RHIN,STRASBOURG,0671915T,177,177,0,0,81,96,6 ème
BAS-RHIN,STRASBOURG,0672301M,198,198,0,0,102,96,6 ème
BAS-RHIN,STRASBOURG,0672459J,79,62,14,3,41,38,6 ème
BAS-RHIN,STRASBOURG,0673079H,81,81,0,0,40,41,6 ème
BAS-RHIN,STRASBOURG,0673178R,60,60,0,0,31,29,6 ème
BAS-RHIN,SUNDHOUSE,0670106B,130,129,0,1,71,59,6 ème
BAS-RHIN,TRUCHTERSHEIM,0670107C,168,168,0,0,86,82,6 ème
BAS-RHIN,WOERTH,0671596W,113,111,0,2,49,64,6 ème
HAUT-RHIN,ALTKIRCH,0680001G,0,0,0,0,0,0,6 ème
HAUT-RHIN,CERNAY,0680006M,175,171,0,4,87,88,6 ème
HAUT-RHIN,COLMAR,0680010S,0,0,0,0,0,0,6 ème
HAUT-RHIN,COLMAR,0680088B,125,117,0,8,50,75,6 ème
HAUT-RHIN,COLMAR,0681123B,180,160,16,4,85,95,6 ème
HAUT-RHIN,COLMAR,0681659J,183,183,0,0,88,95,6 ème
HAUT-RHIN,ENSISHEIM,0680013V,187,170,12,5,90,97,6 ème
HAUT-RHIN,HEGENHEIM,0681268J,179,179,0,0,81,98,6 ème
HAUT-RHIN,INGERSHEIM,0681817F,0,0,0,0,0,0,6 ème
HAUT-RHIN,LANDSER,0681660K,148,148,0,0,73,75,6 ème
HAUT-RHIN,MULHOUSE,0680039Y,0,0,0,0,0,0,6 ème
HAUT-RHIN,MULHOUSE,0680111B,140,119,15,6,70,70,6 ème
HAUT-RHIN,MULHOUSE,0681127F,182,164,12,6,98,84,6 ème
HAUT-RHIN,PFASTATT,0681267H,107,102,0,5,47,60,6 ème
HAUT-RHIN,RIBEAUVILLE,0680101R,185,172,12,1,79,106,6 ème
HAUT-RHIN,RIEDISHEIM,0680136D,179,179,0,0,90,89,6 ème
HAUT-RHIN,ROUFFACH,0681366R,104,100,0,4,45,59,6 ème
HAUT-RHIN,THANN,0681368T,133,112,15,6,61,72,6 ème
HAUT-RHIN,WITTELSHEIM,0681888H,0,0,0,0,0,0,6 ème
GUADELOUPE,ANSE-BERTRAND,9710025A,49,49,0,0,25,24,6 ème
GUADELOUPE,BAIE-MAHAULT,9711086D,178,175,0,3,102,76,6 ème
GUADELOUPE,BAILLIF,9710041T,48,48,0,0,25,23,6 ème
GUADELOUPE,BASSE-TERRE,9710985U,126,126,0,0,66,60,6 ème
GUADELOUPE,CAPESTERRE-DE-MARIE-GALANTE,9710032H,14,14,0,0,7,7,6 ème
GUADELOUPE,LE MOULE,9710015P,121,111,10,0,62,59,6 ème
GUADELOUPE,PETIT-CANAL,9710028D,87,84,0,3,50,37,6 ème
GUADELOUPE,POINTE-A-PITRE,9710686U,84,69,10,5,44,40,6 ème
GUADELOUPE,POINTE-A-PITRE,9710722H,0,0,0,0,0,0,6 ème
GUADELOUPE,POINTE-NOIRE,9710029E,51,51,0,0,29,22,6 ème
GUADELOUPE,SAINT-CLAUDE,9710036M,140,140,0,0,71,69,6 ème
GUADELOUPE,SAINTE-ANNE,9710687V,73,72,0,1,31,42,6 ème
GUADELOUPE,SAINT-MARTIN,9710022X,222,201,16,5,103,119,6 ème
GUADELOUPE,TERRE-DE-HAUT,9711155D,19,19,0,0,12,7,6 ème
GUYANE,CAYENNE,9730091L,174,163,0,11,79,95,6 ème
GUYANE,IRACOUBO,9730219A,52,47,5,0,29,23,6 ème
GUYANE,REMIRE-MONTJOLY,9730370P,161,158,0,3,81,80,6 ème
GUYANE,ROURA,9730289B,41,41,0,0,20,21,6 ème
GUYANE,SAINT-LAURENT-DU-MARONI,9730329V,300,272,27,1,158,142,6 ème
AISNE,BELLEU,0021659T,118,118,0,0,62,56,6 ème
AISNE,BOHAIN-EN-VERMANDOIS,0022131F,60,60,0,0,37,23,6 ème
AISNE,CHATEAU-THIERRY,0021724N,160,160,0,0,80,80,6 ème
AISNE,CHAUNY,0022008X,0,0,0,0,0,0,6 ème
AISNE,LA CAPELLE,0021595Y,102,101,0,1,44,58,6 ème
AISNE,LA FERE,0022210S,0,0,0,0,0,0,6 ème
AISNE,LE NOUVION-EN-THIERACHE,0020039G,78,74,0,4,42,36,6 ème
AISNE,LIESSE-NOTRE-DAME,0020472C,35,35,0,0,15,20,6 ème
AISNE,SAINT-GOBAIN,0020046P,74,69,0,5,43,31,6 ème
AISNE,SAINT-MICHEL,0021663X,51,51,0,0,25,26,6 ème
AISNE,SAINT-QUENTIN,0020079A,0,0,0,0,0,0,6 ème
AISNE,SISSONNE,0021686X,116,115,0,1,54,62,6 ème
AISNE,SOISSONS,0021492L,117,110,7,0,56,61,6 ème
AISNE,SOISSONS,0021691C,111,102,0,9,64,47,6 ème
AISNE,SOISSONS,0022180J,0,0,0,0,0,0,6 ème
AISNE,VILLERS-COTTERETS,0021688Z,124,118,4,2,62,62,6 ème
AISNE,WASSIGNY,0020072T,62,56,0,6,29,33,6 ème
OISE,AGNETZ,0601155E,240,236,0,4,106,134,6 ème
OISE,BEAUVAIS,0600007G,185,178,0,7,86,99,6 ème
OISE,BEAUVAIS,0601162M,0,0,0,0,0,0,6 ème
OISE,BORNEL,0602077G,136,133,0,3,66,70,6 ème
OISE,BREUIL-LE-VERT,0601787S,0,0,0,0,0,0,6 ème
OISE,CAUFFRY,0601607W,177,159,16,2,86,91,6 ème
OISE,COMPIEGNE,0601524F,91,79,10,2,35,56,6 ème
OISE,COULOISY,0600028E,147,147,0,0,68,79,6 ème
OISE,CREIL,0600022Y,153,153,0,0,64,89,6 ème
OISE,CREIL,0601177D,192,179,12,1,99,93,6 ème
OISE,ESTREES-SAINT-DENIS,0601432F,231,231,0,0,106,125,6 ème
OISE,FORMERIE,0601469W,129,114,14,1,57,72,6 ème
OISE,GRANDVILLIERS,0600030G,111,105,0,6,54,57,6 ème
OISE,LA CHAPELLE-EN-SERVAL,0601766U,90,90,0,0,44,46,6 ème
OISE,LASSIGNY,0601970R,90,90,0,0,50,40,6 ème
OISE,MAIGNELAY-MONTIGNY,0601180G,79,77,0,2,39,40,6 ème
OISE,MARGNY-LES-COMPIEGNE,0601193W,154,142,10,2,81,73,6 ème
OISE,NOAILLES,0601443T,210,209,0,1,107,103,6 ème
OISE,NOYON,0600041U,0,0,0,0,0,0,6 ème
OISE,NOYON,0601158H,69,69,0,0,32,37,6 ème
OISE,NOYON,0601605U,164,163,0,1,92,72,6 ème
OISE,PONT-SAINTE-MAXENCE,0601296H,109,106,0,3,53,56,6 ème
OISE,SENLIS,0600050D,88,88,0,0,46,42,6 ème
OISE,SENLIS,0601367K,112,104,8,0,58,54,6 ème
SOMME,ABBEVILLE,0801368C,102,101,0,1,57,45,6 ème
SOMME,ABBEVILLE,0801512J,182,159,17,6,88,94,6 ème
SOMME,AILLY-LE-HAUT-CLOCHER,0801372G,75,71,0,4,36,39,6 ème
SOMME,ALBERT,0801375K,83,79,0,4,38,45,6 ème
SOMME,AMIENS,0800013E,0,0,0,0,0,0,6 ème
SOMME,AMIENS,0801263N,108,105,0,3,51,57,6 ème
SOMME,AMIENS,0801533G,115,111,0,4,62,53,6 ème
SOMME,AMIENS,0801628K,0,0,0,0,0,0,6 ème
SOMME,AMIENS,0801949J,0,0,0,0,0,0,6 ème
SOMME,HAM,0801252B,0,0,0,0,0,0,6 ème
SOMME,MONTDIDIER,0801853E,0,0,0,0,0,0,6 ème
SOMME,OISEMONT,0800045P,66,66,0,0,36,30,6 ème
SOMME,PERONNE,0801951L,0,0,0,0,0,0,6 ème
SOMME,ROSIERES-EN-SANTERRE,0800051W,81,79,0,2,39,42,6 ème
SOMME,RUE,0801489J,84,84,0,0,31,53,6 ème
NORD,ANICHE,0592610S,0,0,0,0,0,0,6 ème
NORD,ANZIN,0590006L,140,140,0,0,73,67,6 ème
NORD,ARLEUX,0594401N,215,206,6,3,107,108,6 ème
NORD,ARMENTIERES,0592946G,70,70,0,0,36,34,6 ème
NORD,AVESNES-SUR-HELPE,0595384G,72,72,0,0,37,35,6 ème
NORD,BAVAY,0593490Y,151,150,0,1,65,86,6 ème
NORD,BERGUES,0592933T,107,107,0,0,48,59,6 ème
NORD,BRUAY-SUR-L'ESCAUT,0590031N,136,127,8,1,68,68,6 ème
NORD,CAMBRAI,0593171B,264,261,0,3,129,135,6 ème
NORD,COUDEKERQUE-BRANCHE,0593120W,84,81,3,0,48,36,6 ème
NORD,CYSOING,0590057S,200,196,0,4,103,97,6 ème
NORD,CYSOING,0592960X,225,225,0,0,122,103,6 ème
NORD,DECHY,0590058T,112,112,0,0,62,50,6 ème
NORD,DOUAI,0594402P,146,141,5,0,63,83,6 ème
NORD,DOUAI,0595190W,65,65,0,0,29,36,6 ème
NORD,DUNKERQUE,0593058D,0,0,0,0,0,0,6 ème
NORD,DUNKERQUE,0593663L,102,93,9,0,56,46,6 ème
NORD,DUNKERQUE,0593664M,95,94,0,1,54,41,6 ème
NORD,DUNKERQUE,0593666P,134,127,4,3,63,71,6 ème
NORD,ESTAIRES,0593103C,77,77,0,0,31,46,6 ème
NORD,FLINES-LEZ-RACHES,0590082U,84,84,0,0,38,46,6 ème
NORD,FOURMIES,0595177G,44,44,0,0,24,20,6 ème
NORD,GRAVELINES,0593123Z,87,87,0,0,37,50,6 ème
NORD,HAZEBROUCK,0595170Z,202,202,0,0,109,93,6 ème
NORD,IWUY,0590107W,72,72,0,0,30,42,6 ème
NORD,JEUMONT,0590109Y,60,57,0,3,32,28,6 ème
NORD,LA BASSEE,0592950L,210,210,0,0,98,112,6 ème
NORD,LAMBERSART,0595163S,75,66,9,0,30,45,6 ème
NORD,LEERS,0595713P,140,140,0,0,68,72,6 ème
NORD,LILLE,0590111A,0,0,0,0,0,0,6 ème
NORD,LILLE,0593006X,0,0,0,0,0,0,6 ème
NORD,LILLE,0596957S,0,0,0,0,0,0,6 ème
NORD,LINSELLES,0596172N,73,67,0,6,33,40,6 ème
NORD,LOOS,0590133Z,0,0,0,0,0,0,6 ème
NORD,LOOS,0593233U,99,99,0,0,49,50,6 ème
NORD,LOOS,0594541R,11,11,0,0,5,6,6 ème
NORD,LOURCHES,0594533G,120,117,0,3,66,54,6 ème
NORD,LOUVROIL,0593686L,80,80,0,0,30,50,6 ème
NORD,MARCQ-EN-BAROEUL,0595398X,418,418,0,0,200,218,6 ème
NORD,MARCQ-EN-BAROEUL,0597115N,41,41,0,0,21,20,6 ème
NORD,MAUBEUGE,0590151U,81,79,0,2,45,36,6 ème
NORD,MAUBEUGE,0593254S,81,75,2,4,35,46,6 ème
NORD,MOUVAUX,0594527A,84,83,0,1,40,44,6 ème
NORD,NIEPPE,0596988A,115,110,0,5,51,64,6 ème
NORD,ONNAING,0590157A,113,113,0,0,56,57,6 ème
NORD,QUIEVRECHAIN,0594303G,114,114,0,0,51,63,6 ème
NORD,RONCHIN,0594865T,86,84,0,2,40,46,6 ème
NORD,ROUBAIX,0592886S,130,130,0,0,66,64,6 ème
NORD,ROUBAIX,0592963A,0,0,0,0,0,0,6 ème
NORD,ROUBAIX,0595167W,78,77,0,1,43,35,6 ème
NORD,ROUBAIX,0595302T,221,218,0,3,110,111,6 ème
NORD,SAINT-AMAND-LES-EAUX,0590192N,0,0,0,0,0,0,6 ème
NORD,SAINT-AMAND-LES-EAUX,0594411Z,203,195,6,2,86,117,6 ème
NORD,SECLIN,0592833J,0,0,0,0,0,0,6 ème
NORD,SECLIN,0593662K,118,107,11,0,64,54,6 ème
NORD,SOMAIN,0592976P,0,0,0,0,0,0,6 ème
NORD,TOURCOING,0590217R,0,0,0,0,0,0,6 ème
NORD,TOURCOING,0592965C,0,0,0,0,0,0,6 ème
NORD,TOURCOING,0592980U,0,0,0,0,0,0,6 ème
NORD,VALENCIENNES,0590224Y,126,126,0,0,62,64,6 ème
NORD,VIEUX-CONDE,0594412A,167,161,3,3,88,79,6 ème
NORD,VILLENEUVE-D'ASCQ,0595328W,120,114,6,0,51,69,6 ème
NORD,VILLENEUVE-D'ASCQ,0595404D,377,377,0,0,197,180,6 ème
NORD,WATTIGNIES,0595597N,116,116,0,0,57,59,6 ème
NORD,WATTRELOS,0593160P,355,355,0,0,202,153,6 ème
NORD,WATTRELOS,0594392D,62,62,0,0,30,32,6 ème
NORD,WATTRELOS,0595169Y,75,72,0,3,31,44,6 ème
NORD,WORMHOUT,0594643B,121,121,0,0,60,61,6 ème
PAS-DE-CALAIS,AIRE-SUR-LA-LYS,0622100W,247,247,0,0,124,123,6 ème
PAS-DE-CALAIS,ARRAS,0620011A,0,0,0,0,0,0,6 ème
PAS-DE-CALAIS,ARRAS,0622789V,94,91,0,3,40,54,6 ème
PAS-DE-CALAIS,ARRAS,0624343J,78,65,0,13,31,47,6 ème
PAS-DE-CALAIS,AUCHEL,0623313P,87,87,0,0,37,50,6 ème
PAS-DE-CALAIS,AUCHY-LES-HESDIN,0622097T,46,46,0,0,22,24,6 ème
PAS-DE-CALAIS,AUXI-LE-CHATEAU,0620025R,56,56,0,0,32,24,6 ème
PAS-DE-CALAIS,AVESNES-LE-COMTE,0620026S,113,105,5,3,60,53,6 ème
PAS-DE-CALAIS,AVION,0622420U,97,92,3,2,39,58,6 ème
PAS-DE-CALAIS,AVION,0622422W,110,110,0,0,50,60,6 ème
PAS-DE-CALAIS,BETHUNE,0622129C,139,139,0,0,61,78,6 ème
PAS-DE-CALAIS,BETHUNE,0622947S,165,160,5,0,91,74,6 ème
PAS-DE-CALAIS,BRUAY-LA-BUISSIERE,0623314R,101,101,0,0,57,44,6 ème
PAS-DE-CALAIS,CALAIS,0622211S,0,0,0,0,0,0,6 ème
PAS-DE-CALAIS,COULOGNE,0620073T,136,133,0,3,64,72,6 ème
PAS-DE-CALAIS,COURCELLES-LES-LENS,0622943M,124,114,8,2,67,57,6 ème
PAS-DE-CALAIS,DESVRES,0622135J,74,74,0,0,27,47,6 ème
PAS-DE-CALAIS,FRUGES,0620085F,91,91,0,0,41,50,6 ème
PAS-DE-CALAIS,HENIN-BEAUMONT,0623328F,0,0,0,0,0,0,6 ème
PAS-DE-CALAIS,HERSIN-COUPIGNY,0620097U,90,90,0,0,35,55,6 ème
PAS-DE-CALAIS,LAVENTIE,0622427B,172,172,0,0,81,91,6 ème
PAS-DE-CALAIS,LENS,0622115M,290,288,0,2,136,154,6 ème
PAS-DE-CALAIS,LE PORTEL,0622095R,130,130,0,0,62,68,6 ème
PAS-DE-CALAIS,LIEVIN,0623377J,0,0,0,0,0,0,6 ème
PAS-DE-CALAIS,MARCK,0622873L,148,148,0,0,71,77,6 ème
PAS-DE-CALAIS,MARLES-LES-MINES,0622272H,118,115,0,3,57,61,6 ème
PAS-DE-CALAIS,NORRENT-FONTES,0620195A,102,102,0,0,57,45,6 ème
PAS-DE-CALAIS,NOYELLES-SOUS-LENS,0623016S,95,95,0,0,47,48,6 ème
PAS-DE-CALAIS,OUTREAU,0620221D,0,0,0,0,0,0,6 ème
PAS-DE-CALAIS,PAS-EN-ARTOIS,0623112W,96,96,0,0,45,51,6 ème
PAS-DE-CALAIS,SAINT-OMER,0620165T,161,159,0,2,84,77,6 ème
PAS-DE-CALAIS,SAINT-OMER,0622119S,38,34,0,4,16,22,6 ème
PAS-DE-CALAIS,SAINT-POL-SUR-TERNOISE,0622790W,138,138,0,0,79,59,6 ème
PAS-DE-CALAIS,THEROUANNE,0620172A,183,180,0,3,74,109,6 ème
PAS-DE-CALAIS,VERMELLES,0623022Y,116,113,0,3,56,60,6 ème
SEINE-ET-MARNE,AVON,0771422C,129,117,11,1,57,72,6 ème
SEINE-ET-MARNE,CESSON,0771662N,106,104,0,2,53,53,6 ème
SEINE-ET-MARNE,CHAMPAGNE-SUR-SEINE,0771342R,160,147,10,3,71,89,6 ème
SEINE-ET-MARNE,CHELLES,0771766B,150,136,12,2,79,71,6 ème
SEINE-ET-MARNE,COULOMMIERS,0770924L,0,0,0,0,0,0,6 ème
SEINE-ET-MARNE,CRECY-LA-CHAPELLE,0771667U,174,170,0,4,97,77,6 ème
SEINE-ET-MARNE,CREGY-LES-MEAUX,0772248A,152,151,0,1,69,83,6 ème
SEINE-ET-MARNE,FONTAINEBLEAU,0771424E,121,121,0,0,66,55,6 ème
SEINE-ET-MARNE,JUILLY,0771917R,127,127,0,0,62,65,6 ème
SEINE-ET-MARNE,LA FERTE-GAUCHER,0771661M,174,159,12,3,66,108,6 ème
SEINE-ET-MARNE,LA FERTE-SOUS-JOUARRE,0771222K,117,117,0,0,60,57,6 ème
SEINE-ET-MARNE,LA FERTE-SOUS-JOUARRE,0771659K,139,123,16,0,76,63,6 ème
SEINE-ET-MARNE,LAGNY-SUR-MARNE,0771768D,148,135,13,0,73,75,6 ème
SEINE-ET-MARNE,LE MEE-SUR-SEINE,0772056S,151,145,0,6,73,78,6 ème
SEINE-ET-MARNE,LIEUSAINT,0772429X,101,98,0,3,53,48,6 ème
SEINE-ET-MARNE,LOGNES,0772125S,92,92,0,0,56,36,6 ème
SEINE-ET-MARNE,LORREZ-LE-BOCAGE-PREAUX,0770030P,145,143,0,2,64,81,6 ème
SEINE-ET-MARNE,MEAUX,0771029A,144,144,0,0,62,82,6 ème
SEINE-ET-MARNE,MEAUX,0771173G,138,138,0,0,68,70,6 ème
SEINE-ET-MARNE,MELUN,0770934X,0,0,0,0,0,0,6 ème
SEINE-ET-MARNE,MITRY-MORY,0771331D,155,143,12,0,66,89,6 ème
SEINE-ET-MARNE,MONTEREAU-FAULT-YONNE,0771174H,132,132,0,0,59,73,6 ème
SEINE-ET-MARNE,NOISIEL,0771940R,0,0,0,0,0,0,6 ème
SEINE-ET-MARNE,PERTHES,0772427V,137,137,0,0,71,66,6 ème
SEINE-ET-MARNE,ROISSY-EN-BRIE,0771563F,176,176,0,0,94,82,6 ème
SEINE-ET-MARNE,SAINT-GERMAIN-SUR-MORIN,0772714G,139,137,0,2,70,69,6 ème
SEINE-ET-MARNE,SAINT-THIBAULT-DES-VIGNES,0772154Y,145,143,0,2,71,74,6 ème
SEINE-ET-MARNE,TRILPORT,0772091E,132,130,0,2,65,67,6 ème
SEINE-ET-MARNE,VILLEPARISIS,0771878Y,143,124,15,4,64,79,6 ème
SEINE-SAINT-DENIS,AUBERVILLIERS,0930903B,112,112,0,0,55,57,6 ème
SEINE-SAINT-DENIS,AUBERVILLIERS,0932122B,0,0,0,0,0,0,6 ème
SEINE-SAINT-DENIS,AULNAY-SOUS-BOIS,0930846P,0,0,0,0,0,0,6 ème
SEINE-SAINT-DENIS,AULNAY-SOUS-BOIS,0931434D,136,128,0,8,52,84,6 ème
SEINE-SAINT-DENIS,AULNAY-SOUS-BOIS,0932652C,62,62,0,0,26,36,6 ème
SEINE-SAINT-DENIS,DRANCY,0930892P,168,168,0,0,81,87,6 ème
SEINE-SAINT-DENIS,DUGNY,0931376R,178,174,0,4,85,93,6 ème
SEINE-SAINT-DENIS,EPINAY-SUR-SEINE,0931145P,189,176,13,0,90,99,6 ème
SEINE-SAINT-DENIS,EPINAY-SUR-SEINE,0931207G,130,125,0,5,65,65,6 ème
SEINE-SAINT-DENIS,LA COURNEUVE,0931188L,169,168,0,1,81,88,6 ème
SEINE-SAINT-DENIS,LA COURNEUVE,0931738J,0,0,0,0,0,0,6 ème
SEINE-SAINT-DENIS,LE RAINCY,0930629D,210,210,0,0,99,111,6 ème
SEINE-SAINT-DENIS,LES PAVILLONS-SOUS-BOIS,0930089S,169,167,0,2,88,81,6 ème
SEINE-SAINT-DENIS,LES PAVILLONS-SOUS-BOIS,0930966V,78,78,0,0,36,42,6 ème
SEINE-SAINT-DENIS,MONTREUIL,0931210K,133,128,0,5,66,67,6 ème
SEINE-SAINT-DENIS,NEUILLY-PLAISANCE,0930623X,184,183,0,1,101,83,6 ème
SEINE-SAINT-DENIS,NEUILLY-SUR-MARNE,0930894S,196,179,15,2,86,110,6 ème
SEINE-SAINT-DENIS,NOISY-LE-GRAND,0931369H,0,0,0,0,0,0,6 ème
SEINE-SAINT-DENIS,NOISY-LE-SEC,0931710D,137,137,0,0,67,70,6 ème
SEINE-SAINT-DENIS,NOISY-LE-SEC,0931883S,76,72,0,4,32,44,6 ème
SEINE-SAINT-DENIS,PANTIN,0931217T,172,169,0,3,92,80,6 ème
SEINE-SAINT-DENIS,PANTIN,0931218U,146,146,0,0,90,56,6 ème
SEINE-SAINT-DENIS,PANTIN,0931764M,8,8,0,0,0,8,6 ème
SEINE-SAINT-DENIS,ROSNY-SOUS-BOIS,0930593P,181,171,10,0,90,91,6 ème
SEINE-SAINT-DENIS,ROSNY-SOUS-BOIS,0931723T,137,135,0,2,68,69,6 ème
SEINE-SAINT-DENIS,SAINT-DENIS,0930138V,0,0,0,0,0,0,6 ème
SEINE-SAINT-DENIS,SAINT-DENIS,0931232J,133,117,9,7,68,65,6 ème
SEINE-SAINT-DENIS,SAINT-DENIS,0932582B,143,136,0,7,65,78,6 ème
SEINE-SAINT-DENIS,SEVRAN,0931190N,168,152,16,0,85,83,6 ème
SEINE-SAINT-DENIS,SEVRAN,0932262D,191,191,0,0,94,97,6 ème
SEINE-SAINT-DENIS,TREMBLAY-EN-FRANCE,0931193S,0,0,0,0,0,0,6 ème
SEINE-SAINT-DENIS,VAUJOURS,0932301W,138,138,0,0,59,79,6 ème
SEINE-SAINT-DENIS,VILLEPINTE,0931192R,162,157,0,5,78,84,6 ème
VAL-DE-MARNE,BONNEUIL-SUR-MARNE,0940171A,4,0,4,0,2,2,6 ème
VAL-DE-MARNE,CHARENTON-LE-PONT,0941353K,169,169,0,0,86,83,6 ème
VAL-DE-MARNE,CHOISY-LE-ROI,0940141T,0,0,0,0,0,0,6 ème
VAL-DE-MARNE,CHOISY-LE-ROI,0941710Y,140,140,0,0,81,59,6 ème
VAL-DE-MARNE,CRETEIL,0940521F,100,100,0,0,41,59,6 ème
VAL-DE-MARNE,CRETEIL,0940884A,120,120,0,0,64,56,6 ème
VAL-DE-MARNE,CRETEIL,0942127B,142,139,0,3,77,65,6 ème
VAL-DE-MARNE,IVRY-SUR-SEINE,0941781A,144,144,0,0,83,61,6 ème
VAL-DE-MARNE,LE KREMLIN-BICETRE,0940809U,88,87,0,1,45,43,6 ème
VAL-DE-MARNE,LE KREMLIN-BICETRE,0941679P,92,92,0,0,45,47,6 ème
VAL-DE-MARNE,LIMEIL-BREVANNES,0941603G,138,119,15,4,65,73,6 ème
VAL-DE-MARNE,MAISONS-ALFORT,0941596Z,142,135,6,1,74,68,6 ème
VAL-DE-MARNE,ORMESSON-SUR-MARNE,0941017V,134,129,0,5,63,71,6 ème
VAL-DE-MARNE,SAINT-MANDE,0940024R,30,30,0,0,13,17,6 ème
VAL-DE-MARNE,SAINT-MAUR-DES-FOSSES,0940879V,117,117,0,0,56,61,6 ème
VAL-DE-MARNE,THIAIS,0940090M,177,177,0,0,88,89,6 ème
VAL-DE-MARNE,VILLEJUIF,0941039U,104,102,0,2,41,63,6 ème
VAL-DE-MARNE,VILLENEUVE-LE-ROI,0941602F,92,89,0,3,45,47,6 ème
VAL-DE-MARNE,VILLENEUVE-SAINT-GEORGES,0940791Z,154,139,15,0,74,80,6 ème
VAL-DE-MARNE,VILLENEUVE-SAINT-GEORGES,0941952L,0,0,0,0,0,0,6 ème
VAL-DE-MARNE,VILLIERS-SUR-MARNE,0941411Y,189,173,16,0,90,99,6 ème
VAL-DE-MARNE,VINCENNES,0940793B,178,178,0,0,78,100,6 ème
VAL-DE-MARNE,VITRY-SUR-SEINE,0940874P,97,97,0,0,50,47,6 ème
VAL-DE-MARNE,VITRY-SUR-SEINE,0941032L,103,103,0,0,46,57,6 ème
VAL-DE-MARNE,VITRY-SUR-SEINE,0941294W,0,0,0,0,0,0,6 ème
PARIS,PARIS,0750362L,107,106,0,1,53,54,6 ème
PARIS,PARIS,0750465Y,98,93,0,5,39,59,6 ème
PARIS,PARIS,0750558Z,0,0,0,0,0,0,6 ème
PARIS,PARIS,0752537A,101,100,0,1,44,57,6 ème
PARIS,PARIS,0752911G,116,110,0,6,62,54,6 ème
PARIS,PARIS,0752934G,264,259,0,5,133,131,6 ème
PARIS,PARIS,0753518S,139,139,0,0,67,72,6 ème
PARIS,PARIS,0753985Z,145,141,0,4,77,68,6 ème
PARIS,PARIS,0754861B,11,0,0,11,2,9,6 ème
PARIS,PARIS,0755000C,112,112,0,0,50,62,6 ème
PARIS,PARIS,0752544H,104,104,0,0,51,53,6 ème
PARIS,PARIS,0755840R,36,36,0,0,14,22,6 ème
PARIS,PARIS,0750436S,0,0,0,0,0,0,6 ème
PARIS,PARIS,0750793E,0,0,0,0,0,0,6 ème
PARIS,PARIS,0752192A,105,105,0,0,50,55,6 ème
PARIS,PARIS,0752317L,115,115,0,0,59,56,6 ème
PARIS,PARIS,0752870M,291,291,0,0,117,174,6 ème
PARIS,PARIS,0752897S,146,146,0,0,79,67,6 ème
PARIS,PARIS,0752918P,164,164,0,0,109,55,6 ème
PARIS,PARIS,0755779Z,121,109,12,0,60,61,6 ème
PARIS,PARIS,0752195D,73,67,0,6,34,39,6 ème
PARIS,PARIS,0750575T,108,102,0,6,53,55,6 ème
PARIS,PARIS,0751707Y,111,95,15,1,48,63,6 ème
PARIS,PARIS,0753938Y,79,79,0,0,39,40,6 ème
PARIS,PARIS,0754004V,129,129,0,0,76,53,6 ème
PARIS,PARIS,0750552T,115,114,0,1,56,59,6 ème
PARIS,PARIS,0752198G,132,120,9,3,60,72,6 ème
PARIS,PARIS,0753939Z,80,80,0,0,43,37,6 ème
PARIS,PARIS,0752525M,90,84,0,6,52,38,6 ème
PARIS,PARIS,0752920S,150,150,0,0,87,63,6 ème
PARIS,PARIS,0752186U,97,96,0,1,42,55,6 ème
PARIS,PARIS,0752531U,85,84,0,1,33,52,6 ème
PARIS,PARIS,0752925X,89,89,0,0,44,45,6 ème
PARIS,PARIS,0754008Z,15,10,0,5,3,12,6 ème
PARIS,PARIS,0754029X,0,0,0,0,0,0,6 ème
PARIS,PARIS,0753854G,25,25,0,0,15,10,6 ème
PARIS,PARIS,0751791P,205,205,0,0,98,107,6 ème
PARIS,PARIS,0752529S,112,111,0,1,59,53,6 ème
PARIS,PARIS,0752532V,131,130,0,1,59,72,6 ème
PARIS,PARIS,0752916M,22,12,0,10,6,16,6 ème
ESSONNE,BONDOUFLE,0911340M,196,191,0,5,91,105,6 ème
ESSONNE,BRETIGNY-SUR-ORGE,0911039K,258,258,0,0,129,129,6 ème
ESSONNE,CROSNE,0910979V,237,235,0,2,124,113,6 ème
ESSONNE,DOURDAN,0911491B,172,162,8,2,79,93,6 ème
ESSONNE,DRAVEIL,0910830H,97,97,0,0,54,43,6 ème
ESSONNE,DRAVEIL,0910973N,159,144,10,5,79,80,6 ème
ESSONNE,EPINAY-SOUS-SENART,0911397Z,162,161,0,1,81,81,6 ème
ESSONNE,ETAMPES,0910717K,135,135,0,0,69,66,6 ème
ESSONNE,ETAMPES,0911150F,161,157,0,4,77,84,6 ème
ESSONNE,ETAMPES,0911401D,0,0,0,0,0,0,6 ème
ESSONNE,GRIGNY,0911253T,143,142,0,1,72,71,6 ème
ESSONNE,IGNY,0911824N,38,38,0,0,18,20,6 ème
ESSONNE,LES ULIS,0911334F,146,130,16,0,66,80,6 ème
ESSONNE,LONGJUMEAU,0910718L,171,171,0,0,87,84,6 ème
ESSONNE,MASSY,0910624J,122,118,0,4,55,67,6 ème
ESSONNE,ORSAY,0910968H,145,143,0,2,83,62,6 ème
ESSONNE,PALAISEAU,0910045E,109,109,0,0,57,52,6 ème
ESSONNE,PALAISEAU,0912321D,0,0,0,0,0,0,6 ème
ESSONNE,PARAY-VIEILLE-POSTE,0911441X,121,121,0,0,65,56,6 ème
ESSONNE,SAINT-CHERON,0911256W,197,194,0,3,106,91,6 ème
ESSONNE,SAINT-MICHEL-SUR-ORGE,0910775Y,171,171,0,0,98,73,6 ème
ESSONNE,SAULX-LES-CHARTREUX,0911029Z,176,162,9,5,87,89,6 ème
ESSONNE,VERRIERES-LE-BUISSON,0910057T,136,136,0,0,59,77,6 ème
ESSONNE,VIGNEUX-SUR-SEINE,0910776Z,167,163,0,4,78,89,6 ème
ESSONNE,VIRY-CHATILLON,0910060W,128,128,0,0,65,63,6 ème
ESSONNE,YERRES,0910756C,0,0,0,0,0,0,6 ème
HAUTS-DE-SEINE,ANTONY,0921170X,158,154,0,4,67,91,6 ème
HAUTS-DE-SEINE,ASNIERES-SUR-SEINE,0921547G,144,139,0,5,74,70,6 ème
HAUTS-DE-SEINE,BAGNEUX,0921168V,131,123,6,2,54,77,6 ème
HAUTS-DE-SEINE,CHATENAY-MALABRY,0921179G,75,73,0,2,30,45,6 ème
HAUTS-DE-SEINE,CHATILLON,0921354X,128,128,0,0,66,62,6 ème
HAUTS-DE-SEINE,COURBEVOIE,0920999L,120,120,0,0,52,68,6 ème
HAUTS-DE-SEINE,FONTENAY-AUX-ROSES,0920963X,0,0,0,0,0,0,6 ème
HAUTS-DE-SEINE,GENNEVILLIERS,0921157H,252,250,0,2,113,139,6 ème
HAUTS-DE-SEINE,LA GARENNE-COLOMBES,0922645A,129,127,0,2,64,65,6 ème
HAUTS-DE-SEINE,LEVALLOIS-PERRET,0921393P,178,173,0,5,96,82,6 ème
HAUTS-DE-SEINE,MALAKOFF,0921165S,115,113,0,2,55,60,6 ème
HAUTS-DE-SEINE,MEUDON,0922450N,226,226,0,0,113,113,6 ème
HAUTS-DE-SEINE,MONTROUGE,0921504K,104,103,0,1,42,62,6 ème
HAUTS-DE-SEINE,NANTERRE,0921394R,142,129,12,1,77,65,6 ème
HAUTS-DE-SEINE,NANTERRE,0922579D,13,13,0,0,6,7,6 ème
HAUTS-DE-SEINE,NEUILLY-SUR-SEINE,0921780K,167,166,0,1,76,91,6 ème
HAUTS-DE-SEINE,NEUILLY-SUR-SEINE,0921913E,192,192,0,0,91,101,6 ème
HAUTS-DE-SEINE,NEUILLY-SUR-SEINE,0921914F,201,197,0,4,96,105,6 ème
HAUTS-DE-SEINE,RUEIL-MALMAISON,0921501G,143,141,0,2,88,55,6 ème
HAUTS-DE-SEINE,SAINT-CLOUD,0921591E,206,206,0,0,98,108,6 ème
HAUTS-DE-SEINE,SEVRES,0920936T,33,33,0,0,21,12,6 ème
HAUTS-DE-SEINE,SURESNES,0920885M,123,119,4,0,71,52,6 ème
HAUTS-DE-SEINE,SURESNES,0921178F,100,100,0,0,53,47,6 ème
HAUTS-DE-SEINE,VAUCRESSON,0921919L,8,8,0,0,3,5,6 ème
HAUTS-DE-SEINE,VILLENEUVE-LA-GARENNE,0921159K,145,144,0,1,67,78,6 ème
VAL-D'OISE,ARGENTEUIL,0950788R,128,125,0,3,58,70,6 ème
VAL-D'OISE,ARGENTEUIL,0950885W,147,144,0,3,67,80,6 ème
VAL-D'OISE,ARGENTEUIL,0950886X,141,130,10,1,68,73,6 ème
VAL-D'OISE,BESSANCOURT,0951400F,141,141,0,0,65,76,6 ème
VAL-D'OISE,CERGY,0951964U,144,144,0,0,80,64,6 ème
VAL-D'OISE,CORMEILLES-EN-PARISIS,0952236P,122,120,0,2,58,64,6 ème
VAL-D'OISE,EAUBONNE,0950892D,147,147,0,0,73,74,6 ème
VAL-D'OISE,ERAGNY,0951194G,130,128,0,2,63,67,6 ème
VAL-D'OISE,GONESSE,0950025L,157,153,0,4,78,79,6 ème
VAL-D'OISE,GONESSE,0951142A,140,132,7,1,69,71,6 ème
VAL-D'OISE,GOUSSAINVILLE,0951921X,150,147,0,3,67,83,6 ème
VAL-D'OISE,JOUY-LE-MOUTIER,0951801S,113,112,0,1,59,54,6 ème
VAL-D'OISE,LOUVRES,0952145R,125,125,0,0,64,61,6 ème
VAL-D'OISE,MAGNY-EN-VEXIN,0951102G,116,111,0,5,58,58,6 ème
VAL-D'OISE,MARLY-LA-VILLE,0951919V,143,143,0,0,85,58,6 ème
VAL-D'OISE,MONTMAGNY,0951141Z,163,161,0,2,73,90,6 ème
VAL-D'OISE,MONTMAGNY,0952010U,14,14,0,0,7,7,6 ème
VAL-D'OISE,MONTMORENCY,0950891C,113,102,10,1,67,46,6 ème
VAL-D'OISE,OSNY,0951403J,163,161,0,2,91,72,6 ème
VAL-D'OISE,PONTOISE,0950896H,151,135,15,1,59,92,6 ème
VAL-D'OISE,SAINT-BRICE-SOUS-FORET,0950931W,132,128,0,4,65,67,6 ème
VAL-D'OISE,SAINT-LEU-LA-FORET,0950748X,146,146,0,0,68,78,6 ème
VAL-D'OISE,SAINT-LEU-LA-FORET,0950763N,189,189,0,0,84,105,6 ème
VAL-D'OISE,TAVERNY,0950945L,154,140,14,0,71,83,6 ème
VAL-D'OISE,VIARMES,0951052C,165,165,0,0,77,88,6 ème
VAL-D'OISE,VILLIERS-LE-BEL,0950939E,153,144,7,2,80,73,6 ème
YVELINES,ACHERES,0783248G,154,138,12,4,76,78,6 ème
YVELINES,BOIS-D'ARCY,0780261K,172,169,0,3,89,83,6 ème
YVELINES,BONNIERES-SUR-SEINE,0783300N,70,70,0,0,38,32,6 ème
YVELINES,CARRIERES-SUR-SEINE,0780033M,165,165,0,0,76,89,6 ème
YVELINES,CONFLANS-SAINTE-HONORINE,0781985J,140,140,0,0,70,70,6 ème
YVELINES,JOUARS-PONTCHARTRAIN,0781632A,149,146,0,3,74,75,6 ème
YVELINES,LA CELLE-SAINT-CLOUD,0780504Z,104,104,0,0,49,55,6 ème
YVELINES,LE MESNIL-SAINT-DENIS,0783342J,108,108,0,0,57,51,6 ème
YVELINES,LE PECQ,0780263M,153,145,8,0,88,65,6 ème
YVELINES,LE PECQ,0783215W,88,83,0,5,45,43,6 ème
YVELINES,LES CLAYES-SOUS-BOIS,0780760C,132,128,0,4,63,69,6 ème
YVELINES,LE VESINET,0781594J,161,161,0,0,78,83,6 ème
YVELINES,MAISONS-LAFFITTE,0783156G,136,135,0,1,64,72,6 ème
YVELINES,MAULE,0780709X,198,198,0,0,85,113,6 ème
YVELINES,MONTESSON,0780578E,150,148,0,2,77,73,6 ème
YVELINES,POISSY,0781591F,174,174,0,0,94,80,6 ème
YVELINES,SAINT-ARNOULT-EN-YVELINES,0780712A,169,169,0,0,87,82,6 ème
YVELINES,SAINT-CYR-L'ECOLE,0782593V,0,0,0,0,0,0,6 ème
YVELINES,SARTROUVILLE,0780258G,215,203,12,0,113,102,6 ème
YVELINES,TRAPPES,0780514K,185,185,0,0,79,106,6 ème
YVELINES,TRAPPES,0780584L,0,0,0,0,0,0,6 ème
YVELINES,VERSAILLES,0780580G,124,124,0,0,61,63,6 ème
YVELINES,VERSAILLES,0780718G,106,102,0,4,56,50,6 ème
YVELINES,VERSAILLES,0781597M,373,372,0,1,177,196,6 ème
YVELINES,VERSAILLES,0783295H,247,245,0,2,120,127,6 ème
YVELINES,VOISINS-LE-BRETONNEUX,0781570H,104,104,0,0,52,52,6 ème
LA REUNION,LA POSSESSION,9741236A,189,186,0,3,90,99,6 ème
LA REUNION,LE PORT,9741313J,117,103,14,0,58,59,6 ème
LA REUNION,LE TAMPON,9740620F,208,201,0,7,90,118,6 ème
LA REUNION,LE TAMPON,9740652R,244,212,30,2,123,121,6 ème
LA REUNION,LE TAMPON,9741088P,87,82,0,5,39,48,6 ème
LA REUNION,LE TAMPON,9741262D,166,163,0,3,83,83,6 ème
LA REUNION,L'ETANG-SALE,9740813R,137,136,0,1,72,65,6 ème
LA REUNION,SAINT-ANDRE,9741261C,176,176,0,0,81,95,6 ème
LA REUNION,SAINT-BENOIT,9741366S,199,193,0,6,96,103,6 ème
LA REUNION,SAINT-BENOIT,9741546M,170,159,11,0,87,83,6 ème
LA REUNION,SAINT-DENIS,9740042C,176,153,12,11,84,92,6 ème
LA REUNION,SAINT-DENIS,9741208V,118,115,0,3,55,63,6 ème
LA REUNION,SAINTE-MARIE,9740022F,149,148,0,1,62,87,6 ème
LA REUNION,SAINTE-SUZANNE,9741237B,215,211,0,4,108,107,6 ème
LA REUNION,SAINT-JOSEPH,9740578K,205,202,0,3,107,98,6 ème
LA REUNION,SAINT-LOUIS,9740012V,173,173,0,0,94,79,6 ème
LA REUNION,SAINT-LOUIS,9740091F,185,182,0,3,91,94,6 ème
LA REUNION,SAINT-PIERRE,9741630D,64,64,0,0,26,38,6 ème
MARTINIQUE,GROS-MORNE,9720012F,83,76,6,1,39,44,6 ème
MARTINIQUE,LA TRINITE,9720025V,97,90,0,7,46,51,6 ème
MARTINIQUE,LA TRINITE,9720351Z,50,39,11,0,29,21,6 ème
MARTINIQUE,LE LORRAIN,9720726G,0,0,0,0,0,0,6 ème
MARTINIQUE,LE MARIN,9720468B,0,0,0,0,0,0,6 ème
MARTINIQUE,LE ROBERT,9720861D,78,62,12,4,40,38,6 ème
MARTINIQUE,LES ANSES-D'ARLET,9720565G,29,22,7,0,10,19,6 ème
MARTINIQUE,RIVIERE-SALEE,9720725F,0,0,0,0,0,0,6 ème
MARTINIQUE,SAINTE-LUCE,9720449F,74,72,0,2,40,34,6 ème
MARTINIQUE,SAINTE-LUCE,9720776L,121,121,0,0,55,66,6 ème
MARTINIQUE,SAINT-ESPRIT,9720020P,97,94,0,3,50,47,6 ème
MAYOTTE,MAMOUDZOU,9760009F,360,355,0,5,171,189,6 ème
MAYOTTE,MAMOUDZOU,9760368W,366,345,19,2,179,187,6 ème
MAYOTTE,OUANGANI,9760371Z,344,311,30,3,185,159,6 ème
MAYOTTE,PAMANDZI,9760183V,284,281,0,3,147,137,6 ème
MAYOTTE,SADA,9760180S,271,268,0,3,130,141,6 ème
CALVADOS,BLAINVILLE-SUR-ORNE,0141940H,105,100,0,5,54,51,6 ème
CALVADOS,CAEN,0140019V,0,0,0,0,0,0,6 ème
CALVADOS,CAEN,0141160K,185,185,0,0,86,99,6 ème
CALVADOS,CAEN,0141212S,138,134,0,4,77,61,6 ème
CALVADOS,CAEN,0141313B,75,72,0,3,33,42,6 ème
CALVADOS,DEAUVILLE,0141192V,0,0,0,0,0,0,6 ème
CALVADOS,DIVES-SUR-MER,0141270E,75,66,4,5,40,35,6 ème
CALVADOS,DOUVRES-LA-DELIVRANDE,0140049C,131,131,0,0,66,65,6 ème
CALVADOS,DOZULE,0140050D,71,71,0,0,38,33,6 ème
CALVADOS,FLEURY-SUR-ORNE,0141553M,123,120,0,3,57,66,6 ème
CALVADOS,HONFLEUR,0141168U,32,32,0,0,16,16,6 ème
CALVADOS,HONFLEUR,0141765T,133,133,0,0,59,74,6 ème
CALVADOS,LISIEUX,0141135H,136,124,12,0,66,70,6 ème
CALVADOS,LISIEUX,0141315D,71,62,0,9,37,34,6 ème
CALVADOS,LISIEUX,0141862Y,142,142,0,0,64,78,6 ème
CALVADOS,SAINT-PIERRE-EN-AUGE,0141226G,106,106,0,0,56,50,6 ème
CALVADOS,SAINT-PIERRE-EN-AUGE,0141272G,85,83,0,2,43,42,6 ème
CALVADOS,TILLY-SUR-SEULLES,0140081M,102,102,0,0,52,50,6 ème
CALVADOS,VIRE NORMANDIE,0141864A,45,45,0,0,21,24,6 ème
CALVADOS,VIRE NORMANDIE,0142145F,58,54,0,4,32,26,6 ème
CALVADOS,VIRE NORMANDIE,0142178S,0,0,0,0,0,0,6 ème
EURE,BEAUMONT-LE-ROGER,0271267F,157,153,0,4,81,76,6 ème
EURE,BERNAY,0271448C,55,55,0,0,20,35,6 ème
EURE,BERNAY,0271581X,0,0,0,0,0,0,6 ème
EURE,BRETEUIL,0270008M,96,96,0,0,42,54,6 ème
EURE,BRIONNE,0270010P,159,145,10,4,69,90,6 ème
EURE,CONCHES-EN-OUCHE,0271094T,137,135,0,2,63,74,6 ème
EURE,ETREPAGNY,0271106F,117,114,0,3,52,65,6 ème
EURE,EVREUX,0270020A,106,99,0,7,51,55,6 ème
EURE,EVREUX,0271070S,0,0,0,0,0,0,6 ème
EURE,GAILLON,0270025F,129,129,0,0,71,58,6 ème
EURE,GISORS,0271047S,98,98,0,0,48,50,6 ème
EURE,LOUVIERS,0271398Y,92,92,0,0,53,39,6 ème
EURE,MESNILS-SUR-ITON,0271060F,145,145,0,0,78,67,6 ème
EURE,NONANCOURT,0270033P,169,169,0,0,77,92,6 ème
EURE,THIBERVILLE,0271099Y,81,81,0,0,32,49,6 ème
EURE,VERNEUIL D'AVRE ET D'ITON,0270043A,142,128,12,2,60,82,6 ème
EURE,VERNON,0271289E,129,117,12,0,63,66,6 ème
EURE,VERNON,0271399Z,78,78,0,0,42,36,6 ème
MANCHE,AGNEAUX,0501701C,129,129,0,0,68,61,6 ème
MANCHE,CARENTAN-LES-MARAIS,0500012S,110,106,0,4,46,64,6 ème
MANCHE,CHERBOURG-EN-COTENTIN,0500034R,111,111,0,0,57,54,6 ème
MANCHE,CHERBOURG-EN-COTENTIN,0500062W,106,103,0,3,56,50,6 ème
MANCHE,CHERBOURG-EN-COTENTIN,0501788X,0,0,0,0,0,0,6 ème
MANCHE,MONTEBOURG,0501201J,31,31,0,0,16,15,6 ème
MANCHE,PORT-BAIL-SUR-MER,0501217B,53,53,0,0,25,28,6 ème
MANCHE,SAINT-CLAIR-SUR-L'ELLE,0500059T,64,58,0,6,33,31,6 ème
MANCHE,SAINT-LO,0500094F,101,100,0,1,48,53,6 ème
MANCHE,SAINT-LO,0500150S,79,77,0,2,35,44,6 ème
MANCHE,SAINT-LO,0501789Y,0,0,0,0,0,0,6 ème
MANCHE,SAINT-PIERRE-EGLISE,0500069D,71,71,0,0,36,35,6 ème
MANCHE,SAINT-SAUVEUR-LE-VICOMTE,0500072G,52,47,0,5,28,24,6 ème
MANCHE,SAINT-SAUVEUR-VILLAGES,0500071F,65,65,0,0,35,30,6 ème
MANCHE,VALOGNES,0500096H,111,108,0,3,48,63,6 ème
ORNE,ALENCON,0610002W,0,0,0,0,0,0,6 ème
ORNE,ATHIS-VAL DE ROUVRE,0610051Z,66,66,0,0,30,36,6 ème
ORNE,GACE,0610958K,60,60,0,0,26,34,6 ème
ORNE,GIEL-COURTEILLES,0610699D,19,19,0,0,7,12,6 ème
ORNE,LA FERRIERE-AUX-ETANGS,0610017M,71,71,0,0,36,35,6 ème
ORNE,L'AIGLE,0610026X,0,0,0,0,0,0,6 ème
ORNE,VAL-AU-PERCHE,0610959L,73,73,0,0,38,35,6 ème
SEINE MARITIME,BOLBEC,0760013B,0,0,0,0,0,0,6 ème
SEINE MARITIME,BUCHY,0761952J,165,163,0,2,82,83,6 ème
SEINE MARITIME,DARNETAL,0760021K,114,114,0,0,51,63,6 ème
SEINE MARITIME,DIEPPE,0761703N,74,59,12,3,36,38,6 ème
SEINE MARITIME,DIEPPE,0761786D,98,96,0,2,47,51,6 ème
SEINE MARITIME,EPOUVILLE,0762598L,169,169,0,0,73,96,6 ème
SEINE MARITIME,GODERVILLE,0761741E,159,149,9,1,87,72,6 ème
SEINE MARITIME,ISNEAUVILLE,0763368Y,138,138,0,0,68,70,6 ème
SEINE MARITIME,LE HAVRE,0762127Z,62,62,0,0,30,32,6 ème
SEINE MARITIME,LE HAVRE,0762173Z,90,82,8,0,46,44,6 ème
SEINE MARITIME,LE PETIT-QUEVILLY,0760087G,0,0,0,0,0,0,6 ème
SEINE MARITIME,LE PETIT-QUEVILLY,0761949F,130,123,0,7,69,61,6 ème
SEINE MARITIME,LE TREPORT,0760114L,0,0,0,0,0,0,6 ème
SEINE MARITIME,MAROMME,0760075U,137,119,16,2,65,72,6 ème
SEINE MARITIME,MONTIVILLIERS,0762227H,197,188,9,0,113,84,6 ème
SEINE MARITIME,ROUEN,0760172Z,141,139,0,2,70,71,6 ème
SEINE MARITIME,ROUEN,0762290B,76,76,0,0,42,34,6 ème
SEINE MARITIME,SAINTE-ADRESSE,0761735Y,0,0,0,0,0,0,6 ème
SEINE MARITIME,SOTTEVILLE-LES-ROUEN,0760173A,110,108,0,2,57,53,6 ème
DORDOGNE,BERGERAC,0241136E,174,174,0,0,99,75,6 ème
DORDOGNE,LANOUAILLE,0240015L,50,50,0,0,23,27,6 ème
DORDOGNE,LE BUGUE,0240011G,55,51,0,4,26,29,6 ème
DORDOGNE,PERIGUEUX,0240052B,107,104,0,3,41,66,6 ème
DORDOGNE,RIBERAC,0240050Z,0,0,0,0,0,0,6 ème
DORDOGNE,SIGOULES-ET-FLAUGEAC,0240924Z,88,74,14,0,38,50,6 ème
DORDOGNE,THIVIERS,0240040N,85,80,4,1,43,42,6 ème
DORDOGNE,TRELISSAC,0240112S,0,0,0,0,0,0,6 ème
GIRONDE,BEGLES,0331882S,0,0,0,0,0,0,6 ème
GIRONDE,BLANQUEFORT,0330018R,0,0,0,0,0,0,6 ème
GIRONDE,BLANQUEFORT,0331548D,0,0,0,0,0,0,6 ème
GIRONDE,BORDEAUX,0330066T,138,134,0,4,63,75,6 ème
GIRONDE,BORDEAUX,0330142A,0,0,0,0,0,0,6 ème
GIRONDE,BORDEAUX,0331513R,84,84,0,0,38,46,6 ème
GIRONDE,BORDEAUX,0332492E,171,171,0,0,91,80,6 ème
GIRONDE,BORDEAUX,0332497K,0,0,0,0,0,0,6 ème
GIRONDE,BRANNE,0330058J,138,133,0,5,82,56,6 ème
GIRONDE,CESTAS,0332342S,214,214,0,0,104,110,6 ème
GIRONDE,EYSINES,0331739L,0,0,0,0,0,0,6 ème
GIRONDE,FLOIRAC,0331419N,177,176,0,1,81,96,6 ème
GIRONDE,GRADIGNAN,0332190B,138,123,15,0,67,71,6 ème
GIRONDE,GUJAN-MESTRAS,0331759H,222,206,14,2,97,125,6 ème
GIRONDE,LANGON,0330084M,203,190,9,4,100,103,6 ème
GIRONDE,LANGON,0331527F,40,40,0,0,14,26,6 ème
GIRONDE,LE PIAN-SUR-GARONNE,0332934K,165,160,0,5,91,74,6 ème
GIRONDE,LESPARRE-MEDOC,0331891B,151,148,0,3,76,75,6 ème
GIRONDE,LIBOURNE,0330091V,148,137,9,2,67,81,6 ème
GIRONDE,LIBOURNE,0331507J,205,205,0,0,110,95,6 ème
GIRONDE,LUSSAC,0330093X,89,83,0,6,46,43,6 ème
GIRONDE,MARCHEPRIME,0333121N,134,134,0,0,67,67,6 ème
GIRONDE,MARSAS,0333484H,182,182,0,0,94,88,6 ème
GIRONDE,PAUILLAC,0330103H,209,187,16,6,115,94,6 ème
GIRONDE,PESSAC,0330106L,113,107,0,6,54,59,6 ème
GIRONDE,SAINTE-FOY-LA-GRANDE,0331531K,36,36,0,0,17,19,6 ème
GIRONDE,SAINT-MEDARD-DE-GUIZIERES,0331532L,92,92,0,0,49,43,6 ème
GIRONDE,SAINT-SELVE,0333528F,142,142,0,0,64,78,6 ème
GIRONDE,SOULAC-SUR-MER,0330125G,65,65,0,0,27,38,6 ème
GIRONDE,TALENCE,0332195G,157,152,0,5,86,71,6 ème
GIRONDE,VILLENAVE-D'ORNON,0330132P,173,171,0,2,86,87,6 ème
LANDES,AIRE-SUR-L'ADOUR,0400047J,0,0,0,0,0,0,6 ème
LANDES,AIRE-SUR-L'ADOUR,0400090F,110,107,0,3,48,62,6 ème
LANDES,AMOU,0400003L,60,60,0,0,30,30,6 ème
LANDES,ANGRESSE,0401091U,133,130,0,3,69,64,6 ème
LANDES,BISCARROSSE,0401048X,123,123,0,0,61,62,6 ème
LANDES,DAX,0400740M,121,116,0,5,53,68,6 ème
LANDES,HAGETMAU,0400727Y,123,105,11,7,64,59,6 ème
LANDES,LABENNE,0401014K,170,164,0,6,68,102,6 ème
LANDES,MONT-DE-MARSAN,0400019D,0,0,0,0,0,0,6 ème
LANDES,MONT-DE-MARSAN,0400774Z,110,103,0,7,69,41,6 ème
LANDES,MONT-DE-MARSAN,0400779E,137,133,0,4,67,70,6 ème
LANDES,MONT-DE-MARSAN,0400858R,121,120,0,1,63,58,6 ème
LANDES,MORCENX-LA-NOUVELLE,0400097N,0,0,0,0,0,0,6 ème
LANDES,MUGRON,0400025K,72,70,0,2,39,33,6 ème
LANDES,POUILLON,0400032T,117,111,0,6,59,58,6 ème
LOT-ET-GARONNE,AGEN,0470061L,140,138,0,2,58,82,6 ème
LOT-ET-GARONNE,FOULAYRONNES,0470782V,0,0,0,0,0,0,6 ème
LOT-ET-GARONNE,LAVARDAC,0470775M,57,44,13,0,29,28,6 ème
LOT-ET-GARONNE,MARMANDE,0470069V,82,82,0,0,45,37,6 ème
LOT-ET-GARONNE,VILLENEUVE-SUR-LOT,0470049Y,129,127,0,2,65,64,6 ème
LOT-ET-GARONNE,VILLENEUVE-SUR-LOT,0470753N,0,0,0,0,0,0,6 ème
PYRENEES-ATLANTIQUES,ANGLET,0640003F,165,163,0,2,80,85,6 ème
PYRENEES-ATLANTIQUES,ARTHEZ-DE-BEARN,0640005H,50,50,0,0,24,26,6 ème
PYRENEES-ATLANTIQUES,BAYONNE,0640013S,0,0,0,0,0,0,6 ème
PYRENEES-ATLANTIQUES,BAYONNE,0640141F,41,41,0,0,16,25,6 ème
PYRENEES-ATLANTIQUES,BEDOUS,0640016V,36,36,0,0,16,20,6 ème
PYRENEES-ATLANTIQUES,BILLERE,0640606L,159,154,0,5,75,84,6 ème
PYRENEES-ATLANTIQUES,CAMBO-LES-BAINS,0641702C,79,77,0,2,34,45,6 ème
PYRENEES-ATLANTIQUES,HASPARREN,0641393S,118,116,0,2,52,66,6 ème
PYRENEES-ATLANTIQUES,HENDAYE,0640228A,166,162,0,4,93,73,6 ème
PYRENEES-ATLANTIQUES,LARCEVEAU-ARROS-CIBITS,0642006H,69,68,0,1,44,25,6 ème
PYRENEES-ATLANTIQUES,MONEIN,0640041X,82,82,0,0,42,40,6 ème
PYRENEES-ATLANTIQUES,OLORON-SAINTE-MARIE,0640211G,106,94,11,1,67,39,6 ème
PYRENEES-ATLANTIQUES,ORTHEZ,0640053K,0,0,0,0,0,0,6 ème
PYRENEES-ATLANTIQUES,ORTHEZ,0640214K,94,78,14,2,38,56,6 ème
PYRENEES-ATLANTIQUES,ORTHEZ,0641560Y,108,108,0,0,60,48,6 ème
PYRENEES-ATLANTIQUES,PAU,0641660G,126,126,0,0,68,58,6 ème
PYRENEES-ATLANTIQUES,PAU,0642010M,6,6,0,0,4,2,6 ème
PYRENEES-ATLANTIQUES,PAU,0642011N,18,18,0,0,9,9,6 ème
PYRENEES-ATLANTIQUES,PONTACQ,0640062V,80,78,0,2,43,37,6 ème
PYRENEES-ATLANTIQUES,SAINT-JEAN-DE-LUZ,0640163E,112,109,0,3,47,65,6 ème
PYRENEES-ATLANTIQUES,SAINT-JEAN-DE-LUZ,0641661H,143,139,0,4,66,77,6 ème
PYRENEES-ATLANTIQUES,SAINT-PALAIS,0640168K,39,39,0,0,17,22,6 ème
PYRENEES-ATLANTIQUES,SAINT-PALAIS,0641232S,94,88,0,6,43,51,6 ème
PYRENEES-ATLANTIQUES,SALIES-DE-BEARN,0640071E,56,54,0,2,30,26,6 ème
PYRENEES-ATLANTIQUES,SAUVETERRE-DE-BEARN,0640073G,50,50,0,0,24,26,6 ème
PYRENEES-ATLANTIQUES,SERRES-CASTET,0641780M,211,208,0,3,113,98,6 ème
CORREZE,ALLASSAC,0190001Y,117,117,0,0,57,60,6 ème
CORREZE,BEAULIEU-SUR-DORDOGNE,0190004B,37,37,0,0,18,19,6 ème
CORREZE,BEYNAT,0190006D,42,42,0,0,20,22,6 ème
CORREZE,BRIVE-LA-GAILLARDE,0190065T,45,40,0,5,24,21,6 ème
CORREZE,BRIVE-LA-GAILLARDE,0190671B,94,93,0,1,31,63,6 ème
CORREZE,BRIVE-LA-GAILLARDE,0190701J,0,0,0,0,0,0,6 ème
CORREZE,BRIVE-LA-GAILLARDE,0190723H,110,110,0,0,55,55,6 ème
CORREZE,BRIVE-LA-GAILLARDE,0190780V,123,116,7,0,49,74,6 ème
CORREZE,MEYSSAC,0190026A,59,59,0,0,37,22,6 ème
CORREZE,SEILHAC,0190030E,103,103,0,0,47,56,6 ème
CREUSE,AHUN,0230001B,48,40,0,8,21,27,6 ème
CREUSE,AUZANCES,0230004E,29,29,0,0,11,18,6 ème
CREUSE,BOUSSAC,0230009K,39,39,0,0,20,19,6 ème
HAUTE-VIENNE,BELLAC,0870004G,0,0,0,0,0,0,6 ème
HAUTE-VIENNE,CHALUS,0870007K,71,71,0,0,35,36,6 ème
HAUTE-VIENNE,LIMOGES,0870117E,151,131,15,5,61,90,6 ème
HAUTE-VIENNE,LIMOGES,0870909R,110,110,0,0,49,61,6 ème
HAUTE-VIENNE,LIMOGES,0875023M,0,0,0,0,0,0,6 ème
HAUTE-VIENNE,PIERRE-BUFFIERE,0870036S,97,97,0,0,56,41,6 ème
HAUTE-VIENNE,SAINT-JUNIEN,0870734A,115,115,0,0,44,71,6 ème
CHARENTE,ANGOULEME,0160047P,0,0,0,0,0,0,6 ème
CHARENTE,ANGOULEME,0160050T,102,102,0,0,64,38,6 ème
CHARENTE,BARBEZIEUX-SAINT-HILAIRE,0161049D,55,55,0,0,24,31,6 ème
CHARENTE,CHALAIS,0160015E,36,36,0,0,21,15,6 ème
CHARENTE,CHASSENEUIL-SUR-BONNIEURE,0160048R,0,0,0,0,0,0,6 ème
CHARENTE,COGNAC,0160117R,95,77,14,4,45,50,6 ème
CHARENTE,GOND-PONTOUVRE,0160106D,127,106,16,5,62,65,6 ème
CHARENTE,JARNAC,0160027T,132,129,0,3,66,66,6 ème
CHARENTE,MONTEMBOEUF,0160031X,35,35,0,0,15,20,6 ème
CHARENTE,MONTMOREAU,0160032Y,61,56,0,5,30,31,6 ème
CHARENTE,ROUILLAC,0160034A,95,92,0,3,37,58,6 ème
CHARENTE,RUELLE-SUR-TOUVRE,0160036C,0,0,0,0,0,0,6 ème
CHARENTE,SEGONZAC,0160042J,91,91,0,0,41,50,6 ème
CHARENTE,SOYAUX,0160100X,70,54,16,0,33,37,6 ème
CHARENTE,SOYAUX,0160862A,0,0,0,0,0,0,6 ème
CHARENTE,VILLEFAGNAN,0160115N,38,38,0,0,29,9,6 ème
CHARENTE-MARITIME,AIGREFEUILLE-D'AUNIS,0170110C,34,30,0,4,15,19,6 ème
CHARENTE-MARITIME,AIGREFEUILLE-D'AUNIS,0171129K,193,190,0,3,102,91,6 ème
CHARENTE-MARITIME,DOMPIERRE-SUR-MER,0171210Y,183,183,0,0,95,88,6 ème
CHARENTE-MARITIME,GEMOZAC,0170009T,127,127,0,0,55,72,6 ème
CHARENTE-MARITIME,LA JARRIE,0170010U,170,170,0,0,76,94,6 ème
CHARENTE-MARITIME,LA ROCHELLE,0170088D,120,116,0,4,57,63,6 ème
CHARENTE-MARITIME,MARANS,0170112E,42,42,0,0,23,19,6 ème
CHARENTE-MARITIME,PONS,0170020E,0,0,0,0,0,0,6 ème
CHARENTE-MARITIME,SAINT-AIGULIN,0170048K,49,49,0,0,24,25,6 ème
CHARENTE-MARITIME,SAINT-JEAN-D'ANGELY,0170051N,0,0,0,0,0,0,6 ème
CHARENTE-MARITIME,SAINT-JEAN-D'ANGELY,0170118L,40,40,0,0,15,25,6 ème
CHARENTE-MARITIME,TONNAY-CHARENTE,0170072L,131,131,0,0,77,54,6 ème
DEUX-SEVRES,AIRVAULT,0790059K,21,21,0,0,10,11,6 ème
DEUX-SEVRES,AIRVAULT,0790704L,62,62,0,0,28,34,6 ème
DEUX-SEVRES,BRESSUIRE,0790080H,0,0,0,0,0,0,6 ème
DEUX-SEVRES,BRESSUIRE,0791014Y,169,169,0,0,90,79,6 ème
DEUX-SEVRES,CERIZAY,0790945Y,93,74,16,3,38,55,6 ème
DEUX-SEVRES,CHEF-BOUTONNE,0790014L,40,40,0,0,19,21,6 ème
DEUX-SEVRES,COULONGES-SUR-L'AUTIZE,0790016N,111,111,0,0,62,49,6 ème
DEUX-SEVRES,LORETZ-D'ARGENTON,0790004A,51,51,0,0,29,22,6 ème
DEUX-SEVRES,MAULEON,0790065S,128,128,0,0,71,57,6 ème
DEUX-SEVRES,MENIGOUTE,0790020T,30,30,0,0,9,21,6 ème
DEUX-SEVRES,NIORT,0790043T,0,0,0,0,0,0,6 ème
DEUX-SEVRES,SAINT-MAIXENT-L'ECOLE,0790978J,126,111,11,4,57,69,6 ème
DEUX-SEVRES,SECONDIGNY,0790034H,43,43,0,0,24,19,6 ème
DEUX-SEVRES,THENEZAY,0790035J,48,48,0,0,25,23,6 ème
DEUX-SEVRES,THOUARS,0790038M,0,0,0,0,0,0,6 ème
DEUX-SEVRES,THOUARS,0790708R,106,102,0,4,53,53,6 ème
VIENNE,CHATELLERAULT,0860006P,0,0,0,0,0,0,6 ème
VIENNE,CHAUVIGNY,0860792U,184,171,10,3,90,94,6 ème
VIENNE,GENCAY,0860016A,101,99,0,2,47,54,6 ème
VIENNE,LATILLE,0860019D,126,126,0,0,62,64,6 ème
VIENNE,L'ISLE-JOURDAIN,0860017B,42,42,0,0,25,17,6 ème
VIENNE,NEUVILLE-DE-POITOU,0860032T,169,164,0,5,86,83,6 ème
VIENNE,POITIERS,0860076R,210,197,13,0,111,99,6 ème
VIENNE,POITIERS,0860823C,0,0,0,0,0,0,6 ème
VIENNE,VALENCE-EN-POITOU,0860762L,46,46,0,0,21,25,6 ème
AUDE,BRAM,0110676A,154,150,0,4,80,74,6 ème
AUDE,CARCASSONNE,0110665N,169,169,0,0,90,79,6 ème
AUDE,CASTELNAUDARY,0110011C,103,103,0,0,50,53,6 ème
AUDE,COUIZA,0110015G,73,73,0,0,35,38,6 ème
AUDE,LIMOUX,0110019L,0,0,0,0,0,0,6 ème
AUDE,LIMOUX,0110052X,33,28,0,5,15,18,6 ème
AUDE,NARBONNE,0110788X,120,102,14,4,58,62,6 ème
GARD,BAGNOLS-SUR-CEZE,0300088H,132,132,0,0,59,73,6 ème
GARD,BESSEGES,0300013B,42,39,0,3,20,22,6 ème
GARD,BOUILLARGUES,0301209B,216,216,0,0,106,110,6 ème
GARD,BRIGNON,0301246S,189,189,0,0,89,100,6 ème
GARD,GALLARGUES-LE-MONTUEUX,0301816L,161,161,0,0,85,76,6 ème
GARD,GENOLHAC,0300016E,22,22,0,0,13,9,6 ème
GARD,LA GRAND-COMBE,0300091L,12,12,0,0,7,5,6 ème
GARD,LEDIGNAN,0301747L,115,115,0,0,58,57,6 ème
GARD,LE MARTINET,0300020J,14,14,0,0,6,8,6 ème
GARD,MARGUERITTES,0301245R,189,170,16,3,91,98,6 ème
GARD,NIMES,0300057Z,0,0,0,0,0,0,6 ème
GARD,NIMES,0300059B,128,128,0,0,64,64,6 ème
GARD,NIMES,0300141R,151,126,23,2,71,80,6 ème
GARD,NIMES,0300996V,20,12,0,8,8,12,6 ème
GARD,NIMES,0301270T,0,0,0,0,0,0,6 ème
GARD,ROCHEFORT-DU-GARD,0301656M,150,150,0,0,80,70,6 ème
GARD,SAINT-AMBROIX,0300099V,44,35,9,0,26,18,6 ème
GARD,VESTRIC-ET-CANDIAC,0301653J,182,182,0,0,88,94,6 ème
HERAULT,AGDE,0341893Y,127,108,15,4,66,61,6 ème
HERAULT,BAILLARGUES,0341577E,154,152,0,2,67,87,6 ème
HERAULT,BEDARIEUX,0340006X,0,0,0,0,0,0,6 ème
HERAULT,BEDARIEUX,0340888F,12,12,0,0,3,9,6 ème
HERAULT,BESSAN,0340008Z,126,122,0,4,65,61,6 ème
HERAULT,BEZIERS,0340011C,0,0,0,0,0,0,6 ème
HERAULT,BEZIERS,0340118U,114,114,0,0,60,54,6 ème
HERAULT,BEZIERS,0340836Z,156,139,16,1,72,84,6 ème
HERAULT,BEZIERS,0341066Z,187,168,14,5,88,99,6 ème
HERAULT,BEZIERS,0342132H,147,129,15,3,72,75,6 ème
HERAULT,CASTELNAU-LE-LEZ,0340086J,227,223,0,4,109,118,6 ème
HERAULT,FABREGUES,0342077Y,166,165,0,1,79,87,6 ème
HERAULT,GANGES,0341424N,186,181,0,5,82,104,6 ème
HERAULT,GIGNAC,0342436N,0,0,0,0,0,0,6 ème
HERAULT,JACOU,0342036D,203,203,0,0,98,105,6 ème
HERAULT,LE CRES,0341363X,219,202,16,1,101,118,6 ème
HERAULT,LUNEL,0340030Y,0,0,0,0,0,0,6 ème
HERAULT,LUNEL,0341825Z,178,159,15,4,86,92,6 ème
HERAULT,LUNEL,0342090M,0,0,0,0,0,0,6 ème
HERAULT,MEZE,0340973Y,122,122,0,0,62,60,6 ème
HERAULT,MONTPELLIER,0340043M,0,0,0,0,0,0,6 ème
HERAULT,MONTPELLIER,0340048T,150,150,0,0,81,69,6 ème
HERAULT,MONTPELLIER,0340051W,115,115,0,0,57,58,6 ème
HERAULT,MONTPELLIER,0340053Y,167,148,16,3,77,90,6 ème
HERAULT,MONTPELLIER,0340111L,111,111,0,0,51,60,6 ème
HERAULT,MONTPELLIER,0340899T,124,124,0,0,62,62,6 ème
HERAULT,MONTPELLIER,0341277D,96,78,16,2,41,55,6 ème
HERAULT,MONTPELLIER,0341421K,255,250,0,5,114,141,6 ème
HERAULT,MONTPELLIER,0341726S,2,0,2,0,1,1,6 ème
HERAULT,MONTPELLIER,0342488V,136,136,0,0,72,64,6 ème
HERAULT,MURVIEL-LES-BEZIERS,0340054Z,150,146,0,4,77,73,6 ème
HERAULT,QUARANTE,0340063J,61,60,0,1,35,26,6 ème
HERAULT,SAINT-ANDRE-DE-SANGONIS,0342186S,181,167,14,0,89,92,6 ème
HERAULT,SAINT-GEORGES-D'ORQUES,0340908C,96,96,0,0,52,44,6 ème
LOZERE,MARVEJOLS,0480005V,68,55,11,2,41,27,6 ème
LOZERE,MENDE,0480025S,0,0,0,0,0,0,6 ème
PYRENEES-ORIENTALES,ESPIRA-DE-L'AGLY,0660065M,99,85,14,0,50,49,6 ème
PYRENEES-ORIENTALES,FONT-ROMEU-ODEILLO-VIA,0660634F,86,86,0,0,38,48,6 ème
PYRENEES-ORIENTALES,PERPIGNAN,0660062J,126,126,0,0,65,61,6 ème
PYRENEES-ORIENTALES,PRADES,0660022R,137,120,15,2,76,61,6 ème
PYRENEES-ORIENTALES,SAINT-ANDRE,0660865G,157,155,0,2,74,83,6 ème
PYRENEES-ORIENTALES,SAINT-LAURENT-DE-LA-SALANQUE,0660028X,228,222,0,6,107,121,6 ème
PYRENEES-ORIENTALES,VILLELONGUE-DELS-MONTS,0660026V,0,0,0,0,0,0,6 ème
ARIEGE,AX-LES-THERMES,0090001C,43,43,0,0,21,22,6 ème
ARIEGE,FOIX,0090478W,242,239,0,3,128,114,6 ème
ARIEGE,LAVELANET,0090007J,68,68,0,0,34,34,6 ème
ARIEGE,MAZERES,0090012P,85,83,0,2,46,39,6 ème
ARIEGE,MIREPOIX,0090573Z,113,106,5,2,58,55,6 ème
ARIEGE,SAINT-GIRONS,0090019X,0,0,0,0,0,0,6 ème
AVEYRON,LAISSAC-SEVERAC L'EGLISE,0120078V,36,36,0,0,20,16,6 ème
AVEYRON,MILLAU,0120014A,0,0,0,0,0,0,6 ème
AVEYRON,MILLAU,0120878P,216,205,10,1,116,100,6 ème
AVEYRON,ONET-LE-CHATEAU,0121273U,116,115,0,1,61,55,6 ème
AVEYRON,PONT-DE-SALARS,0120018E,93,91,0,2,54,39,6 ème
AVEYRON,RIEUPEYROUX,0120020G,38,36,0,2,21,17,6 ème
AVEYRON,RIGNAC,0120021H,92,92,0,0,46,46,6 ème
AVEYRON,VILLEFRANCHE-DE-ROUERGUE,0121255Z,92,89,0,3,42,50,6 ème
GERS,EAUZE,0320052H,28,28,0,0,18,10,6 ème
GERS,FLEURANCE,0320012P,81,79,0,2,34,47,6 ème
GERS,LECTOURE,0320017V,92,83,3,6,50,42,6 ème
GERS,MARCIAC,0320019X,54,54,0,0,24,30,6 ème
GERS,MAUVEZIN,0320021Z,105,98,0,7,59,46,6 ème
GERS,NOGARO,0320027F,82,74,4,4,42,40,6 ème
GERS,SAMATAN,0320030J,0,0,0,0,0,0,6 ème
GERS,SAMATAN,0320031K,103,97,0,6,49,54,6 ème
HAUTE-GARONNE,AUTERIVE,0310084Y,210,193,14,3,110,100,6 ème
HAUTE-GARONNE,AYGUESVIVES,0311573S,212,206,0,6,109,103,6 ème
HAUTE-GARONNE,BOULOGNE-SUR-GESSE,0310007P,45,45,0,0,26,19,6 ème
HAUTE-GARONNE,CASTELGINEST,0311720B,168,164,0,4,78,90,6 ème
HAUTE-GARONNE,ESCALQUENS,0313010D,175,175,0,0,88,87,6 ème
HAUTE-GARONNE,FONTENILLES,0312743N,168,164,0,4,86,82,6 ème
HAUTE-GARONNE,FROUZINS,0311915N,156,153,0,3,69,87,6 ème
HAUTE-GARONNE,GOURDAN-POLIGNAN,0310017A,0,0,0,0,0,0,6 ème
HAUTE-GARONNE,LABARTHE-SUR-LEZE,0312843X,141,138,0,3,63,78,6 ème
HAUTE-GARONNE,LAUNAGUET,0312139G,134,133,0,1,58,76,6 ème
HAUTE-GARONNE,MONTREJEAU,0310023G,76,74,0,2,34,42,6 ème
HAUTE-GARONNE,MURET,0311130K,149,149,0,0,87,62,6 ème
HAUTE-GARONNE,QUINT-FONSEGRIVES,0312762J,148,148,0,0,70,78,6 ème
HAUTE-GARONNE,SAINT-GAUDENS,0311851U,101,95,0,6,61,40,6 ème
HAUTE-GARONNE,SAINT-GAUDENS,0311968W,87,83,0,4,43,44,6 ème
HAUTE-GARONNE,SAINT-LYS,0311772H,159,159,0,0,76,83,6 ème
HAUTE-GARONNE,SAINT-ORENS-DE-GAMEVILLE,0311850T,144,142,0,2,85,59,6 ème
HAUTE-GARONNE,SAINT-PIERRE-DE-LAGES,0312609T,138,134,0,4,63,75,6 ème
HAUTE-GARONNE,TOULOUSE,0310040A,0,0,0,0,0,0,6 ème
HAUTE-GARONNE,TOULOUSE,0310044E,0,0,0,0,0,0,6 ème
HAUTE-GARONNE,TOULOUSE,0310046G,0,0,0,0,0,0,6 ème
HAUTE-GARONNE,TOULOUSE,0310053P,0,0,0,0,0,0,6 ème
HAUTE-GARONNE,TOULOUSE,0310091F,0,0,0,0,0,0,6 ème
HAUTE-GARONNE,TOULOUSE,0311168B,54,54,0,0,32,22,6 ème
HAUTE-GARONNE,TOULOUSE,0311232W,83,83,0,0,45,38,6 ème
HAUTE-GARONNE,TOULOUSE,0311328A,149,147,0,2,82,67,6 ème
HAUTE-GARONNE,TOULOUSE,0311333F,107,91,12,4,45,62,6 ème
HAUTE-GARONNE,TOULOUSE,0312065B,0,0,0,0,0,0,6 ème
HAUTE-GARONNE,TOULOUSE,0313079D,176,172,0,4,92,84,6 ème
HAUTE-GARONNE,TOURNEFEUILLE,0311688S,220,218,0,2,111,109,6 ème
HAUTE-GARONNE,TOURNEFEUILLE,0312307P,187,186,0,1,100,87,6 ème
HAUTES-PYRENEES,ARREAU,0650003A,71,71,0,0,29,42,6 ème
HAUTES-PYRENEES,BAGNERES-DE-BIGORRE,0650005C,0,0,0,0,0,0,6 ème
HAUTES-PYRENEES,BAGNERES-DE-BIGORRE,0650738Z,22,22,0,0,11,11,6 ème
HAUTES-PYRENEES,LANNEMEZAN,0650084N,120,108,4,8,60,60,6 ème
HAUTES-PYRENEES,LOURDES,0650014M,0,0,0,0,0,0,6 ème
HAUTES-PYRENEES,MONLEON-MAGNOAC,0650878B,69,66,0,3,29,40,6 ème
HAUTES-PYRENEES,SAINT-LAURENT-DE-NESTE,0650022W,54,54,0,0,27,27,6 ème
HAUTES-PYRENEES,TARBES,0650033H,46,43,0,3,24,22,6 ème
HAUTES-PYRENEES,TARBES,0650050B,138,136,0,2,66,72,6 ème
HAUTES-PYRENEES,TARBES,0650067V,0,0,0,0,0,0,6 ème
HAUTES-PYRENEES,TARBES,0651004N,148,148,0,0,58,90,6 ème
HAUTES-PYRENEES,VIC-EN-BIGORRE,0650838H,151,145,3,3,74,77,6 ème
LOT,CAHORS,0460050E,0,0,0,0,0,0,6 ème
LOT,CAHORS,0460051F,0,0,0,0,0,0,6 ème
LOT,CAHORS,0460620Z,85,85,0,0,39,46,6 ème
LOT,GOURDON,0460592U,119,106,11,2,52,67,6 ème
LOT,LALBENQUE,0460734Y,47,47,0,0,20,27,6 ème
LOT,SOUILLAC,0460028F,0,0,0,0,0,0,6 ème
TARN,ALBAN,0810002M,72,72,0,0,44,28,6 ème
TARN,ALBI,0811030E,206,177,27,2,104,102,6 ème
TARN,ALBI,0811062P,109,109,0,0,50,59,6 ème
TARN,ALBI,0811197L,169,148,15,6,81,88,6 ème
TARN,BLAYE-LES-MINES,0810788S,167,148,15,4,79,88,6 ème
TARN,BRASSAC,0810008U,47,47,0,0,24,23,6 ème
TARN,CASTRES,0810061B,94,77,15,2,46,48,6 ème
TARN,CASTRES,0810105Z,0,0,0,0,0,0,6 ème
TARN,CASTRES,0810113H,0,0,0,0,0,0,6 ème
TARN,CASTRES,0810959C,0,0,0,0,0,0,6 ème
TARN,CORDES-SUR-CIEL,0810019F,59,59,0,0,34,25,6 ème
TARN,DOURGNE,0810020G,97,97,0,0,45,52,6 ème
TARN,MAZAMET,0811067V,101,101,0,0,47,54,6 ème
TARN,PUYLAURENS,0810036Z,106,106,0,0,44,62,6 ème
TARN,REALMONT,0810038B,106,106,0,0,52,54,6 ème
TARN-ET-GARONNE,CAUSSADE,0820007M,190,174,13,3,83,107,6 ème
TARN-ET-GARONNE,LABASTIDE-SAINT-PIERRE,0820823Z,157,154,0,3,68,89,6 ème
TARN-ET-GARONNE,MONTAUBAN,0820022D,206,196,0,10,104,102,6 ème
TARN-ET-GARONNE,MONTAUBAN,0820052L,112,107,0,5,55,57,6 ème
TARN-ET-GARONNE,MONTAUBAN,0820061W,0,0,0,0,0,0,6 ème
TARN-ET-GARONNE,MONTAUBAN,0820588U,255,236,14,5,116,139,6 ème
TARN-ET-GARONNE,MONTAUBAN,0820896D,155,135,17,3,76,79,6 ème
LOIRE-ATLANTIQUE,AIGREFEUILLE-SUR-MAINE,0442542Z,142,140,0,2,70,72,6 ème
LOIRE-ATLANTIQUE,BOUAYE,0440184L,135,135,0,0,76,59,6 ème
LOIRE-ATLANTIQUE,BOUGUENAIS,0441656L,0,0,0,0,0,0,6 ème
LOIRE-ATLANTIQUE,CLISSON,0440188R,153,153,0,0,86,67,6 ème
LOIRE-ATLANTIQUE,LA BAULE-ESCOUBLAC,0441822S,112,109,0,3,58,54,6 ème
LOIRE-ATLANTIQUE,LA MONTAGNE,0440198B,84,84,0,0,29,55,6 ème
LOIRE-ATLANTIQUE,LE LOROUX-BOTTEREAU,0441686U,127,127,0,0,59,68,6 ème
LOIRE-ATLANTIQUE,LE POULIGUEN,0440061C,56,56,0,0,27,29,6 ème
LOIRE-ATLANTIQUE,MISSILLAC,0441917V,74,71,0,3,38,36,6 ème
LOIRE-ATLANTIQUE,NANTES,0440028S,126,125,0,1,61,65,6 ème
LOIRE-ATLANTIQUE,NANTES,0440030U,0,0,0,0,0,0,6 ème
LOIRE-ATLANTIQUE,NANTES,0440045K,154,152,0,2,77,77,6 ème
LOIRE-ATLANTIQUE,NANTES,0440536U,95,95,0,0,41,54,6 ème
LOIRE-ATLANTIQUE,NANTES,0441934N,136,136,0,0,72,64,6 ème
LOIRE-ATLANTIQUE,NORT-SUR-ERDRE,0440221B,173,168,5,0,93,80,6 ème
LOIRE-ATLANTIQUE,NOZAY,0440292D,141,140,0,1,74,67,6 ème
LOIRE-ATLANTIQUE,REZE,0440231M,67,67,0,0,31,36,6 ème
LOIRE-ATLANTIQUE,SAINTE-LUCE-SUR-LOIRE,0441724K,176,157,16,3,77,99,6 ème
LOIRE-ATLANTIQUE,SAINT-HERBLAIN,0441940V,207,207,0,0,97,110,6 ème
LOIRE-ATLANTIQUE,SAINT-NAZAIRE,0440307V,0,0,0,0,0,0,6 ème
LOIRE-ATLANTIQUE,SAINT-NAZAIRE,0440315D,0,0,0,0,0,0,6 ème
LOIRE-ATLANTIQUE,SAINT-NAZAIRE,0440350S,120,115,0,5,61,59,6 ème
LOIRE-ATLANTIQUE,SAINT-PHILBERT-DE-GRAND-LIEU,0440239W,201,199,0,2,90,111,6 ème
LOIRE-ATLANTIQUE,SAINT-PHILBERT-DE-GRAND-LIEU,0442782K,116,115,0,1,58,58,6 ème
LOIRE-ATLANTIQUE,SAINT-SEBASTIEN-SUR-LOIRE,0440279P,0,0,0,0,0,0,6 ème
LOIRE-ATLANTIQUE,SAINT-SEBASTIEN-SUR-LOIRE,0440537V,0,0,0,0,0,0,6 ème
LOIRE-ATLANTIQUE,VERTOU,0440244B,307,307,0,0,137,170,6 ème
MAINE-ET-LOIRE,ANGERS,0490060Z,79,79,0,0,37,42,6 ème
MAINE-ET-LOIRE,ANGERS,0490845C,64,64,0,0,25,39,6 ème
MAINE-ET-LOIRE,ANGERS,0490953V,77,57,16,4,33,44,6 ème
MAINE-ET-LOIRE,ANGERS,0491764B,98,81,16,1,46,52,6 ème
MAINE-ET-LOIRE,AVRILLE,0490801E,0,0,0,0,0,0,6 ème
MAINE-ET-LOIRE,BEAUPREAU-EN-MAUGES,0490903R,0,0,0,0,0,0,6 ème
MAINE-ET-LOIRE,CHOLET,0491025Y,111,111,0,0,60,51,6 ème
MAINE-ET-LOIRE,CHOLET,0491026Z,82,79,0,3,41,41,6 ème
MAINE-ET-LOIRE,LYS-HAUT-LAYON,0491707P,94,94,0,0,46,48,6 ème
MAINE-ET-LOIRE,MAULEVRIER,0490868C,120,120,0,0,55,65,6 ème
MAINE-ET-LOIRE,MONTREUIL-JUIGNE,0490032U,199,198,0,1,95,104,6 ème
MAINE-ET-LOIRE,MONTREVAULT-SUR-EVRE,0490034W,65,62,0,3,31,34,6 ème
MAINE-ET-LOIRE,SAUMUR,0490042E,45,41,0,4,30,15,6 ème
MAINE-ET-LOIRE,SAUMUR,0490960C,100,97,0,3,54,46,6 ème
MAINE-ET-LOIRE,SAUMUR,0491930G,191,180,11,0,89,102,6 ème
MAINE-ET-LOIRE,SEGRE-EN-ANJOU BLEU,0490962E,145,127,16,2,71,74,6 ème
MAYENNE,ANDOUILLE,0530002P,103,103,0,0,48,55,6 ème
MAYENNE,CHATEAU-GONTIER-SUR-MAYENNE,0530874M,151,147,0,4,78,73,6 ème
MAYENNE,EVRON,0530059B,126,126,0,0,70,56,6 ème
MAYENNE,GORRON,0530793Z,48,48,0,0,22,26,6 ème
MAYENNE,LASSAY-LES-CHATEAUX,0530803K,51,51,0,0,27,24,6 ème
MAYENNE,LAVAL,0530061D,200,185,15,0,99,101,6 ème
MAYENNE,LAVAL,0530875N,228,224,0,4,107,121,6 ème
MAYENNE,MAYENNE,0530826K,91,87,0,4,48,43,6 ème
MAYENNE,MESLAY-DU-MAINE,0530791X,65,65,0,0,35,30,6 ème
MAYENNE,MONTSURS,0530064G,28,28,0,0,11,17,6 ème
MAYENNE,MONTSURS,0530792Y,50,50,0,0,30,20,6 ème
MAYENNE,RENAZE,0530584X,46,44,0,2,21,25,6 ème
MAYENNE,VILLAINES-LA-JUHEL,0530025P,24,23,0,1,13,11,6 ème
SARTHE,ALLONNES,0721224P,95,90,0,5,52,43,6 ème
SARTHE,CERANS-FOULLETOURTE,0721483W,77,77,0,0,43,34,6 ème
SARTHE,CHANGE,0720920J,13,0,13,0,6,7,6 ème
SARTHE,LA CHARTRE-SUR-LE-LOIR,0720011W,53,53,0,0,30,23,6 ème
SARTHE,LA FLECHE,0720021G,0,0,0,0,0,0,6 ème
SARTHE,LA FLECHE,0721405L,101,101,0,0,46,55,6 ème
SARTHE,MONTVAL-SUR-LOIR,0720804H,48,48,0,0,23,25,6 ème
SARTHE,PARIGNE-L'EVEQUE,0720847E,100,94,5,1,46,54,6 ème
SARTHE,PRUILLE-LE-CHETIF,0720811R,114,101,13,0,57,57,6 ème
SARTHE,PRUILLE-LE-CHETIF,0721478R,0,0,0,0,0,0,6 ème
SARTHE,SABLE-SUR-SARTHE,0720048L,0,0,0,0,0,0,6 ème
SARTHE,SAINTE-JAMME-SUR-SARTHE,0721042S,128,128,0,0,75,53,6 ème
SARTHE,SILLE-LE-GUILLAUME,0721365T,45,45,0,0,16,29,6 ème
VENDEE,BENET,0850092N,90,90,0,0,41,49,6 ème
VENDEE,BENET,0851145H,60,60,0,0,34,26,6 ème
VENDEE,CHANTONNAY,0850145W,134,116,15,3,67,67,6 ème
VENDEE,ESSARTS EN BOCAGE,0851647D,125,123,0,2,70,55,6 ème
VENDEE,LA ROCHE-SUR-YON,0850130E,0,0,0,0,0,0,6 ème
VENDEE,LA ROCHE-SUR-YON,0850604V,134,123,10,1,59,75,6 ème
VENDEE,LES ACHARDS,0850106D,144,144,0,0,76,68,6 ème
VENDEE,LES HERBIERS,0851193K,138,120,16,2,70,68,6 ème
VENDEE,MONTAIGU-VENDEE,0850136L,0,0,0,0,0,0,6 ème
VENDEE,MONTAIGU-VENDEE,0850639H,120,104,16,0,66,54,6 ème
VENDEE,MONTAIGU-VENDEE,0851704R,81,81,0,0,32,49,6 ème
VENDEE,NOIRMOUTIER-EN-L'ILE,0851144G,41,41,0,0,18,23,6 ème
VENDEE,SAINT-HILAIRE-DES-LOGES,0851195M,46,46,0,0,31,15,6 ème
VENDEE,SAINT-JEAN-DE-MONTS,0850039F,131,131,0,0,71,60,6 ème
VENDEE,SAINT-LAURENT-SUR-SEVRE,0851293U,201,201,0,0,103,98,6 ème
ALPES-DE-HTE-PROVENCE,MANOSQUE,0040013T,81,79,0,2,41,40,6 ème
ALPES-DE-HTE-PROVENCE,MANOSQUE,0040587S,66,66,0,0,26,40,6 ème
ALPES-DE-HTE-PROVENCE,SAINTE-TULLE,0040524Y,118,116,0,2,50,68,6 ème
ALPES-DE-HTE-PROVENCE,SEYNE,0040021B,21,17,0,4,6,15,6 ème
BOUCHES-DU-RHONE,AIX-EN-PROVENCE,0131711P,150,145,0,5,66,84,6 ème
BOUCHES-DU-RHONE,AIX-EN-PROVENCE,0132917A,243,240,0,3,124,119,6 ème
BOUCHES-DU-RHONE,AIX-EN-PROVENCE,0133397X,110,110,0,0,52,58,6 ème
BOUCHES-DU-RHONE,AIX-EN-PROVENCE,0134094E,166,166,0,0,79,87,6 ème
BOUCHES-DU-RHONE,AIX-EN-PROVENCE,0134342Z,93,93,0,0,48,45,6 ème
BOUCHES-DU-RHONE,ARLES,0131609D,139,138,0,1,68,71,6 ème
BOUCHES-DU-RHONE,ARLES,0131746C,178,165,13,0,80,98,6 ème
BOUCHES-DU-RHONE,AUBAGNE,0131364M,91,91,0,0,50,41,6 ème
BOUCHES-DU-RHONE,AUBAGNE,0132412B,194,166,24,4,105,89,6 ème
BOUCHES-DU-RHONE,CABRIES,0133115R,148,148,0,0,73,75,6 ème
BOUCHES-DU-RHONE,EYGUIERES,0133790Z,168,168,0,0,76,92,6 ème
BOUCHES-DU-RHONE,FOS-SUR-MER,0132634T,216,216,0,0,108,108,6 ème
BOUCHES-DU-RHONE,GREASQUE,0130028K,234,230,0,4,121,113,6 ème
BOUCHES-DU-RHONE,ISTRES,0131888G,144,144,0,0,71,73,6 ème
BOUCHES-DU-RHONE,ISTRES,0132276D,0,0,0,0,0,0,6 ème
BOUCHES-DU-RHONE,LA CIOTAT,0131883B,102,102,0,0,55,47,6 ème
BOUCHES-DU-RHONE,LA CIOTAT,0132786H,185,171,12,2,77,108,6 ème
BOUCHES-DU-RHONE,LAMBESC,0131259Y,116,116,0,0,60,56,6 ème
BOUCHES-DU-RHONE,LANCON-PROVENCE,0134431W,167,167,0,0,83,84,6 ème
BOUCHES-DU-RHONE,LE PUY-SAINTE-REPARADE,0133992U,128,128,0,0,71,57,6 ème
BOUCHES-DU-RHONE,MARIGNANE,0131607B,189,182,0,7,97,92,6 ème
BOUCHES-DU-RHONE,MARIGNANE,0131608C,221,187,30,4,83,138,6 ème
BOUCHES-DU-RHONE,MARSEILLE,0133544G,31,31,0,0,14,17,6 ème
BOUCHES-DU-RHONE,MARSEILLE,0130057S,0,0,0,0,0,0,6 ème
BOUCHES-DU-RHONE,MARSEILLE,0131968U,138,127,9,2,73,65,6 ème
BOUCHES-DU-RHONE,MARSEILLE,0130050J,0,0,0,0,0,0,6 ème
BOUCHES-DU-RHONE,MARSEILLE,0132790M,0,0,0,0,0,0,6 ème
BOUCHES-DU-RHONE,MARSEILLE,0131703F,131,109,22,0,61,70,6 ème
BOUCHES-DU-RHONE,MARSEILLE,0132408X,137,134,0,3,63,74,6 ème
BOUCHES-DU-RHONE,MARSEILLE,0133986M,85,85,0,0,52,33,6 ème
BOUCHES-DU-RHONE,MARSEILLE,0134101M,0,0,0,0,0,0,6 ème
BOUCHES-DU-RHONE,MARSEILLE,0131932E,221,221,0,0,103,118,6 ème
BOUCHES-DU-RHONE,MARSEILLE,0132950L,68,58,10,0,30,38,6 ème
BOUCHES-DU-RHONE,MARSEILLE,0133278T,48,48,0,0,24,24,6 ème
BOUCHES-DU-RHONE,MARSEILLE,0133788X,153,140,12,1,73,80,6 ème
BOUCHES-DU-RHONE,MARSEILLE,0131264D,121,121,0,0,56,65,6 ème
BOUCHES-DU-RHONE,MARSEILLE,0130079R,118,118,0,0,60,58,6 ème
BOUCHES-DU-RHONE,MARSEILLE,0131441W,0,0,0,0,0,0,6 ème
BOUCHES-DU-RHONE,MARSEILLE,0132911U,96,96,0,0,63,33,6 ème
BOUCHES-DU-RHONE,MARSEILLE,0130054N,0,0,0,0,0,0,6 ème
BOUCHES-DU-RHONE,MARSEILLE,0131603X,89,89,0,0,35,54,6 ème
BOUCHES-DU-RHONE,MARSEILLE,0131927Z,150,150,0,0,71,79,6 ème
BOUCHES-DU-RHONE,MARSEILLE,0130084W,105,103,0,2,49,56,6 ème
BOUCHES-DU-RHONE,MARSEILLE,0130139F,71,65,0,6,32,39,6 ème
BOUCHES-DU-RHONE,PEYROLLES-EN-PROVENCE,0131723C,138,138,0,0,67,71,6 ème
BOUCHES-DU-RHONE,ROGNES,0133287C,149,147,0,2,71,78,6 ème
BOUCHES-DU-RHONE,ROQUEVAIRE,0130156Z,191,191,0,0,94,97,6 ème
BOUCHES-DU-RHONE,ROUSSET,0133451F,169,166,0,3,94,75,6 ème
BOUCHES-DU-RHONE,SAINT-CHAMAS,0130158B,109,109,0,0,50,59,6 ème
BOUCHES-DU-RHONE,SAINT-MITRE-LES-REMPARTS,0131367R,96,96,0,0,54,42,6 ème
BOUCHES-DU-RHONE,SALON-DE-PROVENCE,0132789L,145,145,0,0,79,66,6 ème
BOUCHES-DU-RHONE,SALON-DE-PROVENCE,0133492A,168,165,0,3,82,86,6 ème
BOUCHES-DU-RHONE,TARASCON,0131611F,181,162,14,5,89,92,6 ème
BOUCHES-DU-RHONE,VITROLLES,0132214L,129,129,0,0,67,62,6 ème
BOUCHES-DU-RHONE,VITROLLES,0132411A,184,169,15,0,93,91,6 ème
BOUCHES-DU-RHONE,VITROLLES,0133352Y,93,93,0,0,40,53,6 ème
HAUTES-ALPES,LARAGNE-MONTEGLIN,0050452P,84,76,0,8,44,40,6 ème
VAUCLUSE,APT,0840001V,0,0,0,0,0,0,6 ème
VAUCLUSE,APT,0840759U,229,217,9,3,106,123,6 ème
VAUCLUSE,AVIGNON,0840007B,158,158,0,0,70,88,6 ème
VAUCLUSE,AVIGNON,0840042P,0,0,0,0,0,0,6 ème
VAUCLUSE,AVIGNON,0840940R,0,0,0,0,0,0,6 ème
VAUCLUSE,BOLLENE,0840437U,154,136,15,3,75,79,6 ème
VAUCLUSE,CARPENTRAS,0840852V,123,123,0,0,0,123,6 ème
VAUCLUSE,CAVAILLON,0840079E,129,129,0,0,60,69,6 ème
VAUCLUSE,LA TOUR-D'AIGUES,0841027K,183,178,0,5,92,91,6 ème
VAUCLUSE,L'ISLE-SUR-LA-SORGUE,0840021S,0,0,0,0,0,0,6 ème
VAUCLUSE,ORANGE,0840764Z,193,190,0,3,105,88,6 ème
VAUCLUSE,SAINTE-CECILE-LES-VIGNES,0841099N,186,182,0,4,93,93,6 ème
VAUCLUSE,SORGUES,0840033E,96,93,0,3,42,54,6 ème
VAUCLUSE,VALREAS,0840714V,59,59,0,0,20,39,6 ème
VAUCLUSE,VALREAS,0840716X,154,145,9,0,79,75,6 ème
VAUCLUSE,VEDENE,0840039L,0,0,0,0,0,0,6 ème
ALPES-MARITIMES,ANTIBES,0060083H,118,116,0,2,39,79,6 ème
ALPES-MARITIMES,ANTIBES,0061456A,102,102,0,0,57,45,6 ème
ALPES-MARITIMES,CARROS,0061130W,209,192,14,3,100,109,6 ème
ALPES-MARITIMES,GRASSE,0061244V,195,176,16,3,103,92,6 ème
ALPES-MARITIMES,GRASSE,0061668F,121,108,10,3,58,63,6 ème
ALPES-MARITIMES,LA COLLE-SUR-LOUP,0061376N,177,177,0,0,83,94,6 ème
ALPES-MARITIMES,MENTON,0061238N,150,150,0,0,71,79,6 ème
ALPES-MARITIMES,NICE,0060084J,184,180,0,4,78,106,6 ème
ALPES-MARITIMES,NICE,0060086L,149,146,0,3,83,66,6 ème
ALPES-MARITIMES,NICE,0060676C,89,87,0,2,59,30,6 ème
ALPES-MARITIMES,NICE,0061001F,160,141,16,3,72,88,6 ème
ALPES-MARITIMES,NICE,0061003H,116,113,0,3,54,62,6 ème
ALPES-MARITIMES,NICE,0061339Y,236,235,0,1,101,135,6 ème
ALPES-MARITIMES,NICE,0061460E,156,156,0,0,77,79,6 ème
ALPES-MARITIMES,SAINT-JEANNET,0061666D,218,218,0,0,107,111,6 ème
ALPES-MARITIMES,VALBONNE,0062011D,171,171,0,0,94,77,6 ème
ALPES-MARITIMES,VALLAURIS,0061211J,235,214,16,5,100,135,6 ème
VAR,BARJOLS,0830928H,143,126,16,1,75,68,6 ème
VAR,BRIGNOLES,0830833E,167,167,0,0,72,95,6 ème
VAR,FREJUS,0830823U,196,185,11,0,104,92,6 ème
VAR,FREJUS,0830960T,0,0,0,0,0,0,6 ème
VAR,HYERES,0830028E,143,143,0,0,61,82,6 ème
VAR,HYERES,0830832D,115,112,0,3,45,70,6 ème
VAR,HYERES,0831186N,195,193,0,2,111,84,6 ème
VAR,LA CRAU,0830147J,43,43,0,0,21,22,6 ème
VAR,LA GARDE,0830179U,172,172,0,0,83,89,6 ème
VAR,LA SEYNE-SUR-MER,0830830B,140,140,0,0,73,67,6 ème
VAR,LA SEYNE-SUR-MER,0830923C,0,0,0,0,0,0,6 ème
VAR,LE BEAUSSET,0831056X,161,161,0,0,79,82,6 ème
VAR,LES ARCS,0830001A,197,197,0,0,102,95,6 ème
VAR,ROQUEBRUNE-SUR-ARGENS,0831474B,206,206,0,0,96,110,6 ème
VAR,SAINT-CYR-SUR-MER,0830038R,111,111,0,0,53,58,6 ème
VAR,SAINT-MAXIMIN-LA-SAINTE-BAUME,0830959S,172,172,0,0,96,76,6 ème
VAR,SAINT-RAPHAEL,0831116M,204,199,0,5,102,102,6 ème
VAR,TOULON,0830058M,0,0,0,0,0,0,6 ème
VAR,TOULON,0830059N,0,0,0,0,0,0,6 ème
VAR,TOULON,0830110U,169,169,0,0,79,90,6 ème
VAR,TOULON,0830111V,90,89,0,1,49,41,6 ème
VAR,TOULON,0830162A,109,106,0,3,60,49,6 ème
VAR,TOULON,0830926F,197,197,0,0,93,104,6 ème
VAR,TOULON,0831115L,79,76,0,3,44,35,6 ème
VAR,VIDAUBAN,0831379Y,155,155,0,0,73,82,6 ème
ALLIER,BELLENAVES,0030001K,80,75,0,5,46,34,6 ème
ALLIER,BELLERIVE-SUR-ALLIER,0030002L,130,130,0,0,61,69,6 ème
ALLIER,COMMENTRY,0030890B,80,65,13,2,46,34,6 ème
ALLIER,COMMENTRY,0031044U,0,0,0,0,0,0,6 ème
ALLIER,CUSSET,0030979Y,110,110,0,0,59,51,6 ème
ALLIER,DOYET,0030015A,35,35,0,0,12,23,6 ème
ALLIER,MONTLUCON,0030030S,72,72,0,0,34,38,6 ème
ALLIER,MONTLUCON,0030091H,138,133,0,5,71,67,6 ème
ALLIER,MONTMARAULT,0030035X,44,39,0,5,14,30,6 ème
ALLIER,MOULINS,0030039B,125,122,0,3,66,59,6 ème
ALLIER,SAINT-GERMAIN-DES-FOSSES,0030043F,79,75,0,4,37,42,6 ème
ALLIER,SAINT-POURCAIN-SUR-SIOULE,0030104X,33,33,0,0,14,19,6 ème
ALLIER,SAINT-POURCAIN-SUR-SIOULE,0030892D,105,105,0,0,50,55,6 ème
ALLIER,VARENNES-SUR-ALLIER,0030048L,101,82,16,3,46,55,6 ème
ALLIER,VICHY,0030049M,73,71,0,2,32,41,6 ème
CANTAL,ALLANCHE,0150001V,17,17,0,0,6,11,6 ème
CANTAL,CONDAT,0150011F,11,11,0,0,8,3,6 ème
CANTAL,MONTSALVY,0150020R,35,35,0,0,18,17,6 ème
CANTAL,RIOM-ES-MONTAGNES,0150027Y,32,32,0,0,22,10,6 ème
CANTAL,SAINT-FLOUR,0150053B,55,53,0,2,34,21,6 ème
CANTAL,YDES,0150034F,52,52,0,0,26,26,6 ème
HAUTE-LOIRE,BRIOUDE,0430854V,121,112,0,9,67,54,6 ème
HAUTE-LOIRE,BRIOUDE,0430898T,102,98,0,4,53,49,6 ème
HAUTE-LOIRE,LE PUY-EN-VELAY,0430902X,114,114,0,0,50,64,6 ème
HAUTE-LOIRE,MONISTROL-SUR-LOIRE,0430663M,156,152,0,4,85,71,6 ème
HAUTE-LOIRE,RETOURNAC,0430026V,81,81,0,0,37,44,6 ème
HAUTE-LOIRE,SAINT-JULIEN-CHAPTEUIL,0430086K,56,56,0,0,32,24,6 ème
HAUTE-LOIRE,SAUGUES,0430032B,22,22,0,0,10,12,6 ème
HAUTE-LOIRE,YSSINGEAUX,0430909E,110,109,0,1,57,53,6 ème
PUY-DE-DOME,AUBIERE,0631081H,54,51,0,3,29,25,6 ème
PUY-DE-DOME,BESSE-ET-SAINT-ANASTAISE,0630008S,64,64,0,0,26,38,6 ème
PUY-DE-DOME,BILLOM,0630009T,198,198,0,0,92,106,6 ème
PUY-DE-DOME,CLERMONT-FERRAND,0630024J,0,0,0,0,0,0,6 ème
PUY-DE-DOME,CLERMONT-FERRAND,0631085M,173,173,0,0,80,93,6 ème
PUY-DE-DOME,CLERMONT-FERRAND,0631086N,148,148,0,0,71,77,6 ème
PUY-DE-DOME,CLERMONT-FERRAND,0631502R,88,84,0,4,34,54,6 ème
PUY-DE-DOME,CLERMONT-FERRAND,0631731P,130,130,0,0,71,59,6 ème
PUY-DE-DOME,CLERMONT-FERRAND,0631773K,137,132,0,5,59,78,6 ème
PUY-DE-DOME,COURPIERE,0631523N,67,65,0,2,33,34,6 ème
PUY-DE-DOME,COURPIERE,0631733S,36,36,0,0,20,16,6 ème
PUY-DE-DOME,ISSOIRE,0630041C,0,0,0,0,0,0,6 ème
PUY-DE-DOME,RIOM,0631763Z,172,137,30,5,90,82,6 ème
PUY-DE-DOME,SAINT-ELOY-LES-MINES,0630060Y,90,86,0,4,42,48,6 ème
ARDECHE,ANNONAY,0070100W,0,0,0,0,0,0,6 ème
ARDECHE,ANNONAY,0071156U,195,173,19,3,103,92,6 ème
ARDECHE,GUILHERAND-GRANGES,0070011Z,152,146,0,6,74,78,6 ème
ARDECHE,JOYEUSE,0070012A,82,79,0,3,41,41,6 ème
ARDECHE,LAMASTRE,0071168G,26,26,0,0,14,12,6 ème
ARDECHE,LARGENTIERE,0070017F,42,42,0,0,16,26,6 ème
ARDECHE,SAINT-PERAY,0071320X,145,127,15,3,72,73,6 ème
ARDECHE,SATILLIEU,0070086F,69,69,0,0,34,35,6 ème
ARDECHE,TOURNON-SUR-RHONE,0071192H,147,147,0,0,69,78,6 ème
DROME,BOURG-DE-PEAGE,0260001K,239,235,0,4,126,113,6 ème
DROME,CLEON-D'ANDRAN,0260005P,125,125,0,0,51,74,6 ème
DROME,DIEULEFIT,0260009U,92,92,0,0,39,53,6 ème
DROME,MONTELIMAR,0260045H,173,160,0,13,82,91,6 ème
DROME,MONTELIMAR,0261086P,145,143,0,2,75,70,6 ème
DROME,PORTES-LES-VALENCE,0260021G,188,182,0,6,97,91,6 ème
DROME,ROMANS-SUR-ISERE,0261091V,42,39,0,3,23,19,6 ème
DROME,SAINT-DONAT-SUR-L'HERBASSE,0260026M,175,169,0,6,92,83,6 ème
DROME,SAINT-RAMBERT-D'ALBON,0260101U,94,86,0,8,40,54,6 ème
DROME,SUZE-LA-ROUSSE,0260033V,77,77,0,0,39,38,6 ème
DROME,VALENCE,0261100E,0,0,0,0,0,0,6 ème
HAUTE SAVOIE,ANNECY,0740065U,96,92,0,4,48,48,6 ème
HAUTE SAVOIE,ANNECY,0740106N,123,123,0,0,53,70,6 ème
HAUTE SAVOIE,ANNECY,0740930J,151,147,0,4,73,78,6 ème
HAUTE SAVOIE,ANNECY,0741278M,178,178,0,0,88,90,6 ème
HAUTE SAVOIE,ANNEMASSE,0741476C,0,0,0,0,0,0,6 ème
HAUTE SAVOIE,BONNEVILLE,0740157U,158,155,0,3,72,86,6 ème
HAUTE SAVOIE,CHAMONIX-MONT-BLANC,0740110T,57,57,0,0,28,29,6 ème
HAUTE SAVOIE,CLUSES,0740143D,0,0,0,0,0,0,6 ème
HAUTE SAVOIE,COLLONGES-SOUS-SALEVE,0740114X,87,87,0,0,40,47,6 ème
HAUTE SAVOIE,FRANGY,0740024Z,143,143,0,0,72,71,6 ème
HAUTE SAVOIE,GAILLARD,0741097R,143,141,0,2,81,62,6 ème
HAUTE SAVOIE,LA ROCHE-SUR-FORON,0740931K,204,188,16,0,92,112,6 ème
HAUTE SAVOIE,LA ROCHE-SUR-FORON,0741286W,0,0,0,0,0,0,6 ème
HAUTE SAVOIE,MARGENCEL,0741666J,166,147,16,3,80,86,6 ème
HAUTE SAVOIE,MEGEVE,0740026B,76,76,0,0,36,40,6 ème
HAUTE SAVOIE,POISY,0741699V,118,116,0,2,60,58,6 ème
HAUTE SAVOIE,RUMILLY,0740032H,201,177,22,2,83,118,6 ème
HAUTE SAVOIE,SAINT-GERVAIS-LES-BAINS,0740095B,23,23,0,0,13,10,6 ème
HAUTE SAVOIE,SAINT-JEOIRE,0740035L,177,174,0,3,82,95,6 ème
HAUTE SAVOIE,SAINT-JEOIRE,0740152N,0,0,0,0,0,0,6 ème
HAUTE SAVOIE,SAINT-JULIEN-EN-GENEVOIS,0740038P,246,236,10,0,113,133,6 ème
HAUTE SAVOIE,SALLANCHES,0741281R,106,103,0,3,58,48,6 ème
HAUTE SAVOIE,TANINGES,0740043V,115,115,0,0,59,56,6 ème
HAUTE SAVOIE,THONON-LES-BAINS,0740102J,153,153,0,0,75,78,6 ème
HAUTE SAVOIE,THONON-LES-BAINS,0741227G,224,223,0,1,100,124,6 ème
HAUTE SAVOIE,THONON-LES-BAINS,0741341F,244,224,16,4,116,128,6 ème
HAUTE SAVOIE,VILLE-LA-GRAND,0740910M,251,227,20,4,131,120,6 ème
ISERE,BEAUREPAIRE,0381685A,42,42,0,0,21,21,6 ème
ISERE,BOURGOIN-JALLIEU,0381658W,140,140,0,0,68,72,6 ème
ISERE,BOURGOIN-JALLIEU,0382174G,190,162,27,1,96,94,6 ème
ISERE,CHARVIEU-CHAVAGNEUX,0380011F,135,131,0,4,68,67,6 ème
ISERE,ECHIROLLES,0381903M,107,100,6,1,45,62,6 ème
ISERE,FONTAINE,0381810L,123,110,12,1,58,65,6 ème
ISERE,GIERES,0380025W,156,153,0,3,81,75,6 ème
ISERE,GRENOBLE,0380032D,0,0,0,0,0,0,6 ème
ISERE,GRENOBLE,0381758E,0,0,0,0,0,0,6 ème
ISERE,GRENOBLE,0381780D,137,137,0,0,57,80,6 ème
ISERE,GRENOBLE,0382114S,142,140,0,2,66,76,6 ème
ISERE,GRENOBLE,0383437E,20,14,6,0,8,12,6 ème
ISERE,LA COTE-SAINT-ANDRE,0382893N,0,0,0,0,0,0,6 ème
ISERE,LA MURE,0382426F,146,135,8,3,79,67,6 ème
ISERE,LA TRONCHE,0381630R,0,0,0,0,0,0,6 ème
ISERE,LE PONT-DE-BEAUVOISIN,0382427G,129,125,0,4,74,55,6 ème
ISERE,LE PONT-DE-CLAIX,0380013H,112,112,0,0,60,52,6 ème
ISERE,LES AVENIERES VEYRINS-THUELLIN,0380004Y,141,141,0,0,79,62,6 ème
ISERE,MONTALIEU-VERCIEU,0380045T,138,138,0,0,71,67,6 ème
ISERE,SAINT-ETIENNE-DE-SAINT-GEOIRS,0380059H,134,134,0,0,68,66,6 ème
ISERE,SAINT-MARTIN-D'HERES,0380357G,117,101,16,0,50,67,6 ème
ISERE,SAINT-MARTIN-LE-VINOUX,0382036G,144,135,8,1,63,81,6 ème
ISERE,SALAISE-SUR-SANNE,0383253E,193,193,0,0,80,113,6 ème
ISERE,VARCES-ALLIERES-ET-RISSET,0383260M,133,133,0,0,62,71,6 ème
ISERE,VIENNE,0382430K,169,169,0,0,79,90,6 ème
ISERE,VINAY,0380087N,160,157,0,3,71,89,6 ème
ISERE,VOIRON,0381809K,0,0,0,0,0,0,6 ème
SAVOIE,AIME-LA-PLAGNE,0730002F,97,97,0,0,45,52,6 ème
SAVOIE,AIX-LES-BAINS,0730791N,116,116,0,0,61,55,6 ème
SAVOIE,AIX-LES-BAINS,0731204M,100,100,0,0,47,53,6 ème
SAVOIE,ALBERTVILLE,0730760E,0,0,0,0,0,0,6 ème
SAVOIE,BARBERAZ,0730772T,0,0,0,0,0,0,6 ème
SAVOIE,BEAUFORT,0730007L,62,62,0,0,28,34,6 ème
SAVOIE,CHAMBERY,0730811K,9,0,9,0,1,8,6 ème
SAVOIE,MONTMELIAN,0731044N,234,221,13,0,115,119,6 ème
AIN,ARTEMARE,0010794H,65,63,0,2,31,34,6 ème
AIN,BAGE-DOMMARTIN,0010005A,158,157,0,1,73,85,6 ème
AIN,BELLEY,0011150V,96,94,0,2,52,44,6 ème
AIN,DAGNEUX,0011142L,146,146,0,0,63,83,6 ème
AIN,GEX,0010024W,212,193,15,4,92,120,6 ème
AIN,PERONNAS,0010938P,155,137,16,2,85,70,6 ème
AIN,PONCIN,0010036J,137,131,0,6,66,71,6 ème
AIN,TREVOUX,0010097A,163,163,0,0,81,82,6 ème
LOIRE,BOURG-ARGENTAL,0420003A,53,53,0,0,23,30,6 ème
LOIRE,CHAZELLES-SUR-LYON,0420011J,83,83,0,0,38,45,6 ème
LOIRE,LA PACAUDIERE,0421456E,70,70,0,0,35,35,6 ème
LOIRE,LE COTEAU,0421084A,125,113,9,3,60,65,6 ème
LOIRE,MONTBRISON,0421454C,274,247,24,3,137,137,6 ème
LOIRE,NOIRETABLE,0420022W,31,31,0,0,14,17,6 ème
LOIRE,RIVE-DE-GIER,0421172W,181,167,14,0,98,83,6 ème
LOIRE,ROANNE,0420987V,0,0,0,0,0,0,6 ème
LOIRE,SAINT-CHAMOND,0421486M,100,95,0,5,50,50,6 ème
LOIRE,SAINT-ETIENNE,0420049A,0,0,0,0,0,0,6 ème
LOIRE,SAINT-ETIENNE,0421176A,87,74,12,1,30,57,6 ème
LOIRE,SAINT-ETIENNE,0421686E,108,91,14,3,58,50,6 ème
LOIRE,SAINT-ETIENNE,0421804H,192,192,0,0,108,84,6 ème
LOIRE,SAINT-JUST-EN-CHEVALET,0420062P,50,50,0,0,26,24,6 ème
LOIRE,SAINT-JUST-EN-CHEVALET,0421061A,27,27,0,0,14,13,6 ème
RHONE,BRIGNAIS,0692582G,90,89,0,1,42,48,6 ème
RHONE,CALUIRE-ET-CUIRE,0691728D,150,134,11,5,65,85,6 ème
RHONE,CALUIRE-ET-CUIRE,0692968B,0,0,0,0,0,0,6 ème
RHONE,CHAPONNAY,0693243A,180,180,0,0,91,89,6 ème
RHONE,CHATILLON,0693975W,188,188,0,0,103,85,6 ème
RHONE,CIVRIEUX-D'AZERGUES,0690584K,80,78,0,2,38,42,6 ème
RHONE,CONDRIEU,0690587N,87,87,0,0,40,47,6 ème
RHONE,CORBAS,0692898A,116,113,0,3,57,59,6 ème
RHONE,COURS,0690016T,57,57,0,0,23,34,6 ème
RHONE,COURS,0690590S,23,23,0,0,14,9,6 ème
RHONE,DECINES-CHARPIEU,0694185Z,84,84,0,0,50,34,6 ème
RHONE,DEUX-GROSNES,0690070B,56,56,0,0,27,29,6 ème
RHONE,FRANCHEVILLE,0694151M,157,156,0,1,72,85,6 ème
RHONE,GENAS,0691650U,185,182,0,3,103,82,6 ème
RHONE,IRIGNY,0691824H,150,148,0,2,73,77,6 ème
RHONE,L'ARBRESLE,0690578D,113,113,0,0,60,53,6 ème
RHONE,LYON,0692929J,195,195,0,0,83,112,6 ème
RHONE,LYON,0694191F,171,171,0,0,75,96,6 ème
RHONE,LYON,0690641X,0,0,0,0,0,0,6 ème
RHONE,LYON,0690698J,0,0,0,0,0,0,6 ème
RHONE,LYON,0692505Y,166,165,0,1,78,88,6 ème
RHONE,LYON,0691798E,91,88,0,3,41,50,6 ème
RHONE,LYON,0692920Z,154,154,0,0,70,84,6 ème
RHONE,LYON,0692339T,149,134,14,1,73,76,6 ème
RHONE,LYON,0692922B,119,119,0,0,63,56,6 ème
RHONE,LYON,0693479G,164,164,0,0,84,80,6 ème
RHONE,LYON,0692340U,159,138,15,6,73,86,6 ème
RHONE,LYON,0692940W,203,203,0,0,107,96,6 ème
RHONE,LYON,0692698H,231,229,0,2,124,107,6 ème
RHONE,NEUVILLE-SUR-SAONE,0692941X,271,271,0,0,125,146,6 ème
RHONE,OULLINS,0691673U,55,54,0,1,27,28,6 ème
RHONE,RILLIEUX-LA-PAPE,0691498D,160,157,0,3,70,90,6 ème
RHONE,RILLIEUX-LA-PAPE,0692159X,149,137,12,0,71,78,6 ème
RHONE,SAINT-DIDIER-AU-MONT-D'OR,0690546U,153,153,0,0,84,69,6 ème
RHONE,SAINT-LAURENT-DE-MURE,0692865P,202,198,0,4,85,117,6 ème
RHONE,SAINT-PRIEST,0694312M,86,86,0,0,41,45,6 ème
RHONE,TASSIN-LA-DEMI-LUNE,0692163B,197,193,0,4,88,109,6 ème
RHONE,VAL D'OINGT,0690580F,81,81,0,0,27,54,6 ème
RHONE,VAUGNERAY,0690621A,180,178,0,2,94,86,6 ème
RHONE,VAULX-EN-VELIN,0692336P,157,141,12,4,77,80,6 ème
RHONE,VENISSIEUX,0690551Z,179,179,0,0,101,78,6 ème
RHONE,VILLEFRANCHE-SUR-SAONE,0690099H,119,106,11,2,54,65,6 ème
RHONE,VILLEFRANCHE-SUR-SAONE,0693375U,0,0,0,0,0,0,6 ème
RHONE,VILLEURBANNE,0690047B,0,0,0,0,0,0,6 ème
RHONE,VILLEURBANNE,0690107S,0,0,0,0,0,0,6 ème
RHONE,VILLEURBANNE,0690626F,150,139,8,3,69,81,6 ème
RHONE,VILLEURBANNE,0692337R,142,141,0,1,76,66,6 ème
RHONE,VILLEURBANNE,0693093M,101,100,0,1,48,53,6 ème
RHONE,VILLEURBANNE,0694296V,126,123,0,3,64,62,6 ème
DOUBS,AMANCEY,0251048D,14,14,0,0,5,9,6 ème
DOUBS,AUDINCOURT,0250001R,0,0,0,0,0,0,6 ème
DOUBS,BESANCON,0250013D,0,0,0,0,0,0,6 ème
DOUBS,BESANCON,0251079M,0,0,0,0,0,0,6 ème
DOUBS,BESANCON,0251080N,160,144,16,0,81,79,6 ème
DOUBS,BESANCON,0251127P,153,152,0,1,70,83,6 ème
DOUBS,LEVIER,0251069B,76,76,0,0,29,47,6 ème
DOUBS,MOUTHE,0250040H,130,130,0,0,59,71,6 ème
DOUBS,ORNANS,0251129S,92,90,0,2,33,59,6 ème
DOUBS,ROULANS,0250051V,109,109,0,0,50,59,6 ème
DOUBS,SAINT-VIT,0251394E,182,171,11,0,80,102,6 ème
DOUBS,VERCEL-VILLEDIEU-LE-CAMP,0251062U,73,73,0,0,33,40,6 ème
HAUTE-SAONE,DAMPIERRE-SUR-SALON,0700004Z,85,85,0,0,30,55,6 ème
HAUTE-SAONE,FOUGEROLLES-SAINT-VALBERT,0700007C,42,39,0,3,21,21,6 ème
HAUTE-SAONE,GRAY,0700011G,0,0,0,0,0,0,6 ème
HAUTE-SAONE,LURE,0700018P,0,0,0,0,0,0,6 ème
HAUTE-SAONE,LURE,0700076C,0,0,0,0,0,0,6 ème
HAUTE-SAONE,MARNAY,0700026Y,142,142,0,0,81,61,6 ème
HAUTE-SAONE,RIOZ,0700029B,202,199,0,3,103,99,6 ème
HAUTE-SAONE,SAINT-LOUP-SUR-SEMOUSE,0700788B,73,73,0,0,36,37,6 ème
HAUTE-SAONE,VESOUL,0700786Z,128,106,21,1,71,57,6 ème
HAUTE-SAONE,VILLERSEXEL,0700077D,12,0,12,0,3,9,6 ème
JURA,ARBOIS,0390960G,44,44,0,0,21,23,6 ème
JURA,CHAMPAGNOLE,0390961H,120,120,0,0,60,60,6 ème
JURA,DAMPARIS,0390010Z,80,80,0,0,37,43,6 ème
JURA,DOLE,0390797E,110,109,0,1,63,47,6 ème
JURA,DOLE,0391002C,176,157,16,3,78,98,6 ème
JURA,FRAISANS,0390016F,100,100,0,0,48,52,6 ème
JURA,LONS-LE-SAUNIER,0390907Z,152,124,25,3,71,81,6 ème
JURA,ORGELET,0390031X,53,48,0,5,25,28,6 ème
JURA,SAINT-AMOUR,0390914G,0,0,0,0,0,0,6 ème
JURA,SAINT-CLAUDE,0390071R,76,76,0,0,36,40,6 ème
JURA,VOITEUR,0390073T,58,58,0,0,28,30,6 ème
TERRITOIRE DE BELFORT,BAVILLIERS,0900355X,0,0,0,0,0,0,6 ème
TERRITOIRE DE BELFORT,BEAUCOURT,0900275K,116,113,0,3,69,47,6 ème
TERRITOIRE DE BELFORT,DANJOUTIN,0900237U,152,150,0,2,80,72,6 ème
TERRITOIRE DE BELFORT,DELLE,0900007U,121,113,8,0,55,66,6 ème
TERRITOIRE DE BELFORT,DELLE,0900019G,0,0,0,0,0,0,6 ème
COTE D'OR,ARNAY-LE-DUC,0210001M,44,44,0,0,15,29,6 ème
COTE D'OR,BROCHON,0211140A,157,157,0,0,80,77,6 ème
COTE D'OR,CHENOVE,0211225T,71,58,12,1,32,39,6 ème
COTE D'OR,CHEVIGNY-SAINT-SAUVEUR,0211137X,196,194,0,2,94,102,6 ème
COTE D'OR,DIJON,0210019G,0,0,0,0,0,0,6 ème
COTE D'OR,DIJON,0210025N,74,72,0,2,32,42,6 ème
COTE D'OR,DIJON,0211070Z,305,286,15,4,142,163,6 ème
COTE D'OR,MARSANNAY-LA-COTE,0211391Y,88,85,0,3,35,53,6 ème
COTE D'OR,MONTBARD,0210034Y,67,65,0,2,34,33,6 ème
COTE D'OR,NOLAY,0210037B,49,49,0,0,25,24,6 ème
COTE D'OR,PONTAILLER-SUR-SAONE,0210040E,103,103,0,0,53,50,6 ème
COTE D'OR,SEMUR-EN-AUXOIS,0210047M,0,0,0,0,0,0,6 ème
COTE D'OR,TALANT,0211523S,86,84,0,2,43,43,6 ème
NIEVRE,DORNES,0580019F,29,29,0,0,11,18,6 ème
NIEVRE,IMPHY,0580618G,82,78,0,4,38,44,6 ème
NIEVRE,LUZY,0580619H,28,28,0,0,10,18,6 ème
NIEVRE,MOULINS-ENGILBERT,0580030T,50,50,0,0,27,23,6 ème
NIEVRE,VARENNES-VAUZELLES,0580620J,104,87,15,2,43,61,6 ème
SAONE-ET-LOIRE,CHAGNY,0710009Z,144,138,0,6,73,71,6 ème
SAONE-ET-LOIRE,CHALON-SUR-SAONE,0710012C,0,0,0,0,0,0,6 ème
SAONE-ET-LOIRE,CHAUFFAILLES,0710021M,58,58,0,0,29,29,6 ème
SAONE-ET-LOIRE,DIGOIN,0711136Z,117,115,0,2,53,64,6 ème
SAONE-ET-LOIRE,LUGNY,0710044M,138,137,0,1,67,71,6 ème
SAONE-ET-LOIRE,MACON,0711054K,185,172,12,1,90,95,6 ème
SAONE-ET-LOIRE,MATOUR,0710053X,67,67,0,0,36,31,6 ème
SAONE-ET-LOIRE,MONTCEAU-LES-MINES,0711135Y,101,96,0,5,45,56,6 ème
SAONE-ET-LOIRE,PARAY-LE-MONIAL,0711314T,89,89,0,0,37,52,6 ème
SAONE-ET-LOIRE,SAINT-GENGOUX-LE-NATIONAL,0710064J,60,60,0,0,26,34,6 ème
SAONE-ET-LOIRE,TOURNUS,0710535W,109,103,0,6,50,59,6 ème
YONNE,ANCY-LE-FRANC,0890979F,35,35,0,0,20,15,6 ème
YONNE,BRIENON-SUR-ARMANCON,0891057R,54,54,0,0,33,21,6 ème
YONNE,PONT-SUR-YONNE,0890823L,142,134,8,0,56,86,6 ème
YONNE,SENS,0890030Z,93,91,0,2,45,48,6 ème
YONNE,VERMENTON,0890037G,47,47,0,0,25,22,6 ème
COTES D'ARMOR,BROONS,0220136D,56,56,0,0,29,27,6 ème
COTES D'ARMOR,CORLAY,0220009R,20,20,0,0,6,14,6 ème
COTES D'ARMOR,DINAN,0221744B,111,106,0,5,53,58,6 ème
COTES D'ARMOR,GOUAREC,0221745C,17,17,0,0,8,9,6 ème
COTES D'ARMOR,GUERLEDAN,0220150U,28,28,0,0,13,15,6 ème
COTES D'ARMOR,LAMBALLE-ARMOR,0220142K,215,213,0,2,104,111,6 ème
COTES D'ARMOR,LAMBALLE-ARMOR,0220196U,0,0,0,0,0,0,6 ème
COTES D'ARMOR,LE MENE,0220008P,58,58,0,0,32,26,6 ème
COTES D'ARMOR,PLERIN,0220134B,95,95,0,0,42,53,6 ème
COTES D'ARMOR,PLOUER-SUR-RANCE,0220161F,70,70,0,0,30,40,6 ème
COTES D'ARMOR,SAINT-BRIEUC,0220071H,0,0,0,0,0,0,6 ème
COTES D'ARMOR,SAINT-BRIEUC,0220184F,98,90,8,0,43,55,6 ème
COTES D'ARMOR,SAINT-NICOLAS-DU-PELEM,0220061X,16,16,0,0,8,8,6 ème
COTES D'ARMOR,SAINT-QUAY-PORTRIEUX,0220063Z,87,87,0,0,41,46,6 ème
COTES D'ARMOR,SAINT-QUAY-PORTRIEUX,0220176X,56,56,0,0,27,29,6 ème
FINISTERE,BREST,0290012F,0,0,0,0,0,0,6 ème
FINISTERE,BREST,0290236Z,44,44,0,0,17,27,6 ème
FINISTERE,BREST,0291661Y,75,59,16,0,41,34,6 ème
FINISTERE,BREST,0291869Z,204,204,0,0,105,99,6 ème
FINISTERE,CARHAIX-PLOUGUER,0290247L,64,64,0,0,25,39,6 ème
FINISTERE,CONCARNEAU,0290031B,86,85,0,1,48,38,6 ème
FINISTERE,CROZON,0290032C,112,112,0,0,52,60,6 ème
FINISTERE,DOUARNENEZ,0290260A,72,72,0,0,37,35,6 ème
FINISTERE,GUERLESQUIN,0290039K,56,56,0,0,33,23,6 ème
FINISTERE,GUILERS,0291713E,58,58,0,0,27,31,6 ème
FINISTERE,GUIPAVAS,0291655S,141,139,0,2,70,71,6 ème
FINISTERE,HUELGOAT,0290148D,29,29,0,0,18,11,6 ème
FINISTERE,LANDERNEAU,0290045S,197,183,14,0,102,95,6 ème
FINISTERE,LE RELECQ-KERHUON,0292055B,95,95,0,0,35,60,6 ème
FINISTERE,MOELAN-SUR-MER,0291717J,95,95,0,0,48,47,6 ème
FINISTERE,MORLAIX,0291104T,52,48,0,4,25,27,6 ème
FINISTERE,PLABENNEC,0290286D,134,131,0,3,65,69,6 ème
FINISTERE,PLOUDALMEZEAU,0290065N,104,104,0,0,54,50,6 ème
FINISTERE,PLOUGASTEL-DAOULAS,0291928N,130,125,0,5,63,67,6 ème
FINISTERE,PLOUHINEC,0290330B,52,52,0,0,23,29,6 ème
FINISTERE,PLOUNEOUR-MENEZ,0290058F,73,73,0,0,37,36,6 ème
FINISTERE,PLOUZANE,0291753Y,89,89,0,0,40,49,6 ème
FINISTERE,PONT-AVEN,0290301V,25,25,0,0,14,11,6 ème
FINISTERE,PONT-L'ABBE,0290168A,0,0,0,0,0,0,6 ème
FINISTERE,QUIMPER,0290071V,0,0,0,0,0,0,6 ème
FINISTERE,QUIMPER,0290320R,79,79,0,0,39,40,6 ème
FINISTERE,QUIMPERLE,0290107J,81,79,0,2,43,38,6 ème
FINISTERE,SAINT-MARTIN-DES-CHAMPS,0290083H,58,53,0,5,23,35,6 ème
ILLE-ET-VILAINE,BREAL-SOUS-MONTFORT,0352958A,163,163,0,0,79,84,6 ème
ILLE-ET-VILAINE,CANCALE,0350853M,76,76,0,0,46,30,6 ème
ILLE-ET-VILAINE,CESSON-SEVIGNE,0353006C,60,60,0,0,28,32,6 ème
ILLE-ET-VILAINE,CHATEAUBOURG,0352448W,156,156,0,0,75,81,6 ème
ILLE-ET-VILAINE,COMBOURG,0350707D,176,176,0,0,83,93,6 ème
ILLE-ET-VILAINE,CREVIN,0352860U,134,134,0,0,61,73,6 ème
ILLE-ET-VILAINE,DINARD,0351795L,126,126,0,0,64,62,6 ème
ILLE-ET-VILAINE,FOUGERES,0350770X,219,219,0,0,118,101,6 ème
ILLE-ET-VILAINE,FOUGERES,0350967L,103,71,32,0,50,53,6 ème
ILLE-ET-VILAINE,GUICHEN,0351881E,176,174,0,2,86,90,6 ème
ILLE-ET-VILAINE,LA GUERCHE-DE-BRETAGNE,0350863Y,138,138,0,0,63,75,6 ème
ILLE-ET-VILAINE,MARTIGNE-FERCHAUD,0350868D,72,72,0,0,35,37,6 ème
ILLE-ET-VILAINE,MELESSE,0352183H,147,147,0,0,65,82,6 ème
ILLE-ET-VILAINE,MONTFORT-SUR-MEU,0350872H,178,177,0,1,90,88,6 ème
ILLE-ET-VILAINE,MONTFORT-SUR-MEU,0351791G,211,185,26,0,111,100,6 ème
ILLE-ET-VILAINE,PIPRIAC,0350875L,107,107,0,0,50,57,6 ème
ILLE-ET-VILAINE,PLEINE-FOUGERES,0350021H,74,74,0,0,40,34,6 ème
ILLE-ET-VILAINE,PLEINE-FOUGERES,0350877N,49,49,0,0,24,25,6 ème
ILLE-ET-VILAINE,PLELAN-LE-GRAND,0350878P,73,73,0,0,38,35,6 ème
ILLE-ET-VILAINE,REDON,0350102W,0,0,0,0,0,0,6 ème
ILLE-ET-VILAINE,RENNES,0350031U,0,0,0,0,0,0,6 ème
ILLE-ET-VILAINE,RENNES,0350760L,80,80,0,0,48,32,6 ème
ILLE-ET-VILAINE,RENNES,0350776D,0,0,0,0,0,0,6 ème
ILLE-ET-VILAINE,RENNES,0350835T,127,122,0,5,62,65,6 ème
ILLE-ET-VILAINE,RENNES,0351054F,0,0,0,0,0,0,6 ème
ILLE-ET-VILAINE,RENNES,0352071L,30,30,0,0,8,22,6 ème
ILLE-ET-VILAINE,SAINT-MALO,0350785N,110,110,0,0,57,53,6 ème
ILLE-ET-VILAINE,TINTENIAC,0350050P,0,0,0,0,0,0,6 ème
ILLE-ET-VILAINE,VAL D'ANAST,0350017D,88,84,0,4,45,43,6 ème
ILLE-ET-VILAINE,VITRE,0350808N,0,0,0,0,0,0,6 ème
ILLE-ET-VILAINE,VITRE,0352008T,112,112,0,0,50,62,6 ème
MORBIHAN,BAUD,0561386C,95,95,0,0,41,54,6 ème
MORBIHAN,BAUD,0561399S,83,83,0,0,40,43,6 ème
MORBIHAN,ETEL,0560009F,119,119,0,0,67,52,6 ème
MORBIHAN,GOURIN,0561383Z,53,53,0,0,29,24,6 ème
MORBIHAN,GROIX,0561352R,5,5,0,0,2,3,6 ème
MORBIHAN,GUER,0560061M,85,85,0,0,52,33,6 ème
MORBIHAN,LA GACILLY,0561400T,118,118,0,0,52,66,6 ème
MORBIHAN,LE PALAIS,0560034H,41,41,0,0,18,23,6 ème
MORBIHAN,LORIENT,0560149H,114,111,0,3,59,55,6 ème
MORBIHAN,PLESCOP,0561931V,123,112,0,11,69,54,6 ème
MORBIHAN,PLOERMEL,0560108N,235,209,16,10,133,102,6 ème
MORBIHAN,PLUVIGNER,0561356V,169,169,0,0,77,92,6 ème
MORBIHAN,QUESTEMBERT,0561641E,0,0,0,0,0,0,6 ème
MORBIHAN,QUEVEN,0561384A,172,159,10,3,89,83,6 ème
MORBIHAN,VANNES,0560118Z,217,202,15,0,101,116,6 ème
CHER,BOURGES,0180593X,180,162,16,2,97,83,6 ème
CHER,BOURGES,0180766K,64,64,0,0,26,38,6 ème
CHER,BOURGES,0180796T,223,223,0,0,111,112,6 ème
CHER,BOURGES,0180823X,0,0,0,0,0,0,6 ème
CHER,CHATEAUMEILLANT,0180013S,51,46,5,0,30,21,6 ème
CHER,LA GUERCHE-SUR-L'AUBOIS,0180710Z,69,59,8,2,39,30,6 ème
CHER,MEHUN-SUR-YEVRE,0180586P,119,112,0,7,55,64,6 ème
CHER,SAINT-GERMAIN-DU-PUY,0180732Y,125,113,11,1,60,65,6 ème
CHER,SANCOINS,0180033N,46,46,0,0,24,22,6 ème
CHER,VIERZON,0180036S,0,0,0,0,0,0,6 ème
CHER,VIERZON,0180572Z,0,0,0,0,0,0,6 ème
EURE-ET-LOIR,AUTHON-DU-PERCHE,0280002A,46,45,0,1,24,22,6 ème
EURE-ET-LOIR,BU,0281095N,133,127,0,6,68,65,6 ème
EURE-ET-LOIR,CHARTRES,0280691Z,0,0,0,0,0,0,6 ème
EURE-ET-LOIR,CHARTRES,0280993C,159,159,0,0,99,60,6 ème
EURE-ET-LOIR,CHATEAUDUN,0280918W,82,66,16,0,33,49,6 ème
EURE-ET-LOIR,ILLIERS-COMBRAY,0280702L,140,137,0,3,63,77,6 ème
EURE-ET-LOIR,LES VILLAGES VOVEENS,0280040S,102,98,0,4,48,54,6 ème
EURE-ET-LOIR,LUCE,0280657M,85,64,16,5,37,48,6 ème
EURE-ET-LOIR,LUISANT,0281043G,149,146,0,3,78,71,6 ème
EURE-ET-LOIR,NOGENT-LE-ROI,0280035L,160,156,0,4,76,84,6 ème
EURE-ET-LOIR,SAINT-MAURICE-SAINT-GERMAIN,0280684S,0,0,0,0,0,0,6 ème
EURE-ET-LOIR,SAINT-PREST,0281055V,182,180,0,2,93,89,6 ème
EURE-ET-LOIR,SENONCHES,0280887M,76,76,0,0,36,40,6 ème
INDRE,AIGURANDE,0360001F,33,33,0,0,17,16,6 ème
INDRE,ARGENTON-SUR-CREUSE,0360003H,0,0,0,0,0,0,6 ème
INDRE,BUZANCAIS,0360511K,29,29,0,0,16,13,6 ème
INDRE,ISSOUDUN,0360024F,0,0,0,0,0,0,6 ème
INDRE,LE BLANC,0360005K,0,0,0,0,0,0,6 ème
INDRE,LE BLANC,0360719L,96,85,7,4,47,49,6 ème
INDRE,LEVROUX,0360028K,61,61,0,0,31,30,6 ème
INDRE,NEUVY-SAINT-SEPULCHRE,0360030M,75,70,0,5,27,48,6 ème
INDRE,VALENCAY,0360525A,61,56,0,5,31,30,6 ème
INDRE-ET-LOIRE,AMBOISE,0371325P,78,78,0,0,45,33,6 ème
INDRE-ET-LOIRE,FONDETTES,0371397T,107,107,0,0,47,60,6 ème
INDRE-ET-LOIRE,LOCHES,0370016S,0,0,0,0,0,0,6 ème
INDRE-ET-LOIRE,SAINTE-MAURE-DE-TOURAINE,0371101W,123,110,10,3,62,61,6 ème
INDRE-ET-LOIRE,SAINT-PIERRE-DES-CORPS,0371391L,97,97,0,0,47,50,6 ème
INDRE-ET-LOIRE,TOURS,0370040T,0,0,0,0,0,0,6 ème
INDRE-ET-LOIRE,TOURS,0370045Y,107,107,0,0,51,56,6 ème
INDRE-ET-LOIRE,TOURS,0370732V,63,63,0,0,27,36,6 ème
INDRE-ET-LOIRE,TOURS,0370757X,0,0,0,0,0,0,6 ème
INDRE-ET-LOIRE,TOURS,0370884K,142,142,0,0,69,73,6 ème
INDRE-ET-LOIRE,TOURS,0370991B,91,71,15,5,34,57,6 ème
INDRE-ET-LOIRE,TOURS,0371158H,65,65,0,0,38,27,6 ème
LOIRET,AMILLY,0450937Z,223,207,12,4,109,114,6 ème
LOIRET,BEAUNE-LA-ROLANDE,0450006M,164,160,0,4,80,84,6 ème
LOIRET,BELLEGARDE,0450007N,122,107,14,1,56,66,6 ème
LOIRET,COURTENAY,0451173F,135,132,0,3,73,62,6 ème
LOIRET,FERRIERES-EN-GATINAIS,0450022E,138,137,0,1,61,77,6 ème
LOIRET,GIEN,0451245J,107,102,0,5,50,57,6 ème
LOIRET,LA CHAPELLE-SAINT-MESMIN,0451035F,151,145,0,6,71,80,6 ème
LOIRET,LES BORDES,0451608D,114,112,0,2,52,62,6 ème
LOIRET,MONTARGIS,0450041A,81,79,0,2,40,41,6 ème
LOIRET,OLIVET,0450047G,164,164,0,0,75,89,6 ème
LOIRET,ORLEANS,0450786K,0,0,0,0,0,0,6 ème
LOIRET,ORLEANS,0450939B,137,132,0,5,62,75,6 ème
LOIRET,ORLEANS,0451316L,116,109,3,4,63,53,6 ème
LOIRET,ORLEANS,0451590J,0,0,0,0,0,0,6 ème
LOIRET,PATAY,0450061X,114,108,0,6,64,50,6 ème
LOIRET,PITHIVIERS,0450750W,0,0,0,0,0,0,6 ème
LOIRET,PITHIVIERS,0451788Z,151,140,6,5,69,82,6 ème
LOIRET,SAINT-DENIS-EN-VAL,0451660K,140,138,0,2,61,79,6 ème
LOIRET,TIGY,0451449F,121,117,0,4,62,59,6 ème
LOIR-ET-CHER,BLOIS,0410003F,142,126,16,0,69,73,6 ème
LOIR-ET-CHER,BLOIS,0410918A,147,147,0,0,75,72,6 ème
LOIR-ET-CHER,MONTOIRE-SUR-LE-LOIR,0410566T,121,110,9,2,56,65,6 ème
LOIR-ET-CHER,NEUNG-SUR-BEUVRON,0410035R,71,71,0,0,37,34,6 ème
LOIR-ET-CHER,OUCQUES LA NOUVELLE,0410015U,61,58,0,3,32,29,6 ème
LOIR-ET-CHER,SAINT-LAURENT-NOUAN,0410914W,121,102,16,3,58,63,6 ème
LOIR-ET-CHER,SALBRIS,0410686Y,31,31,0,0,18,13,6 ème
LOIR-ET-CHER,SALBRIS,0410717G,88,86,0,2,38,50,6 ème
LOIR-ET-CHER,VENDOME,0410768M,194,167,23,4,96,98,6 ème
CORSE-DU-SUD,AJACCIO,6200011T,164,164,0,0,85,79,6 ème
CORSE-DU-SUD,AJACCIO,6200084X,195,195,0,0,106,89,6 ème
CORSE-DU-SUD,AJACCIO,6200636X,0,0,0,0,0,0,6 ème
CORSE-DU-SUD,PORTO-VECCHIO,6200697N,111,93,13,5,42,69,6 ème
CORSE-DU-SUD,VICO,6200048H,38,38,0,0,17,21,6 ème
HAUTE-CORSE,CERVIONE,7200020J,100,98,2,0,52,48,6 ème
HAUTE-CORSE,L'ILE-ROUSSE,7200025P,106,100,3,3,53,53,6 ème
MEURTHE-ET-MOSELLE,ART-SUR-MEURTHE,0541344T,0,0,0,0,0,0,6 ème
MEURTHE-ET-MOSELLE,BENAMENIL,0540004L,81,78,0,3,40,41,6 ème
MEURTHE-ET-MOSELLE,DOMMARTEMONT,0541706L,88,71,16,1,47,41,6 ème
MEURTHE-ET-MOSELLE,JARNY,0540076P,0,0,0,0,0,0,6 ème
MEURTHE-ET-MOSELLE,JARVILLE-LA-MALGRANGE,0541306B,235,235,0,0,132,103,6 ème
MEURTHE-ET-MOSELLE,JARVILLE-LA-MALGRANGE,0541817G,135,117,15,3,52,83,6 ème
MEURTHE-ET-MOSELLE,LAXOU,0542262R,0,0,0,0,0,0,6 ème
MEURTHE-ET-MOSELLE,LIVERDUN,0541284C,133,133,0,0,49,84,6 ème
MEURTHE-ET-MOSELLE,LONGUYON,0542349K,100,100,0,0,47,53,6 ème
MEURTHE-ET-MOSELLE,LONGWY,0541288G,97,95,0,2,39,58,6 ème
MEURTHE-ET-MOSELLE,LUDRES,0542189L,147,143,0,4,72,75,6 ème
MEURTHE-ET-MOSELLE,NANCY,0540082W,0,0,0,0,0,0,6 ème
MEURTHE-ET-MOSELLE,NANCY,0540106X,135,133,0,2,82,53,6 ème
MEURTHE-ET-MOSELLE,REHON,0541336J,96,96,0,0,47,49,6 ème
MEURTHE-ET-MOSELLE,SAINT-NICOLAS-DE-PORT,0541572R,120,118,0,2,62,58,6 ème
MEURTHE-ET-MOSELLE,TOUL,0541210X,142,140,0,2,65,77,6 ème
MEURTHE-ET-MOSELLE,VAL DE BRIEY,0540115G,100,97,0,3,53,47,6 ème
MEURTHE-ET-MOSELLE,VEZELISE,0540071J,120,120,0,0,56,64,6 ème
MEUSE,BAR-LE-DUC,0550003E,0,0,0,0,0,0,6 ème
MEUSE,BAR-LE-DUC,0550004F,0,0,0,0,0,0,6 ème
MEUSE,STENAY,0550020Y,106,89,8,9,54,52,6 ème
MEUSE,VERDUN,0550026E,0,0,0,0,0,0,6 ème
MEUSE,VERDUN,0550055L,38,38,0,0,21,17,6 ème
MOSELLE,ALGRANGE,0570241C,0,0,0,0,0,0,6 ème
MOSELLE,AUMETZ,0572583Y,76,76,0,0,34,42,6 ème
MOSELLE,BOUZONVILLE,0570012D,118,113,0,5,60,58,6 ème
MOSELLE,DELME,0570020M,95,93,0,2,47,48,6 ème
MOSELLE,FAREBERSVILLER,0572023P,138,130,5,3,68,70,6 ème
MOSELLE,FOLSCHVILLER,0572187T,86,82,0,4,40,46,6 ème
MOSELLE,FORBACH,0572180K,122,110,8,4,68,54,6 ème
MOSELLE,FREYMING-MERLEBACH,0573491K,0,0,0,0,0,0,6 ème
MOSELLE,GROSBLIEDERSTROFF,0572363J,91,89,0,2,51,40,6 ème
MOSELLE,LONGEVILLE-LES-SAINT-AVOLD,0572360F,88,87,0,1,48,40,6 ème
MOSELLE,LORQUIN,0570328X,76,76,0,0,37,39,6 ème
MOSELLE,MARLY,0573211F,0,0,0,0,0,0,6 ème
MOSELLE,METZ,0570283Y,0,0,0,0,0,0,6 ème
MOSELLE,METZ,0572168X,102,101,0,1,49,53,6 ème
MOSELLE,SAINT-AVOLD,0572488V,162,146,11,5,88,74,6 ème
MOSELLE,SARREBOURG,0570213X,59,59,0,0,25,34,6 ème
MOSELLE,THIONVILLE,0572811W,129,129,0,0,54,75,6 ème
MOSELLE,VERNY,0573754W,143,139,0,4,73,70,6 ème
MOSELLE,WOIPPY,0572582X,118,118,0,0,56,62,6 ème
VOSGES,CAPAVENIR VOSGES,0881147U,127,118,3,6,65,62,6 ème
VOSGES,CHARMES,0881145S,137,115,12,10,62,75,6 ème
VOSGES,CHATEL-SUR-MOSELLE,0880418B,108,107,0,1,53,55,6 ème
VOSGES,EPINAL,0880149J,90,88,0,2,47,43,6 ème
VOSGES,LE THILLOT,0880065T,117,105,7,5,62,55,6 ème
VOSGES,RAMBERVILLERS,0880045W,118,114,0,4,66,52,6 ème
VOSGES,RAON-L'ETAPE,0881120P,87,80,5,2,42,45,6 ème
VOSGES,REMIREMONT,0881140L,0,0,0,0,0,0,6 ème
VOSGES,SAINT-DIE-DES-VOSGES,0880151L,163,150,10,3,84,79,6 ème
VOSGES,SAINT-DIE-DES-VOSGES,0881447V,37,36,0,1,25,12,6 ème
VOSGES,SENONES,0881101U,73,66,0,7,35,38,6 ème
VOSGES,VITTEL,0880156S,90,84,0,6,41,49,6 ème
ARDENNES,CARIGNAN,0081099B,84,77,7,0,41,43,6 ème
ARDENNES,CHARLEVILLE-MEZIERES,0080010T,0,0,0,0,0,0,6 ème
ARDENNES,CHARLEVILLE-MEZIERES,0080035V,84,83,0,1,48,36,6 ème
ARDENNES,CHARLEVILLE-MEZIERES,0080068F,61,61,0,0,31,30,6 ème
ARDENNES,JUNIVILLE,0080021E,82,82,0,0,42,40,6 ème
ARDENNES,NOUZONVILLE,0080036W,69,62,7,0,38,31,6 ème
ARDENNES,SEDAN,0080048J,0,0,0,0,0,0,6 ème
ARDENNES,VIREUX-WALLERAND,0080052N,49,49,0,0,24,25,6 ème
ARDENNES,VRIGNE AUX BOIS,0080839U,86,74,9,3,47,39,6 ème
AUBE,BAR-SUR-SEINE,0100005B,143,132,9,2,67,76,6 ème
AUBE,BOUILLY,0100765C,149,144,5,0,71,78,6 ème
AUBE,LUSIGNY-SUR-BARSE,0100033G,120,120,0,0,45,75,6 ème
AUBE,PONT-SAINTE-MARIE,0101031S,162,153,6,3,88,74,6 ème
AUBE,ROMILLY-SUR-SEINE,0100016N,0,0,0,0,0,0,6 ème
AUBE,ROMILLY-SUR-SEINE,0100787B,138,135,0,3,63,75,6 ème
AUBE,ROMILLY-SUR-SEINE,0100905E,138,121,14,3,73,65,6 ème
AUBE,SAINTE-SAVINE,0100664T,169,169,0,0,83,86,6 ème
HAUTE-MARNE,CHATEAUVILLAIN,0520006Z,37,37,0,0,21,16,6 ème
HAUTE-MARNE,CHAUMONT,0520966T,96,96,0,0,49,47,6 ème
HAUTE-MARNE,DOULAINCOURT-SAUCOURT,0520014H,55,55,0,0,30,25,6 ème
HAUTE-MARNE,FRONCLES,0520018M,36,36,0,0,20,16,6 ème
HAUTE-MARNE,LANGRES,0520021R,0,0,0,0,0,0,6 ème
HAUTE-MARNE,LA PORTE DU DER,0520022S,71,71,0,0,44,27,6 ème
HAUTE-MARNE,SAINT-DIZIER,0520692V,0,0,0,0,0,0,6 ème
HAUTE-MARNE,SAINT-DIZIER,0520968V,115,115,0,0,63,52,6 ème
HAUTE-MARNE,WASSY,0520032C,0,0,0,0,0,0,6 ème
MARNE,ANGLURE,0510001Z,79,79,0,0,39,40,6 ème
MARNE,CHALONS-EN-CHAMPAGNE,0511106A,1,0,1,0,0,1,6 ème
MARNE,CHALONS-EN-CHAMPAGNE,0511147V,0,0,0,0,0,0,6 ème
MARNE,FAGNIERES,0511472Y,134,131,3,0,73,61,6 ème
MARNE,GUEUX,0511564Y,157,157,0,0,79,78,6 ème
MARNE,MONTMIRAIL,0511177C,45,45,0,0,26,19,6 ème
MARNE,REIMS,0511801F,198,198,0,0,83,115,6 ème
MARNE,SAINT-MEMMIE,0511216V,167,156,11,0,84,83,6 ème
MARNE,VITRY-LE-FRANCOIS,0511144S,86,86,0,0,45,41,6 ème
MARNE,WITRY-LES-REIMS,0512014M,114,114,0,0,64,50,6 ème
BAS-RHIN,CHATENOIS,0671962U,115,115,0,0,57,58,6 ème
BAS-RHIN,DRULINGEN,0670014B,97,94,0,3,55,42,6 ème
BAS-RHIN,ERSTEIN,0670017E,177,158,16,3,84,93,6 ème
BAS-RHIN,GERSTHEIM,0672135G,86,86,0,0,44,42,6 ème
BAS-RHIN,HOERDT,0672012Y,111,111,0,0,61,50,6 ème
BAS-RHIN,ILLKIRCH-GRAFFENSTADEN,0672194W,184,176,6,2,80,104,6 ème
BAS-RHIN,LAUTERBOURG,0671688W,82,82,0,0,44,38,6 ème
BAS-RHIN,LINGOLSHEIM,0671690Y,154,136,15,3,73,81,6 ème
BAS-RHIN,MARMOUTIER,0671985U,106,102,0,4,60,46,6 ème
BAS-RHIN,MATZENHEIM,0671604E,79,79,0,0,37,42,6 ème
BAS-RHIN,MOLSHEIM,0672606U,152,133,15,4,64,88,6 ème
BAS-RHIN,NIEDERBRONN-LES-BAINS,0671738A,86,82,0,4,41,45,6 ème
BAS-RHIN,REICHSHOFFEN,0671595V,98,86,8,4,39,59,6 ème
BAS-RHIN,SAVERNE,0671987W,120,117,0,3,71,49,6 ème
BAS-RHIN,SCHILTIGHEIM,0670089H,0,0,0,0,0,0,6 ème
BAS-RHIN,SELESTAT,0671830A,151,135,16,0,65,86,6 ème
BAS-RHIN,SOUFFELWEYERSHEIM,0672254L,130,129,0,1,64,66,6 ème
BAS-RHIN,STRASBOURG,0670085D,0,0,0,0,0,0,6 ème
BAS-RHIN,STRASBOURG,0671508A,158,158,0,0,77,81,6 ème
BAS-RHIN,STRASBOURG,0671594U,122,120,0,2,55,67,6 ème
BAS-RHIN,STRASBOURG,0671620X,122,122,0,0,60,62,6 ème
BAS-RHIN,STRASBOURG,0671636P,0,0,0,0,0,0,6 ème
BAS-RHIN,STRASBOURG,0672128Z,99,94,0,5,46,53,6 ème
BAS-RHIN,STRASBOURG,0672304R,66,66,0,0,34,32,6 ème
BAS-RHIN,VAL-DE-MODER,0671598Y,102,99,0,3,45,57,6 ème
BAS-RHIN,VENDENHEIM,0672658A,87,87,0,0,35,52,6 ème
BAS-RHIN,VILLE,0671601B,93,93,0,0,45,48,6 ème
BAS-RHIN,WISSEMBOURG,0671984T,172,155,9,8,80,92,6 ème
HAUT-RHIN,ALTKIRCH,0681373Y,184,147,32,5,88,96,6 ème
HAUT-RHIN,FERRETTE,0680014W,116,116,0,0,53,63,6 ème
HAUT-RHIN,FORTSCHWIHR,0681190Z,202,202,0,0,101,101,6 ème
HAUT-RHIN,HUNINGUE,0680020C,153,145,8,0,65,88,6 ème
HAUT-RHIN,MULHOUSE,0680105V,180,167,11,2,88,92,6 ème
HAUT-RHIN,MULHOUSE,0680135C,219,219,0,0,112,107,6 ème
HAUT-RHIN,MULHOUSE,0681768C,0,0,0,0,0,0,6 ème
HAUT-RHIN,MULHOUSE,0681961M,155,150,0,5,87,68,6 ème
HAUT-RHIN,SAINT-AMARIN,0680064A,99,99,0,0,48,51,6 ème
HAUT-RHIN,SAINT-LOUIS,0680066C,0,0,0,0,0,0,6 ème
HAUT-RHIN,SIERENTZ,0681269K,149,145,0,4,76,73,6 ème
HAUT-RHIN,SOULTZ-HAUT-RHIN,0680128V,106,102,0,4,63,43,6 ème
HAUT-RHIN,VOLGELSHEIM,0681125D,174,140,23,11,75,99,6 ème
HAUT-RHIN,WITTELSHEIM,0681322T,54,52,0,2,28,26,6 ème
HAUT-RHIN,WITTENHEIM,0680161F,6,0,6,0,4,2,6 ème
GUADELOUPE,BASSE-TERRE,9710482X,79,62,13,4,37,42,6 ème
GUADELOUPE,CAPESTERRE-BELLE-EAU,9710406P,123,104,16,3,61,62,6 ème
GUADELOUPE,CAPESTERRE-BELLE-EAU,9710418C,0,0,0,0,0,0,6 ème
GUADELOUPE,LAMENTIN,9710086S,201,183,14,4,96,105,6 ème
GUADELOUPE,LAMENTIN,9710090W,0,0,0,0,0,0,6 ème
GUADELOUPE,LE GOSIER,9710039R,249,241,8,0,111,138,6 ème
GUADELOUPE,LES ABYMES,9710826W,147,144,0,3,74,73,6 ème
GUADELOUPE,LES ABYMES,9710938T,170,170,0,0,96,74,6 ème
GUADELOUPE,MORNE-A-L'EAU,9710403L,170,159,10,1,81,89,6 ème
GUADELOUPE,POINTE-A-PITRE,9710073C,99,97,0,2,48,51,6 ème
GUADELOUPE,SAINTE-ROSE,9710023Y,120,106,12,2,62,58,6 ème
GUADELOUPE,SAINTE-ROSE,9711181G,96,96,0,0,46,50,6 ème
GUADELOUPE,SAINT-LOUIS,9710037N,31,24,4,3,14,17,6 ème
GUADELOUPE,VIEUX-HABITANTS,9710045X,80,79,0,1,46,34,6 ème
GUYANE,CAYENNE,9730020J,224,202,16,6,101,123,6 ème
GUYANE,CAYENNE,9730083C,312,294,14,4,173,139,6 ème
GUYANE,CAYENNE,9730247F,197,190,0,7,104,93,6 ème
GUYANE,CAYENNE,9730479H,28,28,0,0,15,13,6 ème
GUYANE,GRAND-SANTI,9730380A,131,110,21,0,75,56,6 ème
GUYANE,KOUROU,9730483M,121,117,0,4,65,56,6 ème
GUYANE,MACOURIA,9730206L,201,195,0,6,92,109,6 ème
GUYANE,MANA,9730373T,167,152,13,2,92,75,6 ème
GUYANE,MATOURY,9730307W,245,194,47,4,116,129,6 ème
GUYANE,PAPAICHTON,9730381B,60,49,10,1,25,35,6 ème
GUYANE,REMIRE-MONTJOLY,9730179G,207,196,9,2,103,104,6 ème
GUYANE,SAINT-GEORGES,9730173A,181,170,9,2,102,79,6 ème
GUYANE,SAINT-LAURENT-DU-MARONI,9730110G,264,229,29,6,136,128,6 ème
GUYANE,SAINT-LAURENT-DU-MARONI,9730348R,223,215,0,8,117,106,6 ème
AISNE,CHARMES,0020467X,25,25,0,0,13,12,6 ème
AISNE,CHATEAU-THIERRY,0021939X,0,0,0,0,0,0,6 ème
AISNE,CORBENY,0020017H,105,105,0,0,42,63,6 ème
AISNE,FLAVY-LE-MARTEL,0021593W,125,125,0,0,59,66,6 ème
AISNE,HARLY,0021534G,77,73,0,4,34,43,6 ème
AISNE,HIRSON,0020075W,118,103,12,3,60,58,6 ème
AISNE,HIRSON,0020089L,0,0,0,0,0,0,6 ème
AISNE,RIBEMONT,0021689A,98,92,0,6,49,49,6 ème
AISNE,SAINT-QUENTIN,0020056A,91,84,5,2,45,46,6 ème
AISNE,SAINT-QUENTIN,0020473D,199,199,0,0,94,105,6 ème
AISNE,SAINT-QUENTIN,0022042J,0,0,0,0,0,0,6 ème
AISNE,SOISSONS,0020492Z,0,0,0,0,0,0,6 ème
AISNE,SOISSONS,0022044L,0,0,0,0,0,0,6 ème
AISNE,TERGNIER,0020063H,165,144,14,7,83,82,6 ème
AISNE,VERVINS,0020067M,100,84,12,4,48,52,6 ème
AISNE,VILLENEUVE-SUR-AISNE,0020029W,98,98,0,0,56,42,6 ème
AISNE,VILLERS-COTTERETS,0021989B,92,92,0,0,54,38,6 ème
OISE,BEAUVAIS,0600002B,0,0,0,0,0,0,6 ème
OISE,BEAUVAIS,0601189S,117,115,0,2,55,62,6 ème
OISE,BRENOUILLE,0601786R,110,108,0,2,49,61,6 ème
OISE,BRESLES,0601424X,137,137,0,0,80,57,6 ème
OISE,BRETEUIL,0601153C,31,23,4,4,10,21,6 ème
OISE,CHAMBLY,0600060P,140,140,0,0,70,70,6 ème
OISE,COMPIEGNE,0601295G,76,76,0,0,47,29,6 ème
OISE,COMPIEGNE,0601366J,122,119,0,3,63,59,6 ème
OISE,CREPY-EN-VALOIS,0601294F,164,164,0,0,90,74,6 ème
OISE,CREVECOEUR-LE-GRAND,0600027D,130,116,12,2,58,72,6 ème
OISE,LAMORLAYE,0601872J,136,136,0,0,63,73,6 ème
OISE,MOUY,0601293E,162,159,0,3,78,84,6 ème
OISE,PONT-SAINTE-MAXENCE,0601147W,165,165,0,0,79,86,6 ème
OISE,RIBECOURT-DRESLINCOURT,0601822E,0,0,0,0,0,0,6 ème
OISE,SAINT-AUBIN-EN-BRAY,0601292D,160,158,0,2,63,97,6 ème
OISE,SAINT-JUST-EN-CHAUSSEE,0601445V,200,186,14,0,104,96,6 ème
OISE,SAINT-LEU-D'ESSERENT,0601409F,168,166,0,2,75,93,6 ème
SOMME,ALBERT,0801218P,76,73,0,3,42,34,6 ème
SOMME,AMIENS,0800019L,108,93,11,4,57,51,6 ème
SOMME,AMIENS,0800020M,127,124,0,3,76,51,6 ème
SOMME,AMIENS,0801194N,0,0,0,0,0,0,6 ème
SOMME,AMIENS,0801219R,176,176,0,0,94,82,6 ème
SOMME,AMIENS,0801946F,0,0,0,0,0,0,6 ème
SOMME,BRAY-SUR-SOMME,0800023R,49,49,0,0,23,26,6 ème
SOMME,CHAULNES,0801536K,99,98,0,1,40,59,6 ème
SOMME,CONTY,0800025T,112,108,0,4,55,57,6 ème
SOMME,CORBIE,0801478X,106,106,0,0,54,52,6 ème
SOMME,CRECY-EN-PONTHIEU,0800027V,69,69,0,0,38,31,6 ème
SOMME,FLIXECOURT,0801487G,59,57,0,2,28,31,6 ème
SOMME,HAM,0800036E,124,106,14,4,56,68,6 ème
SOMME,LONGPRE-LES-CORPS-SAINTS,0800037F,77,73,0,4,39,38,6 ème
SOMME,MONTDIDIER,0801225X,85,84,0,1,49,36,6 ème
NORD,ARMENTIERES,0590257J,0,0,0,0,0,0,6 ème
NORD,ARMENTIERES,0594397J,113,111,0,2,46,67,6 ème
NORD,AVESNELLES,0595176F,133,127,3,3,53,80,6 ème
NORD,BAILLEUL,0593063J,0,0,0,0,0,0,6 ème
NORD,BAILLEUL,0594636U,206,196,10,0,97,109,6 ème
NORD,BAVAY,0592924H,21,21,0,0,12,9,6 ème
NORD,BERGUES,0593479L,69,69,0,0,38,31,6 ème
NORD,BERLAIMONT,0594415D,84,84,0,0,47,37,6 ème
NORD,BEUVRAGES,0594301E,127,122,2,3,59,68,6 ème
NORD,CAMBRAI,0593487V,122,118,0,4,68,54,6 ème
NORD,CAMBRAI,0593488W,140,128,8,4,78,62,6 ème
NORD,CAMBRAI,0595175E,111,108,0,3,59,52,6 ème
NORD,CAPPELLE-EN-PEVELE,0596873A,171,171,0,0,86,85,6 ème
NORD,CAUDRY,0590044C,0,0,0,0,0,0,6 ème
NORD,COUDEKERQUE-BRANCHE,0590263R,0,0,0,0,0,0,6 ème
NORD,COUDEKERQUE-BRANCHE,0594295Y,33,28,0,5,13,20,6 ème
NORD,CROIX,0593239A,137,129,0,8,72,65,6 ème
NORD,DENAIN,0592962Z,88,86,0,2,48,40,6 ème
NORD,DOUAI,0590068D,155,152,0,3,81,74,6 ème
NORD,DOUAI,0592941B,165,155,0,10,70,95,6 ème
NORD,DOUAI,0595387K,208,208,0,0,101,107,6 ème
NORD,DUNKERQUE,0590164H,81,78,0,3,44,37,6 ème
NORD,DUNKERQUE,0593101A,91,91,0,0,50,41,6 ème
NORD,FACHES-THUMESNIL,0593476H,134,134,0,0,67,67,6 ème
NORD,FOURMIES,0590083V,0,0,0,0,0,0,6 ème
NORD,FOURMIES,0593252P,87,76,8,3,38,49,6 ème
NORD,GRANDE-SYNTHE,0595782P,85,82,0,3,42,43,6 ème
NORD,HALLUIN,0590091D,149,149,0,0,67,82,6 ème
NORD,HAUBOURDIN,0593127D,66,63,0,3,41,25,6 ème
NORD,HAUTMONT,0590098L,0,0,0,0,0,0,6 ème
NORD,HAZEBROUCK,0593077Z,0,0,0,0,0,0,6 ème
NORD,HEM,0595630Z,136,136,0,0,63,73,6 ème
NORD,JEUMONT,0592712C,0,0,0,0,0,0,6 ème
NORD,LA MADELEINE,0593658F,109,95,10,4,44,65,6 ème
NORD,LESQUIN,0592889V,219,219,0,0,96,123,6 ème
NORD,LILLE,0590115E,125,123,0,2,52,73,6 ème
NORD,LILLE,0590131X,121,117,0,4,53,68,6 ème
NORD,LILLE,0590266U,0,0,0,0,0,0,6 ème
NORD,LILLE,0593027V,0,0,0,0,0,0,6 ème
NORD,LILLE,0594288R,105,105,0,0,55,50,6 ème
NORD,LILLE,0594523W,79,76,0,3,36,43,6 ème
NORD,LILLE,0596177U,85,85,0,0,35,50,6 ème
NORD,LILLE,0597004T,125,125,0,0,63,62,6 ème
NORD,LINSELLES,0592895B,164,164,0,0,86,78,6 ème
NORD,LOOS,0593660H,79,79,0,0,32,47,6 ème
NORD,MARCQ-EN-BAROEUL,0593227M,176,176,0,0,78,98,6 ème
NORD,MASNIERES,0593683H,115,115,0,0,61,54,6 ème
NORD,MASNY,0593483R,105,101,0,4,42,63,6 ème
NORD,MAUBEUGE,0594362W,136,128,6,2,59,77,6 ème
NORD,MAUBEUGE,0595399Y,112,112,0,0,50,62,6 ème
NORD,MONS-EN-BAROEUL,0593178J,134,122,12,0,60,74,6 ème
NORD,MONS-EN-BAROEUL,0593218C,120,120,0,0,75,45,6 ème
NORD,PERENCHIES,0594628K,111,106,0,5,61,50,6 ème
NORD,RAISMES,0594408W,96,93,3,0,52,44,6 ème
NORD,RONCQ,0593668S,78,78,0,0,43,35,6 ème
NORD,ROOST-WARENDIN,0593251N,141,141,0,0,76,65,6 ème
NORD,ROUBAIX,0590189K,0,0,0,0,0,0,6 ème
NORD,ROUBAIX,0592905M,121,112,9,0,59,62,6 ème
NORD,ROUBAIX,0593667R,145,132,9,4,69,76,6 ème
NORD,ROUBAIX,0594634S,97,83,11,3,51,46,6 ème
NORD,SAINT-AMAND-LES-EAUX,0595400Z,229,229,0,0,103,126,6 ème
NORD,SAINT-ANDRE-LEZ-LILLE,0592911U,78,78,0,0,37,41,6 ème
NORD,SIN-LE-NOBLE,0593185S,187,177,7,3,91,96,6 ème
NORD,SOMAIN,0597055Y,214,214,0,0,106,108,6 ème
NORD,THUMERIES,0590211J,139,139,0,0,67,72,6 ème
NORD,TOURCOING,0592714E,91,86,0,5,45,46,6 ème
NORD,TOURCOING,0592966D,0,0,0,0,0,0,6 ème
NORD,TOURCOING,0593149C,132,131,0,1,78,54,6 ème
NORD,TOURCOING,0593150D,95,95,0,0,46,49,6 ème
NORD,TOURCOING,0593152F,45,45,0,0,24,21,6 ème
NORD,VALENCIENNES,0592967E,0,0,0,0,0,0,6 ème
NORD,VALENCIENNES,0592969G,0,0,0,0,0,0,6 ème
NORD,VALENCIENNES,0593155J,199,195,1,3,99,100,6 ème
NORD,VALENCIENNES,0595173C,78,78,0,0,41,37,6 ème
NORD,VILLENEUVE-D'ASCQ,0595656C,74,71,0,3,42,32,6 ème
NORD,WATTEN,0593159N,79,77,0,2,37,42,6 ème
NORD,WATTRELOS,0593242D,136,124,8,4,67,69,6 ème
NORD,WORMHOUT,0595856V,0,0,0,0,0,0,6 ème
PAS-DE-CALAIS,AIRE-SUR-LA-LYS,0622094P,169,165,2,2,81,88,6 ème
PAS-DE-CALAIS,ARDRES,0620004T,190,190,0,0,92,98,6 ème
PAS-DE-CALAIS,ARDRES,0622123W,128,121,0,7,61,67,6 ème
PAS-DE-CALAIS,AUBIGNY-EN-ARTOIS,0620016F,139,139,0,0,75,64,6 ème
PAS-DE-CALAIS,BERCK,0620229M,8,8,0,0,4,4,6 ème
PAS-DE-CALAIS,BETHUNE,0622089J,0,0,0,0,0,0,6 ème
PAS-DE-CALAIS,BOULOGNE-SUR-MER,0620199E,114,111,0,3,53,61,6 ème
PAS-DE-CALAIS,BOULOGNE-SUR-MER,0622131E,72,72,0,0,36,36,6 ème
PAS-DE-CALAIS,BOULOGNE-SUR-MER,0623571V,117,117,0,0,53,64,6 ème
PAS-DE-CALAIS,BOUVIGNY-BOYEFFLES,0622108E,153,153,0,0,73,80,6 ème
PAS-DE-CALAIS,BRUAY-LA-BUISSIERE,0620198D,121,121,0,0,68,53,6 ème
PAS-DE-CALAIS,CALAIS,0620188T,0,0,0,0,0,0,6 ème
PAS-DE-CALAIS,CALAIS,0622099V,2,0,2,0,0,2,6 ème
PAS-DE-CALAIS,DIVION,0620079Z,99,97,0,2,52,47,6 ème
PAS-DE-CALAIS,ETAPLES,0620187S,0,0,0,0,0,0,6 ème
PAS-DE-CALAIS,ETAPLES,0622192W,0,0,0,0,0,0,6 ème
PAS-DE-CALAIS,FREVENT,0622261W,82,71,11,0,44,38,6 ème
PAS-DE-CALAIS,GUINES,0622150A,0,0,0,0,0,0,6 ème
PAS-DE-CALAIS,HARNES,0622791X,160,150,7,3,67,93,6 ème
PAS-DE-CALAIS,HESDIN,0620099W,91,89,2,0,46,45,6 ème
PAS-DE-CALAIS,ISBERGUES,0620136L,110,110,0,0,53,57,6 ème
PAS-DE-CALAIS,LENS,0622418S,203,194,9,0,91,112,6 ème
PAS-DE-CALAIS,LENS,0623864N,0,0,0,0,0,0,6 ème
PAS-DE-CALAIS,LIEVIN,0620190V,0,0,0,0,0,0,6 ème
PAS-DE-CALAIS,LIEVIN,0620219B,103,93,7,3,47,56,6 ème
PAS-DE-CALAIS,LIEVIN,0622086F,136,133,0,3,62,74,6 ème
PAS-DE-CALAIS,MARQUISE,0620131F,0,0,0,0,0,0,6 ème
PAS-DE-CALAIS,MARQUISE,0622143T,93,88,0,5,45,48,6 ème
PAS-DE-CALAIS,MAZINGARBE,0622087G,130,126,0,4,63,67,6 ème
PAS-DE-CALAIS,MERICOURT,0622262X,166,153,8,5,71,95,6 ème
PAS-DE-CALAIS,MONTIGNY-EN-GOHELLE,0622423X,77,77,0,0,38,39,6 ème
PAS-DE-CALAIS,NOEUX-LES-MINES,0624440P,0,0,0,0,0,0,6 ème
PAS-DE-CALAIS,OUTREAU,0620154F,151,151,0,0,69,82,6 ème
PAS-DE-CALAIS,ROUVROY,0620158K,147,147,0,0,76,71,6 ème
PAS-DE-CALAIS,SAINT-MARTIN-BOULOGNE,0622198C,0,0,0,0,0,0,6 ème
PAS-DE-CALAIS,SAINT-NICOLAS,0623014P,192,182,6,4,94,98,6 ème
PAS-DE-CALAIS,SAINT-OMER,0622907Y,75,70,2,3,40,35,6 ème
PAS-DE-CALAIS,SAINT-POL-SUR-TERNOISE,0622121U,60,60,0,0,27,33,6 ème
PAS-DE-CALAIS,VITRY-EN-ARTOIS,0622084D,161,156,3,2,76,85,6 ème
PAS-DE-CALAIS,WIMILLE,0622299M,104,104,0,0,50,54,6 ème
PAS-DE-CALAIS,WINGLES,0620180J,127,116,7,4,59,68,6 ème
SEINE-ET-MARNE,BRIE-COMTE-ROBERT,0771363N,212,193,16,3,110,102,6 ème
SEINE-ET-MARNE,BRIE-COMTE-ROBERT,0771993Y,99,99,0,0,45,54,6 ème
SEINE-ET-MARNE,BUSSY-SAINT-GEORGES,0772413E,137,137,0,0,74,63,6 ème
SEINE-ET-MARNE,BUSSY-SAINT-GEORGES,0772588V,141,137,0,4,70,71,6 ème
SEINE-ET-MARNE,CHAMPS-SUR-MARNE,0772330P,141,141,0,0,56,85,6 ème
SEINE-ET-MARNE,CHATEAU-LANDON,0770010T,63,63,0,0,27,36,6 ème
SEINE-ET-MARNE,CHELLES,0770013W,105,105,0,0,48,57,6 ème
SEINE-ET-MARNE,COMBS-LA-VILLE,0771475K,193,179,10,4,87,106,6 ème
SEINE-ET-MARNE,COULOMMIERS,0771513B,165,152,13,0,85,80,6 ème
SEINE-ET-MARNE,COURTRY,0772396L,131,130,0,1,72,59,6 ème
SEINE-ET-MARNE,DAMMARIE-LES-LYS,0770019C,161,141,14,6,83,78,6 ème
SEINE-ET-MARNE,FONTAINEBLEAU,0771925Z,203,203,0,0,99,104,6 ème
SEINE-ET-MARNE,GRETZ-ARMAINVILLIERS,0772189L,156,154,0,2,76,80,6 ème
SEINE-ET-MARNE,LA CHAPELLE-LA-REINE,0770009S,120,116,0,4,54,66,6 ème
SEINE-ET-MARNE,LA FERTE-SOUS-JOUARRE,0770024H,177,173,0,4,87,90,6 ème
SEINE-ET-MARNE,LE MEE-SUR-SEINE,0771337K,166,166,0,0,93,73,6 ème
SEINE-ET-MARNE,LIEUSAINT,0772128V,93,89,0,4,49,44,6 ème
SEINE-ET-MARNE,MELUN,0771238C,0,0,0,0,0,0,6 ème
SEINE-ET-MARNE,MELUN,0771762X,171,167,0,4,86,85,6 ème
SEINE-ET-MARNE,MONTEREAU-FAULT-YONNE,0770938B,0,0,0,0,0,0,6 ème
SEINE-ET-MARNE,MONTEREAU-FAULT-YONNE,0771567K,137,122,13,2,57,80,6 ème
SEINE-ET-MARNE,MOUROUX,0772247Z,127,122,0,5,52,75,6 ème
SEINE-ET-MARNE,NANTEUIL-LES-MEAUX,0772499Y,191,190,0,1,106,85,6 ème
SEINE-ET-MARNE,NEMOURS,0771621U,67,67,0,0,42,25,6 ème
SEINE-ET-MARNE,PONTAULT-COMBAULT,0771419Z,159,159,0,0,86,73,6 ème
SEINE-ET-MARNE,PROVINS,0771336J,0,0,0,0,0,0,6 ème
SEINE-ET-MARNE,PROVINS,0771515D,123,120,0,3,64,59,6 ème
SEINE-ET-MARNE,SAINT-PIERRE-LES-NEMOURS,0772574E,112,111,0,1,51,61,6 ème
SEINE-ET-MARNE,SAVIGNY-LE-TEMPLE,0771960M,162,147,12,3,78,84,6 ème
SEINE-ET-MARNE,SOURDUN,0772737G,45,45,0,0,25,20,6 ème
SEINE-ET-MARNE,THORIGNY-SUR-MARNE,0770944H,0,0,0,0,0,0,6 ème
SEINE-ET-MARNE,THORIGNY-SUR-MARNE,0771472G,140,140,0,0,73,67,6 ème
SEINE-ET-MARNE,TORCY,0772482E,90,90,0,0,40,50,6 ème
SEINE-ET-MARNE,VARENNES-SUR-SEINE,0770053P,143,138,0,5,65,78,6 ème
SEINE-ET-MARNE,VILLIERS-SAINT-GEORGES,0770059W,90,88,0,2,41,49,6 ème
SEINE-SAINT-DENIS,AUBERVILLIERS,0931184G,166,150,16,0,66,100,6 ème
SEINE-SAINT-DENIS,AUBERVILLIERS,0931186J,144,144,0,0,73,71,6 ème
SEINE-SAINT-DENIS,AUBERVILLIERS,0932272P,128,107,16,5,64,64,6 ème
SEINE-SAINT-DENIS,BAGNOLET,0930936M,0,0,0,0,0,0,6 ème
SEINE-SAINT-DENIS,BOBIGNY,0931198X,0,0,0,0,0,0,6 ème
SEINE-SAINT-DENIS,BONDY,0931005M,131,127,0,4,71,60,6 ème
SEINE-SAINT-DENIS,BONDY,0931612X,136,121,15,0,68,68,6 ème
SEINE-SAINT-DENIS,BONDY,0932282A,0,0,0,0,0,0,6 ème
SEINE-SAINT-DENIS,DRANCY,0931201A,199,194,0,5,94,105,6 ème
SEINE-SAINT-DENIS,DRANCY,0932229T,0,0,0,0,0,0,6 ème
SEINE-SAINT-DENIS,DUGNY,0932126F,0,0,0,0,0,0,6 ème
SEINE-SAINT-DENIS,EPINAY-SUR-SEINE,0931428X,157,157,0,0,78,79,6 ème
SEINE-SAINT-DENIS,GAGNY,0930898W,148,142,0,6,70,78,6 ème
SEINE-SAINT-DENIS,GOURNAY-SUR-MARNE,0931382X,120,120,0,0,63,57,6 ème
SEINE-SAINT-DENIS,LE PRE-SAINT-GERVAIS,0931219V,140,140,0,0,75,65,6 ème
SEINE-SAINT-DENIS,LE RAINCY,0930969Y,160,160,0,0,76,84,6 ème
SEINE-SAINT-DENIS,LE RAINCY,0932302X,28,28,0,0,27,1,6 ème
SEINE-SAINT-DENIS,LIVRY-GARGAN,0930619T,212,211,0,1,103,109,6 ème
SEINE-SAINT-DENIS,LIVRY-GARGAN,0932454M,170,170,0,0,78,92,6 ème
SEINE-SAINT-DENIS,MONTREUIL,0931213N,99,97,0,2,45,54,6 ème
SEINE-SAINT-DENIS,MONTREUIL,0932579Y,146,140,0,6,77,69,6 ème
SEINE-SAINT-DENIS,NOISY-LE-GRAND,0931705Y,164,164,0,0,80,84,6 ème
SEINE-SAINT-DENIS,NOISY-LE-GRAND,0932333F,167,159,0,8,73,94,6 ème
SEINE-SAINT-DENIS,NOISY-LE-GRAND,0932581A,106,104,0,2,64,42,6 ème
SEINE-SAINT-DENIS,PIERREFITTE-SUR-SEINE,0931224A,169,169,0,0,76,93,6 ème
SEINE-SAINT-DENIS,ROMAINVILLE,0931222Y,118,117,0,1,60,58,6 ème
SEINE-SAINT-DENIS,ROSNY-SOUS-BOIS,0931739K,0,0,0,0,0,0,6 ème
SEINE-SAINT-DENIS,SAINT-DENIS,0930865K,139,137,0,2,63,76,6 ème
SEINE-SAINT-DENIS,SAINT-DENIS,0931229F,150,140,10,0,88,62,6 ème
SEINE-SAINT-DENIS,SAINT-DENIS,0931230G,123,123,0,0,67,56,6 ème
SEINE-SAINT-DENIS,SAINT-OUEN,0932261C,128,124,0,4,56,72,6 ème
SEINE-SAINT-DENIS,TREMBLAY-EN-FRANCE,0931149U,201,195,0,6,91,110,6 ème
SEINE-SAINT-DENIS,VAUJOURS,0930921W,196,196,0,0,91,105,6 ème
SEINE-SAINT-DENIS,VILLEMOMBLE,0931227D,192,187,0,5,91,101,6 ème
SEINE-SAINT-DENIS,VILLEPINTE,0932038K,141,141,0,0,67,74,6 ème
VAL-DE-MARNE,ALFORTVILLE,0941022A,152,142,10,0,79,73,6 ème
VAL-DE-MARNE,ARCUEIL,0941971G,179,160,12,7,84,95,6 ème
VAL-DE-MARNE,BOISSY-SAINT-LEGER,0940612E,100,97,0,3,45,55,6 ème
VAL-DE-MARNE,CHAMPIGNY-SUR-MARNE,0941015T,126,114,12,0,65,61,6 ème
VAL-DE-MARNE,CHENNEVIERES-SUR-MARNE,0941348E,126,109,14,3,55,71,6 ème
VAL-DE-MARNE,CRETEIL,0940006W,151,138,11,2,61,90,6 ème
VAL-DE-MARNE,CRETEIL,0940031Y,100,100,0,0,53,47,6 ème
VAL-DE-MARNE,CRETEIL,0940100Y,98,90,0,8,38,60,6 ème
VAL-DE-MARNE,CRETEIL,0941102M,113,109,0,4,58,55,6 ème
VAL-DE-MARNE,CRETEIL,0941614U,62,62,0,0,62,0,6 ème
VAL-DE-MARNE,GENTILLY,0940134K,0,0,0,0,0,0,6 ème
VAL-DE-MARNE,IVRY-SUR-SEINE,0941025D,187,171,16,0,80,107,6 ème
VAL-DE-MARNE,IVRY-SUR-SEINE,0941601E,161,157,0,4,73,88,6 ème
VAL-DE-MARNE,JOINVILLE-LE-PONT,0940012C,138,138,0,0,64,74,6 ème
VAL-DE-MARNE,LE PERREUX-SUR-MARNE,0940788W,168,166,0,2,62,106,6 ème
VAL-DE-MARNE,LE PLESSIS-TREVISE,0941221S,204,204,0,0,107,97,6 ème
VAL-DE-MARNE,L'HAY-LES-ROSES,0940583Y,156,145,6,5,71,85,6 ème
VAL-DE-MARNE,MAISONS-ALFORT,0941024C,90,90,0,0,42,48,6 ème
VAL-DE-MARNE,MAISONS-ALFORT,0941355M,0,0,0,0,0,0,6 ème
VAL-DE-MARNE,NOGENT-SUR-MARNE,0941714C,232,232,0,0,112,120,6 ème
VAL-DE-MARNE,RUNGIS,0940072T,90,90,0,0,42,48,6 ème
VAL-DE-MARNE,SAINT-MAUR-DES-FOSSES,0940140S,0,0,0,0,0,0,6 ème
VAL-DE-MARNE,SAINT-MAUR-DES-FOSSES,0940552P,179,179,0,0,91,88,6 ème
VAL-DE-MARNE,SAINT-MAUR-DES-FOSSES,0940569H,179,179,0,0,101,78,6 ème
VAL-DE-MARNE,SAINT-MAUR-DES-FOSSES,0941600D,174,174,0,0,62,112,6 ème
VAL-DE-MARNE,VALENTON,0941052H,139,139,0,0,66,73,6 ème
VAL-DE-MARNE,VILLEJUIF,0941038T,116,116,0,0,64,52,6 ème
VAL-DE-MARNE,VILLENEUVE-SAINT-GEORGES,0940749D,140,138,0,2,67,73,6 ème
VAL-DE-MARNE,VILLENEUVE-SAINT-GEORGES,0940792A,122,120,0,2,56,66,6 ème
VAL-DE-MARNE,VITRY-SUR-SEINE,0941033M,138,122,16,0,72,66,6 ème
VAL-DE-MARNE,VITRY-SUR-SEINE,0941224V,118,108,10,0,61,57,6 ème
PARIS,PARIS,0750776L,0,0,0,0,0,0,6 ème
PARIS,PARIS,0752829T,58,56,0,2,28,30,6 ème
PARIS,PARIS,0755778Y,68,66,0,2,28,40,6 ème
PARIS,PARIS,0750607C,142,140,0,2,81,61,6 ème
PARIS,PARIS,0750778N,0,0,0,0,0,0,6 ème
PARIS,PARIS,0752536Z,108,108,0,0,41,67,6 ème
PARIS,PARIS,0753896C,246,236,0,10,111,135,6 ème
PARIS,PARIS,0754853T,77,77,0,0,37,40,6 ème
PARIS,PARIS,0752316K,99,99,0,0,52,47,6 ème
PARIS,PARIS,0753982W,133,133,0,0,67,66,6 ème
PARIS,PARIS,0754924V,0,0,0,0,0,0,6 ème
PARIS,PARIS,0750445B,123,111,12,0,53,70,6 ème
PARIS,PARIS,0750463W,0,0,0,0,0,0,6 ème
PARIS,PARIS,0752543G,78,78,0,0,36,42,6 ème
PARIS,PARIS,0752846L,0,0,0,0,0,0,6 ème
PARIS,PARIS,0751708Z,0,0,0,0,0,0,6 ème
PARIS,PARIS,0752318M,139,139,0,0,76,63,6 ème
PARIS,PARIS,0752545J,177,176,0,1,90,87,6 ème
PARIS,PARIS,0752546K,193,189,0,4,102,91,6 ème
PARIS,PARIS,0753992G,63,63,0,0,34,29,6 ème
PARIS,PARIS,0754475G,0,0,0,0,0,0,6 ème
PARIS,PARIS,0752919R,57,57,0,0,28,29,6 ème
PARIS,PARIS,0752936J,130,130,0,0,60,70,6 ème
PARIS,PARIS,0752554U,188,183,0,5,94,94,6 ème
PARIS,PARIS,0753350J,0,0,0,0,0,0,6 ème
PARIS,PARIS,0750429J,95,92,0,3,59,36,6 ème
PARIS,PARIS,0752196E,99,87,12,0,42,57,6 ème
PARIS,PARIS,0750650Z,0,0,0,0,0,0,6 ème
PARIS,PARIS,0751706X,111,111,0,0,58,53,6 ème
PARIS,PARIS,0755052J,48,48,0,0,17,31,6 ème
PARIS,PARIS,0753046D,109,109,0,0,51,58,6 ème
PARIS,PARIS,0754005W,150,150,0,0,78,72,6 ème
PARIS,PARIS,0755029J,30,30,0,0,0,30,6 ème
PARIS,PARIS,0752693V,104,101,0,3,55,49,6 ème
PARIS,PARIS,0753965C,55,55,0,0,26,29,6 ème
PARIS,PARIS,0750407K,55,52,0,3,37,18,6 ème
PARIS,PARIS,0753967E,114,114,0,0,65,49,6 ème
PARIS,PARIS,0752527P,144,139,0,5,70,74,6 ème
PARIS,PARIS,0752528R,120,120,0,0,58,62,6 ème
PARIS,PARIS,0752882A,118,118,0,0,70,48,6 ème
PARIS,PARIS,0752912H,93,93,0,0,53,40,6 ème
PARIS,PARIS,0752961L,0,0,0,0,0,0,6 ème
PARIS,PARIS,0752533W,109,105,0,4,58,51,6 ème
ESSONNE,ATHIS-MONS,0911027X,173,162,8,3,76,97,6 ème
ESSONNE,BALLANCOURT-SUR-ESSONNE,0910773W,181,177,0,4,84,97,6 ème
ESSONNE,CORBEIL-ESSONNES,0911570M,124,109,15,0,63,61,6 ème
ESSONNE,DOURDAN,0911940P,89,89,0,0,48,41,6 ème
ESSONNE,ETAMPES,0911402E,180,168,11,1,82,98,6 ème
ESSONNE,EVRY-COURCOURONNES,0910021D,162,147,15,0,78,84,6 ème
ESSONNE,EVRY-COURCOURONNES,0911748F,199,199,0,0,97,102,6 ème
ESSONNE,GRIGNY,0911036G,157,138,16,3,83,74,6 ème
ESSONNE,LA FERTE-ALAIS,0910977T,149,146,0,3,65,84,6 ème
ESSONNE,LE MEREVILLOIS,0911403F,211,209,0,2,108,103,6 ème
ESSONNE,MASSY,0910859P,184,163,15,6,98,86,6 ème
ESSONNE,MASSY,0911031B,185,185,0,0,100,85,6 ème
ESSONNE,MONTGERON,0910677S,167,167,0,0,81,86,6 ème
ESSONNE,MONTLHERY,0910980W,32,32,0,0,15,17,6 ème
ESSONNE,MORSANG-SUR-ORGE,0910042B,186,171,14,1,84,102,6 ème
ESSONNE,SAINTE-GENEVIEVE-DES-BOIS,0910860R,204,203,0,1,93,111,6 ème
ESSONNE,SAINT-GERMAIN-LES-CORBEIL,0911341N,219,216,0,3,117,102,6 ème
ESSONNE,SAINT-PIERRE-DU-PERRAY,0911948Y,150,150,0,0,64,86,6 ème
ESSONNE,SAVIGNY-SUR-ORGE,0910836P,59,59,0,0,32,27,6 ème
ESSONNE,VERRIERES-LE-BUISSON,0911601W,25,25,0,0,13,12,6 ème
HAUTS-DE-SEINE,ANTONY,0921786S,167,164,0,3,84,83,6 ème
HAUTS-DE-SEINE,ASNIERES-SUR-SEINE,0920890T,155,155,0,0,82,73,6 ème
HAUTS-DE-SEINE,ASNIERES-SUR-SEINE,0922256C,55,55,0,0,36,19,6 ème
HAUTS-DE-SEINE,ASNIERES-SUR-SEINE,0922565N,198,196,0,2,95,103,6 ème
HAUTS-DE-SEINE,BAGNEUX,0921631Y,116,116,0,0,52,64,6 ème
HAUTS-DE-SEINE,BOULOGNE-BILLANCOURT,0920902F,187,187,0,0,100,87,6 ème
HAUTS-DE-SEINE,BOULOGNE-BILLANCOURT,0921238W,111,110,0,1,58,53,6 ème
HAUTS-DE-SEINE,BOULOGNE-BILLANCOURT,0921904V,118,118,0,0,53,65,6 ème
HAUTS-DE-SEINE,BOURG-LA-REINE,0921242A,179,168,7,4,95,84,6 ème
HAUTS-DE-SEINE,BOURG-LA-REINE,0921905W,232,232,0,0,127,105,6 ème
HAUTS-DE-SEINE,CHATENAY-MALABRY,0921180H,67,67,0,0,35,32,6 ème
HAUTS-DE-SEINE,CHAVILLE,0920689Z,156,156,0,0,83,73,6 ème
HAUTS-DE-SEINE,CHAVILLE,0921907Y,163,160,0,3,83,80,6 ème
HAUTS-DE-SEINE,CLAMART,0920653K,185,180,0,5,89,96,6 ème
HAUTS-DE-SEINE,COLOMBES,0920626F,135,135,0,0,70,65,6 ème
HAUTS-DE-SEINE,COLOMBES,0921160L,184,184,0,0,85,99,6 ème
HAUTS-DE-SEINE,COURBEVOIE,0922578C,144,144,0,0,72,72,6 ème
HAUTS-DE-SEINE,LE PLESSIS-ROBINSON,0920624D,154,139,9,6,75,79,6 ème
HAUTS-DE-SEINE,LEVALLOIS-PERRET,0921391M,103,97,0,6,43,60,6 ème
HAUTS-DE-SEINE,MALAKOFF,0921012A,110,107,0,3,54,56,6 ème
HAUTS-DE-SEINE,NEUILLY-SUR-SEINE,0920985W,0,0,0,0,0,0,6 ème
HAUTS-DE-SEINE,PUTEAUX,0921219A,140,138,0,2,74,66,6 ème
HAUTS-DE-SEINE,PUTEAUX,0922731U,118,118,0,0,61,57,6 ème
HAUTS-DE-SEINE,RUEIL-MALMAISON,0921018G,153,153,0,0,103,50,6 ème
HAUTS-DE-SEINE,RUEIL-MALMAISON,0921590D,135,131,4,0,80,55,6 ème
HAUTS-DE-SEINE,RUEIL-MALMAISON,0921916H,182,182,0,0,182,0,6 ème
VAL-D'OISE,BEAUMONT-SUR-OISE,0950751A,64,64,0,0,34,30,6 ème
VAL-D'OISE,BEAUMONT-SUR-OISE,0951748J,0,0,0,0,0,0,6 ème
VAL-D'OISE,BRAY-ET-LU,0952079U,82,82,0,0,45,37,6 ème
VAL-D'OISE,CERGY,0950937C,178,162,12,4,90,88,6 ème
VAL-D'OISE,CERGY,0951697D,171,156,12,3,84,87,6 ème
VAL-D'OISE,CHARS,0951282C,0,0,0,0,0,0,6 ème
VAL-D'OISE,CORMEILLES-EN-PARISIS,0950656X,0,0,0,0,0,0,6 ème
VAL-D'OISE,CORMEILLES-EN-PARISIS,0950790T,94,94,0,0,45,49,6 ème
VAL-D'OISE,CORMEILLES-EN-PARISIS,0951099D,130,127,0,3,60,70,6 ème
VAL-D'OISE,CORMEILLES-EN-PARISIS,0952045G,135,130,0,5,64,71,6 ème
VAL-D'OISE,DOMONT,0951220K,12,12,0,0,0,12,6 ème
VAL-D'OISE,EAUBONNE,0950893E,154,149,0,5,69,85,6 ème
VAL-D'OISE,ECOUEN,0950941G,128,117,8,3,61,67,6 ème
VAL-D'OISE,ERAGNY,0951672B,110,107,0,3,46,64,6 ème
VAL-D'OISE,ERMONT,0950019E,166,163,0,3,79,87,6 ème
VAL-D'OISE,FOSSES,0950926R,201,191,10,0,103,98,6 ème
VAL-D'OISE,L'ISLE-ADAM,0950898K,200,192,8,0,89,111,6 ème
VAL-D'OISE,MENUCOURT,0951233Z,126,126,0,0,51,75,6 ème
VAL-D'OISE,MONTSOULT,0951051B,131,131,0,0,61,70,6 ème
VAL-D'OISE,OSNY,0950760K,136,136,0,0,66,70,6 ème
VAL-D'OISE,PONTOISE,0951943W,82,82,0,0,44,38,6 ème
VAL-D'OISE,SAINT-GRATIEN,0951190C,145,127,12,6,69,76,6 ème
VAL-D'OISE,SAINT-OUEN-L'AUMONE,0950039B,131,131,0,0,72,59,6 ème
VAL-D'OISE,SANNOIS,0950805J,0,0,0,0,0,0,6 ème
VAL-D'OISE,SANNOIS,0951754R,120,118,0,2,55,65,6 ème
VAL-D'OISE,SARCELLES,0950723V,201,201,0,0,119,82,6 ème
VAL-D'OISE,SARCELLES,0951509Z,190,190,0,0,94,96,6 ème
VAL-D'OISE,SOISY-SOUS-MONTMORENCY,0951352D,153,134,17,2,65,88,6 ème
VAL-D'OISE,VAUREAL,0951705M,145,142,0,3,58,87,6 ème
VAL-D'OISE,VIGNY,0952080V,134,134,0,0,74,60,6 ème
YVELINES,ANDRESY,0780002D,213,213,0,0,103,110,6 ème
YVELINES,BOUGIVAL,0783301P,95,95,0,0,55,40,6 ème
YVELINES,CHANTELOUP-LES-VIGNES,0781986K,82,82,0,0,44,38,6 ème
YVELINES,CHATOU,0780507C,132,122,6,4,61,71,6 ème
YVELINES,COIGNIERES,0781511U,111,109,0,2,47,64,6 ème
YVELINES,CONFLANS-SAINTE-HONORINE,0780050F,180,177,0,3,82,98,6 ème
YVELINES,CONFLANS-SAINTE-HONORINE,0783447Y,0,0,0,0,0,0,6 ème
YVELINES,EPONE,0780656P,145,141,0,4,73,72,6 ème
YVELINES,FEUCHEROLLES,0781863B,137,137,0,0,66,71,6 ème
YVELINES,GUYANCOURT,0781695U,99,88,11,0,47,52,6 ème
YVELINES,ISSOU,0781885A,155,155,0,0,65,90,6 ème
YVELINES,LES CLAYES-SOUS-BOIS,0783251K,97,97,0,0,41,56,6 ème
YVELINES,MAGNY-LES-HAMEAUX,0781171Z,133,133,0,0,73,60,6 ème
YVELINES,MANTES-LA-VILLE,0780116C,205,202,0,3,96,109,6 ème
YVELINES,MONTESSON,0783339F,159,159,0,0,74,85,6 ème
YVELINES,MONTIGNY-LE-BRETONNEUX,0781818C,127,127,0,0,54,73,6 ème
YVELINES,NOISY-LE-ROI,0780179W,142,127,9,6,64,78,6 ème
YVELINES,PLAISIR,0780761D,191,186,0,5,100,91,6 ème
YVELINES,POISSY,0780264N,136,123,9,4,62,74,6 ème
YVELINES,SAINT-CYR-L'ECOLE,0780186D,142,140,0,2,65,77,6 ème
YVELINES,SAINT-GERMAIN-EN-LAYE,0781589D,195,195,0,0,77,118,6 ème
YVELINES,SAINT-GERMAIN-EN-LAYE,0783307W,143,143,0,0,70,73,6 ème
YVELINES,SAINT-GERMAIN-EN-LAYE,0783547G,155,155,0,0,84,71,6 ème
YVELINES,TRAPPES,0780273Y,0,0,0,0,0,0,6 ème
YVELINES,TRIEL-SUR-SEINE,0780573Z,184,180,0,4,75,109,6 ème
YVELINES,VERNOUILLET,0780845V,110,110,0,0,56,54,6 ème
YVELINES,VERSAILLES,0781107E,221,221,0,0,109,112,6 ème
YVELINES,VIROFLAY,0780184B,145,145,0,0,84,61,6 ème
LA REUNION,BRAS-PANON,9740046G,200,200,0,0,103,97,6 ème
LA REUNION,LE TAMPON,9740036W,189,161,21,7,85,104,6 ème
LA REUNION,SAINT-ANDRE,9740599H,153,152,0,1,71,82,6 ème
LA REUNION,SAINT-ANDRE,9741386N,176,174,0,2,90,86,6 ème
LA REUNION,SAINT-DENIS,9740081V,223,223,0,0,105,118,6 ème
LA REUNION,SAINT-DENIS,9740572D,248,214,32,2,119,129,6 ème
LA REUNION,SAINT-DENIS,9740618D,143,123,17,3,72,71,6 ème
LA REUNION,SAINT-DENIS,9740734E,122,105,8,9,51,71,6 ème
LA REUNION,SAINT-DENIS,9741654E,25,25,0,0,12,13,6 ème
LA REUNION,SAINTE-ROSE,9740044E,88,84,0,4,49,39,6 ème
LA REUNION,SAINT-JOSEPH,9741047V,169,168,0,1,86,83,6 ème
LA REUNION,SAINT-LEU,9741048W,192,156,31,5,86,106,6 ème
LA REUNION,SAINT-LOUIS,9740011U,238,223,14,1,123,115,6 ème
LA REUNION,SAINT-PAUL,9740093H,242,209,32,1,142,100,6 ème
LA REUNION,SAINT-PAUL,9741190A,121,119,0,2,67,54,6 ème
LA REUNION,SAINT-PHILIPPE,9740468R,78,71,0,7,39,39,6 ème
MARTINIQUE,DUCOS,9720469C,181,162,12,7,104,77,6 ème
MARTINIQUE,FORT-DE-FRANCE,9720052Z,66,61,0,5,36,30,6 ème
MARTINIQUE,FORT-DE-FRANCE,9720084J,58,45,6,7,20,38,6 ème
MARTINIQUE,FORT-DE-FRANCE,9720429J,0,0,0,0,0,0,6 ème
MARTINIQUE,FORT-DE-FRANCE,9720501M,0,0,0,0,0,0,6 ème
MARTINIQUE,LE CARBET,9720008B,66,66,0,0,39,27,6 ème
MARTINIQUE,LE FRANCOIS,9720771F,0,0,0,0,0,0,6 ème
MARTINIQUE,RIVIERE-PILOTE,9720017L,109,88,17,4,53,56,6 ème
MARTINIQUE,RIVIERE-SALEE,9720448E,93,79,11,3,54,39,6 ème
MARTINIQUE,SAINTE-MARIE,9720842H,51,51,0,0,20,31,6 ème
MARTINIQUE,SAINT-JOSEPH,9720021R,172,152,17,3,78,94,6 ème
MARTINIQUE,SAINT-PIERRE,9720446C,45,32,8,5,20,25,6 ème
MAYOTTE,BOUENI,9760379H,180,165,12,3,93,87,6 ème
MAYOTTE,CHICONI,9760119A,222,221,0,1,122,100,6 ème
MAYOTTE,DEMBENI,9760245M,470,468,0,2,229,241,6 ème
MAYOTTE,KOUNGOU,9760369X,424,399,19,6,213,211,6 ème
MAYOTTE,MAMOUDZOU,9760308F,451,446,0,5,242,209,6 ème
CALVADOS,ARGENCES,0140072C,128,128,0,0,58,70,5 ème
CALVADOS,BAYEUX,0141860W,166,166,0,0,88,78,5 ème
CALVADOS,CABOURG,0141812U,49,49,0,0,20,29,5 ème
CALVADOS,CAEN,0140015R,115,113,0,2,60,55,5 ème
CALVADOS,CAEN,0140024A,132,131,0,1,67,65,5 ème
CALVADOS,CAEN,0141596J,128,126,0,2,57,71,5 ème
CALVADOS,CAEN,0141816Y,130,108,14,8,80,50,5 ème
CALVADOS,COURSEULLES-SUR-MER,0140041U,124,118,0,6,68,56,5 ème
CALVADOS,CREULLY SUR SEULLES,0140042V,110,108,0,2,56,54,5 ème
CALVADOS,DOUVRES-LA-DELIVRANDE,0141216W,206,199,7,0,95,111,5 ème
CALVADOS,EVRECY,0140051E,167,166,0,1,78,89,5 ème
CALVADOS,HEROUVILLE-SAINT-CLAIR,0141166S,43,43,0,0,21,22,5 ème
CALVADOS,LISIEUX,0141766U,150,143,0,7,74,76,5 ème
CALVADOS,ORBEC,0140073D,86,86,0,0,42,44,5 ème
CALVADOS,PONT-L'EVEQUE,0140075F,140,134,0,6,67,73,5 ème
CALVADOS,SAINT-MARTIN-DE-FONTENAY,0140068Y,160,160,0,0,65,95,5 ème
CALVADOS,VERSON,0140087U,184,177,0,7,86,98,5 ème
EURE,BERNAY,0271096V,121,116,0,5,60,61,5 ème
EURE,BERNAY,0271316J,77,61,16,0,35,42,5 ème
EURE,BROGLIE,0271122Y,70,70,0,0,38,32,5 ème
EURE,BUEIL,0271744Z,142,142,0,0,64,78,5 ème
EURE,EVREUX,0271449D,107,107,0,0,55,52,5 ème
EURE,GASNY,0271442W,142,140,0,2,75,67,5 ème
EURE,GISORS,0270026G,0,0,0,0,0,0,5 ème
EURE,LES ANDELYS,0270001E,120,113,0,7,46,74,5 ème
EURE,LE VAL D'HAZEY,0271482P,125,109,16,0,67,58,5 ème
EURE,LOUVIERS,0270029K,0,0,0,0,0,0,5 ème
EURE,LOUVIERS,0271336F,138,120,16,2,71,67,5 ème
EURE,LOUVIERS,0271634E,0,0,0,0,0,0,5 ème
EURE,MESNILS-SUR-ITON,0270014U,99,96,0,3,48,51,5 ème
EURE,PONT-AUDEMER,0271081D,0,0,0,0,0,0,5 ème
EURE,PONT-AUDEMER,0271450E,100,96,0,4,49,51,5 ème
EURE,ROMILLY-SUR-ANDELLE,0271533V,138,138,0,0,77,61,5 ème
EURE,VERNEUIL D'AVRE ET D'ITON,0271676A,14,14,0,0,8,6,5 ème
EURE,VERNON,0270052K,0,0,0,0,0,0,5 ème
EURE,VERNON,0271068P,86,86,0,0,47,39,5 ème
MANCHE,AGON-COUTAINVILLE,0500001E,78,78,0,0,32,46,5 ème
MANCHE,AVRANCHES,0500003G,88,80,0,8,35,53,5 ème
MANCHE,BRICQUEBEC-EN-COTENTIN,0500010P,145,123,17,5,71,74,5 ème
MANCHE,CARENTAN-LES-MARAIS,0500139E,128,126,0,2,80,48,5 ème
MANCHE,CERISY-LA-SALLE,0500014U,54,54,0,0,25,29,5 ème
MANCHE,CHERBOURG-EN-COTENTIN,0501205N,107,92,15,0,54,53,5 ème
MANCHE,CHERBOURG-EN-COTENTIN,0501216A,115,111,0,4,51,64,5 ème
MANCHE,CHERBOURG-EN-COTENTIN,0501482P,104,80,18,6,43,61,5 ème
MANCHE,CHERBOURG-EN-COTENTIN,0502008L,81,79,0,2,45,36,5 ème
MANCHE,GAVRAY-SUR-SIENNE,0500035S,48,46,0,2,30,18,5 ème
MANCHE,ISIGNY-LE-BUAT,0501830T,35,35,0,0,18,17,5 ème
MANCHE,LA HAYE,0501218C,68,66,0,2,44,24,5 ème
MANCHE,SAINT-HILAIRE-DU-HARCOUET,0500148P,54,54,0,0,23,31,5 ème
MANCHE,SAINT-JEAN-DE-DAYE,0501301T,60,60,0,0,30,30,5 ème
MANCHE,SAINT-LO,0501219D,0,0,0,0,0,0,5 ème
MANCHE,SAINT-PIERRE-EGLISE,0500122L,47,47,0,0,25,22,5 ème
MANCHE,SAINT-VAAST-LA-HOUGUE,0501300S,33,33,0,0,16,17,5 ème
MANCHE,TORIGNY-LES-VILLES,0500079P,145,138,0,7,69,76,5 ème
ORNE,ALENCON,0610056E,108,107,0,1,41,67,5 ème
ORNE,ARGENTAN,0611022E,78,66,12,0,38,40,5 ème
ORNE,ARGENTAN,0611023F,108,106,0,2,65,43,5 ème
ORNE,ARGENTAN,0611099N,65,65,0,0,21,44,5 ème
ORNE,DOMFRONT EN POIRAIE,0610696A,61,61,0,0,22,39,5 ème
ORNE,DOMFRONT EN POIRAIE,0610970Y,58,51,6,1,29,29,5 ème
ORNE,ECOUCHE-LES-VALLEES,0610016L,74,74,0,0,39,35,5 ème
ORNE,FLERS,0610698C,0,0,0,0,0,0,5 ème
ORNE,GIEL-COURTEILLES,0610724F,0,0,0,0,0,0,5 ème
ORNE,LA FERTE MACE,0610709P,80,80,0,0,40,40,5 ème
ORNE,L'AIGLE,0610691V,106,106,0,0,54,52,5 ème
ORNE,LE MELE-SUR-SARTHE,0610031C,64,64,0,0,27,37,5 ème
ORNE,LONGNY LES VILLAGES,0610739X,47,47,0,0,22,25,5 ème
ORNE,PUTANGES-LE-LAC,0610037J,48,48,0,0,23,25,5 ème
ORNE,SEES,0611095J,67,67,0,0,34,33,5 ème
SEINE MARITIME,AUMALE,0762107C,70,70,0,0,31,39,5 ème
SEINE MARITIME,BACQUEVILLE-EN-CAUX,0760004S,75,73,0,2,38,37,5 ème
SEINE MARITIME,BARENTIN,0760007V,0,0,0,0,0,0,5 ème
SEINE MARITIME,BARENTIN,0762286X,128,128,0,0,64,64,5 ème
SEINE MARITIME,BARENTIN,0762764S,155,135,16,4,75,80,5 ème
SEINE MARITIME,BOLBEC,0761701L,148,129,16,3,71,77,5 ème
SEINE MARITIME,BOLBEC,0761725M,116,116,0,0,58,58,5 ème
SEINE MARITIME,DIEPPE,0760024N,0,0,0,0,0,0,5 ème
SEINE MARITIME,DIEPPE,0762225F,140,133,0,7,60,80,5 ème
SEINE MARITIME,EU,0762170W,142,130,12,0,51,91,5 ème
SEINE MARITIME,FORGES-LES-EAUX,0762600N,0,0,0,0,0,0,5 ème
SEINE MARITIME,GRAND-COURONNE,0762836V,0,0,0,0,0,0,5 ème
SEINE MARITIME,LA FEUILLIE,0762177D,76,76,0,0,34,42,5 ème
SEINE MARITIME,LE GRAND-QUEVILLY,0760049R,81,81,0,0,41,40,5 ème
SEINE MARITIME,LE GRAND-QUEVILLY,0762093M,100,85,13,2,58,42,5 ème
SEINE MARITIME,LE HAVRE,0760062E,0,0,0,0,0,0,5 ème
SEINE MARITIME,LE HAVRE,0761328F,89,89,0,0,42,47,5 ème
SEINE MARITIME,LE HAVRE,0761699J,138,134,0,4,66,72,5 ème
SEINE MARITIME,LE HAVRE,0761781Y,100,88,9,3,48,52,5 ème
SEINE MARITIME,LE HAVRE,0762564Z,284,284,0,0,139,145,5 ème
SEINE MARITIME,LE HAVRE,0763500S,0,0,0,0,0,0,5 ème
SEINE MARITIME,LE HOULME,0761746K,120,120,0,0,59,61,5 ème
SEINE MARITIME,LE MESNIL-ESNARD,0762565A,156,156,0,0,78,78,5 ème
SEINE MARITIME,LILLEBONNE,0762289A,185,165,16,4,102,83,5 ème
SEINE MARITIME,RIVES-EN-SEINE,0762084C,150,148,0,2,66,84,5 ème
SEINE MARITIME,ROUEN,0761717D,62,62,0,0,28,34,5 ème
SEINE MARITIME,ROUEN,0762178E,134,134,0,0,64,70,5 ème
SEINE MARITIME,SAINT-ETIENNE-DU-ROUVRAY,0761647C,111,100,11,0,50,61,5 ème
SEINE MARITIME,SAINT-ETIENNE-DU-ROUVRAY,0762132E,62,62,0,0,31,31,5 ème
SEINE MARITIME,SOTTEVILLE-LES-ROUEN,0761691A,205,185,17,3,93,112,5 ème
SEINE MARITIME,TERRES-DE-CAUX,0760034Z,127,123,0,4,71,56,5 ème
SEINE MARITIME,YVETOT,0762880T,0,0,0,0,0,0,5 ème
DORDOGNE,ANNESSE-ET-BEAULIEU,0240997D,58,58,0,0,27,31,5 ème
DORDOGNE,BEAUMONTOIS EN PERIGORD,0240001W,66,66,0,0,32,34,5 ème
DORDOGNE,BERGERAC,0240094X,0,0,0,0,0,0,5 ème
DORDOGNE,BERGERAC,0240996C,117,114,0,3,61,56,5 ème
DORDOGNE,COULAURES,0240012H,0,0,0,0,0,0,5 ème
DORDOGNE,LA FORCE,0240053C,125,114,11,0,60,65,5 ème
DORDOGNE,LALINDE,0240158S,91,91,0,0,42,49,5 ème
DORDOGNE,MONTIGNAC,0240927C,103,103,0,0,54,49,5 ème
DORDOGNE,MUSSIDAN,0240961P,99,96,0,3,56,43,5 ème
DORDOGNE,NEUVIC,0240044T,77,75,0,2,36,41,5 ème
DORDOGNE,PERIGUEUX,0241043D,124,124,0,0,58,66,5 ème
DORDOGNE,SAINT-CYPRIEN,0240065R,62,62,0,0,25,37,5 ème
DORDOGNE,SARLAT-LA-CANEDA,0240121B,219,209,7,3,111,108,5 ème
DORDOGNE,TERRASSON-LAVILLEDIEU,0240037K,152,143,7,2,84,68,5 ème
DORDOGNE,THENON,0240066S,79,79,0,0,49,30,5 ème
GIRONDE,ARCACHON,0330167C,101,101,0,0,52,49,5 ème
GIRONDE,BEGLES,0331752A,147,144,0,3,56,91,5 ème
GIRONDE,BIGANOS,0330017P,144,141,0,3,61,83,5 ème
GIRONDE,BLAYE,0331511N,58,54,0,4,26,32,5 ème
GIRONDE,BLAYE,0332347X,167,147,14,6,78,89,5 ème
GIRONDE,BORDEAUX,0331462K,82,82,0,0,47,35,5 ème
GIRONDE,BORDEAUX,0331662C,236,229,0,7,126,110,5 ème
GIRONDE,BORDEAUX,0331663D,121,113,6,2,61,60,5 ème
GIRONDE,BORDEAUX,0332082J,107,107,0,0,56,51,5 ème
GIRONDE,BORDEAUX,0332491D,49,49,0,0,29,20,5 ème
GIRONDE,BORDEAUX,0332496J,0,0,0,0,0,0,5 ème
GIRONDE,BORDEAUX,0333531J,52,52,0,0,26,26,5 ème
GIRONDE,BOURG,0332341R,157,156,0,1,85,72,5 ème
GIRONDE,CARBON-BLANC,0333132A,165,160,0,5,84,81,5 ème
GIRONDE,CASTILLON-LA-BATAILLE,0330064R,106,103,0,3,59,47,5 ème
GIRONDE,CUDOS,0332327A,49,49,0,0,20,29,5 ème
GIRONDE,HOURTIN,0330081J,116,116,0,0,53,63,5 ème
GIRONDE,LANGON,0330082K,0,0,0,0,0,0,5 ème
GIRONDE,LANGON,0330083L,161,158,0,3,87,74,5 ème
GIRONDE,LIBOURNE,0330162X,89,86,0,3,49,40,5 ème
GIRONDE,MERIGNAC,0330145D,135,134,0,1,57,78,5 ème
GIRONDE,MERIGNAC,0331668J,0,0,0,0,0,0,5 ème
GIRONDE,MONSEGUR,0330100E,66,66,0,0,29,37,5 ème
GIRONDE,PAREMPUYRE,0332569N,135,135,0,0,69,66,5 ème
GIRONDE,PAUILLAC,0331644H,81,81,0,0,48,33,5 ème
GIRONDE,PESSAC,0331758G,200,197,0,3,106,94,5 ème
GIRONDE,PODENSAC,0330108N,176,161,15,0,81,95,5 ème
GIRONDE,SAINT-ANDRE-DE-CUBZAC,0331530J,161,156,0,5,76,85,5 ème
GIRONDE,SAINT-LOUBES,0332340P,275,275,0,0,138,137,5 ème
GIRONDE,SAINT-MEDARD-EN-JALLES,0330119A,0,0,0,0,0,0,5 ème
GIRONDE,TALENCE,0330128K,132,132,0,0,69,63,5 ème
LANDES,CAPBRETON,0400005N,134,120,14,0,66,68,5 ème
LANDES,DAX,0400729A,174,165,0,9,90,84,5 ème
LANDES,DAX,0401022U,143,140,0,3,73,70,5 ème
LANDES,GEAUNE,0400011V,64,64,0,0,29,35,5 ème
LANDES,MONT-DE-MARSAN,0400020E,0,0,0,0,0,0,5 ème
LANDES,MONT-DE-MARSAN,0400648M,145,143,0,2,79,66,5 ème
LANDES,MONTFORT-EN-CHALOSSE,0400023H,125,120,0,5,63,62,5 ème
LANDES,PARENTIS-EN-BORN,0400026L,196,184,12,0,86,110,5 ème
LANDES,RION-DES-LANDES,0400033U,74,74,0,0,35,39,5 ème
LANDES,SAINT-PAUL-LES-DAX,0401066S,165,161,0,4,69,96,5 ème
LANDES,SAINT-VINCENT-DE-TYROSSE,0400039A,112,112,0,0,62,50,5 ème
LANDES,SOUSTONS,0400728Z,140,137,0,3,67,73,5 ème
LANDES,TARNOS,0400091G,126,126,0,0,62,64,5 ème
LOT-ET-GARONNE,AGEN,0470777P,175,171,0,4,82,93,5 ème
LOT-ET-GARONNE,CASSENEUIL,0470011G,56,56,0,0,34,22,5 ème
LOT-ET-GARONNE,CLAIRAC,0470015L,0,0,0,0,0,0,5 ème
LOT-ET-GARONNE,LE MAS-D'AGENAIS,0470043S,106,102,0,4,48,58,5 ème
LOT-ET-GARONNE,LE PASSAGE,0470105J,229,211,17,1,115,114,5 ème
LOT-ET-GARONNE,MARMANDE,0470733S,171,166,0,5,81,90,5 ème
LOT-ET-GARONNE,NERAC,0470776N,89,89,0,0,43,46,5 ème
LOT-ET-GARONNE,NERAC,0471038Y,21,21,0,0,8,13,5 ème
LOT-ET-GARONNE,VILLENEUVE-SUR-LOT,0470038L,0,0,0,0,0,0,5 ème
PYRENEES-ATLANTIQUES,ANGLET,0640110X,111,111,0,0,54,57,5 ème
PYRENEES-ATLANTIQUES,BAYONNE,0640212H,182,166,11,5,74,108,5 ème
PYRENEES-ATLANTIQUES,BIARRITZ,0641414P,125,108,10,7,61,64,5 ème
PYRENEES-ATLANTIQUES,BIZANOS,0641413N,160,157,0,3,79,81,5 ème
PYRENEES-ATLANTIQUES,CAMBO-LES-BAINS,0641392R,92,81,8,3,57,35,5 ème
PYRENEES-ATLANTIQUES,GELOS,0640026F,0,0,0,0,0,0,5 ème
PYRENEES-ATLANTIQUES,LASSEUBE,0640036S,54,52,0,2,22,32,5 ème
PYRENEES-ATLANTIQUES,LESCAR,0640121J,59,57,0,2,25,34,5 ème
PYRENEES-ATLANTIQUES,LESTELLE-BETHARRAM,0641655B,62,49,13,0,17,45,5 ème
PYRENEES-ATLANTIQUES,MAULEON-LICHARRE,0641656C,20,20,0,0,13,7,5 ème
PYRENEES-ATLANTIQUES,MOURENX,0641561Z,95,78,15,2,48,47,5 ème
PYRENEES-ATLANTIQUES,ORTHEZ,0641659F,48,48,0,0,28,20,5 ème
PYRENEES-ATLANTIQUES,PAU,0640058R,0,0,0,0,0,0,5 ème
PYRENEES-ATLANTIQUES,PAU,0640189H,0,0,0,0,0,0,5 ème
PYRENEES-ATLANTIQUES,PAU,0640227Z,202,187,12,3,104,98,5 ème
PYRENEES-ATLANTIQUES,PAU,0640607M,199,192,0,7,92,107,5 ème
PYRENEES-ATLANTIQUES,PAU,0640608N,173,142,23,8,82,91,5 ème
PYRENEES-ATLANTIQUES,SAINT-JEAN-DE-LUZ,0640066Z,0,0,0,0,0,0,5 ème
PYRENEES-ATLANTIQUES,SAINT-JEAN-DE-LUZ,0640229B,118,105,10,3,49,69,5 ème
CORREZE,BRIVE-LA-GAILLARDE,0190059L,111,111,0,0,57,54,5 ème
CORREZE,BRIVE-LA-GAILLARDE,0190635M,115,95,15,5,50,65,5 ème
CORREZE,EGLETONS,0190019T,83,78,0,5,44,39,5 ème
CORREZE,MERLINES,0190023X,14,14,0,0,8,6,5 ème
CORREZE,MEYMAC,0190025Z,59,59,0,0,27,32,5 ème
CORREZE,OBJAT,0190717B,156,153,0,3,79,77,5 ème
CORREZE,TREIGNAC,0190632J,41,41,0,0,21,20,5 ème
CORREZE,TULLE,0190614P,143,140,0,3,71,72,5 ème
CORREZE,USSEL,0190782X,27,27,0,0,14,13,5 ème
CREUSE,AUBUSSON,0230506A,67,56,8,3,41,26,5 ème
CREUSE,BENEVENT-L'ABBAYE,0230005F,38,38,0,0,21,17,5 ème
CREUSE,BONNAT,0230006G,33,33,0,0,13,20,5 ème
CREUSE,FELLETIN,0230017U,72,72,0,0,31,41,5 ème
CREUSE,SAINT-VAURY,0230028F,72,72,0,0,34,38,5 ème
HAUTE-VIENNE,AMBAZAC,0870684W,182,182,0,0,110,72,5 ème
HAUTE-VIENNE,EYMOUTIERS,0870014T,40,40,0,0,21,19,5 ème
HAUTE-VIENNE,LIMOGES,0870022B,124,106,16,2,69,55,5 ème
HAUTE-VIENNE,LIMOGES,0870771R,170,152,15,3,80,90,5 ème
HAUTE-VIENNE,LIMOGES,0870816P,177,177,0,0,95,82,5 ème
HAUTE-VIENNE,LIMOGES,0870817R,120,117,0,3,70,50,5 ème
HAUTE-VIENNE,LIMOGES,0870865T,145,142,0,3,62,83,5 ème
HAUTE-VIENNE,NEXON,0870032M,77,77,0,0,39,38,5 ème
HAUTE-VIENNE,ROCHECHOUART,0870037T,85,85,0,0,40,45,5 ème
HAUTE-VIENNE,SAINT-MATHIEU,0870047D,47,47,0,0,20,27,5 ème
CHARENTE,AIGRE,0160001P,45,45,0,0,17,28,5 ème
CHARENTE,ANGOULEME,0160061E,142,142,0,0,78,64,5 ème
CHARENTE,ANGOULEME,0160113L,60,60,0,0,29,31,5 ème
CHARENTE,CHAMPAGNE-MOUTON,0160016F,27,27,0,0,9,18,5 ème
CHARENTE,JARNAC,0160075V,23,23,0,0,12,11,5 ème
CHARENTE,RUFFEC,0160077X,56,56,0,0,30,26,5 ème
CHARENTE,RUFFEC,0161003D,0,0,0,0,0,0,5 ème
CHARENTE-MARITIME,AYTRE,0171339N,98,94,0,4,43,55,5 ème
CHARENTE-MARITIME,COURCON,0170007R,236,234,0,2,117,119,5 ème
CHARENTE-MARITIME,LAGORD,0170970M,230,230,0,0,124,106,5 ème
CHARENTE-MARITIME,LA ROCHELLE,0171184V,226,221,0,5,108,118,5 ème
CHARENTE-MARITIME,LA ROCHELLE,0171238D,0,0,0,0,0,0,5 ème
CHARENTE-MARITIME,LA TREMBLADE,0170388E,147,147,0,0,75,72,5 ème
CHARENTE-MARITIME,LE CHATEAU-D'OLERON,0170005N,85,85,0,0,51,34,5 ème
CHARENTE-MARITIME,MONTLIEU-LA-GARDE,0170076R,60,60,0,0,24,36,5 ème
CHARENTE-MARITIME,ROCHEFORT,0170081W,110,92,16,2,52,58,5 ème
CHARENTE-MARITIME,ROYAN,0170384A,75,74,0,1,39,36,5 ème
DEUX-SEVRES,BRESSUIRE,0790091V,142,138,0,4,65,77,5 ème
DEUX-SEVRES,BRESSUIRE,0791029P,0,0,0,0,0,0,5 ème
DEUX-SEVRES,CELLES-SUR-BELLE,0790011H,132,132,0,0,79,53,5 ème
DEUX-SEVRES,CERIZAY,0790063P,66,66,0,0,31,35,5 ème
DEUX-SEVRES,MAUZE-SUR-LE-MIGNON,0790929F,90,90,0,0,41,49,5 ème
DEUX-SEVRES,MELLE,0790943W,123,100,16,7,64,59,5 ème
DEUX-SEVRES,MONCOUTANT-SUR-SEVRE,0790067U,91,91,0,0,44,47,5 ème
DEUX-SEVRES,NIORT,0791016A,146,144,0,2,76,70,5 ème
DEUX-SEVRES,PARTHENAY,0790030D,87,81,0,6,42,45,5 ème
DEUX-SEVRES,PARTHENAY,0791042D,86,85,0,1,42,44,5 ème
DEUX-SEVRES,SAINT-MAIXENT-L'ECOLE,0790031E,0,0,0,0,0,0,5 ème
VIENNE,CHATELLERAULT,0860752A,0,0,0,0,0,0,5 ème
VIENNE,CIVRAY,0860761K,53,53,0,0,22,31,5 ème
VIENNE,DANGE-SAINT-ROMAIN,0860763M,49,49,0,0,25,24,5 ème
VIENNE,JAUNAY-MARIGNY,0861038L,198,196,0,2,101,97,5 ème
VIENNE,LOUDUN,0860022G,0,0,0,0,0,0,5 ème
VIENNE,LUSIGNAN,0861053C,122,122,0,0,75,47,5 ème
VIENNE,MIGNALOUX-BEAUVOIR,0860793V,20,0,20,0,8,12,5 ème
VIENNE,POITIERS,0860037Y,0,0,0,0,0,0,5 ème
VIENNE,POITIERS,0860040B,142,142,0,0,73,69,5 ème
VIENNE,POITIERS,0860759H,94,94,0,0,51,43,5 ème
VIENNE,POITIERS,0861092V,106,104,0,2,53,53,5 ème
VIENNE,SAINT-BENOIT,0861073Z,211,191,16,4,117,94,5 ème
VIENNE,SAINT-JEAN-DE-SAUVES,0860045G,50,50,0,0,25,25,5 ème
VIENNE,VALENCE-EN-POITOU,0860014Y,72,72,0,0,36,36,5 ème
VIENNE,VIVONNE,0860047J,137,136,0,1,67,70,5 ème
AUDE,CARCASSONNE,0110007Y,0,0,0,0,0,0,5 ème
AUDE,CASTELNAUDARY,0110012D,0,0,0,0,0,0,5 ème
AUDE,CASTELNAUDARY,0110896P,32,32,0,0,11,21,5 ème
AUDE,LEZIGNAN-CORBIERES,0111034P,78,78,0,0,31,47,5 ème
AUDE,LEZIGNAN-CORBIERES,0111051H,100,87,13,0,44,56,5 ème
AUDE,NARBONNE,0110021N,166,143,16,7,71,95,5 ème
AUDE,NARBONNE,0110023R,0,0,0,0,0,0,5 ème
AUDE,NARBONNE,0110026U,161,145,16,0,92,69,5 ème
AUDE,RIEUX-MINERVOIS,0110667R,91,91,0,0,46,45,5 ème
AUDE,TREBES,0110674Y,107,102,0,5,50,57,5 ème
GARD,ARAMON,0301325C,132,129,0,3,62,70,5 ème
GARD,BAGNOLS-SUR-CEZE,0300055X,224,219,0,5,116,108,5 ème
GARD,BAGNOLS-SUR-CEZE,0300106C,0,0,0,0,0,0,5 ème
GARD,BAGNOLS-SUR-CEZE,0301327E,159,152,0,7,87,72,5 ème
GARD,BEAUCAIRE,0300089J,61,59,0,2,25,36,5 ème
GARD,BEAUCAIRE,0301208A,146,142,0,4,61,85,5 ème
GARD,NIMES,0300946R,115,109,0,6,57,58,5 ème
GARD,NIMES,0301010K,122,110,11,1,55,67,5 ème
GARD,NIMES,0301098F,162,143,16,3,74,88,5 ème
GARD,NIMES,0301210C,0,0,0,0,0,0,5 ème
GARD,QUISSAC,0300032X,113,113,0,0,59,54,5 ème
GARD,SAINT-AMBROIX,0300036B,100,98,0,2,53,47,5 ème
GARD,SAINT-GENIES-DE-MALGOIRES,0301670C,152,136,16,0,70,82,5 ème
GARD,SOMMIERES,0301232B,233,230,0,3,116,117,5 ème
GARD,UZES,0300047N,0,0,0,0,0,0,5 ème
GARD,VERGEZE,0300050S,195,174,16,5,94,101,5 ème
HERAULT,AGDE,0342080B,86,86,0,0,38,48,5 ème
HERAULT,BEDARIEUX,0340119V,183,176,3,4,78,105,5 ème
HERAULT,CAZOULS-LES-BEZIERS,0340021N,182,163,17,2,79,103,5 ème
HERAULT,CLERMONT-L'HERAULT,0340893L,131,131,0,0,62,69,5 ème
HERAULT,GIGNAC,0341386X,223,218,0,5,108,115,5 ème
HERAULT,MONTAGNAC,0340037F,94,87,0,7,42,52,5 ème
HERAULT,MONTPELLIER,0340042L,0,0,0,0,0,0,5 ème
HERAULT,MONTPELLIER,0340109J,149,148,0,1,64,85,5 ème
HERAULT,MONTPELLIER,0340833W,6,0,6,0,2,4,5 ème
HERAULT,MONTPELLIER,0340880X,131,131,0,0,70,61,5 ème
HERAULT,MONTPELLIER,0341278E,212,196,14,2,101,111,5 ème
HERAULT,MONTPELLIER,0342266D,33,31,0,2,11,22,5 ème
HERAULT,PEZENAS,0340837A,155,136,16,3,87,68,5 ème
HERAULT,SAINT-JEAN-DE-VEDAS,0341276C,198,195,0,3,101,97,5 ème
HERAULT,SAINT-PONS-DE-THOMIERES,0340069R,0,0,0,0,0,0,5 ème
HERAULT,SAINT-PONS-DE-THOMIERES,0340070S,69,63,6,0,36,33,5 ème
HERAULT,SERIGNAN,0341388Z,238,218,14,6,105,133,5 ème
HERAULT,SETE,0340115R,135,135,0,0,70,65,5 ème
LOZERE,FLORAC TROIS RIVIERES,0480003T,66,61,0,5,34,32,5 ème
LOZERE,LA CANOURGUE,0480006W,64,64,0,0,32,32,5 ème
LOZERE,LE COLLET-DE-DEZE,0480002S,24,24,0,0,12,12,5 ème
LOZERE,MENDE,0480607Z,179,164,9,6,85,94,5 ème
LOZERE,MEYRUEIS,0480011B,20,20,0,0,3,17,5 ème
LOZERE,MEYRUEIS,0480034B,16,16,0,0,5,11,5 ème
LOZERE,MONT LOZERE ET GOULET,0480001R,18,18,0,0,7,11,5 ème
PYRENEES-ORIENTALES,BOURG-MADAME,0660600U,107,99,7,1,54,53,5 ème
PYRENEES-ORIENTALES,CABESTANY,0660521H,225,202,18,5,103,122,5 ème
PYRENEES-ORIENTALES,CANET-EN-ROUSSILLON,0660648W,220,217,0,3,94,126,5 ème
PYRENEES-ORIENTALES,CERET,0660601V,233,215,14,4,116,117,5 ème
PYRENEES-ORIENTALES,LE SOLER,0660872P,69,69,0,0,30,39,5 ème
PYRENEES-ORIENTALES,PRADES,0660021P,0,0,0,0,0,0,5 ème
PYRENEES-ORIENTALES,RIVESALTES,0660037G,177,158,16,3,88,89,5 ème
PYRENEES-ORIENTALES,SAINT-CYPRIEN,0660846L,98,98,0,0,52,46,5 ème
ARIEGE,LAVELANET,0090006H,0,0,0,0,0,0,5 ème
ARIEGE,LAVELANET,0090490J,52,50,0,2,26,26,5 ème
ARIEGE,PAMIERS,0090037S,119,117,0,2,59,60,5 ème
ARIEGE,PAMIERS,0090481Z,12,0,12,0,2,10,5 ème
AVEYRON,AUBIN,0120096P,0,0,0,0,0,0,5 ème
AVEYRON,DECAZEVILLE,0120006S,0,0,0,0,0,0,5 ème
AVEYRON,RIGNAC,0120070L,50,50,0,0,30,20,5 ème
AVEYRON,RODEZ,0121133S,122,106,14,2,58,64,5 ème
AVEYRON,VILLEFRANCHE-DE-ROUERGUE,0121213D,148,142,0,6,68,80,5 ème
AVEYRON,VILLEFRANCHE-DE-ROUERGUE,0121260E,0,0,0,0,0,0,5 ème
GERS,AUCH,0320562M,96,85,11,0,49,47,5 ème
GERS,FLEURANCE,0320686X,24,24,0,0,12,12,5 ème
GERS,MASSEUBE,0320608M,65,65,0,0,30,35,5 ème
GERS,MIRANDE,0320035P,79,73,0,6,32,47,5 ème
GERS,NOGARO,0320025D,0,0,0,0,0,0,5 ème
GERS,RISCLE,0320029H,54,54,0,0,29,25,5 ème
GERS,VIC-FEZENSAC,0320033M,74,67,0,7,25,49,5 ème
HAUTE-GARONNE,AUCAMVILLE,0311632F,180,175,0,5,91,89,5 ème
HAUTE-GARONNE,AURIGNAC,0310003K,59,53,0,6,33,26,5 ème
HAUTE-GARONNE,BALMA,0311330C,172,153,15,4,66,106,5 ème
HAUTE-GARONNE,BEAUZELLE,0313078C,132,129,0,3,67,65,5 ème
HAUTE-GARONNE,CARAMAN,0311690U,123,105,18,0,60,63,5 ème
HAUTE-GARONNE,CASTANET-TOLOSAN,0311266H,187,187,0,0,86,101,5 ème
HAUTE-GARONNE,CAZERES,0310012V,146,139,0,7,67,79,5 ème
HAUTE-GARONNE,COLOMIERS,0311238C,149,149,0,0,78,71,5 ème
HAUTE-GARONNE,COLOMIERS,0311687R,171,164,0,7,89,82,5 ème
HAUTE-GARONNE,FONSORBES,0312338Y,155,151,0,4,68,87,5 ème
HAUTE-GARONNE,LEGUEVIN,0312337X,230,224,0,6,87,143,5 ème
HAUTE-GARONNE,MURET,0311240E,16,0,16,0,9,7,5 ème
HAUTE-GARONNE,NAILLOUX,0312699R,150,146,0,4,86,64,5 ème
HAUTE-GARONNE,NOE,0312868Z,197,188,0,9,91,106,5 ème
HAUTE-GARONNE,SAINT-GAUDENS,0310083X,142,115,24,3,62,80,5 ème
HAUTE-GARONNE,TOULOUSE,0310057U,0,0,0,0,0,0,5 ème
HAUTE-GARONNE,TOULOUSE,0310092G,175,171,0,4,89,86,5 ème
HAUTE-GARONNE,TOULOUSE,0311231V,108,104,0,4,48,60,5 ème
HAUTE-GARONNE,TOULOUSE,0311236A,226,226,0,0,132,94,5 ème
HAUTE-GARONNE,TOULOUSE,0311264F,101,93,0,8,47,54,5 ème
HAUTE-GARONNE,TOULOUSE,0311570N,37,37,0,0,13,24,5 ème
HAUTE-GARONNE,TOULOUSE,0311631E,193,190,0,3,103,90,5 ème
HAUTE-GARONNE,TOULOUSE,0311962P,245,245,0,0,123,122,5 ème
HAUTE-GARONNE,TOULOUSE,0312284P,17,17,0,0,7,10,5 ème
HAUTE-GARONNE,VERFEIL,0311335H,124,124,0,0,70,54,5 ème
HAUTES-PYRENEES,ARGELES-GAZOST,0650836F,99,99,0,0,42,57,5 ème
HAUTES-PYRENEES,AUREILHAN,0650028C,0,0,0,0,0,0,5 ème
HAUTES-PYRENEES,LOURDES,0650015N,85,70,14,1,46,39,5 ème
HAUTES-PYRENEES,LOURDES,0650877A,158,153,0,5,81,77,5 ème
HAUTES-PYRENEES,LOURES-BAROUSSE,0650017R,43,43,0,0,23,20,5 ème
HAUTES-PYRENEES,MAUBOURGUET,0650019T,56,54,0,2,29,27,5 ème
HAUTES-PYRENEES,TARBES,0650031F,116,111,0,5,60,56,5 ème
HAUTES-PYRENEES,TARBES,0650034J,147,129,18,0,74,73,5 ème
HAUTES-PYRENEES,TARBES,0650886K,0,0,0,0,0,0,5 ème
HAUTES-PYRENEES,TOURNAY,0650036L,64,62,0,2,31,33,5 ème
HAUTES-PYRENEES,VIC-EN-BIGORRE,0650035K,0,0,0,0,0,0,5 ème
LOT,BRETENOUX,0460573Y,83,83,0,0,37,46,5 ème
LOT,FIGEAC,0460032K,0,0,0,0,0,0,5 ème
LOT,FIGEAC,0460054J,145,135,8,2,67,78,5 ème
LOT,GRAMAT,0460046A,16,11,0,5,6,10,5 ème
LOT,LATRONQUIERE,0460018V,14,14,0,0,7,7,5 ème
LOT,SOUILLAC,0460594W,68,63,0,5,36,32,5 ème
TARN,ALBI,0811061N,116,114,0,2,42,74,5 ème
TARN,CASTRES,0810016C,0,0,0,0,0,0,5 ème
TARN,CASTRES,0810088F,41,41,0,0,22,19,5 ème
TARN,GRAULHET,0810125W,179,160,15,4,86,93,5 ème
TARN,LABRUGUIERE,0810089G,76,76,0,0,34,42,5 ème
TARN,LAUTREC,0810028R,75,75,0,0,37,38,5 ème
TARN,LAVAUR,0811032G,227,211,12,4,124,103,5 ème
TARN,MAZAMET,0810126X,92,78,13,1,45,47,5 ème
TARN,SAINT-SULPICE-LA-POINTE,0810041E,183,181,0,2,93,90,5 ème
TARN-ET-GARONNE,DIEUPENTALE,0820678S,50,44,0,6,17,33,5 ème
TARN-ET-GARONNE,MOISSAC,0820017Y,190,174,11,5,92,98,5 ème
TARN-ET-GARONNE,MONTAUBAN,0820754Z,161,158,3,0,87,74,5 ème
TARN-ET-GARONNE,MONTEILS,0820883P,0,0,0,0,0,0,5 ème
LOIRE-ATLANTIQUE,BASSE-GOULAINE,0442277L,155,155,0,0,69,86,5 ème
LOIRE-ATLANTIQUE,BOUGUENAIS,0440316E,170,152,16,2,87,83,5 ème
LOIRE-ATLANTIQUE,GORGES,0440107C,22,22,0,0,4,18,5 ème
LOIRE-ATLANTIQUE,GUERANDE,0442368K,79,79,0,0,37,42,5 ème
LOIRE-ATLANTIQUE,HERBIGNAC,0440015C,100,100,0,0,47,53,5 ème
LOIRE-ATLANTIQUE,HERBIGNAC,0440195Y,138,138,0,0,68,70,5 ème
LOIRE-ATLANTIQUE,LE LOROUX-BOTTEREAU,0440200D,192,191,0,1,96,96,5 ème
LOIRE-ATLANTIQUE,LE PELLERIN,0441658N,154,154,0,0,78,76,5 ème
LOIRE-ATLANTIQUE,LIGNE,0440199C,121,121,0,0,58,63,5 ème
LOIRE-ATLANTIQUE,MONTOIR-DE-BRETAGNE,0440539X,81,76,0,5,41,40,5 ème
LOIRE-ATLANTIQUE,NANTES,0440033X,0,0,0,0,0,0,5 ème
LOIRE-ATLANTIQUE,NANTES,0440049P,109,106,0,3,58,51,5 ème
LOIRE-ATLANTIQUE,NANTES,0440210P,76,76,0,0,34,42,5 ème
LOIRE-ATLANTIQUE,NANTES,0440219Z,39,39,0,0,17,22,5 ème
LOIRE-ATLANTIQUE,NANTES,0440246D,0,0,0,0,0,0,5 ème
LOIRE-ATLANTIQUE,NANTES,0440309X,87,87,0,0,40,47,5 ème
LOIRE-ATLANTIQUE,NANTES,0441545R,149,133,14,2,82,67,5 ème
LOIRE-ATLANTIQUE,NANTES,0441608J,73,57,13,3,32,41,5 ème
LOIRE-ATLANTIQUE,NANTES,0441938T,181,181,0,0,88,93,5 ème
LOIRE-ATLANTIQUE,NANTES,0442725Y,0,0,0,0,0,0,5 ème
LOIRE-ATLANTIQUE,NOZAY,0440223D,148,148,0,0,67,81,5 ème
LOIRE-ATLANTIQUE,ORVAULT,0440055W,176,176,0,0,86,90,5 ème
LOIRE-ATLANTIQUE,PAIMBOEUF,0441862K,86,70,16,0,37,49,5 ème
LOIRE-ATLANTIQUE,REZE,0440064F,137,137,0,0,73,64,5 ème
LOIRE-ATLANTIQUE,REZE,0440065G,170,170,0,0,80,90,5 ème
LOIRE-ATLANTIQUE,SAINT-BREVIN-LES-PINS,0440233P,113,110,0,3,51,62,5 ème
LOIRE-ATLANTIQUE,SAINT-PERE-EN-RETZ,0440238V,138,138,0,0,76,62,5 ème
LOIRE-ATLANTIQUE,THOUARE-SUR-LOIRE,0442417N,145,142,0,3,73,72,5 ème
LOIRE-ATLANTIQUE,TREILLIERES,0440209N,150,150,0,0,67,83,5 ème
LOIRE-ATLANTIQUE,TREILLIERES,0442418P,193,193,0,0,93,100,5 ème
LOIRE-ATLANTIQUE,VERTOU,0440080Y,141,139,0,2,65,76,5 ème
MAINE-ET-LOIRE,ANGERS,0490784L,0,0,0,0,0,0,5 ème
MAINE-ET-LOIRE,ANGERS,0490921K,170,170,0,0,90,80,5 ème
MAINE-ET-LOIRE,ANGERS,0491028B,89,89,0,0,42,47,5 ème
MAINE-ET-LOIRE,ANGERS,0491083L,180,180,0,0,70,110,5 ème
MAINE-ET-LOIRE,ANGERS,0491641T,87,87,0,0,37,50,5 ème
MAINE-ET-LOIRE,ANGERS,0492004M,244,224,16,4,112,132,5 ème
MAINE-ET-LOIRE,ANGERS,0492081W,143,141,0,2,73,70,5 ème
MAINE-ET-LOIRE,BEAUPREAU-EN-MAUGES,0490851J,207,206,0,1,97,110,5 ème
MAINE-ET-LOIRE,BELLEVIGNE-EN-LAYON,0490879P,98,98,0,0,45,53,5 ème
MAINE-ET-LOIRE,CHALONNES-SUR-LOIRE,0490955X,115,111,0,4,63,52,5 ème
MAINE-ET-LOIRE,CHEMILLE-EN-ANJOU,0490858S,200,198,0,2,101,99,5 ème
MAINE-ET-LOIRE,CHOLET,0491675E,88,72,16,0,49,39,5 ème
MAINE-ET-LOIRE,DOUE-EN-ANJOU,0490863X,123,123,0,0,53,70,5 ème
MAINE-ET-LOIRE,GENNES-VAL-DE-LOIRE,0491261E,116,116,0,0,65,51,5 ème
MAINE-ET-LOIRE,INGRANDES-LE FRESNE SUR LOIRE,0490026M,63,63,0,0,35,28,5 ème
MAINE-ET-LOIRE,LE LION-D'ANGERS,0490866A,106,103,0,3,54,52,5 ème
MAINE-ET-LOIRE,LES HAUTS-D'ANJOU,0490857R,131,131,0,0,67,64,5 ème
MAINE-ET-LOIRE,LES PONTS-DE-CE,0491923Z,117,117,0,0,68,49,5 ème
MAINE-ET-LOIRE,LYS-HAUT-LAYON,0490881S,88,88,0,0,46,42,5 ème
MAINE-ET-LOIRE,MAUGES-SUR-LOIRE,0490873H,92,92,0,0,46,46,5 ème
MAINE-ET-LOIRE,NOYANT-VILLAGES,0491766D,38,38,0,0,18,20,5 ème
MAINE-ET-LOIRE,OMBREE D'ANJOU,0490037Z,54,54,0,0,26,28,5 ème
MAINE-ET-LOIRE,OMBREE D'ANJOU,0490871F,64,64,0,0,35,29,5 ème
MAINE-ET-LOIRE,SAUMUR,0490055U,0,0,0,0,0,0,5 ème
MAINE-ET-LOIRE,SAUMUR,0490836T,86,84,0,2,36,50,5 ème
MAINE-ET-LOIRE,SAUMUR,0490839W,89,89,0,0,51,38,5 ème
MAINE-ET-LOIRE,SEVREMOINE,0490874J,57,57,0,0,24,33,5 ème
MAINE-ET-LOIRE,TRELAZE,0490048L,161,145,16,0,72,89,5 ème
MAINE-ET-LOIRE,VAL D'ERDRE-AUXENCE,0490029R,123,123,0,0,61,62,5 ème
MAINE-ET-LOIRE,VERRIERES-EN-ANJOU,0492140K,155,155,0,0,87,68,5 ème
MAYENNE,AMBRIERES-LES-VALLEES,0530001N,68,68,0,0,33,35,5 ème
MAYENNE,CHATEAU-GONTIER-SUR-MAYENNE,0530040F,0,0,0,0,0,0,5 ème
MAYENNE,ERNEE,0530770Z,126,123,0,3,55,71,5 ème
MAYENNE,GORRON,0530060C,19,19,0,0,9,10,5 ème
MAYENNE,LAVAL,0530484N,112,94,15,3,55,57,5 ème
SARTHE,ALLONNES,0720001K,133,116,16,1,68,65,5 ème
SARTHE,CHANGE,0721477P,83,80,0,3,37,46,5 ème
SARTHE,CONLIE,0720014Z,79,63,15,1,33,46,5 ème
SARTHE,CONNERRE,0720015A,173,173,0,0,94,79,5 ème
SARTHE,ECOMMOY,0721043T,117,117,0,0,69,48,5 ème
SARTHE,LA FLECHE,0720023J,120,104,16,0,45,75,5 ème
SARTHE,LE MANS,0720033V,0,0,0,0,0,0,5 ème
SARTHE,LE MANS,0720034W,0,0,0,0,0,0,5 ème
SARTHE,LE MANS,0720038A,80,80,0,0,37,43,5 ème
SARTHE,LE MANS,0720812S,184,184,0,0,93,91,5 ème
SARTHE,LE MANS,0720902P,105,88,16,1,44,61,5 ème
SARTHE,LE MANS,0720986F,175,157,16,2,82,93,5 ème
SARTHE,LE MANS,0721608G,1,1,0,0,0,1,5 ème
SARTHE,MAROLLES-LES-BRAULTS,0720043F,46,46,0,0,26,20,5 ème
SARTHE,SILLE-LE-GUILLAUME,0720817X,70,70,0,0,31,39,5 ème
SARTHE,TELOCHE,0721261E,190,188,0,2,94,96,5 ème
SARTHE,YVRE-L'EVEQUE,0721225R,82,80,0,2,48,34,5 ème
VENDEE,CHALLANS,0850142T,0,0,0,0,0,0,5 ème
VENDEE,CHALLANS,0850147Y,192,174,16,2,96,96,5 ème
VENDEE,CHALLANS,0851158X,303,290,12,1,135,168,5 ème
VENDEE,CHALLANS,0851698J,85,81,0,4,34,51,5 ème
VENDEE,FONTENAY-LE-COMTE,0850066K,126,126,0,0,71,55,5 ème
VENDEE,LA CHATAIGNERAIE,0850097U,104,104,0,0,52,52,5 ème
VENDEE,LA ROCHE-SUR-YON,0850027T,0,0,0,0,0,0,5 ème
VENDEE,LA ROCHE-SUR-YON,0851274Y,179,179,0,0,73,106,5 ème
VENDEE,LES ACHARDS,0851655M,155,155,0,0,89,66,5 ème
VENDEE,LES HERBIERS,0851400K,0,0,0,0,0,0,5 ème
VENDEE,LES SABLES-D'OLONNE,0850033Z,0,0,0,0,0,0,5 ème
VENDEE,LES SABLES-D'OLONNE,0850117R,183,168,12,3,81,102,5 ème
VENDEE,LUCON,0851290R,175,173,0,2,86,89,5 ème
VENDEE,MONTAIGU-VENDEE,0850104B,275,256,16,3,125,150,5 ème
VENDEE,MOUTIERS-LES-MAUXFAITS,0850107E,149,149,0,0,77,72,5 ème
VENDEE,MOUTIERS-LES-MAUXFAITS,0850641K,164,164,0,0,81,83,5 ème
VENDEE,NOIRMOUTIER-EN-L'ILE,0850109G,22,22,0,0,3,19,5 ème
VENDEE,PALLUAU,0850108F,101,101,0,0,55,46,5 ème
VENDEE,SAINT-JEAN-DE-MONTS,0850123X,90,90,0,0,49,41,5 ème
VENDEE,SAINT-MICHEL-EN-L'HERM,0851132U,70,70,0,0,29,41,5 ème
ALPES-DE-HTE-PROVENCE,ANNOT,0040001E,22,22,0,0,10,12,5 ème
ALPES-DE-HTE-PROVENCE,BANON,0040002F,38,38,0,0,14,24,5 ème
ALPES-DE-HTE-PROVENCE,CHATEAU-ARNOUX-SAINT-AUBAN,0040052K,162,155,0,7,79,83,5 ème
ALPES-DE-HTE-PROVENCE,DIGNE-LES-BAINS,0040007L,0,0,0,0,0,0,5 ème
ALPES-DE-HTE-PROVENCE,FORCALQUIER,0040382U,120,120,0,0,62,58,5 ème
ALPES-DE-HTE-PROVENCE,MANOSQUE,0040011R,0,0,0,0,0,0,5 ème
ALPES-DE-HTE-PROVENCE,MANOSQUE,0040462F,116,113,0,3,53,63,5 ème
ALPES-DE-HTE-PROVENCE,RIEZ,0040017X,75,75,0,0,31,44,5 ème
ALPES-DE-HTE-PROVENCE,SAINT-ANDRE-LES-ALPES,0040019Z,54,54,0,0,27,27,5 ème
BOUCHES-DU-RHONE,AIX-EN-PROVENCE,0132325G,109,105,0,4,42,67,5 ème
BOUCHES-DU-RHONE,AIX-EN-PROVENCE,0133395V,0,0,0,0,0,0,5 ème
BOUCHES-DU-RHONE,ARLES,0131322S,151,151,0,0,80,71,5 ème
BOUCHES-DU-RHONE,ARLES,0131610E,181,175,0,6,91,90,5 ème
BOUCHES-DU-RHONE,ARLES,0132572A,168,165,0,3,99,69,5 ème
BOUCHES-DU-RHONE,FUVEAU,0133243E,240,240,0,0,115,125,5 ème
BOUCHES-DU-RHONE,MARIGNANE,0130033R,0,0,0,0,0,0,5 ème
BOUCHES-DU-RHONE,MARSEILLE,0132204A,125,124,0,1,60,65,5 ème
BOUCHES-DU-RHONE,MARSEILLE,0130068D,0,0,0,0,0,0,5 ème
BOUCHES-DU-RHONE,MARSEILLE,0131379D,98,94,0,4,55,43,5 ème
BOUCHES-DU-RHONE,MARSEILLE,0131385K,93,93,0,0,48,45,5 ème
BOUCHES-DU-RHONE,MARSEILLE,0132401P,126,116,10,0,64,62,5 ème
BOUCHES-DU-RHONE,MARSEILLE,0132402R,200,200,0,0,86,114,5 ème
BOUCHES-DU-RHONE,MARSEILLE,0131756N,171,148,23,0,80,91,5 ème
BOUCHES-DU-RHONE,MARSEILLE,0133494C,29,29,0,0,17,12,5 ème
BOUCHES-DU-RHONE,MARSEILLE,0132312T,237,232,0,5,117,120,5 ème
BOUCHES-DU-RHONE,MARSEILLE,0133827P,5,5,0,0,4,1,5 ème
BOUCHES-DU-RHONE,MARSEILLE,0131604Y,135,134,0,1,64,71,5 ème
BOUCHES-DU-RHONE,MARSEILLE,0132114C,87,87,0,0,41,46,5 ème
BOUCHES-DU-RHONE,MARSEILLE,0132491M,149,116,30,3,58,91,5 ème
BOUCHES-DU-RHONE,MARSEILLE,0132956T,106,106,0,0,58,48,5 ème
BOUCHES-DU-RHONE,MARSEILLE,0133775H,67,64,0,3,32,35,5 ème
BOUCHES-DU-RHONE,MARSEILLE,0131372W,85,85,0,0,39,46,5 ème
BOUCHES-DU-RHONE,MARSEILLE,0131885D,149,146,0,3,80,69,5 ème
BOUCHES-DU-RHONE,MARSEILLE,0132785G,117,114,0,3,62,55,5 ème
BOUCHES-DU-RHONE,MARSEILLE,0131605Z,149,132,16,1,82,67,5 ème
BOUCHES-DU-RHONE,MARSEILLE,0131370U,48,48,0,0,19,29,5 ème
BOUCHES-DU-RHONE,MARSEILLE,0130055P,0,0,0,0,0,0,5 ème
BOUCHES-DU-RHONE,MARSEILLE,0132949K,132,132,0,0,66,66,5 ème
BOUCHES-DU-RHONE,MARSEILLE,0133445Z,12,12,0,0,2,10,5 ème
BOUCHES-DU-RHONE,MARSEILLE,0131943S,213,210,0,3,104,109,5 ème
BOUCHES-DU-RHONE,MARSEILLE,0132193N,0,0,0,0,0,0,5 ème
BOUCHES-DU-RHONE,MARSEILLE,0130062X,0,0,0,0,0,0,5 ème
BOUCHES-DU-RHONE,MARSEILLE,0132913W,179,179,0,0,88,91,5 ème
BOUCHES-DU-RHONE,MARSEILLE,0132914X,195,191,0,4,95,100,5 ème
BOUCHES-DU-RHONE,MARSEILLE,0132311S,131,121,0,10,65,66,5 ème
BOUCHES-DU-RHONE,MARTIGUES,0131707K,118,115,0,3,60,58,5 ème
BOUCHES-DU-RHONE,PLAN-DE-CUQUES,0133665N,148,148,0,0,71,77,5 ème
BOUCHES-DU-RHONE,PORT-DE-BOUC,0132322D,135,135,0,0,61,74,5 ème
BOUCHES-DU-RHONE,SAINT-ANDIOL,0133621R,139,136,0,3,68,71,5 ème
BOUCHES-DU-RHONE,SAINT-REMY-DE-PROVENCE,0132573B,192,180,12,0,91,101,5 ème
BOUCHES-DU-RHONE,SALON-DE-PROVENCE,0130163G,146,120,23,3,66,80,5 ème
BOUCHES-DU-RHONE,SALON-DE-PROVENCE,0131349W,157,152,0,5,73,84,5 ème
BOUCHES-DU-RHONE,VELAUX,0133353Z,207,207,0,0,94,113,5 ème
BOUCHES-DU-RHONE,VITROLLES,0133196D,165,165,0,0,73,92,5 ème
HAUTES-ALPES,GAP,0050008G,0,0,0,0,0,0,5 ème
HAUTES-ALPES,GAP,0050480V,175,159,13,3,82,93,5 ème
HAUTES-ALPES,L'ARGENTIERE-LA-BESSEE,0050409T,67,66,0,1,36,31,5 ème
HAUTES-ALPES,SERRES,0050520N,38,38,0,0,17,21,5 ème
HAUTES-ALPES,TALLARD,0050638S,114,114,0,0,65,49,5 ème
HAUTES-ALPES,VEYNES,0050022X,67,67,0,0,31,36,5 ème
VAUCLUSE,CARPENTRAS,0840761W,134,130,0,4,72,62,5 ème
VAUCLUSE,CARPENTRAS,0840851U,112,112,0,0,112,0,5 ème
VAUCLUSE,CAVAILLON,0840018N,124,97,23,4,57,67,5 ème
VAUCLUSE,CAVAILLON,0841086Z,121,109,0,12,59,62,5 ème
VAUCLUSE,LE PONTET,0840664R,171,149,16,6,95,76,5 ème
VAUCLUSE,L'ISLE-SUR-LA-SORGUE,0840585E,124,120,0,4,57,67,5 ème
VAUCLUSE,L'ISLE-SUR-LA-SORGUE,0841118J,130,130,0,0,64,66,5 ème
VAUCLUSE,MAZAN,0841043C,147,147,0,0,73,74,5 ème
VAUCLUSE,MONTEUX,0840698C,191,187,0,4,100,91,5 ème
VAUCLUSE,PERTUIS,0840069U,88,88,0,0,45,43,5 ème
VAUCLUSE,PERTUIS,0840926A,119,116,0,3,54,65,5 ème
VAUCLUSE,SORGUES,0840583C,187,172,15,0,77,110,5 ème
VAUCLUSE,SORGUES,0841078R,0,0,0,0,0,0,5 ème
VAUCLUSE,VEDENE,0840803S,193,193,0,0,108,85,5 ème
ALPES-MARITIMES,ANTIBES,0060795G,88,88,0,0,50,38,5 ème
ALPES-MARITIMES,BEAUSOLEIL,0061278G,110,110,0,0,59,51,5 ème
ALPES-MARITIMES,CANNES,0061174U,104,103,0,1,48,56,5 ème
ALPES-MARITIMES,CANNES,0061394H,0,0,0,0,0,0,5 ème
ALPES-MARITIMES,CANNES,0061457B,255,255,0,0,128,127,5 ème
ALPES-MARITIMES,CANNES,0061561P,0,0,0,0,0,0,5 ème
ALPES-MARITIMES,LA TRINITE,0060910G,145,141,0,4,71,74,5 ème
ALPES-MARITIMES,MANDELIEU-LA-NAPOULE,0061175V,148,148,0,0,76,72,5 ème
ALPES-MARITIMES,MANDELIEU-LA-NAPOULE,0061924J,152,148,0,4,64,88,5 ème
ALPES-MARITIMES,NICE,0060043P,0,0,0,0,0,0,5 ème
ALPES-MARITIMES,NICE,0060085K,140,133,0,7,66,74,5 ème
ALPES-MARITIMES,NICE,0060679F,122,122,0,0,58,64,5 ème
ALPES-MARITIMES,NICE,0060681H,67,67,0,0,39,28,5 ème
ALPES-MARITIMES,NICE,0060745C,105,100,0,5,57,48,5 ème
ALPES-MARITIMES,NICE,0060840F,231,208,17,6,114,117,5 ème
ALPES-MARITIMES,NICE,0061462G,0,0,0,0,0,0,5 ème
ALPES-MARITIMES,PEGOMAS,0062181N,143,143,0,0,82,61,5 ème
ALPES-MARITIMES,ROQUEBILLIERE,0061237M,76,69,7,0,36,40,5 ème
ALPES-MARITIMES,ROQUEFORT-LES-PINS,0062056C,180,180,0,0,97,83,5 ème
VAR,AUPS,0830002B,134,131,0,3,78,56,5 ème
VAR,BANDOL,0830003C,82,67,13,2,36,46,5 ème
VAR,BESSE-SUR-ISSOLE,0831630W,186,186,0,0,87,99,5 ème
VAR,BRIGNOLES,0830103L,190,188,0,2,100,90,5 ème
VAR,BRIGNOLES,0830734X,175,158,12,5,82,93,5 ème
VAR,CUERS,0831482K,52,52,0,0,20,32,5 ème
VAR,DRAGUIGNAN,0830929J,171,171,0,0,84,87,5 ème
VAR,DRAGUIGNAN,0830956N,226,203,16,7,108,118,5 ème
VAR,DRAGUIGNAN,0831306U,87,87,0,0,47,40,5 ème
VAR,GAREOULT,0831391L,145,145,0,0,70,75,5 ème
VAR,HYERES,0830145G,175,146,26,3,84,91,5 ème
VAR,LA SEYNE-SUR-MER,0831052T,117,117,0,0,57,60,5 ème
VAR,LA SEYNE-SUR-MER,0831196Z,152,141,11,0,74,78,5 ème
VAR,LORGUES,0830076G,137,136,0,1,66,71,5 ème
VAR,OLLIOULES,0831188R,204,170,0,34,99,105,5 ème
VAR,ROCBARON,0831645M,158,158,0,0,70,88,5 ème
VAR,SAINT-MANDRIER-SUR-MER,0830071B,45,45,0,0,18,27,5 ème
VAR,SAINT-ZACHARIE,0831657A,178,178,0,0,98,80,5 ème
VAR,SANARY-SUR-MER,0830178T,107,107,0,0,52,55,5 ème
VAR,TOULON,0830953K,162,158,0,4,88,74,5 ème
VAR,TOULON,0831197A,129,127,0,2,69,60,5 ème
VAR,TOULON,0831198B,120,120,0,0,52,68,5 ème
VAR,VINON-SUR-VERDON,0831552L,182,182,0,0,92,90,5 ème
ALLIER,BOURBON-L'ARCHAMBAULT,0030004N,66,63,0,3,37,29,5 ème
ALLIER,CERILLY,0030005P,33,33,0,0,13,20,5 ème
ALLIER,CUSSET,0030061A,0,0,0,0,0,0,5 ème
ALLIER,GANNAT,0030017C,94,90,0,4,33,61,5 ème
ALLIER,MONTLUCON,0030981A,73,73,0,0,33,40,5 ème
ALLIER,MOULINS,0030081X,64,63,0,1,29,35,5 ème
ALLIER,YZEURE,0030837U,177,177,0,0,88,89,5 ème
CANTAL,AURILLAC,0150008C,0,0,0,0,0,0,5 ème
CANTAL,AURILLAC,0150639N,69,67,0,2,44,25,5 ème
CANTAL,MAURIAC,0150061K,24,24,0,0,14,10,5 ème
CANTAL,PIERREFORT,0150024V,18,18,0,0,9,9,5 ème
CANTAL,RIOM-ES-MONTAGNES,0150062L,7,7,0,0,3,4,5 ème
CANTAL,VIC-SUR-CERE,0150033E,44,44,0,0,21,23,5 ème
HAUTE-LOIRE,BRIVES-CHARENSAC,0430917N,55,37,13,5,27,28,5 ème
HAUTE-LOIRE,ESPALY-SAINT-MARCEL,0430023S,0,0,0,0,0,0,5 ème
HAUTE-LOIRE,LANGEAC,0430013F,47,43,0,4,20,27,5 ème
HAUTE-LOIRE,LANGEAC,0430072V,27,27,0,0,12,15,5 ème
HAUTE-LOIRE,LE PUY-EN-VELAY,0430903Y,59,55,0,4,38,21,5 ème
HAUTE-LOIRE,MONISTROL-SUR-LOIRE,0430906B,239,222,17,0,119,120,5 ème
HAUTE-LOIRE,SAINTE-FLORINE,0430029Y,72,70,0,2,38,34,5 ème
HAUTE-LOIRE,SAINTE-FLORINE,0430085J,19,19,0,0,11,8,5 ème
HAUTE-LOIRE,YSSINGEAUX,0430953C,0,0,0,0,0,0,5 ème
PUY-DE-DOME,BEAUMONT,0630007R,145,142,0,3,77,68,5 ème
PUY-DE-DOME,CEYRAT,0630063B,153,149,0,4,68,85,5 ème
PUY-DE-DOME,CHATEL-GUYON,0630017B,127,127,0,0,69,58,5 ème
PUY-DE-DOME,CLERMONT-FERRAND,0631073Z,129,129,0,0,66,63,5 ème
PUY-DE-DOME,CLERMONT-FERRAND,0631120A,114,90,16,8,64,50,5 ème
PUY-DE-DOME,CLERMONT-FERRAND,0631126G,136,116,16,4,57,79,5 ème
PUY-DE-DOME,CLERMONT-FERRAND,0631522M,160,147,13,0,78,82,5 ème
PUY-DE-DOME,CLERMONT-FERRAND,0632091F,0,0,0,0,0,0,5 ème
PUY-DE-DOME,COURNON-D'AUVERGNE,0631688T,186,166,16,4,95,91,5 ème
PUY-DE-DOME,CUNLHAT,0630031S,21,21,0,0,14,7,5 ème
PUY-DE-DOME,GERZAT,0631161V,170,151,13,6,80,90,5 ème
PUY-DE-DOME,ISSOIRE,0631734T,143,143,0,0,72,71,5 ème
PUY-DE-DOME,LA TOUR-D'AUVERGNE,0630036X,28,28,0,0,10,18,5 ème
PUY-DE-DOME,LEMPDES,0631412T,180,158,16,6,93,87,5 ème
PUY-DE-DOME,LEZOUX,0631481T,164,161,0,3,82,82,5 ème
PUY-DE-DOME,MANZAT,0630038Z,58,58,0,0,31,27,5 ème
PUY-DE-DOME,OLLIERGUES,0630045G,16,16,0,0,9,7,5 ème
PUY-DE-DOME,ORCINES,0631100D,15,15,0,0,4,11,5 ème
PUY-DE-DOME,PONT-DU-CHATEAU,0630916D,167,167,0,0,79,88,5 ème
PUY-DE-DOME,PONT-DU-CHATEAU,0631480S,0,0,0,0,0,0,5 ème
PUY-DE-DOME,PUY-GUILLAUME,0630050M,76,76,0,0,38,38,5 ème
PUY-DE-DOME,RIOM,0631580A,128,123,0,5,67,61,5 ème
PUY-DE-DOME,ROMAGNAT,0630665F,4,0,4,0,1,3,5 ème
PUY-DE-DOME,SAINT-ELOY-LES-MINES,0630061Z,0,0,0,0,0,0,5 ème
PUY-DE-DOME,SAINT-ELOY-LES-MINES,0631109N,20,20,0,0,13,7,5 ème
PUY-DE-DOME,SAINT-SATURNIN,0631111R,55,52,0,3,24,31,5 ème
ARDECHE,BOURG-SAINT-ANDEOL,0070006U,147,130,13,4,73,74,5 ème
ARDECHE,LE POUZIN,0070019H,109,101,0,8,63,46,5 ème
ARDECHE,LE TEIL,0070864B,56,56,0,0,21,35,5 ème
ARDECHE,TOURNON-SUR-RHONE,0070848J,235,214,16,5,114,121,5 ème
DROME,BOURG-DE-PEAGE,0260090G,193,193,0,0,91,102,5 ème
DROME,CREST,0261092W,106,104,0,2,53,53,5 ème
DROME,DIE,0261093X,110,106,0,4,61,49,5 ème
DROME,MONTELIMAR,0260789S,186,157,25,4,95,91,5 ème
DROME,MONTELIMAR,0261088S,150,150,0,0,65,85,5 ème
DROME,ROMANS-SUR-ISERE,0260115J,155,131,16,8,71,84,5 ème
DROME,SAINT-VALLIER,0260032U,186,164,16,6,89,97,5 ème
DROME,SAINT-VALLIER,0261397C,0,0,0,0,0,0,5 ème
DROME,VALENCE,0260049M,137,127,0,10,78,59,5 ème
DROME,VALENCE,0260070K,140,140,0,0,66,74,5 ème
DROME,VALENCE,0260082Y,0,0,0,0,0,0,5 ème
DROME,VALENCE,0260978X,186,173,13,0,97,89,5 ème
HAUTE SAVOIE,ANNECY,0740062R,0,0,0,0,0,0,5 ème
HAUTE SAVOIE,ANNECY,0741096P,162,157,0,5,93,69,5 ème
HAUTE SAVOIE,BONS-EN-CHABLAIS,0740015P,203,197,0,6,97,106,5 ème
HAUTE SAVOIE,CLUSES,0740017S,0,0,0,0,0,0,5 ème
HAUTE SAVOIE,COLLONGES-SOUS-SALEVE,0741596H,25,25,0,0,13,12,5 ème
HAUTE SAVOIE,CRANVES-SALES,0741514U,239,232,0,7,129,110,5 ème
HAUTE SAVOIE,EVIAN-LES-BAINS,0740117A,53,53,0,0,30,23,5 ème
HAUTE SAVOIE,GROISY,0740025A,232,230,0,2,121,111,5 ème
HAUTE SAVOIE,LA ROCHE-SUR-FORON,0741279N,199,199,0,0,92,107,5 ème
HAUTE SAVOIE,MEGEVE,0740119C,52,52,0,0,24,28,5 ème
HAUTE SAVOIE,REIGNIER-ESERY,0740029E,235,233,0,2,110,125,5 ème
HAUTE SAVOIE,SAINT-JULIEN-EN-GENEVOIS,0741282S,155,153,0,2,69,86,5 ème
HAUTE SAVOIE,SAINT-JULIEN-EN-GENEVOIS,0741419R,186,179,0,7,86,100,5 ème
HAUTE SAVOIE,SAINT-PIERRE-EN-FAUCIGNY,0741665H,164,146,15,3,69,95,5 ème
HAUTE SAVOIE,SALLANCHES,0740039R,122,120,0,2,65,57,5 ème
HAUTE SAVOIE,SCIONZIER,0741139L,213,188,22,3,114,99,5 ème
ISERE,ALLEVARD,0380002W,130,130,0,0,74,56,5 ème
ISERE,ALLEVARD,0381741L,0,0,0,0,0,0,5 ème
ISERE,BOURGOIN-JALLIEU,0381687C,120,120,0,0,49,71,5 ème
ISERE,CHATTE,0383345E,102,102,0,0,50,52,5 ème
ISERE,CLAIX,0382107J,13,0,13,0,2,11,5 ème
ISERE,CLAIX,0382865H,120,116,0,4,64,56,5 ème
ISERE,CREMIEU,0382103E,204,202,0,2,102,102,5 ème
ISERE,ECHIROLLES,0382044R,90,88,0,2,41,49,5 ème
ISERE,GRENOBLE,0380036H,0,0,0,0,0,0,5 ème
ISERE,GRENOBLE,0381667F,149,149,0,0,70,79,5 ème
ISERE,GRENOBLE,0381776Z,152,152,0,0,71,81,5 ème
ISERE,GRENOBLE,0383243U,153,153,0,0,83,70,5 ème
ISERE,HEYRIEUX,0380038K,140,140,0,0,70,70,5 ème
ISERE,LA COTE-SAINT-ANDRE,0380014J,0,0,0,0,0,0,5 ème
ISERE,LA MOTTE-D'AVEILLANS,0380047V,41,41,0,0,19,22,5 ème
ISERE,LA TOUR-DU-PIN,0380073Y,0,0,0,0,0,0,5 ème
ISERE,LA VERPILLIERE,0382176J,157,157,0,0,80,77,5 ème
ISERE,LE GRAND-LEMPS,0380026X,173,173,0,0,88,85,5 ème
ISERE,LE PEAGE-DE-ROUSSILLON,0381733C,0,0,0,0,0,0,5 ème
ISERE,LE PEAGE-DE-ROUSSILLON,0382582A,184,184,0,0,87,97,5 ème
ISERE,LES ABRETS EN DAUPHINE,0380001V,179,178,0,1,90,89,5 ème
ISERE,L'ISLE-D'ABEAU,0383056R,115,112,0,3,52,63,5 ème
ISERE,MEYLAN,0382492C,90,90,0,0,38,52,5 ème
ISERE,PONTCHARRA,0381905P,168,160,8,0,82,86,5 ème
ISERE,PONT-EVEQUE,0382504R,110,104,0,6,51,59,5 ème
ISERE,ROUSSILLON,0381599G,0,0,0,0,0,0,5 ème
ISERE,SAINT-EGREVE,0380058G,191,191,0,0,90,101,5 ème
ISERE,SAINT-ISMIER,0382100B,200,200,0,0,106,94,5 ème
ISERE,SASSENAGE,0382098Z,222,219,0,3,94,128,5 ème
ISERE,SEYSSINET-PARISET,0380072X,109,106,0,3,47,62,5 ème
ISERE,SEYSSUEL,0382115T,225,208,12,5,110,115,5 ème
ISERE,VIENNE,0382583B,258,255,0,3,139,119,5 ème
ISERE,VILLARD-DE-LANS,0382429J,172,171,0,1,86,86,5 ème
ISERE,VOIRON,0382042N,159,154,0,5,67,92,5 ème
SAVOIE,AIX-LES-BAINS,0730853F,150,136,12,2,75,75,5 ème
SAVOIE,ALBERTVILLE,0731272L,84,80,0,4,50,34,5 ème
SAVOIE,CHAMBERY,0730776X,0,0,0,0,0,0,5 ème
SAVOIE,CHAMBERY,0730902J,157,151,0,6,78,79,5 ème
SAVOIE,LES ECHELLES,0730022C,101,96,0,5,43,58,5 ème
SAVOIE,MOUTIERS,0730796U,36,36,0,0,23,13,5 ème
SAVOIE,SAINT-ALBAN-LEYSSE,0730810J,150,131,14,5,52,98,5 ème
SAVOIE,UGINE,0730044B,98,98,0,0,44,54,5 ème
SAVOIE,VALGELON-LA ROCHETTE,0731114P,144,142,0,2,68,76,5 ème
SAVOIE,YENNE,0730045C,91,91,0,0,54,37,5 ème
AIN,BELLEY,0011010T,0,0,0,0,0,0,5 ème
AIN,BOURG-EN-BRESSE,0010018P,132,127,0,5,65,67,5 ème
AIN,BOURG-EN-BRESSE,0010080G,85,85,0,0,42,43,5 ème
AIN,BOURG-EN-BRESSE,0010974D,147,112,30,5,77,70,5 ème
AIN,BOURG-EN-BRESSE,0011118K,0,0,0,0,0,0,5 ème
AIN,BOURG-EN-BRESSE,0011275F,140,137,0,3,76,64,5 ème
AIN,CHATILLON-SUR-CHALARONNE,0010821M,157,155,0,2,78,79,5 ème
AIN,FEILLENS,0010086N,118,118,0,0,55,63,5 ème
AIN,LAGNIEU,0010026Y,220,215,0,5,98,122,5 ème
AIN,LEYMENT,0011300H,166,163,0,3,80,86,5 ème
AIN,MEXIMIEUX,0010041P,242,224,16,2,120,122,5 ème
AIN,MONTLUEL,0010796K,190,186,0,4,90,100,5 ème
AIN,PLATEAU D'HAUTEVILLE,0010025X,100,98,0,2,40,60,5 ème
AIN,REYRIEUX,0011338Z,178,178,0,0,72,106,5 ème
AIN,SAINT-ANDRE-DE-CORCY,0011257L,145,142,0,3,70,75,5 ème
AIN,TREVOUX,0010066S,201,199,0,2,103,98,5 ème
AIN,VALSERHONE,0010006B,0,0,0,0,0,0,5 ème
AIN,VONNAS,0010046V,113,111,0,2,60,53,5 ème
LOIRE,ANDREZIEUX-BOUTHEON,0421691K,0,0,0,0,0,0,5 ème
LOIRE,CHAZELLES-SUR-LYON,0420998G,0,0,0,0,0,0,5 ème
LOIRE,FEURS,0420012K,221,215,0,6,110,111,5 ème
LOIRE,FIRMINY,0421570D,84,68,10,6,43,41,5 ème
LOIRE,FIRMINY,0421659A,72,67,0,5,30,42,5 ème
LOIRE,FIRMINY,0421681Z,86,82,0,4,49,37,5 ème
LOIRE,LE CHAMBON-FEUGEROLLES,0421044G,53,53,0,0,30,23,5 ème
LOIRE,LE CHAMBON-FEUGEROLLES,0421919H,129,113,16,0,71,58,5 ème
LOIRE,PELUSSIN,0420024Y,130,130,0,0,66,64,5 ème
LOIRE,SAINT-CHAMOND,0421688G,90,85,0,5,33,57,5 ème
LOIRE,SAINT-ETIENNE,0421038A,49,49,0,0,24,25,5 ème
LOIRE,SAINT-ETIENNE,0421569C,124,122,0,2,64,60,5 ème
LOIRE,SAINT-ETIENNE,0421741P,121,117,0,4,56,65,5 ème
LOIRE,SAINT-ETIENNE,0421742R,0,0,0,0,0,0,5 ème
LOIRE,SURY-LE-COMTAL,0420985T,0,0,0,0,0,0,5 ème
RHONE,BELLEVILLE-EN-BEAUJOLAIS,0693734J,0,0,0,0,0,0,5 ème
RHONE,BELLEVILLE-EN-BEAUJOLAIS,0694279B,115,115,0,0,45,70,5 ème
RHONE,BRON,0691479H,100,96,0,4,44,56,5 ème
RHONE,CHAPONOST,0693365H,161,159,0,2,84,77,5 ème
RHONE,CHAZAY-D'AZERGUES,0692448L,166,163,0,3,86,80,5 ème
RHONE,CRAPONNE,0692422H,178,177,0,1,82,96,5 ème
RHONE,LAMURE-SUR-AZERGUES,0690022Z,77,77,0,0,40,37,5 ème
RHONE,LYON,0692334M,120,120,0,0,55,65,5 ème
RHONE,LYON,0694007F,177,175,0,2,86,91,5 ème
RHONE,LYON,0692937T,180,180,0,0,87,93,5 ème
RHONE,LYON,0691663H,159,156,0,3,64,95,5 ème
RHONE,LYON,0693137K,164,164,0,0,84,80,5 ème
RHONE,LYON,0694453R,149,146,0,3,76,73,5 ème
RHONE,LYON,0690060R,66,63,0,3,32,34,5 ème
RHONE,LYON,0691669P,155,152,0,3,81,74,5 ème
RHONE,LYON,0693406C,0,0,0,0,0,0,5 ème
RHONE,LYON,0694295U,115,115,0,0,60,55,5 ème
RHONE,LYON,0692703N,85,82,0,3,41,44,5 ème
RHONE,OULLINS,0690541N,159,159,0,0,93,66,5 ème
RHONE,OULLINS,0692924D,343,343,0,0,181,162,5 ème
RHONE,SAINTE-FOY-LES-LYON,0691484N,106,95,10,1,53,53,5 ème
RHONE,SAINT-MARTIN-EN-HAUT,0694092Y,95,95,0,0,40,55,5 ème
RHONE,SAINT-PRIEST,0692417C,152,151,0,1,84,68,5 ème
RHONE,SAINT-PRIEST,0694406P,183,164,12,7,79,104,5 ème
RHONE,TASSIN-LA-DEMI-LUNE,0692943Z,212,208,0,4,105,107,5 ème
RHONE,THIZY-LES-BOURGS,0690581G,29,29,0,0,15,14,5 ème
RHONE,VAL D'OINGT,0691674V,135,132,0,3,70,65,5 ème
RHONE,VAULX-EN-VELIN,0691666L,119,105,9,5,66,53,5 ème
RHONE,VENISSIEUX,0690093B,0,0,0,0,0,0,5 ème
RHONE,VENISSIEUX,0691799F,159,140,16,3,68,91,5 ème
RHONE,VENISSIEUX,0692418D,0,0,0,0,0,0,5 ème
RHONE,VILLEFRANCHE-SUR-SAONE,0690097F,0,0,0,0,0,0,5 ème
RHONE,VILLEFRANCHE-SUR-SAONE,0691645N,123,119,0,4,64,59,5 ème
RHONE,VILLEFRANCHE-SUR-SAONE,0692944A,287,281,0,6,129,158,5 ème
RHONE,VILLEURBANNE,0690599B,64,64,0,0,31,33,5 ème
RHONE,VILLEURBANNE,0692945B,203,203,0,0,96,107,5 ème
RHONE,VOURLES,0690624D,178,178,0,0,81,97,5 ème
DOUBS,BAUME-LES-DAMES,0250063H,0,0,0,0,0,0,5 ème
DOUBS,BESANCON,0250009Z,109,106,0,3,55,54,5 ème
DOUBS,BESANCON,0251371E,15,0,15,0,6,9,5 ème
DOUBS,BESANCON,0251587P,126,126,0,0,63,63,5 ème
DOUBS,BLAMONT,0250015F,52,52,0,0,28,24,5 ème
DOUBS,ETUPES,0251211F,151,150,0,1,78,73,5 ème
DOUBS,L'ISLE-SUR-LE-DOUBS,0250024R,77,74,0,3,45,32,5 ème
DOUBS,ORCHAMPS-VENNES,0251054K,67,67,0,0,25,42,5 ème
DOUBS,ORNANS,0251055L,49,49,0,0,21,28,5 ème
DOUBS,PIERREFONTAINE-LES-VARANS,0251315U,62,62,0,0,38,24,5 ème
DOUBS,PONT-DE-ROIDE-VERMONDANS,0250047R,109,107,0,2,54,55,5 ème
DOUBS,QUINGEY,0250049T,101,99,0,2,61,40,5 ème
DOUBS,SELONCOURT,0251397H,84,84,0,0,36,48,5 ème
HAUTE-SAONE,CHAMPAGNEY,0700895T,131,131,0,0,63,68,5 ème
HAUTE-SAONE,FAUCOGNEY-ET-LA-MER,0700005A,43,43,0,0,20,23,5 ème
HAUTE-SAONE,GRAY,0700060K,52,52,0,0,26,26,5 ème
HAUTE-SAONE,GRAY,0700904C,116,96,16,4,58,58,5 ème
HAUTE-SAONE,GY,0700061L,41,41,0,0,21,20,5 ème
HAUTE-SAONE,JUSSEY,0700016M,75,67,8,0,41,34,5 ème
HAUTE-SAONE,LURE,0700045U,217,199,15,3,112,105,5 ème
HAUTE-SAONE,LUXEUIL-LES-BAINS,0700056F,64,64,0,0,31,33,5 ème
HAUTE-SAONE,VAUVILLERS,0700035H,41,39,0,2,14,27,5 ème
JURA,ARBOIS,0390074U,17,17,0,0,9,8,5 ème
JURA,ARINTHOD,0390783P,54,54,0,0,32,22,5 ème
JURA,CHAUSSIN,0390922R,94,94,0,0,52,42,5 ème
JURA,LONS-LE-SAUNIER,0390022M,99,95,0,4,38,61,5 ème
JURA,NOZEROY,0390784R,37,37,0,0,14,23,5 ème
JURA,SAINT-AMOUR,0390785S,55,55,0,0,28,27,5 ème
JURA,SAINT-CLAUDE,0390924T,107,92,14,1,49,58,5 ème
TERRITOIRE DE BELFORT,BELFORT,0900017E,84,83,0,1,40,44,5 ème
TERRITOIRE DE BELFORT,CHEVREMONT,0900032W,41,41,0,0,18,23,5 ème
TERRITOIRE DE BELFORT,VALDOIE,0900014B,135,132,0,3,70,65,5 ème
COTE D'OR,AUXONNE,0210003P,0,0,0,0,0,0,5 ème
COTE D'OR,BEAUNE,0211229X,159,154,0,5,74,85,5 ème
COTE D'OR,BEAUNE,0211428N,21,0,21,0,9,12,5 ème
COTE D'OR,BLIGNY-SUR-OUCHE,0210011Y,26,26,0,0,11,15,5 ème
COTE D'OR,CHATILLON-SUR-SEINE,0210013A,0,0,0,0,0,0,5 ème
COTE D'OR,CHATILLON-SUR-SEINE,0211079J,27,27,0,0,9,18,5 ème
COTE D'OR,DIJON,0210018F,0,0,0,0,0,0,5 ème
COTE D'OR,DIJON,0211034K,146,142,0,4,81,65,5 ème
COTE D'OR,DIJON,0211071A,112,112,0,0,63,49,5 ème
COTE D'OR,DIJON,0211081L,130,130,0,0,70,60,5 ème
COTE D'OR,DIJON,0211136W,113,95,15,3,52,61,5 ème
COTE D'OR,DIJON,0211150L,130,114,16,0,61,69,5 ème
COTE D'OR,DIJON,0211162Z,70,56,12,2,34,36,5 ème
COTE D'OR,GENLIS,0211164B,147,147,0,0,84,63,5 ème
COTE D'OR,SAULIEU,0210046L,50,47,0,3,27,23,5 ème
COTE D'OR,SOMBERNON,0210051S,123,123,0,0,59,64,5 ème
COTE D'OR,VITTEAUX,0210053U,33,33,0,0,17,16,5 ème
NIEVRE,CORBIGNY,0580012Y,28,28,0,0,12,16,5 ème
NIEVRE,COSNE-COURS-SUR-LOIRE,0580669M,112,97,14,1,44,68,5 ème
NIEVRE,COSNE-COURS-SUR-LOIRE,0580746W,84,84,0,0,43,41,5 ème
NIEVRE,NEVERS,0580050P,0,0,0,0,0,0,5 ème
NIEVRE,NEVERS,0580599L,100,91,0,9,49,51,5 ème
NIEVRE,VARZY,0580042F,0,0,0,0,0,0,5 ème
SAONE-ET-LOIRE,AUTUN,0710115P,62,62,0,0,26,36,5 ème
SAONE-ET-LOIRE,CHALON-SUR-SAONE,0711348E,156,150,0,6,77,79,5 ème
SAONE-ET-LOIRE,CLUNY,0710024R,115,114,0,1,51,64,5 ème
SAONE-ET-LOIRE,CUISEAUX,0710033A,65,65,0,0,34,31,5 ème
SAONE-ET-LOIRE,EPINAC,0710037E,34,34,0,0,15,19,5 ème
SAONE-ET-LOIRE,LA CHAPELLE-DE-GUINCHAY,0711321A,158,158,0,0,78,80,5 ème
SAONE-ET-LOIRE,LE CREUSOT,0711069B,130,115,15,0,54,76,5 ème
SAONE-ET-LOIRE,MACON,0710080B,0,0,0,0,0,0,5 ème
SAONE-ET-LOIRE,MACON,0710534V,137,122,15,0,66,71,5 ème
SAONE-ET-LOIRE,MARCIGNY,0711071D,100,100,0,0,43,57,5 ème
SAONE-ET-LOIRE,MONTCEAU-LES-MINES,0710056A,103,85,15,3,53,50,5 ème
SAONE-ET-LOIRE,MONTCEAU-LES-MINES,0711777W,109,109,0,0,53,56,5 ème
SAONE-ET-LOIRE,MONTCENIS,0711323C,73,69,0,4,37,36,5 ème
SAONE-ET-LOIRE,PARAY-LE-MONIAL,0711755X,0,0,0,0,0,0,5 ème
SAONE-ET-LOIRE,SAINT-GERMAIN-DU-BOIS,0711146K,74,74,0,0,39,35,5 ème
SAONE-ET-LOIRE,SAINT-MARCEL,0711490J,111,95,16,0,62,49,5 ème
YONNE,AUXERRE,0890789Z,209,187,16,6,116,93,5 ème
YONNE,AUXERRE,0890819G,0,0,0,0,0,0,5 ème
YONNE,AVALLON,0890008A,0,0,0,0,0,0,5 ème
YONNE,COURSON-LES-CARRIERES,0890015H,68,68,0,0,33,35,5 ème
YONNE,JOIGNY,0890065M,108,108,0,0,50,58,5 ème
YONNE,JOIGNY,0890937K,132,129,0,3,67,65,5 ème
YONNE,JOIGNY,0891199V,0,0,0,0,0,0,5 ème
YONNE,MONTHOLON,0890788Y,120,120,0,0,62,58,5 ème
YONNE,SAINT-VALERIEN,0890028X,153,152,0,1,76,77,5 ème
YONNE,SENS,0891055N,172,172,0,0,84,88,5 ème
YONNE,SENS,0891093E,114,108,0,6,58,56,5 ème
YONNE,VILLENEUVE-LA-GUYARD,0891186F,131,131,0,0,68,63,5 ème
YONNE,VILLENEUVE-L'ARCHEVEQUE,0890038H,104,104,0,0,48,56,5 ème
COTES D'ARMOR,CREHEN,0221619R,106,106,0,0,54,52,5 ème
COTES D'ARMOR,EVRAN,0220140H,47,47,0,0,22,25,5 ème
COTES D'ARMOR,GUINGAMP,0220197V,113,108,0,5,58,55,5 ème
COTES D'ARMOR,GUINGAMP,0221698B,123,93,30,0,59,64,5 ème
COTES D'ARMOR,HILLION,0222030M,181,180,0,1,80,101,5 ème
COTES D'ARMOR,LAMBALLE-ARMOR,0221537B,210,172,32,6,115,95,5 ème
COTES D'ARMOR,MONCONTOUR,0221594N,98,98,0,0,42,56,5 ème
COTES D'ARMOR,PAIMPOL,0221991V,125,109,16,0,56,69,5 ème
COTES D'ARMOR,PERROS-GUIREC,0220167M,31,31,0,0,14,17,5 ème
COTES D'ARMOR,PERROS-GUIREC,0221029Z,107,107,0,0,56,51,5 ème
COTES D'ARMOR,PLEMET,0220153X,27,27,0,0,13,14,5 ème
COTES D'ARMOR,PLESIDY,0221877W,55,55,0,0,27,28,5 ème
COTES D'ARMOR,PLOUFRAGAN,0221621T,151,136,11,4,71,80,5 ème
COTES D'ARMOR,PLOUGUENAST-LANGAST,0220162G,34,34,0,0,24,10,5 ème
COTES D'ARMOR,SAINT-BRIEUC,0220054P,136,133,0,3,64,72,5 ème
COTES D'ARMOR,SAINT-BRIEUC,0220058U,0,0,0,0,0,0,5 ème
COTES D'ARMOR,SAINT-BRIEUC,0221513A,152,135,11,6,76,76,5 ème
COTES D'ARMOR,SAINT-BRIEUC,0221751J,122,122,0,0,66,56,5 ème
COTES D'ARMOR,TREGUIER,0220072J,0,0,0,0,0,0,5 ème
COTES D'ARMOR,TREGUIER,0220177Y,55,55,0,0,27,28,5 ème
FINISTERE,BREST,0290335G,0,0,0,0,0,0,5 ème
FINISTERE,BREST,0291824A,86,85,0,1,35,51,5 ème
FINISTERE,BREST,0291867X,191,173,15,3,95,96,5 ème
FINISTERE,CARANTEC,0290021R,58,58,0,0,31,27,5 ème
FINISTERE,CARHAIX-PLOUGUER,0291102R,119,101,16,2,56,63,5 ème
FINISTERE,CLEDER,0290253T,17,17,0,0,9,8,5 ème
FINISTERE,CONCARNEAU,0290030A,0,0,0,0,0,0,5 ème
FINISTERE,CONCARNEAU,0290132L,71,55,16,0,18,53,5 ème
FINISTERE,CONCARNEAU,0291873D,150,150,0,0,80,70,5 ème
FINISTERE,DAOULAS,0290033D,119,118,0,1,54,65,5 ème
FINISTERE,DOUARNENEZ,0291591X,120,104,12,4,61,59,5 ème
FINISTERE,FOUESNANT,0290262C,89,89,0,0,43,46,5 ème
FINISTERE,LANDERNEAU,0290184T,0,0,0,0,0,0,5 ème
FINISTERE,LANMEUR,0290047U,103,103,0,0,50,53,5 ème
FINISTERE,LANNILIS,0291639Z,71,71,0,0,27,44,5 ème
FINISTERE,LE RELECQ-KERHUON,0290308C,74,74,0,0,38,36,5 ème
FINISTERE,MORLAIX,0291085X,113,97,16,0,46,67,5 ème
FINISTERE,QUIMPER,0290068S,124,123,0,1,57,67,5 ème
FINISTERE,QUIMPER,0291087Z,135,116,16,3,57,78,5 ème
FINISTERE,QUIMPER,0291592Y,199,193,0,6,98,101,5 ème
FINISTERE,QUIMPER,0292204N,47,47,0,0,24,23,5 ème
FINISTERE,SAINT-POL-DE-LEON,0290207T,0,0,0,0,0,0,5 ème
FINISTERE,SAINT-RENAN,0290086L,108,108,0,0,49,59,5 ème
ILLE-ET-VILAINE,CESSON-SEVIGNE,0351906G,170,167,0,3,73,97,5 ème
ILLE-ET-VILAINE,CHATEAUBOURG,0350854N,140,136,0,4,64,76,5 ème
ILLE-ET-VILAINE,CHATEAUGIRON,0352248D,158,158,0,0,81,77,5 ème
ILLE-ET-VILAINE,DOL-DE-BRETAGNE,0350708E,143,113,26,4,62,81,5 ème
ILLE-ET-VILAINE,FOUGERES,0351997F,123,123,0,0,52,71,5 ème
ILLE-ET-VILAINE,LA GUERCHE-DE-BRETAGNE,0351799R,60,59,0,1,31,29,5 ème
ILLE-ET-VILAINE,MAEN ROCH,0350883V,116,113,0,3,55,61,5 ème
ILLE-ET-VILAINE,MONTAUBAN-DE-BRETAGNE,0350870F,91,91,0,0,45,46,5 ème
ILLE-ET-VILAINE,PACE,0352319F,256,256,0,0,121,135,5 ème
ILLE-ET-VILAINE,REDON,0351969A,117,115,0,2,55,62,5 ème
ILLE-ET-VILAINE,RENNES,0350759K,109,103,0,6,47,62,5 ème
ILLE-ET-VILAINE,RENNES,0350781J,142,136,0,6,66,76,5 ème
ILLE-ET-VILAINE,RENNES,0351878B,0,0,0,0,0,0,5 ème
ILLE-ET-VILAINE,RETIERS,0351882F,118,118,0,0,49,69,5 ème
ILLE-ET-VILAINE,VERN-SUR-SEICHE,0352541X,147,145,0,2,87,60,5 ème
ILLE-ET-VILAINE,VITRE,0350709F,0,0,0,0,0,0,5 ème
MORBIHAN,ALLAIRE,0561376S,127,127,0,0,58,69,5 ème
MORBIHAN,GOURIN,0561546B,66,56,10,0,30,36,5 ème
MORBIHAN,GUER,0560135T,64,64,0,0,32,32,5 ème
MORBIHAN,HENNEBONT,0560070X,0,0,0,0,0,0,5 ème
MORBIHAN,JOSSELIN,0560020T,46,40,6,0,23,23,5 ème
MORBIHAN,LANESTER,0560142A,111,111,0,0,58,53,5 ème
MORBIHAN,LE PALAIS,0560154N,12,12,0,0,7,5,5 ème
MORBIHAN,LORIENT,0560029C,144,144,0,0,67,77,5 ème
MORBIHAN,LORIENT,0560102G,177,164,13,0,83,94,5 ème
MORBIHAN,LORIENT,0562028A,99,95,0,4,52,47,5 ème
MORBIHAN,MAURON,0560032F,51,51,0,0,29,22,5 ème
MORBIHAN,PLOEMEUR,0560802T,113,110,0,3,61,52,5 ème
MORBIHAN,PONTIVY,0561332U,122,99,17,6,49,73,5 ème
MORBIHAN,PONTIVY,0561474Y,105,105,0,0,45,60,5 ème
MORBIHAN,PORT-LOUIS,0560042S,0,0,0,0,0,0,5 ème
MORBIHAN,QUESTEMBERT,0560044U,92,73,16,3,44,48,5 ème
MORBIHAN,RIANTEC,0561409C,155,155,0,0,72,83,5 ème
MORBIHAN,SAINT-AVE,0561840W,121,121,0,0,55,66,5 ème
MORBIHAN,SAINTE-ANNE-D'AURAY,0560119A,0,0,0,0,0,0,5 ème
MORBIHAN,SAINTE-ANNE-D'AURAY,0561545A,147,136,7,4,61,86,5 ème
MORBIHAN,SARZEAU,0560173J,31,31,0,0,18,13,5 ème
MORBIHAN,SENE,0561622J,127,122,0,5,63,64,5 ème
MORBIHAN,VANNES,0560050A,156,156,0,0,84,72,5 ème
CHER,BOURGES,0180008L,0,0,0,0,0,0,5 ème
CHER,BOURGES,0180009M,0,0,0,0,0,0,5 ème
CHER,BOURGES,0180673J,139,130,5,4,64,75,5 ème
CHER,NERONDES,0180023C,64,64,0,0,33,31,5 ème
CHER,NERONDES,0180567U,18,18,0,0,9,9,5 ème
CHER,SAINT-FLORENT-SUR-CHER,0180028H,202,190,12,0,111,91,5 ème
CHER,VIERZON,0180570X,83,78,5,0,36,47,5 ème
CHER,VIERZON,0180592W,154,136,14,4,76,78,5 ème
EURE-ET-LOIR,AUNEAU-BLEURY-SAINT-SYMPHORIEN,0280671C,76,76,0,0,39,37,5 ème
EURE-ET-LOIR,BROU,0280006E,90,87,0,3,36,54,5 ème
EURE-ET-LOIR,BROU,0280674F,54,54,0,0,35,19,5 ème
EURE-ET-LOIR,CHARTRES,0280663U,191,191,0,0,92,99,5 ème
EURE-ET-LOIR,CHARTRES,0280755U,222,221,0,1,113,109,5 ème
EURE-ET-LOIR,DREUX,0280687V,0,0,0,0,0,0,5 ème
EURE-ET-LOIR,DREUX,0280716B,124,111,13,0,58,66,5 ème
EURE-ET-LOIR,DREUX,0280994D,212,206,6,0,111,101,5 ème
EURE-ET-LOIR,DREUX,0281060A,146,144,0,2,68,78,5 ème
EURE-ET-LOIR,VERNOUILLET,0280753S,164,159,0,5,76,88,5 ème
INDRE,ARGENTON-SUR-CREUSE,0360718K,134,112,16,6,70,64,5 ème
INDRE,CHABRIS,0360044C,50,50,0,0,26,24,5 ème
INDRE,CHATEAUROUX,0360011S,0,0,0,0,0,0,5 ème
INDRE,CHATEAUROUX,0360048G,102,98,0,4,42,60,5 ème
INDRE,CHATEAUROUX,0360496U,118,115,0,3,64,54,5 ème
INDRE,CHATEAUROUX,0360541T,100,85,15,0,51,49,5 ème
INDRE,CHATILLON-SUR-INDRE,0360018Z,50,50,0,0,24,26,5 ème
INDRE,DEOLS,0360658V,121,101,15,5,47,74,5 ème
INDRE,ECUEILLE,0360022D,27,27,0,0,10,17,5 ème
INDRE,ISSOUDUN,0360721N,93,77,13,3,45,48,5 ème
INDRE,LA CHATRE,0360019A,0,0,0,0,0,0,5 ème
INDRE,LE BLANC,0360510J,43,43,0,0,19,24,5 ème
INDRE-ET-LOIRE,AMBOISE,0371122U,210,191,16,3,99,111,5 ème
INDRE-ET-LOIRE,AZAY-LE-RIDEAU,0371210P,171,155,12,4,86,85,5 ème
INDRE-ET-LOIRE,CHATEAU-RENAULT,0371211R,0,0,0,0,0,0,5 ème
INDRE-ET-LOIRE,CHINON,0371208M,22,22,0,0,10,12,5 ème
INDRE-ET-LOIRE,JOUE-LES-TOURS,0370071B,83,67,16,0,37,46,5 ème
INDRE-ET-LOIRE,LANGEAIS,0370885L,168,164,0,4,82,86,5 ème
INDRE-ET-LOIRE,NEUVY-LE-ROI,0370023Z,79,79,0,0,43,36,5 ème
INDRE-ET-LOIRE,RICHELIEU,0371191U,46,46,0,0,19,27,5 ème
INDRE-ET-LOIRE,SAINT-CYR-SUR-LOIRE,0371126Y,112,111,0,1,52,60,5 ème
INDRE-ET-LOIRE,SAINT-PIERRE-DES-CORPS,0370766G,53,53,0,0,21,32,5 ème
INDRE-ET-LOIRE,TOURS,0370044X,113,111,0,2,56,57,5 ème
INDRE-ET-LOIRE,TOURS,0370730T,59,59,0,0,24,35,5 ème
INDRE-ET-LOIRE,TOURS,0370764E,103,103,0,0,61,42,5 ème
INDRE-ET-LOIRE,TOURS,0370765F,114,105,0,9,60,54,5 ème
INDRE-ET-LOIRE,TOURS,0371209N,139,137,0,2,68,71,5 ème
INDRE-ET-LOIRE,TOURS,0371330V,127,127,0,0,81,46,5 ème
INDRE-ET-LOIRE,VOUVRAY,0370746K,39,39,0,0,17,22,5 ème
LOIRET,AMILLY,0451104F,20,0,20,0,6,14,5 ème
LOIRET,ARTENAY,0450003J,103,103,0,0,53,50,5 ème
LOIRET,BAZOCHES-LES-GALLERANDES,0450004K,103,95,0,8,52,51,5 ème
LOIRET,BEAUGENCY,0450479B,56,56,0,0,26,30,5 ème
LOIRET,CHATEAUNEUF-SUR-LOIRE,0450783G,180,172,0,8,97,83,5 ème
LOIRET,CHATILLON-SUR-LOIRE,0450017Z,82,80,0,2,41,41,5 ème
LOIRET,DADONVILLE,0451787Y,131,116,9,6,68,63,5 ème
LOIRET,GIEN,0451450G,90,81,0,9,46,44,5 ème
LOIRET,LA FERTE-SAINT-AUBIN,0450023F,142,140,0,2,68,74,5 ème
LOIRET,LE MALESHERBOIS,0450787L,134,128,0,6,66,68,5 ème
LOIRET,LORRIS,0450034T,115,110,0,5,60,55,5 ème
LOIRET,MONTARGIS,0451330B,35,35,0,0,16,19,5 ème
LOIRET,NEUVILLE-AUX-BOIS,0450045E,140,122,15,3,75,65,5 ème
LOIRET,OLIVET,0451304Y,0,0,0,0,0,0,5 ème
LOIRET,ORLEANS,0450049J,0,0,0,0,0,0,5 ème
LOIRET,ORLEANS,0450053N,143,139,0,4,76,67,5 ème
LOIRET,ORLEANS,0450055R,140,120,17,3,75,65,5 ème
LOIRET,ORLEANS,0450782F,0,0,0,0,0,0,5 ème
LOIRET,ORLEANS,0450785J,140,139,0,1,58,82,5 ème
LOIRET,ORLEANS,0451329A,145,145,0,0,70,75,5 ème
LOIRET,SAINT-AY,0451719Z,139,136,0,3,66,73,5 ème
LOIRET,SAINT-BENOIT-SUR-LOIRE,0450123P,59,59,0,0,34,25,5 ème
LOIRET,SAINT-JEAN-DE-BRAYE,0450839T,133,129,0,4,64,69,5 ème
LOIRET,TRAINOU,0451443Z,182,181,0,1,80,102,5 ème
LOIRET,VILLEMANDEUR,0451665R,142,139,0,3,64,78,5 ème
LOIR-ET-CHER,BLOIS,0410621C,47,47,0,0,28,19,5 ème
LOIR-ET-CHER,BLOIS,0410678P,50,46,4,0,27,23,5 ème
LOIR-ET-CHER,LAMOTTE-BEUVRON,0410008L,128,114,14,0,66,62,5 ème
LOIR-ET-CHER,MONTOIRE-SUR-LE-LOIR,0410682U,22,22,0,0,11,11,5 ème
LOIR-ET-CHER,SAINT-AIGNAN,0410714D,127,103,23,1,65,62,5 ème
LOIR-ET-CHER,VENDOME,0410792N,126,125,0,1,61,65,5 ème
CORSE-DU-SUD,AJACCIO,6200006M,171,143,20,8,80,91,5 ème
CORSE-DU-SUD,GROSSETO-PRUGNA,6200080T,112,112,0,0,51,61,5 ème
CORSE-DU-SUD,LEVIE,6200026J,9,9,0,0,5,4,5 ème
HAUTE-CORSE,BASTIA,7200012A,56,50,0,6,30,26,5 ème
HAUTE-CORSE,BASTIA,7200612C,145,129,9,7,59,86,5 ème
HAUTE-CORSE,CALVI,7200017F,115,111,0,4,50,65,5 ème
MEURTHE-ET-MOSELLE,COLOMBEY-LES-BELLES,0540012V,100,98,0,2,55,45,5 ème
MEURTHE-ET-MOSELLE,CUSTINES,0540078S,87,87,0,0,41,46,5 ème
MEURTHE-ET-MOSELLE,GERBEVILLER,0540022F,82,82,0,0,49,33,5 ème
MEURTHE-ET-MOSELLE,LANDRES,0540086A,0,0,0,0,0,0,5 ème
MEURTHE-ET-MOSELLE,LEXY,0541579Y,192,174,14,4,104,88,5 ème
MEURTHE-ET-MOSELLE,LUNEVILLE,0541328A,164,160,0,4,78,86,5 ème
MEURTHE-ET-MOSELLE,LUNEVILLE,0541990V,60,60,0,0,35,25,5 ème
MEURTHE-ET-MOSELLE,MONT-SAINT-MARTIN,0541357G,0,0,0,0,0,0,5 ème
MEURTHE-ET-MOSELLE,NANCY,0541340N,36,36,0,0,16,20,5 ème
MEURTHE-ET-MOSELLE,NANCY,0541370W,0,0,0,0,0,0,5 ème
MEURTHE-ET-MOSELLE,NANCY,0541998D,0,0,0,0,0,0,5 ème
MEURTHE-ET-MOSELLE,NEUVES-MAISONS,0540052N,121,121,0,0,56,65,5 ème
MEURTHE-ET-MOSELLE,PONT-A-MOUSSON,0541270M,0,0,0,0,0,0,5 ème
MEURTHE-ET-MOSELLE,TOUL,0541377D,0,0,0,0,0,0,5 ème
MEURTHE-ET-MOSELLE,TOUL,0541999E,113,109,0,4,64,49,5 ème
MEURTHE-ET-MOSELLE,VANDOEUVRE-LES-NANCY,0540111C,149,146,0,3,73,76,5 ème
MEURTHE-ET-MOSELLE,VANDOEUVRE-LES-NANCY,0541515D,106,90,16,0,59,47,5 ème
MEUSE,BAR-LE-DUC,0550703R,82,80,0,2,40,42,5 ème
MEUSE,CLERMONT-EN-ARGONNE,0550007J,55,55,0,0,28,27,5 ème
MEUSE,COMMERCY,0550008K,0,0,0,0,0,0,5 ème
MEUSE,COMMERCY,0550840P,183,162,12,9,77,106,5 ème
MEUSE,COMMERCY,0550920B,32,32,0,0,13,19,5 ème
MEUSE,MONTMEDY,0550016U,71,71,0,0,41,30,5 ème
MEUSE,SAINT-MIHIEL,0550804A,99,96,0,3,44,55,5 ème
MEUSE,STENAY,0550072E,0,0,0,0,0,0,5 ème
MEUSE,THIERVILLE-SUR-MEUSE,0550759B,115,111,0,4,61,54,5 ème
MEUSE,VERDUN,0550050F,79,79,0,0,44,35,5 ème
MOSELLE,AUDUN-LE-TICHE,0572170Z,115,115,0,0,55,60,5 ème
MOSELLE,BITCHE,0573326F,0,0,0,0,0,0,5 ème
MOSELLE,DIEUZE,0570021N,0,0,0,0,0,0,5 ème
MOSELLE,FAMECK,0572075W,0,0,0,0,0,0,5 ème
MOSELLE,FAULQUEMONT,0572176F,91,79,8,4,43,48,5 ème
MOSELLE,FORBACH,0570030Y,0,0,0,0,0,0,5 ème
MOSELLE,FORBACH,0572922S,254,254,0,0,102,152,5 ème
MOSELLE,FREYMING-MERLEBACH,0570326V,142,118,14,10,74,68,5 ème
MOSELLE,GUENANGE,0573244S,154,133,16,5,86,68,5 ème
MOSELLE,HAGONDANGE,0572172B,128,128,0,0,63,65,5 ème
MOSELLE,METZ,0570069R,98,85,0,13,44,54,5 ème
MOSELLE,METZ,0572088K,106,87,16,3,39,67,5 ème
MOSELLE,METZ,0572166V,150,133,13,4,75,75,5 ème
MOSELLE,METZ,0572352X,112,112,0,0,46,66,5 ème
MOSELLE,MOULINS-LES-METZ,0572186S,77,73,0,4,40,37,5 ème
MOSELLE,OTTANGE,0572101Z,0,0,0,0,0,0,5 ème
MOSELLE,ROMBAS,0572585A,107,102,0,5,55,52,5 ème
MOSELLE,SARREGUEMINES,0572184P,133,130,0,3,74,59,5 ème
MOSELLE,SARREGUEMINES,0572587C,91,75,11,5,44,47,5 ème
MOSELLE,THIONVILLE,0570108H,0,0,0,0,0,0,5 ème
MOSELLE,THIONVILLE,0572951Y,0,0,0,0,0,0,5 ème
MOSELLE,VITRY-SUR-ORNE,0572019K,135,135,0,0,72,63,5 ème
VOSGES,CAPAVENIR VOSGES,0880064S,0,0,0,0,0,0,5 ème
VOSGES,CONTREXEVILLE,0881102V,77,63,8,6,39,38,5 ème
VOSGES,DOMPAIRE,0880017R,101,101,0,0,50,51,5 ème
VOSGES,GERARDMER,0880031F,0,0,0,0,0,0,5 ème
VOSGES,LA VOGE-LES-BAINS,0880002Z,31,31,0,0,12,19,5 ème
VOSGES,LE VAL-D'AJOL,0880068W,55,55,0,0,28,27,5 ème
VOSGES,REMIREMONT,0880154P,105,90,14,1,60,45,5 ème
VOSGES,SAINT-DIE-DES-VOSGES,0880152M,0,0,0,0,0,0,5 ème
ARDENNES,ASFELD,0081102E,139,139,0,0,59,80,5 ème
ARDENNES,BOGNY-SUR-MEUSE,0080105W,42,41,0,1,24,18,5 ème
ARDENNES,CHARLEVILLE-MEZIERES,0080084Y,172,172,0,0,88,84,5 ème
ARDENNES,GRANDPRE,0081096Y,18,18,0,0,11,7,5 ème
ARDENNES,RIMOGNE,0080042C,86,74,12,0,46,40,5 ème
ARDENNES,SAULT-LES-RETHEL,0080909V,100,82,14,4,52,48,5 ème
ARDENNES,SEDAN,0080910W,82,79,0,3,34,48,5 ème
AUBE,AIX-VILLEMAUR-PALIS,0100806X,124,124,0,0,63,61,5 ème
AUBE,BAR-SUR-SEINE,0100004A,0,0,0,0,0,0,5 ème
AUBE,BAR-SUR-SEINE,0100745F,42,42,0,0,25,17,5 ème
AUBE,LA CHAPELLE-SAINT-LUC,0100009F,152,152,0,0,76,76,5 ème
AUBE,MARIGNY-LE-CHATEL,0100011H,86,86,0,0,38,48,5 ème
AUBE,MERY-SUR-SEINE,0100785Z,120,120,0,0,64,56,5 ème
AUBE,SAINT-ANDRE-LES-VERGERS,0100019S,149,133,12,4,75,74,5 ème
AUBE,TROYES,0100031E,138,138,0,0,67,71,5 ème
AUBE,TROYES,0100057H,96,96,0,0,51,45,5 ème
AUBE,TROYES,0100058J,86,85,0,1,45,41,5 ème
AUBE,TROYES,0100947A,118,118,0,0,55,63,5 ème
AUBE,TROYES,0101015Z,0,0,0,0,0,0,5 ème
HAUTE-MARNE,CHAUMONT,0520008B,0,0,0,0,0,0,5 ème
HAUTE-MARNE,CHAUMONT,0520039K,101,82,13,6,56,45,5 ème
HAUTE-MARNE,CHEVILLON,0520842H,68,68,0,0,38,30,5 ème
HAUTE-MARNE,JOINVILLE,0520822L,79,77,0,2,31,48,5 ème
HAUTE-MARNE,SAINT-DIZIER,0520050X,89,89,0,0,41,48,5 ème
HAUTE-MARNE,SAINT-DIZIER,0520051Y,80,77,0,3,46,34,5 ème
MARNE,BAZANCOURT,0511326P,160,160,0,0,85,75,5 ème
MARNE,CHALONS-EN-CHAMPAGNE,0510011K,185,182,0,3,90,95,5 ème
MARNE,CHALONS-EN-CHAMPAGNE,0511083A,134,130,0,4,54,80,5 ème
MARNE,CHALONS-EN-CHAMPAGNE,0511951U,0,0,0,0,0,0,5 ème
MARNE,DORMANS,0511258R,105,100,3,2,52,53,5 ème
MARNE,ESTERNAY,0511567B,69,69,0,0,37,32,5 ème
MARNE,MONTMIRAIL,0510026B,83,81,0,2,41,42,5 ème
MARNE,MONTMORT-LUCY,0510027C,38,38,0,0,15,23,5 ème
MARNE,REIMS,0510036M,0,0,0,0,0,0,5 ème
MARNE,REIMS,0511084B,142,141,0,1,81,61,5 ème
MARNE,REIMS,0511153B,0,0,0,0,0,0,5 ème
MARNE,REIMS,0511251H,120,105,15,0,59,61,5 ème
MARNE,REIMS,0511254L,144,131,0,13,68,76,5 ème
MARNE,RILLY-LA-MONTAGNE,0510048A,82,82,0,0,46,36,5 ème
MARNE,VITRY-LE-FRANCOIS,0510062R,0,0,0,0,0,0,5 ème
BAS-RHIN,BISCHHEIM,0670004R,167,145,15,7,85,82,5 ème
BAS-RHIN,BISCHWILLER,0670006T,0,0,0,0,0,0,5 ème
BAS-RHIN,ESCHAU,0671687V,185,180,0,5,103,82,5 ème
BAS-RHIN,GEISPOLSHEIM,0671824U,173,167,0,6,84,89,5 ème
BAS-RHIN,HAGUENAU,0671603D,151,151,0,0,75,76,5 ème
BAS-RHIN,HAGUENAU,0671734W,128,107,14,7,53,75,5 ème
BAS-RHIN,HOCHFELDEN,0671961T,202,201,0,1,113,89,5 ème
BAS-RHIN,ILLKIRCH-GRAFFENSTADEN,0671455T,16,0,16,0,8,8,5 ème
BAS-RHIN,ILLKIRCH-GRAFFENSTADEN,0671956M,90,87,0,3,42,48,5 ème
BAS-RHIN,ILLKIRCH-GRAFFENSTADEN,0672198A,0,0,0,0,0,0,5 ème
BAS-RHIN,LA BROQUE,0671697F,131,111,17,3,63,68,5 ème
BAS-RHIN,MARLENHEIM,0671989Y,158,158,0,0,74,84,5 ème
BAS-RHIN,MOLSHEIM,0670043H,0,0,0,0,0,0,5 ème
BAS-RHIN,MOLSHEIM,0672615D,0,0,0,0,0,0,5 ème
BAS-RHIN,RHINAU,0671963V,66,66,0,0,30,36,5 ème
BAS-RHIN,SOUFFLENHEIM,0670076U,157,154,0,3,87,70,5 ème
BAS-RHIN,SOULTZ-SOUS-FORETS,0671827X,138,135,0,3,65,73,5 ème
BAS-RHIN,STRASBOURG,0670133F,179,178,0,1,83,96,5 ème
BAS-RHIN,STRASBOURG,0671593T,177,176,0,1,100,77,5 ème
BAS-RHIN,STRASBOURG,0671607H,159,155,0,4,65,94,5 ème
BAS-RHIN,STRASBOURG,0671742E,171,143,18,10,81,90,5 ème
BAS-RHIN,STRASBOURG,0672899M,96,96,0,0,54,42,5 ème
BAS-RHIN,WALBOURG,0672302N,81,81,0,0,33,48,5 ème
BAS-RHIN,WASSELONNE,0671740C,116,111,0,5,58,58,5 ème
BAS-RHIN,WINGEN-SUR-MODER,0671739B,45,45,0,0,26,19,5 ème
HAUT-RHIN,BLOTZHEIM,0680131Y,128,128,0,0,59,69,5 ème
HAUT-RHIN,BRUNSTATT-DIDENHEIM,0681957H,112,106,0,6,46,66,5 ème
HAUT-RHIN,COLMAR,0680133A,152,152,0,0,69,83,5 ème
HAUT-RHIN,HIRSINGUE,0680019B,148,146,0,2,79,69,5 ème
HAUT-RHIN,ILLZACH,0680021D,146,141,0,5,65,81,5 ème
HAUT-RHIN,ISSENHEIM,0680144M,234,234,0,0,112,122,5 ème
HAUT-RHIN,LUTTERBACH,0681370V,136,128,6,2,58,78,5 ème
HAUT-RHIN,MULHOUSE,0680110A,151,131,16,4,84,67,5 ème
HAUT-RHIN,MULHOUSE,0681395X,210,183,25,2,106,104,5 ème
HAUT-RHIN,ORBEY,0681448E,101,101,0,0,49,52,5 ème
HAUT-RHIN,SAINT-LOUIS,0681747E,137,133,0,4,71,66,5 ème
HAUT-RHIN,SEPPOIS-LE-BAS,0680071H,87,87,0,0,43,44,5 ème
HAUT-RHIN,THANN,0680074L,0,0,0,0,0,0,5 ème
HAUT-RHIN,THANN,0681541F,73,73,0,0,29,44,5 ème
HAUT-RHIN,WITTELSHEIM,0680079S,94,91,0,3,42,52,5 ème
HAUT-RHIN,WITTENHEIM,0681126E,136,121,15,0,63,73,5 ème
HAUT-RHIN,WITTENHEIM,0681930D,147,147,0,0,68,79,5 ème
GUADELOUPE,GOURBEYRE,9710034K,56,55,0,1,32,24,5 ème
GUADELOUPE,GOURBEYRE,9710067W,0,0,0,0,0,0,5 ème
GUADELOUPE,GRAND-BOURG,9710926E,63,63,0,0,26,37,5 ème
GUADELOUPE,LE GOSIER,9711066G,0,0,0,0,0,0,5 ème
GUADELOUPE,LE MOULE,9710052E,0,0,0,0,0,0,5 ème
GUADELOUPE,LES ABYMES,9711205H,0,0,0,0,0,0,5 ème
GUADELOUPE,POINTE-A-PITRE,9710072B,45,43,0,2,21,24,5 ème
GUADELOUPE,SAINTE-ANNE,9710021W,195,178,12,5,91,104,5 ème
GUADELOUPE,SAINT-FRANCOIS,9710030F,157,154,0,3,77,80,5 ème
GUADELOUPE,SAINT-MARTIN,9710981P,0,0,0,0,0,0,5 ème
GUADELOUPE,SAINT-MARTIN,9711023K,160,150,0,10,73,87,5 ème
GUYANE,KOUROU,9730125Y,233,187,41,5,122,111,5 ème
GUYANE,KOUROU,9730237V,173,161,0,12,83,90,5 ème
GUYANE,MANA,9730192W,154,137,9,8,75,79,5 ème
GUYANE,REMIRE-MONTJOLY,9730334A,116,116,0,0,59,57,5 ème
GUYANE,SAINT-LAURENT-DU-MARONI,9730394R,237,229,0,8,114,123,5 ème
AISNE,BEAUREVOIR,0020004U,55,55,0,0,26,29,5 ème
AISNE,BRAINE,0020009Z,120,115,0,5,65,55,5 ème
AISNE,CHATEAU-THIERRY,0020468Y,88,87,0,1,35,53,5 ème
AISNE,CHATEAU-THIERRY,0021826Z,195,184,8,3,84,111,5 ème
AISNE,CHAUNY,0021493M,121,108,8,5,64,57,5 ème
AISNE,CUFFIES,0021491K,118,112,0,6,47,71,5 ème
AISNE,FERE-EN-TARDENOIS,0020024R,122,113,8,1,55,67,5 ème
AISNE,GUISE,0020483P,36,36,0,0,19,17,5 ème
AISNE,LA CAPELLE,0020479K,15,15,0,0,4,11,5 ème
AISNE,LAON,0020078Z,0,0,0,0,0,0,5 ème
AISNE,MOY-DE-L'AISNE,0020037E,97,97,0,0,52,45,5 ème
AISNE,NEUILLY-SAINT-FRONT,0020038F,100,100,0,0,45,55,5 ème
AISNE,SAINT-QUENTIN,0020080B,115,109,0,6,64,51,5 ème
AISNE,SAINT-QUENTIN,0021478W,16,0,16,0,6,10,5 ème
AISNE,VILLENEUVE-SAINT-GERMAIN,0021490J,88,75,13,0,50,38,5 ème
OISE,BEAUVAIS,0601140N,211,211,0,0,114,97,5 ème
OISE,BEAUVAIS,0601188R,169,149,15,5,83,86,5 ème
OISE,BEAUVAIS,0601487R,129,111,14,4,60,69,5 ème
OISE,BETZ,0601447X,125,125,0,0,55,70,5 ème
OISE,CHANTILLY,0601606V,116,113,0,3,48,68,5 ème
OISE,CLERMONT,0601471Y,171,167,0,4,92,79,5 ème
OISE,CREIL,0601449Z,192,173,15,4,90,102,5 ème
OISE,CREPY-EN-VALOIS,0601363F,0,0,0,0,0,0,5 ème
OISE,CREVECOEUR-LE-GRAND,0600070A,10,0,10,0,3,7,5 ème
OISE,CUISE-LA-MOTTE,0601146V,26,22,0,4,19,7,5 ème
OISE,GOUVIEUX,0601192V,116,104,11,1,56,60,5 ème
OISE,MERU,0601191U,161,142,16,3,78,83,5 ème
OISE,MONTATAIRE,0601178E,206,188,14,4,109,97,5 ème
OISE,MORTEFONTAINE,0601145U,238,238,0,0,112,126,5 ème
OISE,NANTEUIL-LE-HAUDOUIN,0601408E,172,171,0,1,87,85,5 ème
OISE,NOGENT-SUR-OISE,0600062S,0,0,0,0,0,0,5 ème
OISE,NOYON,0601297J,161,134,24,3,83,78,5 ème
OISE,RIBECOURT-DRESLINCOURT,0600046Z,128,125,0,3,55,73,5 ème
OISE,SAINT-MAXIMIN,0600048B,0,0,0,0,0,0,5 ème
OISE,VILLERS-SAINT-PAUL,0601821D,105,102,0,3,48,57,5 ème
SOMME,ABBEVILLE,0800002T,188,169,16,3,98,90,5 ème
SOMME,AILLY-SUR-NOYE,0800004V,119,115,0,4,57,62,5 ème
SOMME,AMIENS,0801212H,112,112,0,0,53,59,5 ème
SOMME,AMIENS,0801220S,107,107,0,0,44,63,5 ème
SOMME,AMIENS,0802214X,0,0,0,0,0,0,5 ème
SOMME,CORBIE,0801511H,80,75,0,5,38,42,5 ème
SOMME,DOULLENS,0800029X,155,139,12,4,77,78,5 ème
SOMME,DOULLENS,0801900F,0,0,0,0,0,0,5 ème
SOMME,FRIVILLE-ESCARBOTIN,0800033B,113,112,0,1,50,63,5 ème
SOMME,GAMACHES,0800034C,139,125,12,2,68,71,5 ème
SOMME,HAM,0801224W,96,96,0,0,50,46,5 ème
SOMME,MERS-LES-BAINS,0800039H,46,46,0,0,28,18,5 ème
SOMME,NESLE,0801369D,72,72,0,0,36,36,5 ème
SOMME,NOUVION,0801488H,69,69,0,0,34,35,5 ème
SOMME,POIX-DE-PICARDIE,0801326G,101,99,0,2,53,48,5 ème
SOMME,ROISEL,0800050V,61,61,0,0,25,36,5 ème
SOMME,ROYE,0801341Y,134,113,16,5,65,69,5 ème
NORD,ANNOEULLIN,0593234V,137,137,0,0,58,79,5 ème
NORD,ARMENTIERES,0593060F,0,0,0,0,0,0,5 ème
NORD,ARMENTIERES,0595382E,178,178,0,0,81,97,5 ème
NORD,AULNOYE-AYMERIES,0590015W,0,0,0,0,0,0,5 ème
NORD,BONDUES,0595385H,238,238,0,0,124,114,5 ème
NORD,BOURBOURG,0592955S,175,175,0,0,100,75,5 ème
NORD,CONDE-SUR-L'ESCAUT,0590050J,122,103,14,5,60,62,5 ème
NORD,CONDE-SUR-L'ESCAUT,0596854E,0,0,0,0,0,0,5 ème
NORD,COUDEKERQUE-BRANCHE,0593182N,53,53,0,0,20,33,5 ème
NORD,COUDEKERQUE-BRANCHE,0593494C,100,81,16,3,46,54,5 ème
NORD,DENAIN,0590264S,0,0,0,0,0,0,5 ème
NORD,DOUAI,0595171A,172,167,0,5,94,78,5 ème
NORD,DOUAI,0595894L,0,0,0,0,0,0,5 ème
NORD,DUNKERQUE,0590200X,106,106,0,0,41,65,5 ème
NORD,DUNKERQUE,0593143W,102,99,0,3,54,48,5 ème
NORD,DUNKERQUE,0596716E,78,75,0,3,31,47,5 ème
NORD,ESTAIRES,0595757M,122,122,0,0,60,62,5 ème
NORD,FOURMIES,0594879H,72,72,0,0,32,40,5 ème
NORD,FOURMIES,0595390N,51,50,0,1,14,37,5 ème
NORD,GRANDE-SYNTHE,0594398K,101,89,8,4,46,55,5 ème
NORD,GRANDE-SYNTHE,0595388L,69,69,0,0,33,36,5 ème
NORD,GRAND-FORT-PHILIPPE,0595712N,45,45,0,0,27,18,5 ème
NORD,HAUTMONT,0592634T,149,149,0,0,76,73,5 ème
NORD,HAUTMONT,0594309N,101,84,10,7,48,53,5 ème
NORD,HAZEBROUCK,0595391P,145,142,0,3,70,75,5 ème
NORD,LA MADELEINE,0592896C,146,146,0,0,79,67,5 ème
NORD,LAMBRES-LEZ-DOUAI,0594298B,138,135,0,3,75,63,5 ème
NORD,LANDRECIES,0595178H,137,132,5,0,72,65,5 ème
NORD,LE CATEAU-CAMBRESIS,0595337F,180,165,12,3,72,108,5 ème
NORD,LE QUESNOY,0595172B,223,215,8,0,110,113,5 ème
NORD,LESQUIN,0593991T,127,127,0,0,57,70,5 ème
NORD,LILLE,0593131H,104,104,0,0,58,46,5 ème
NORD,LILLE,0593179K,124,123,0,1,54,70,5 ème
NORD,LILLE,0593235W,142,129,13,0,77,65,5 ème
NORD,LOON-PLAGE,0595596M,78,75,0,3,45,33,5 ème
NORD,MERVILLE,0592899F,162,158,0,4,72,90,5 ème
NORD,MONS-EN-BAROEUL,0590155Y,103,100,0,3,46,57,5 ème
NORD,ORCHIES,0592900G,156,156,0,0,69,87,5 ème
NORD,ORCHIES,0593040J,0,0,0,0,0,0,5 ème
NORD,PECQUENCOURT,0596529B,149,147,0,2,70,79,5 ème
NORD,PONT-A-MARCQ,0594866U,135,135,0,0,66,69,5 ème
NORD,ROUBAIX,0590190L,122,118,0,4,53,69,5 ème
NORD,ROUBAIX,0592917A,173,173,0,0,88,85,5 ème
NORD,SAINT-ANDRE-LEZ-LILLE,0592832H,0,0,0,0,0,0,5 ème
NORD,SAINT-ANDRE-LEZ-LILLE,0593228N,104,101,0,3,50,54,5 ème
NORD,SAINT-SAULVE,0594644C,89,85,0,4,46,43,5 ème
NORD,SAINT-SAULVE,0595402B,237,236,0,1,117,120,5 ème
NORD,SEBOURG,0593144X,108,108,0,0,54,54,5 ème
NORD,SOLRE-LE-CHATEAU,0590206D,85,85,0,0,42,43,5 ème
NORD,THIANT,0594645D,143,138,5,0,88,55,5 ème
NORD,TOURCOING,0593217B,319,307,12,0,181,138,5 ème
NORD,VALENCIENNES,0593154H,99,97,0,2,40,59,5 ème
NORD,VALENCIENNES,0593680E,78,65,13,0,32,46,5 ème
NORD,VILLENEUVE-D'ASCQ,0593196D,153,137,10,6,69,84,5 ème
NORD,VILLENEUVE-D'ASCQ,0593198F,103,103,0,0,44,59,5 ème
NORD,VILLENEUVE-D'ASCQ,0594291U,136,136,0,0,60,76,5 ème
NORD,VILLENEUVE-D'ASCQ,0594525Y,87,87,0,0,51,36,5 ème
NORD,WAZIERS,0590238N,82,82,0,0,36,46,5 ème
NORD,WAZIERS,0593495D,0,0,0,0,0,0,5 ème
PAS-DE-CALAIS,ANGRES,0622579S,108,108,0,0,65,43,5 ème
PAS-DE-CALAIS,ANZIN-SAINT-AUBIN,0622125Y,292,289,0,3,144,148,5 ème
PAS-DE-CALAIS,ARRAS,0622196A,0,0,0,0,0,0,5 ème
PAS-DE-CALAIS,BERTINCOURT,0620039F,72,72,0,0,31,41,5 ème
PAS-DE-CALAIS,CALAIS,0620189U,0,0,0,0,0,0,5 ème
PAS-DE-CALAIS,CALAIS,0622109F,124,124,0,0,61,63,5 ème
PAS-DE-CALAIS,CALAIS,0622431F,75,72,0,3,28,47,5 ème
PAS-DE-CALAIS,CALAIS,0622432G,110,110,0,0,55,55,5 ème
PAS-DE-CALAIS,CALAIS,0622576N,119,95,20,4,60,59,5 ème
PAS-DE-CALAIS,CALAIS,0623315S,139,134,0,5,62,77,5 ème
PAS-DE-CALAIS,CARVIN,0623919Y,119,117,0,2,60,59,5 ème
PAS-DE-CALAIS,DESVRES,0623023Z,160,145,11,4,77,83,5 ème
PAS-DE-CALAIS,DOUVRIN,0622867E,145,141,0,4,69,76,5 ème
PAS-DE-CALAIS,FOUQUIERES-LES-LENS,0622098U,77,77,0,0,39,38,5 ème
PAS-DE-CALAIS,FRUGES,0622112J,42,39,0,3,13,29,5 ème
PAS-DE-CALAIS,FRUGES,0622195Z,0,0,0,0,0,0,5 ème
PAS-DE-CALAIS,HENIN-BEAUMONT,0620096T,105,92,13,0,52,53,5 ème
PAS-DE-CALAIS,HESDIN,0622139N,29,29,0,0,16,13,5 ème
PAS-DE-CALAIS,HUCQUELIERS,0620104B,129,125,0,4,57,72,5 ème
PAS-DE-CALAIS,LAVENTIE,0622140P,75,75,0,0,32,43,5 ème
PAS-DE-CALAIS,LENS,0622868F,119,105,11,3,50,69,5 ème
PAS-DE-CALAIS,LE TOUQUET-PARIS-PLAGE,0622806N,91,91,0,0,49,42,5 ème
PAS-DE-CALAIS,LIBERCOURT,0622239X,88,88,0,0,37,51,5 ème
PAS-DE-CALAIS,LICQUES,0620194Z,91,91,0,0,46,45,5 ème
PAS-DE-CALAIS,LIEVIN,0622302R,6,0,6,0,3,3,5 ème
PAS-DE-CALAIS,LILLERS,0620121V,0,0,0,0,0,0,5 ème
PAS-DE-CALAIS,LILLERS,0623312N,121,118,0,3,56,65,5 ème
PAS-DE-CALAIS,LONGUENESSE,0623572W,96,96,0,0,48,48,5 ème
PAS-DE-CALAIS,LOOS-EN-GOHELLE,0620123X,78,78,0,0,36,42,5 ème
PAS-DE-CALAIS,LUMBRES,0620124Y,0,0,0,0,0,0,5 ème
PAS-DE-CALAIS,LUMBRES,0622142S,77,77,0,0,40,37,5 ème
PAS-DE-CALAIS,MARQUISE,0622096S,217,206,11,0,111,106,5 ème
PAS-DE-CALAIS,MONTREUIL,0622117P,89,89,0,0,46,43,5 ème
PAS-DE-CALAIS,MONTREUIL,0622951W,181,165,11,5,84,97,5 ème
PAS-DE-CALAIS,PERNES,0620156H,93,93,0,0,48,45,5 ème
PAS-DE-CALAIS,SANGATTE,0623865P,140,140,0,0,62,78,5 ème
PAS-DE-CALAIS,WINGLES,0620258U,0,0,0,0,0,0,5 ème
PAS-DE-CALAIS,WIZERNES,0622874M,123,106,12,5,55,68,5 ème
SEINE-ET-MARNE,BOIS-LE-ROI,0770002J,157,157,0,0,75,82,5 ème
SEINE-ET-MARNE,CHAMPS-SUR-MARNE,0771511Z,125,125,0,0,56,69,5 ème
SEINE-ET-MARNE,CHELLES,0771171E,0,0,0,0,0,0,5 ème
SEINE-ET-MARNE,CHELLES,0771926A,157,157,0,0,77,80,5 ème
SEINE-ET-MARNE,CHESSY,0772651N,129,128,0,1,66,63,5 ème
SEINE-ET-MARNE,ESBLY,0771361L,175,159,13,3,92,83,5 ème
SEINE-ET-MARNE,LAGNY-SUR-MARNE,0771918S,306,306,0,0,151,155,5 ème
SEINE-ET-MARNE,LE CHATELET-EN-BRIE,0771068T,140,136,0,4,69,71,5 ème
SEINE-ET-MARNE,MAGNY-LE-HONGRE,0772713F,166,166,0,0,87,79,5 ème
SEINE-ET-MARNE,MEAUX,0771420A,132,112,16,4,57,75,5 ème
SEINE-ET-MARNE,MELUN,0771070V,83,78,0,5,40,43,5 ème
SEINE-ET-MARNE,MELUN,0771220H,94,94,0,0,52,42,5 ème
SEINE-ET-MARNE,MELUN,0771923X,212,210,0,2,98,114,5 ème
SEINE-ET-MARNE,MOISSY-CRAMAYEL,0772191N,144,144,0,0,73,71,5 ème
SEINE-ET-MARNE,MORET-LOING-ET-ORVANNE,0770038Y,184,177,0,7,89,95,5 ème
SEINE-ET-MARNE,NANGIS,0770040A,173,170,0,3,100,73,5 ème
SEINE-ET-MARNE,OTHIS,0771562E,156,156,0,0,70,86,5 ème
SEINE-ET-MARNE,OZOIR-LA-FERRIERE,0771334G,149,149,0,0,69,80,5 ème
SEINE-ET-MARNE,OZOIR-LA-FERRIERE,0772293Z,124,121,0,3,66,58,5 ème
SEINE-ET-MARNE,PROVINS,0771176K,121,98,23,0,52,69,5 ème
SEINE-ET-MARNE,SAINT-FARGEAU-PONTHIERRY,0771517F,235,235,0,0,129,106,5 ème
SEINE-ET-MARNE,SAINT-SOUPPLETS,0772483F,103,101,0,2,47,56,5 ème
SEINE-ET-MARNE,SAVIGNY-LE-TEMPLE,0772274D,119,115,0,4,62,57,5 ème
SEINE-ET-MARNE,SERRIS,0772589W,138,132,0,6,68,70,5 ème
SEINE-ET-MARNE,VAIRES-SUR-MARNE,0771177L,166,163,0,3,81,85,5 ème
SEINE-ET-MARNE,VAUX-LE-PENIL,0771178M,167,165,0,2,89,78,5 ème
SEINE-ET-MARNE,VERNEUIL-L'ETANG,0771619S,128,125,0,3,55,73,5 ème
SEINE-ET-MARNE,VOISENON,0771930E,221,221,0,0,105,116,5 ème
SEINE-ET-MARNE,VULAINES-SUR-SEINE,0772867Y,121,121,0,0,55,66,5 ème
SEINE-SAINT-DENIS,AUBERVILLIERS,0930902A,118,118,0,0,63,55,5 ème
SEINE-SAINT-DENIS,AULNAY-SOUS-BOIS,0931379U,179,164,15,0,93,86,5 ème
SEINE-SAINT-DENIS,AULNAY-SOUS-BOIS,0932310F,160,160,0,0,92,68,5 ème
SEINE-SAINT-DENIS,BAGNOLET,0931022F,152,152,0,0,71,81,5 ème
SEINE-SAINT-DENIS,BOBIGNY,0930900Y,125,116,0,9,57,68,5 ème
SEINE-SAINT-DENIS,BOBIGNY,0931194T,228,210,14,4,112,116,5 ème
SEINE-SAINT-DENIS,BONDY,0931711E,140,140,0,0,70,70,5 ème
SEINE-SAINT-DENIS,BONDY,0931860S,114,110,0,4,52,62,5 ème
SEINE-SAINT-DENIS,CLICHY-SOUS-BOIS,0930616P,167,161,0,6,79,88,5 ème
SEINE-SAINT-DENIS,CLICHY-SOUS-BOIS,0932366S,132,132,0,0,70,62,5 ème
SEINE-SAINT-DENIS,DRANCY,0931199Y,185,184,0,1,101,84,5 ème
SEINE-SAINT-DENIS,GAGNY,0931233K,0,0,0,0,0,0,5 ème
SEINE-SAINT-DENIS,GAGNY,0931855L,31,31,0,0,0,31,5 ème
SEINE-SAINT-DENIS,GAGNY,0932311G,168,148,17,3,86,82,5 ème
SEINE-SAINT-DENIS,LA COURNEUVE,0930128J,0,0,0,0,0,0,5 ème
SEINE-SAINT-DENIS,LE BLANC-MESNIL,0932580Z,136,133,0,3,73,63,5 ème
SEINE-SAINT-DENIS,LE PRE-SAINT-GERVAIS,0930917S,91,91,0,0,51,40,5 ème
SEINE-SAINT-DENIS,LE RAINCY,0930970Z,19,19,0,0,8,11,5 ème
SEINE-SAINT-DENIS,LE RAINCY,0932772H,45,45,0,0,22,23,5 ème
SEINE-SAINT-DENIS,LES LILAS,0931439J,147,147,0,0,80,67,5 ème
SEINE-SAINT-DENIS,MONTFERMEIL,0931546A,164,162,0,2,79,85,5 ème
SEINE-SAINT-DENIS,MONTREUIL,0931211L,86,86,0,0,35,51,5 ème
SEINE-SAINT-DENIS,MONTREUIL,0931212M,107,88,14,5,54,53,5 ème
SEINE-SAINT-DENIS,MONTREUIL,0931845A,123,123,0,0,65,58,5 ème
SEINE-SAINT-DENIS,NEUILLY-SUR-MARNE,0931228E,116,109,0,7,48,68,5 ème
SEINE-SAINT-DENIS,NOISY-LE-GRAND,0930883E,196,194,0,2,84,112,5 ème
SEINE-SAINT-DENIS,NOISY-LE-GRAND,0931614Z,172,157,15,0,99,73,5 ème
SEINE-SAINT-DENIS,NOISY-LE-SEC,0931610V,214,197,15,2,117,97,5 ème
SEINE-SAINT-DENIS,PANTIN,0931713G,154,140,14,0,81,73,5 ème
SEINE-SAINT-DENIS,PIERREFITTE-SUR-SEINE,0931223Z,207,191,10,6,108,99,5 ème
SEINE-SAINT-DENIS,SAINT-DENIS,0930959M,246,246,0,0,125,121,5 ème
SEINE-SAINT-DENIS,SAINT-DENIS,0931231H,126,126,0,0,59,67,5 ème
SEINE-SAINT-DENIS,SAINT-DENIS,0932273R,136,132,0,4,68,68,5 ème
SEINE-SAINT-DENIS,SAINT-DENIS,0932586F,66,66,0,0,33,33,5 ème
SEINE-SAINT-DENIS,SAINT-DENIS,0932773J,32,32,0,0,17,15,5 ème
SEINE-SAINT-DENIS,SEVRAN,0931979W,171,163,0,8,88,83,5 ème
SEINE-SAINT-DENIS,STAINS,0931225B,140,136,0,4,54,86,5 ème
SEINE-SAINT-DENIS,VILLEPINTE,0931607S,137,118,15,4,64,73,5 ème
VAL-DE-MARNE,ALFORTVILLE,0940126B,0,0,0,0,0,0,5 ème
VAL-DE-MARNE,BOISSY-SAINT-LEGER,0940892J,65,65,0,0,34,31,5 ème
VAL-DE-MARNE,BONNEUIL-SUR-MARNE,0941095E,127,110,13,4,66,61,5 ème
VAL-DE-MARNE,CHAMPIGNY-SUR-MARNE,0941092B,90,90,0,0,43,47,5 ème
VAL-DE-MARNE,CHAMPIGNY-SUR-MARNE,0941299B,170,154,16,0,82,88,5 ème
VAL-DE-MARNE,CHAMPIGNY-SUR-MARNE,0941431V,130,130,0,0,55,75,5 ème
VAL-DE-MARNE,CHARENTON-LE-PONT,0940808T,179,179,0,0,94,85,5 ème
VAL-DE-MARNE,CHENNEVIERES-SUR-MARNE,0940787V,100,99,0,1,55,45,5 ème
VAL-DE-MARNE,CHOISY-LE-ROI,0941229A,177,164,13,0,77,100,5 ème
VAL-DE-MARNE,CRETEIL,0940003T,75,74,0,1,40,35,5 ème
VAL-DE-MARNE,CRETEIL,0941018W,0,0,0,0,0,0,5 ème
VAL-DE-MARNE,CRETEIL,0941351H,123,112,0,11,55,68,5 ème
VAL-DE-MARNE,FONTENAY-SOUS-BOIS,0940516A,205,205,0,0,104,101,5 ème
VAL-DE-MARNE,FONTENAY-SOUS-BOIS,0941296Y,154,138,16,0,77,77,5 ème
VAL-DE-MARNE,GENTILLY,0941099J,100,100,0,0,45,55,5 ème
VAL-DE-MARNE,LE KREMLIN-BICETRE,0940022N,92,92,0,0,44,48,5 ème
VAL-DE-MARNE,LE PERREUX-SUR-MARNE,0940789X,146,146,0,0,68,78,5 ème
VAL-DE-MARNE,MAISONS-ALFORT,0941046B,142,142,0,0,80,62,5 ème
VAL-DE-MARNE,ORLY,0941044Z,172,172,0,0,89,83,5 ème
VAL-DE-MARNE,SAINT-MANDE,0940790Y,136,134,0,2,64,72,5 ème
VAL-DE-MARNE,SAINT-MANDE,0941715D,153,151,0,2,84,69,5 ème
VAL-DE-MARNE,SAINT-MAUR-DES-FOSSES,0940585A,0,0,0,0,0,0,5 ème
VAL-DE-MARNE,SAINT-MAUR-DES-FOSSES,0940811W,90,90,0,0,45,45,5 ème
VAL-DE-MARNE,SAINT-MAURICE,0941597A,100,100,0,0,60,40,5 ème
VAL-DE-MARNE,SUCY-EN-BRIE,0940748C,162,160,0,2,81,81,5 ème
VAL-DE-MARNE,VILLECRESNES,0941412Z,143,143,0,0,75,68,5 ème
VAL-DE-MARNE,VILLEJUIF,0941035P,97,87,10,0,63,34,5 ème
VAL-DE-MARNE,VILLENEUVE-LE-ROI,0941103N,126,126,0,0,59,67,5 ème
VAL-DE-MARNE,VILLENEUVE-LE-ROI,0941234F,77,77,0,0,38,39,5 ème
VAL-DE-MARNE,VILLIERS-SUR-MARNE,0940625U,109,105,0,4,54,55,5 ème
VAL-DE-MARNE,VINCENNES,0942188T,156,156,0,0,74,82,5 ème
VAL-DE-MARNE,VITRY-SUR-SEINE,0941034N,117,117,0,0,62,55,5 ème
VAL-DE-MARNE,VITRY-SUR-SEINE,0942434K,131,128,0,3,68,63,5 ème
PARIS,PARIS,0752251P,106,103,0,3,53,53,5 ème
PARIS,PARIS,0753047E,97,96,0,1,49,48,5 ème
PARIS,PARIS,0754506R,145,145,0,0,65,80,5 ème
PARIS,PARIS,0750676C,0,0,0,0,0,0,5 ème
PARIS,PARIS,0752895P,133,133,0,0,133,0,5 ème
PARIS,PARIS,0752954D,0,0,0,0,0,0,5 ème
PARIS,PARIS,0753978S,64,64,0,0,26,38,5 ème
PARIS,PARIS,0754528P,127,109,16,2,56,71,5 ème
PARIS,PARIS,0750444A,144,139,0,5,72,72,5 ème
PARIS,PARIS,0750610F,109,109,0,0,53,56,5 ème
PARIS,PARIS,0750783U,0,0,0,0,0,0,5 ème
PARIS,PARIS,0752538B,114,114,0,0,57,57,5 ème
PARIS,PARIS,0752540D,113,113,0,0,55,58,5 ème
PARIS,PARIS,0752896R,85,85,0,0,43,42,5 ème
PARIS,PARIS,0752957G,114,112,0,2,64,50,5 ème
PARIS,PARIS,0753937X,103,97,0,6,52,51,5 ème
PARIS,PARIS,0750611G,140,136,0,4,69,71,5 ème
PARIS,PARIS,0751705W,134,131,0,3,71,63,5 ème
PARIS,PARIS,0753908R,145,145,0,0,63,82,5 ème
PARIS,PARIS,0754253R,81,81,0,0,45,36,5 ème
PARIS,PARIS,0752843H,176,176,0,0,98,78,5 ème
PARIS,PARIS,0754305X,160,154,0,6,67,93,5 ème
PARIS,PARIS,0752548M,373,366,0,7,179,194,5 ème
PARIS,PARIS,0752549N,208,203,0,5,92,116,5 ème
PARIS,PARIS,0753996L,84,84,0,0,46,38,5 ème
PARIS,PARIS,0752107H,194,194,0,0,90,104,5 ème
PARIS,PARIS,0752387M,119,119,0,0,63,56,5 ème
PARIS,PARIS,0752552S,145,141,0,4,67,78,5 ème
PARIS,PARIS,0752821J,158,158,0,0,90,68,5 ème
PARIS,PARIS,0752898T,128,128,0,0,72,56,5 ème
PARIS,PARIS,0752958H,116,112,0,4,67,49,5 ème
PARIS,PARIS,0750182R,106,101,0,5,51,55,5 ème
PARIS,PARIS,0750800M,0,0,0,0,0,0,5 ème
PARIS,PARIS,0751793S,112,107,0,5,51,61,5 ème
PARIS,PARIS,0752108J,114,111,0,3,56,58,5 ème
PARIS,PARIS,0754706H,85,83,0,2,44,41,5 ème
PARIS,PARIS,0750360J,104,101,0,3,55,49,5 ème
PARIS,PARIS,0752555V,80,79,0,1,36,44,5 ème
PARIS,PARIS,0752606A,96,89,0,7,54,42,5 ème
PARIS,PARIS,0752556W,111,109,0,2,55,56,5 ème
PARIS,PARIS,0754006X,95,93,0,2,41,54,5 ème
PARIS,PARIS,0755241P,91,89,0,2,50,41,5 ème
PARIS,PARIS,0752248L,79,79,0,0,31,48,5 ème
PARIS,PARIS,0750387N,90,90,0,0,41,49,5 ème
PARIS,PARIS,0750651A,0,0,0,0,0,0,5 ème
PARIS,PARIS,0752902X,256,250,0,6,132,124,5 ème
PARIS,PARIS,0752526N,145,145,0,0,71,74,5 ème
PARIS,PARIS,0752900V,319,307,9,3,122,197,5 ème
PARIS,PARIS,0752924W,67,67,0,0,25,42,5 ème
PARIS,PARIS,0752249M,177,174,0,3,73,104,5 ème
PARIS,PARIS,0752530T,170,168,0,2,91,79,5 ème
ESSONNE,ATHIS-MONS,0911745C,306,296,5,5,160,146,5 ème
ESSONNE,BRUNOY,0910714G,106,106,0,0,51,55,5 ème
ESSONNE,CERNY,0910630R,0,0,0,0,0,0,5 ème
ESSONNE,CHAMPCUEIL,0912233H,150,150,0,0,81,69,5 ème
ESSONNE,CORBEIL-ESSONNES,0911443Z,172,154,15,3,90,82,5 ème
ESSONNE,ETAMPES,0911747E,123,123,0,0,56,67,5 ème
ESSONNE,EVRY-COURCOURONNES,0911254U,0,0,0,0,0,0,5 ème
ESSONNE,EVRY-COURCOURONNES,0912173T,114,112,0,2,54,60,5 ème
ESSONNE,LA NORVILLE,0911255V,192,172,16,4,89,103,5 ème
ESSONNE,LES ULIS,0911127F,143,132,11,0,68,75,5 ème
ESSONNE,LISSES,0911754M,110,106,0,4,45,65,5 ème
ESSONNE,MENNECY,0911185U,273,255,16,2,126,147,5 ème
ESSONNE,MONTGERON,0911353B,23,23,0,0,13,10,5 ème
ESSONNE,NOZAY,0912174U,137,134,0,3,63,74,5 ème
ESSONNE,OLLAINVILLE,0912175V,145,139,0,6,67,78,5 ème
ESSONNE,PALAISEAU,0910046F,111,107,0,4,58,53,5 ème
ESSONNE,PALAISEAU,0910820X,142,142,0,0,69,73,5 ème
ESSONNE,SAINTE-GENEVIEVE-DES-BOIS,0910678T,138,138,0,0,61,77,5 ème
ESSONNE,SAINT-MICHEL-SUR-ORGE,0911257X,212,192,16,4,97,115,5 ème
ESSONNE,SAINT-MICHEL-SUR-ORGE,0911946W,0,0,0,0,0,0,5 ème
ESSONNE,SAVIGNY-SUR-ORGE,0911038J,124,124,0,0,51,73,5 ème
ESSONNE,VILLEBON-SUR-YVETTE,0911335G,145,133,10,2,66,79,5 ème
ESSONNE,VILLEMOISSON-SUR-ORGE,0911145A,149,147,0,2,78,71,5 ème
ESSONNE,VIRY-CHATILLON,0910971L,164,146,16,2,86,78,5 ème
ESSONNE,VIRY-CHATILLON,0911752K,218,218,0,0,109,109,5 ème
ESSONNE,YERRES,0910062Y,199,199,0,0,100,99,5 ème
ESSONNE,YERRES,0912000E,40,37,0,3,39,1,5 ème
HAUTS-DE-SEINE,ANTONY,0921507N,151,151,0,0,68,83,5 ème
HAUTS-DE-SEINE,ASNIERES-SUR-SEINE,0921545E,159,145,12,2,83,76,5 ème
HAUTS-DE-SEINE,ASNIERES-SUR-SEINE,0921902T,196,196,0,0,96,100,5 ème
HAUTS-DE-SEINE,BAGNEUX,0920680P,0,0,0,0,0,0,5 ème
HAUTS-DE-SEINE,BOIS-COLOMBES,0921779J,170,166,0,4,87,83,5 ème
HAUTS-DE-SEINE,BOULOGNE-BILLANCOURT,0921237V,106,101,0,5,48,58,5 ème
HAUTS-DE-SEINE,CHATENAY-MALABRY,0921906X,209,209,0,0,123,86,5 ème
HAUTS-DE-SEINE,CLAMART,0920998K,91,91,0,0,40,51,5 ème
HAUTS-DE-SEINE,CLICHY,0921623P,157,155,0,2,78,79,5 ème
HAUTS-DE-SEINE,COLOMBES,0921229L,0,0,0,0,0,0,5 ème
HAUTS-DE-SEINE,COURBEVOIE,0921550K,136,132,0,4,59,77,5 ème
HAUTS-DE-SEINE,COURBEVOIE,0922020W,118,114,0,4,57,61,5 ème
HAUTS-DE-SEINE,COURBEVOIE,0922867S,14,14,0,0,6,8,5 ème
HAUTS-DE-SEINE,FONTENAY-AUX-ROSES,0920081N,202,201,0,1,99,103,5 ème
HAUTS-DE-SEINE,ISSY-LES-MOULINEAUX,0921003R,42,42,0,0,10,32,5 ème
HAUTS-DE-SEINE,ISSY-LES-MOULINEAUX,0922247T,176,176,0,0,84,92,5 ème
HAUTS-DE-SEINE,ISSY-LES-MOULINEAUX,0922653J,0,0,0,0,0,0,5 ème
HAUTS-DE-SEINE,LE PLESSIS-ROBINSON,0920883K,103,103,0,0,53,50,5 ème
HAUTS-DE-SEINE,MALAKOFF,0921241Z,154,147,0,7,84,70,5 ème
HAUTS-DE-SEINE,MEUDON,0921782M,175,169,0,6,88,87,5 ème
HAUTS-DE-SEINE,MONTROUGE,0921911C,100,100,0,0,53,47,5 ème
HAUTS-DE-SEINE,NANTERRE,0920594W,111,109,0,2,56,55,5 ème
HAUTS-DE-SEINE,NANTERRE,0921940J,97,93,0,4,55,42,5 ème
HAUTS-DE-SEINE,NANTERRE,0922464D,0,0,0,0,0,0,5 ème
HAUTS-DE-SEINE,NEUILLY-SUR-SEINE,0921498D,113,110,0,3,49,64,5 ème
HAUTS-DE-SEINE,PUTEAUX,0921233R,198,198,0,0,104,94,5 ème
HAUTS-DE-SEINE,RUEIL-MALMAISON,0920852B,66,60,0,6,23,43,5 ème
HAUTS-DE-SEINE,RUEIL-MALMAISON,0921235T,170,170,0,0,89,81,5 ème
HAUTS-DE-SEINE,SCEAUX,0921784P,153,147,0,6,76,77,5 ème
HAUTS-DE-SEINE,VILLE-D'AVRAY,0920886N,142,136,0,6,63,79,5 ème
HAUTS-DE-SEINE,VILLENEUVE-LA-GARENNE,0921543C,162,155,5,2,64,98,5 ème
VAL-D'OISE,ARGENTEUIL,0950789S,128,128,0,0,73,55,5 ème
VAL-D'OISE,CERGY,0951401G,151,130,16,5,63,88,5 ème
VAL-D'OISE,DOMONT,0950014Z,188,183,0,5,88,100,5 ème
VAL-D'OISE,ENGHIEN-LES-BAINS,0950930V,95,93,0,2,37,58,5 ème
VAL-D'OISE,FRANCONVILLE,0950793W,123,123,0,0,63,60,5 ème
VAL-D'OISE,GARGES-LES-GONESSE,0952036X,128,125,0,3,69,59,5 ème
VAL-D'OISE,JOUY-LE-MOUTIER,0951527U,167,155,9,3,75,92,5 ème
VAL-D'OISE,LE PLESSIS-BOUCHARD,0951232Y,117,117,0,0,51,66,5 ème
VAL-D'OISE,L'ISLE-ADAM,0950758H,88,88,0,0,45,43,5 ème
VAL-D'OISE,LOUVRES,0951354F,148,144,0,4,67,81,5 ème
VAL-D'OISE,MAGNY-EN-VEXIN,0950823D,49,49,0,0,26,23,5 ème
VAL-D'OISE,MARINES,0950936B,198,186,12,0,91,107,5 ème
VAL-D'OISE,PARMAIN,0951279Z,145,145,0,0,64,81,5 ème
VAL-D'OISE,PIERRELAYE,0951726K,116,114,0,2,61,55,5 ème
VAL-D'OISE,PONTOISE,0950895G,148,145,0,3,78,70,5 ème
VAL-D'OISE,PONTOISE,0951506W,191,188,0,3,106,85,5 ème
VAL-D'OISE,SAINT-GRATIEN,0950037Z,109,109,0,0,60,49,5 ème
VAL-D'OISE,SAINT-OUEN-L'AUMONE,0950658Z,0,0,0,0,0,0,5 ème
VAL-D'OISE,SAINT-PRIX,0951992Z,136,136,0,0,63,73,5 ème
VAL-D'OISE,SARCELLES,0951939S,30,30,0,0,0,30,5 ème
VAL-D'OISE,VILLIERS-LE-BEL,0950796Z,187,184,0,3,109,78,5 ème
VAL-D'OISE,VILLIERS-LE-BEL,0951090U,0,0,0,0,0,0,5 ème
VAL-D'OISE,VILLIERS-LE-BEL,0951993A,160,155,0,5,85,75,5 ème
YVELINES,BONNIERES-SUR-SEINE,0780707V,175,173,0,2,96,79,5 ème
YVELINES,BREVAL,0781862A,145,145,0,0,63,82,5 ème
YVELINES,CHATOU,0781601S,26,26,0,0,11,15,5 ème
YVELINES,CHEVREUSE,0780418F,173,171,0,2,93,80,5 ème
YVELINES,CONFLANS-SAINTE-HONORINE,0780183A,209,190,17,2,93,116,5 ème
YVELINES,ELANCOURT,0780856G,148,147,0,1,77,71,5 ème
YVELINES,GAILLON-SUR-MONTCIENT,0783464S,121,121,0,0,56,65,5 ème
YVELINES,GARGENVILLE,0780758A,145,143,0,2,61,84,5 ème
YVELINES,HOUDAN,0780254C,197,192,0,5,95,102,5 ème
YVELINES,HOUILLES,0783287Z,158,158,0,0,74,84,5 ème
YVELINES,LE CHESNAY-ROCQUENCOURT,0782602E,0,0,0,0,0,0,5 ème
YVELINES,LE CHESNAY-ROCQUENCOURT,0783252L,225,225,0,0,101,124,5 ème
YVELINES,LIMAY,0780255D,164,164,0,0,80,84,5 ème
YVELINES,MAGNANVILLE,0781098V,184,167,13,4,87,97,5 ème
YVELINES,MAISONS-LAFFITTE,0781587B,96,96,0,0,49,47,5 ème
YVELINES,MANTES-LA-JOLIE,0780708W,152,152,0,0,74,78,5 ème
YVELINES,MANTES-LA-JOLIE,0781590E,190,190,0,0,97,93,5 ème
YVELINES,MANTES-LA-JOLIE,0781955B,121,118,0,3,47,74,5 ème
YVELINES,MANTES-LA-JOLIE,0781977A,79,76,0,3,35,44,5 ème
YVELINES,MANTES-LA-VILLE,0780569V,171,154,13,4,82,89,5 ème
YVELINES,MEULAN-EN-YVELINES,0783340G,155,155,0,0,82,73,5 ème
YVELINES,MONTFORT-L'AMAURY,0780262L,211,197,13,1,99,112,5 ème
YVELINES,MONTIGNY-LE-BRETONNEUX,0781954A,109,105,0,4,57,52,5 ème
YVELINES,PLAISIR,0780420H,155,140,15,0,72,83,5 ème
YVELINES,POISSY,0781101Y,127,127,0,0,59,68,5 ème
YVELINES,SAINT-GERMAIN-EN-LAYE,0783816Z,0,0,0,0,0,0,5 ème
YVELINES,VERNEUIL-SUR-SEINE,0780267S,186,167,16,3,75,111,5 ème
YVELINES,VERSAILLES,0783325R,0,0,0,0,0,0,5 ème
LA REUNION,CILAOS,9740096L,84,82,0,2,34,50,5 ème
LA REUNION,LA PLAINE-DES-PALMISTES,9740037X,122,118,0,4,59,63,5 ème
LA REUNION,LE PORT,9740548C,136,136,0,0,82,54,5 ème
LA REUNION,LE PORT,9740812P,168,136,29,3,85,83,5 ème
LA REUNION,LE PORT,9741045T,120,117,0,3,63,57,5 ème
LA REUNION,LES AVIRONS,9740005M,150,150,0,0,66,84,5 ème
LA REUNION,LE TAMPON,9740070H,251,248,0,3,124,127,5 ème
LA REUNION,LE TAMPON,9741581A,171,168,0,3,70,101,5 ème
LA REUNION,SAINT-ANDRE,9740076P,148,148,0,0,88,60,5 ème
LA REUNION,SAINT-BENOIT,9740083X,118,114,0,4,55,63,5 ème
LA REUNION,SAINT-BENOIT,9740702V,186,151,31,4,81,105,5 ème
LA REUNION,SAINT-DENIS,9740080U,160,156,0,4,86,74,5 ème
LA REUNION,SAINT-DENIS,9741044S,148,146,0,2,86,62,5 ème
LA REUNION,SAINT-DENIS,9741188Y,201,201,0,0,125,76,5 ème
LA REUNION,SAINT-DENIS,9741260B,133,130,0,3,64,69,5 ème
LA REUNION,SAINT-LEU,9740018B,127,119,0,8,58,69,5 ème
LA REUNION,SAINT-LOUIS,9741189Z,141,138,0,3,65,76,5 ème
LA REUNION,SAINT-PAUL,9740035V,198,161,32,5,87,111,5 ème
LA REUNION,SAINT-PAUL,9740039Z,192,189,0,3,103,89,5 ème
LA REUNION,SAINT-PAUL,9740784J,187,184,0,3,89,98,5 ème
LA REUNION,SAINT-PAUL,9740932V,153,131,16,6,72,81,5 ème
LA REUNION,SAINT-PIERRE,9740574F,157,129,22,6,79,78,5 ème
LA REUNION,SAINT-PIERRE,9740576H,111,109,0,2,45,66,5 ème
LA REUNION,SAINT-PIERRE,9740811N,152,132,16,4,76,76,5 ème
LA REUNION,SAINT-PIERRE,9741235Z,147,143,0,4,65,82,5 ème
MARTINIQUE,FORT-DE-FRANCE,9720010D,111,92,11,8,54,57,5 ème
MARTINIQUE,FORT-DE-FRANCE,9720064M,197,197,0,0,70,127,5 ème
MARTINIQUE,FORT-DE-FRANCE,9720349X,115,115,0,0,47,68,5 ème
MARTINIQUE,FORT-DE-FRANCE,9720412R,114,86,28,0,56,58,5 ème
MARTINIQUE,FORT-DE-FRANCE,9720855X,16,16,0,0,6,10,5 ème
MARTINIQUE,LE FRANCOIS,9720495F,86,86,0,0,44,42,5 ème
MARTINIQUE,LE MARIN,9720447D,87,79,8,0,35,52,5 ème
MARTINIQUE,LE MORNE-ROUGE,9720066P,33,33,0,0,17,16,5 ème
MARTINIQUE,LE ROBERT,9720019N,72,72,0,0,37,35,5 ème
MARTINIQUE,SAINTE-ANNE,9720514B,46,46,0,0,15,31,5 ème
MARTINIQUE,SAINTE-MARIE,9720513A,77,51,20,6,34,43,5 ème
MAYOTTE,BANDRELE,9760179R,244,241,0,3,140,104,5 ème
MAYOTTE,CHIRONGUI,9760042S,225,225,0,0,113,112,5 ème
MAYOTTE,MAMOUDZOU,9760162X,300,297,0,3,166,134,5 ème
ALLIER,DOMPIERRE-SUR-BESBRE,0030013Y,101,98,0,3,53,48,5 ème
ALLIER,HURIEL,0030018D,79,79,0,0,37,42,5 ème
ALLIER,JALIGNY-SUR-BESBRE,0030019E,37,35,0,2,16,21,5 ème
ALLIER,LAPALISSE,0030092J,105,101,0,4,49,56,5 ème
ALLIER,LE MAYET-DE-MONTAGNE,0030023J,50,50,0,0,26,24,5 ème
ALLIER,MARCILLAT-EN-COMBRAILLE,0030022H,28,28,0,0,12,16,5 ème
ALLIER,MONTLUCON,0030758H,121,109,0,12,52,69,5 ème
ALLIER,MOULINS,0030838V,120,93,25,2,50,70,5 ème
ALLIER,SAINT-YORRE,0031010G,81,77,0,4,46,35,5 ème
ALLIER,VARENNES-SUR-ALLIER,0030924N,0,0,0,0,0,0,5 ème
ALLIER,VICHY,0030050N,133,116,14,3,61,72,5 ème
ALLIER,VICHY,0030070K,96,96,0,0,48,48,5 ème
CANTAL,AURILLAC,0150647X,137,136,0,1,69,68,5 ème
CANTAL,MASSIAC,0150014J,30,30,0,0,12,18,5 ème
CANTAL,MAURIAC,0150016L,69,56,7,6,36,33,5 ème
CANTAL,SAINT-FLOUR,0150029A,87,69,13,5,37,50,5 ème
HAUTE-LOIRE,BRIOUDE,0430109K,4,0,4,0,2,2,5 ème
HAUTE-LOIRE,BRIVES-CHARENSAC,0430101B,0,0,0,0,0,0,5 ème
HAUTE-LOIRE,CRAPONNE-SUR-ARZON,0430010C,26,26,0,0,9,17,5 ème
HAUTE-LOIRE,CRAPONNE-SUR-ARZON,0430068R,33,33,0,0,17,16,5 ème
HAUTE-LOIRE,LA CHAISE-DIEU,0430006Y,26,21,0,5,10,16,5 ème
HAUTE-LOIRE,LE CHAMBON-SUR-LIGNON,0430820H,31,26,5,0,15,16,5 ème
HAUTE-LOIRE,LE MONASTIER-SUR-GAZEILLE,0430017K,65,65,0,0,32,33,5 ème
HAUTE-LOIRE,LE MONASTIER-SUR-GAZEILLE,0430074X,38,38,0,0,20,18,5 ème
HAUTE-LOIRE,LE PUY-EN-VELAY,0430025U,82,81,0,1,48,34,5 ème
HAUTE-LOIRE,LE PUY-EN-VELAY,0430098Y,0,0,0,0,0,0,5 ème
HAUTE-LOIRE,MONISTROL-SUR-LOIRE,0430103D,0,0,0,0,0,0,5 ème
HAUTE-LOIRE,SAINT-DIDIER-EN-VELAY,0430027W,145,145,0,0,68,77,5 ème
HAUTE-LOIRE,SAINTE-SIGOLENE,0430090P,67,64,0,3,35,32,5 ème
HAUTE-LOIRE,YSSINGEAUX,0430135N,121,98,16,7,58,63,5 ème
PUY-DE-DOME,AMBERT,0630001J,0,0,0,0,0,0,5 ème
PUY-DE-DOME,ARLANC,0630006P,27,27,0,0,12,15,5 ème
PUY-DE-DOME,CLERMONT-FERRAND,0631050Z,0,0,0,0,0,0,5 ème
PUY-DE-DOME,CLERMONT-FERRAND,0631410R,172,172,0,0,90,82,5 ème
PUY-DE-DOME,CLERMONT-FERRAND,0631736V,0,0,0,0,0,0,5 ème
PUY-DE-DOME,COURNON-D'AUVERGNE,0630028N,192,184,0,8,88,104,5 ème
PUY-DE-DOME,ISSOIRE,0631604B,180,152,24,4,84,96,5 ème
PUY-DE-DOME,LES MARTRES-DE-VEYRE,0631479R,202,198,0,4,97,105,5 ème
PUY-DE-DOME,MARINGUES,0630039A,128,128,0,0,61,67,5 ème
PUY-DE-DOME,PONTAUMUR,0630047J,37,37,0,0,12,25,5 ème
PUY-DE-DOME,PONTGIBAUD,0630049L,86,86,0,0,41,45,5 ème
PUY-DE-DOME,RIOM,0631121B,135,135,0,0,69,66,5 ème
PUY-DE-DOME,SAINT-ANTHEME,0630058W,17,17,0,0,7,10,5 ème
PUY-DE-DOME,SAINT-DIER-D'AUVERGNE,0630059X,38,38,0,0,26,12,5 ème
PUY-DE-DOME,THIERS,0631238D,158,136,17,5,83,75,5 ème
PUY-DE-DOME,VOLVIC,0630074N,126,122,0,4,60,66,5 ème
PUY-DE-DOME,VOLVIC,0631115V,33,33,0,0,14,19,5 ème
ARDECHE,AUBENAS,0070062E,174,174,0,0,96,78,5 ème
ARDECHE,AUBENAS,0070115M,0,0,0,0,0,0,5 ème
ARDECHE,AUBENAS,0071169H,158,129,24,5,75,83,5 ème
ARDECHE,LES VANS,0070037C,91,91,0,0,49,42,5 ème
ARDECHE,LE TEIL,0070112J,0,0,0,0,0,0,5 ème
ARDECHE,RUOMS,0070863A,62,62,0,0,37,25,5 ème
ARDECHE,VALLON-PONT-D'ARC,0070035A,96,96,0,0,45,51,5 ème
ARDECHE,VILLENEUVE-DE-BERG,0070040F,105,105,0,0,48,57,5 ème
DROME,BEAUMONT-LES-VALENCE,0261528V,148,145,0,3,83,65,5 ème
DROME,CHABEUIL,0260092J,68,68,0,0,29,39,5 ème
DROME,CREST,0260072M,0,0,0,0,0,0,5 ème
DROME,MONTELIMAR,0261034H,19,0,16,3,9,10,5 ème
DROME,PIERRELATTE,0260019E,0,0,0,0,0,0,5 ème
DROME,ROMANS-SUR-ISERE,0260044G,0,0,0,0,0,0,5 ème
DROME,ROMANS-SUR-ISERE,0260078U,0,0,0,0,0,0,5 ème
DROME,SAINT-RAMBERT-D'ALBON,0260029R,118,118,0,0,56,62,5 ème
DROME,VALENCE,0260116K,0,0,0,0,0,0,5 ème
DROME,VALENCE,0261094Y,98,94,0,4,45,53,5 ème
DROME,VALENCE,0261136U,228,226,0,2,114,114,5 ème
HAUTE SAVOIE,ABONDANCE,0741442R,18,18,0,0,6,12,5 ème
HAUTE SAVOIE,ANNECY,0740124H,225,209,16,0,125,100,5 ème
HAUTE SAVOIE,ANNECY,0740929H,177,172,0,5,87,90,5 ème
HAUTE SAVOIE,ANNECY,0741117M,198,181,13,4,99,99,5 ème
HAUTE SAVOIE,BELLEVAUX,0740109S,84,84,0,0,42,42,5 ème
HAUTE SAVOIE,BOEGE,0740048A,135,135,0,0,59,76,5 ème
HAUTE SAVOIE,CHAMONIX-MONT-BLANC,0741116L,117,117,0,0,60,57,5 ème
HAUTE SAVOIE,CRUSEILLES,0740018T,198,198,0,0,96,102,5 ème
HAUTE SAVOIE,DOUVAINE,0740116Z,94,94,0,0,46,48,5 ème
HAUTE SAVOIE,PASSY,0740263J,194,175,16,3,105,89,5 ème
HAUTE SAVOIE,RUMILLY,0741469V,0,0,0,0,0,0,5 ème
HAUTE SAVOIE,SAINT-JORIOZ,0740036M,116,113,0,3,57,59,5 ème
HAUTE SAVOIE,SILLINGY,0741488R,176,172,0,4,71,105,5 ème
HAUTE SAVOIE,THONES,0741283T,144,144,0,0,76,68,5 ème
HAUTE SAVOIE,THONON-LES-BAINS,0740156T,0,0,0,0,0,0,5 ème
HAUTE SAVOIE,THONON-LES-BAINS,0741163M,159,157,0,2,84,75,5 ème
ISERE,BOURGOIN-JALLIEU,0380111P,222,222,0,0,93,129,5 ème
ISERE,CHAMPIER,0383542U,199,199,0,0,105,94,5 ème
ISERE,CHIRENS,0383454Y,153,153,0,0,86,67,5 ème
ISERE,DOMENE,0382268J,184,165,16,3,82,102,5 ème
ISERE,ECHIROLLES,0380021S,164,159,0,5,86,78,5 ème
ISERE,ENTRE-DEUX-GUIERS,0381692H,79,76,0,3,30,49,5 ème
ISERE,GRENOBLE,0381604M,88,88,0,0,27,61,5 ème
ISERE,GRENOBLE,0381664C,247,245,0,2,125,122,5 ème
ISERE,GRENOBLE,0382032C,99,96,0,3,48,51,5 ème
ISERE,GRENOBLE,0382581Z,187,183,0,4,89,98,5 ème
ISERE,LE PONT-DE-BEAUVOISIN,0380053B,0,0,0,0,0,0,5 ème
ISERE,MONESTIER-DE-CLERMONT,0380044S,87,87,0,0,37,50,5 ème
ISERE,MORESTEL,0380046U,161,156,0,5,77,84,5 ème
ISERE,PONT-DE-CHERUY,0382110M,211,192,15,4,99,112,5 ème
ISERE,PONT-EN-ROYANS,0380055D,74,74,0,0,39,35,5 ème
ISERE,RIVES,0382266G,194,174,15,5,96,98,5 ème
ISERE,ROUSSILLON,0380050Y,146,146,0,0,64,82,5 ème
ISERE,SAINT-JEAN-DE-BOURNAY,0382265F,170,167,0,3,84,86,5 ème
ISERE,SAINT-LAURENT-DU-PONT,0380062L,74,74,0,0,38,36,5 ème
ISERE,SAINT-MARCELLIN,0382428H,163,145,16,2,71,92,5 ème
ISERE,SAINT-MAURICE-L'EXIL,0382043P,149,132,13,4,78,71,5 ème
ISERE,SASSENAGE,0382099A,0,0,0,0,0,0,5 ème
ISERE,SEYSSINS,0382431L,134,130,0,4,60,74,5 ème
ISERE,VIENNE,0381678T,0,0,0,0,0,0,5 ème
ISERE,VIENNE,0382195E,207,207,0,0,95,112,5 ème
ISERE,VIF,0382039K,152,149,0,3,67,85,5 ème
ISERE,VILLARD-BONNOT,0381778B,206,206,0,0,103,103,5 ème
ISERE,VIZILLE,0380089R,0,0,0,0,0,0,5 ème
SAVOIE,ALBERTVILLE,0730006K,0,0,0,0,0,0,5 ème
SAVOIE,ALBERTVILLE,0731069R,91,87,0,4,38,53,5 ème
SAVOIE,BARBY,0731306Y,133,130,0,3,66,67,5 ème
SAVOIE,COGNIN,0731113N,123,123,0,0,63,60,5 ème
SAVOIE,FRONTENEX,0730023D,113,108,0,5,62,51,5 ème
SAVOIE,GRESY-SUR-AIX,0731521G,148,147,0,1,68,80,5 ème
SAVOIE,LA MOTTE-SERVOLEX,0730774V,0,0,0,0,0,0,5 ème
SAVOIE,LE CHATELARD,0730020A,76,70,0,6,35,41,5 ème
SAVOIE,MOUTIERS,0730008M,192,175,14,3,104,88,5 ème
SAVOIE,SAINT-ETIENNE-DE-CUINES,0730017X,77,77,0,0,41,36,5 ème
SAVOIE,SAINT-GENIX-LES-VILLAGES,0730036T,177,172,0,5,93,84,5 ème
SAVOIE,SAINT-PAUL-SUR-ISERE,0730769P,44,44,0,0,17,27,5 ème
SAVOIE,UGINE,0730043A,0,0,0,0,0,0,5 ème
AIN,AMBERIEU-EN-BUGEY,0010001W,0,0,0,0,0,0,5 ème
AIN,ARBENT,0010987T,179,176,0,3,94,85,5 ème
AIN,COLIGNY,0011071J,109,109,0,0,55,54,5 ème
AIN,CULOZ,0010022U,118,115,0,3,57,61,5 ème
AIN,FERNEY-VOLTAIRE,0010896U,246,245,0,1,133,113,5 ème
AIN,JASSANS-RIOTTIER,0011193S,131,113,16,2,59,72,5 ème
AIN,MIRIBEL,0011151W,84,84,0,0,37,47,5 ème
AIN,NANTUA,0011068F,100,95,0,5,46,54,5 ème
AIN,PONT-DE-VAUX,0011070H,107,103,0,4,57,50,5 ème
AIN,SAINT-DENIS-LES-BOURG,0011333U,166,162,0,4,91,75,5 ème
AIN,SAINT-RAMBERT-EN-BUGEY,0010039M,68,65,0,3,32,36,5 ème
LOIRE,BALBIGNY,0421455D,126,120,0,6,61,65,5 ème
LOIRE,CHAZELLES-SUR-LYON,0421658Z,86,86,0,0,43,43,5 ème
LOIRE,MONTBRISON,0421002L,0,0,0,0,0,0,5 ème
LOIRE,PANISSIERES,0420023X,92,92,0,0,50,42,5 ème
LOIRE,RIORGES,0421457F,142,136,0,6,80,62,5 ème
LOIRE,SAINT-BONNET-LE-CHATEAU,0421082Y,45,45,0,0,23,22,5 ème
LOIRE,SAINT-CHAMOND,0420968Z,147,130,16,1,72,75,5 ème
LOIRE,SAINT-ETIENNE,0420984S,0,0,0,0,0,0,5 ème
LOIRE,SAINT-ETIENNE,0421041D,115,115,0,0,56,59,5 ème
LOIRE,SAINT-ETIENNE,0421451Z,90,72,16,2,40,50,5 ème
LOIRE,SAINT-ETIENNE,0421801E,177,177,0,0,92,85,5 ème
LOIRE,SAINT-ETIENNE,0421803G,65,64,0,1,28,37,5 ème
LOIRE,SAINT-ETIENNE,0422158T,0,0,0,0,0,0,5 ème
LOIRE,SAINT-GALMIER,0421058X,164,161,0,3,78,86,5 ème
LOIRE,SAINT-GALMIER,0421607U,175,158,14,3,84,91,5 ème
LOIRE,SAINT-GENEST-LERPT,0422160V,0,0,0,0,0,0,5 ème
LOIRE,SAINT-JUST-SAINT-RAMBERT,0421063C,83,83,0,0,38,45,5 ème
LOIRE,SAINT-JUST-SAINT-RAMBERT,0421734G,213,209,0,4,109,104,5 ème
RHONE,ANSE,0690002C,213,212,0,1,99,114,5 ème
RHONE,BEAUJEU,0690005F,74,69,0,5,25,49,5 ème
RHONE,BELLEVILLE-EN-BEAUJOLAIS,0690007H,222,198,17,7,110,112,5 ème
RHONE,CALUIRE-ET-CUIRE,0692165D,12,12,0,0,2,10,5 ème
RHONE,CALUIRE-ET-CUIRE,0692410V,137,135,0,2,53,84,5 ème
RHONE,CHAMPAGNE-AU-MONT-D'OR,0692414Z,157,146,11,0,71,86,5 ème
RHONE,COMMUNAY,0693092L,149,148,0,1,72,77,5 ème
RHONE,ECULLY,0691481K,103,99,0,4,53,50,5 ème
RHONE,ECULLY,0693095P,0,0,0,0,0,0,5 ème
RHONE,GENAS,0693331W,245,245,0,0,112,133,5 ème
RHONE,GIVORS,0690018V,0,0,0,0,0,0,5 ème
RHONE,GIVORS,0691483M,117,117,0,0,59,58,5 ème
RHONE,L'ARBRESLE,0690003D,0,0,0,0,0,0,5 ème
RHONE,LYON,0690043X,0,0,0,0,0,0,5 ème
RHONE,LYON,0690660T,0,0,0,0,0,0,5 ème
RHONE,LYON,0693370N,0,0,0,0,0,0,5 ème
RHONE,LYON,0692693C,118,116,0,2,58,60,5 ème
RHONE,LYON,0692695E,104,101,0,3,46,58,5 ème
RHONE,LYON,0690125L,0,0,0,0,0,0,5 ème
RHONE,LYON,0690601D,46,46,0,0,18,28,5 ème
RHONE,LYON,0691662G,176,176,0,0,87,89,5 ème
RHONE,LYON,0691670R,102,81,16,5,45,57,5 ème
RHONE,LYON,0692696F,205,205,0,0,110,95,5 ème
RHONE,LYON,0692931L,119,119,0,0,47,72,5 ème
RHONE,LYON,0690604G,91,88,0,3,42,49,5 ème
RHONE,LYON,0692938U,53,53,0,0,30,23,5 ème
RHONE,LYON,0690045Z,0,0,0,0,0,0,5 ème
RHONE,MEYZIEU,0691668N,134,128,0,6,59,75,5 ème
RHONE,MEYZIEU,0692335N,178,167,10,1,91,87,5 ème
RHONE,NEUVILLE-SUR-SAONE,0692423J,241,234,6,1,117,124,5 ème
RHONE,OULLINS,0690075G,125,109,15,1,54,71,5 ème
RHONE,OULLINS,0690129R,0,0,0,0,0,0,5 ème
RHONE,RILLIEUX-LA-PAPE,0691680B,0,0,0,0,0,0,5 ème
RHONE,RILLIEUX-LA-PAPE,0692517L,0,0,0,0,0,0,5 ème
RHONE,SAINT-PIERRE-DE-CHANDIEU,0694227V,164,161,0,3,79,85,5 ème
RHONE,SAINT-PRIEST,0691497C,164,162,0,2,80,84,5 ème
RHONE,THIZY-LES-BOURGS,0692164C,46,43,0,3,24,22,5 ème
RHONE,THIZY-LES-BOURGS,0693566B,0,0,0,0,0,0,5 ème
RHONE,VAULX-EN-VELIN,0690249W,151,145,0,6,80,71,5 ème
RHONE,VAULX-EN-VELIN,0690652J,0,0,0,0,0,0,5 ème
RHONE,VENISSIEUX,0692717D,0,0,0,0,0,0,5 ème
RHONE,VILLEFRANCHE-SUR-SAONE,0691644M,0,0,0,0,0,0,5 ème
RHONE,VILLEFRANCHE-SUR-SAONE,0692699J,181,181,0,0,100,81,5 ème
RHONE,VILLEURBANNE,0691478G,149,147,0,2,76,73,5 ème
RHONE,VILLEURBANNE,0691664J,159,141,16,2,76,83,5 ème
RHONE,VILLEURBANNE,0691675W,183,164,16,3,88,95,5 ème
DOUBS,AUDINCOURT,0250003T,157,141,16,0,66,91,5 ème
DOUBS,BART,0251556F,116,115,0,1,54,62,5 ème
DOUBS,BESANCON,0251116C,131,126,0,5,64,67,5 ème
DOUBS,BESANCON,0251348E,141,137,0,4,67,74,5 ème
DOUBS,BESANCON,0251586N,15,13,0,2,7,8,5 ème
DOUBS,BESANCON,0251589S,184,176,8,0,86,98,5 ème
DOUBS,BESANCON,0251592V,0,0,0,0,0,0,5 ème
DOUBS,DOUBS,0251949H,163,147,14,2,75,88,5 ème
DOUBS,LABERGEMENT-SAINTE-MARIE,0251065X,31,31,0,0,15,16,5 ème
DOUBS,LE RUSSEY,0250052W,67,67,0,0,35,32,5 ème
DOUBS,MAICHE,0251373G,127,117,8,2,55,72,5 ème
DOUBS,MANDEURE,0251324D,93,90,0,3,48,45,5 ème
DOUBS,MONTBELIARD,0250067M,0,0,0,0,0,0,5 ème
DOUBS,MONTBELIARD,0251994G,0,0,0,0,0,0,5 ème
DOUBS,PONTARLIER,0251349F,0,0,0,0,0,0,5 ème
DOUBS,PONTARLIER,0251524W,173,169,0,4,82,91,5 ème
DOUBS,PONTARLIER,0251590T,150,150,0,0,75,75,5 ème
DOUBS,PONTARLIER,0251677M,123,121,0,2,73,50,5 ème
DOUBS,ROUGEMONT,0250050U,68,68,0,0,37,31,5 ème
DOUBS,SANCEY,0251061T,31,31,0,0,14,17,5 ème
DOUBS,SAONE,0251376K,196,196,0,0,98,98,5 ème
DOUBS,SOCHAUX,0250056A,211,193,16,2,113,98,5 ème
DOUBS,VALDAHON,0251372F,158,153,0,5,65,93,5 ème
DOUBS,VALENTIGNEY,0251599C,116,113,0,3,53,63,5 ème
HAUTE-SAONE,GRAY,0700010F,51,48,0,3,23,28,5 ème
HAUTE-SAONE,GRAY,0701001H,0,0,0,0,0,0,5 ème
HAUTE-SAONE,GY,0700013J,54,54,0,0,27,27,5 ème
HAUTE-SAONE,LUXEUIL-LES-BAINS,0701078S,0,0,0,0,0,0,5 ème
HAUTE-SAONE,MELISEY,0700925A,89,86,0,3,46,43,5 ème
HAUTE-SAONE,NOIDANS-LES-VESOUL,0701036W,138,134,0,4,60,78,5 ème
HAUTE-SAONE,VESOUL,0701002J,114,114,0,0,50,64,5 ème
HAUTE-SAONE,VILLERSEXEL,0700896U,93,90,0,3,46,47,5 ème
JURA,BLETTERANS,0390004T,95,93,0,2,44,51,5 ème
JURA,CHAMPAGNOLE,0391001B,0,0,0,0,0,0,5 ème
JURA,DOLE,0390015E,0,0,0,0,0,0,5 ème
JURA,LES ROUSSES,0390923S,100,100,0,0,31,69,5 ème
JURA,LONS-LE-SAUNIER,0390906Y,130,126,0,4,62,68,5 ème
JURA,MONT-SOUS-VAUDREY,0390997X,51,51,0,0,27,24,5 ème
JURA,SAINT-AUBIN,0390083D,52,52,0,0,23,29,5 ème
JURA,SALINS-LES-BAINS,0390085F,23,23,0,0,10,13,5 ème
TERRITOIRE DE BELFORT,BELFORT,0900018F,144,136,0,8,76,68,5 ème
TERRITOIRE DE BELFORT,BELFORT,0900235S,66,66,0,0,39,27,5 ème
TERRITOIRE DE BELFORT,BELFORT,0900295G,162,142,16,4,78,84,5 ème
TERRITOIRE DE BELFORT,BELFORT,0900335A,220,220,0,0,116,104,5 ème
TERRITOIRE DE BELFORT,MONTREUX-CHATEAU,0900011Y,85,85,0,0,44,41,5 ème
TERRITOIRE DE BELFORT,MORVILLARS,0900277M,105,99,0,6,52,53,5 ème
COTE D'OR,DIJON,0211227V,76,76,0,0,38,38,5 ème
COTE D'OR,LONGVIC,0210057Y,158,158,0,0,72,86,5 ème
COTE D'OR,SEMUR-EN-AUXOIS,0211088U,55,55,0,0,25,30,5 ème
NIEVRE,CHATEAU-CHINON (VILLE),0580552K,0,0,0,0,0,0,5 ème
NIEVRE,CLAMECY,0580651T,65,65,0,0,35,30,5 ème
NIEVRE,CORBIGNY,0580065F,33,33,0,0,9,24,5 ème
NIEVRE,DECIZE,0580068J,16,16,0,0,7,9,5 ème
NIEVRE,GUERIGNY,0580023K,75,69,0,6,34,41,5 ème
NIEVRE,LA MACHINE,0580028R,36,36,0,0,17,19,5 ème
NIEVRE,NEVERS,0580071M,0,0,0,0,0,0,5 ème
NIEVRE,SAINT-PIERRE-LE-MOUTIER,0580039C,93,93,0,0,53,40,5 ème
SAONE-ET-LOIRE,AUTUN,0710001R,0,0,0,0,0,0,5 ème
SAONE-ET-LOIRE,AUTUN,0711294W,130,110,16,4,62,68,5 ème
SAONE-ET-LOIRE,BUXY,0710007X,95,95,0,0,49,46,5 ème
SAONE-ET-LOIRE,CHALON-SUR-SAONE,0711322B,0,0,0,0,0,0,5 ème
SAONE-ET-LOIRE,CHALON-SUR-SAONE,0711896A,0,0,0,0,0,0,5 ème
SAONE-ET-LOIRE,CHAROLLES,0710155H,115,93,17,5,60,55,5 ème
SAONE-ET-LOIRE,COUCHES,0710025S,87,87,0,0,47,40,5 ème
SAONE-ET-LOIRE,GIVRY,0710125A,29,29,0,0,13,16,5 ème
SAONE-ET-LOIRE,GIVRY,0710154G,115,114,0,1,69,46,5 ème
SAONE-ET-LOIRE,GUEUGNON,0711252A,139,118,17,4,68,71,5 ème
SAONE-ET-LOIRE,LOUHANS,0710042K,0,0,0,0,0,0,5 ème
SAONE-ET-LOIRE,LOUHANS,0711449P,162,144,16,2,81,81,5 ème
SAONE-ET-LOIRE,LUGNY,0710128D,19,19,0,0,7,12,5 ème
SAONE-ET-LOIRE,PARAY-LE-MONIAL,0710061F,112,107,0,5,60,52,5 ème
SAONE-ET-LOIRE,VERDUN-SUR-LE-DOUBS,0710073U,125,125,0,0,53,72,5 ème
YONNE,AUXERRE,0890006Y,164,144,16,4,78,86,5 ème
YONNE,AUXERRE,0890090P,167,166,0,1,81,86,5 ème
YONNE,AVALLON,0890822K,93,76,16,1,48,45,5 ème
YONNE,JOIGNY,0891016W,24,0,24,0,11,13,5 ème
YONNE,MIGENNES,0890017K,86,82,0,4,39,47,5 ème
YONNE,TONNERRE,0890980G,142,112,25,5,73,69,5 ème
YONNE,VILLENEUVE-SUR-YONNE,0890540D,159,154,0,5,81,78,5 ème
COTES D'ARMOR,DINAN,0220081U,148,113,31,4,64,84,5 ème
COTES D'ARMOR,DINAN,0221623V,180,177,0,3,100,80,5 ème
COTES D'ARMOR,LOUDEAC,0220027K,0,0,0,0,0,0,5 ème
COTES D'ARMOR,MERDRIGNAC,0221538C,59,59,0,0,33,26,5 ème
COTES D'ARMOR,PLANCOET,0220038X,144,139,0,5,80,64,5 ème
COTES D'ARMOR,PLENEE-JUGON,0220040Z,97,97,0,0,53,44,5 ème
COTES D'ARMOR,PLENEUF-VAL-ANDRE,0220158C,85,85,0,0,46,39,5 ème
COTES D'ARMOR,PLERIN,0221039K,187,182,0,5,95,92,5 ème
COTES D'ARMOR,PLOUHA,0221512Z,98,98,0,0,51,47,5 ème
COTES D'ARMOR,ROSTRENEN,0221749G,58,56,0,2,23,35,5 ème
COTES D'ARMOR,SAINT-BRIEUC,0220059V,0,0,0,0,0,0,5 ème
COTES D'ARMOR,SAINT-BRIEUC,0220172T,62,57,0,5,34,28,5 ème
COTES D'ARMOR,SAINT-BRIEUC,0221750H,145,145,0,0,67,78,5 ème
COTES D'ARMOR,TREGUIER,0220073K,115,115,0,0,62,53,5 ème
FINISTERE,BANNALEC,0291086Y,80,80,0,0,43,37,5 ème
FINISTERE,BREST,0290100B,117,116,0,1,55,62,5 ème
FINISTERE,BREST,0290108K,0,0,0,0,0,0,5 ème
FINISTERE,BREST,0290149E,86,69,16,1,37,49,5 ème
FINISTERE,BREST,0291594A,98,95,0,3,38,60,5 ème
FINISTERE,BREST,0291868Y,186,186,0,0,85,101,5 ème
FINISTERE,BREST,0292139T,0,0,0,0,0,0,5 ème
FINISTERE,BRIEC,0290244H,69,69,0,0,37,32,5 ème
FINISTERE,CHATEAUNEUF-DU-FAOU,0290252S,19,19,0,0,9,10,5 ème
FINISTERE,LANDERNEAU,0291874E,175,172,0,3,85,90,5 ème
FINISTERE,LANDIVISIAU,0290153J,111,107,0,4,63,48,5 ème
FINISTERE,LANDIVISIAU,0291640A,249,248,0,1,126,123,5 ème
FINISTERE,LANNILIS,0290048V,144,144,0,0,82,62,5 ème
FINISTERE,LESNEVEN,0290049W,174,172,0,2,89,85,5 ème
FINISTERE,LESNEVEN,0291875F,228,214,14,0,122,106,5 ème
FINISTERE,MORLAIX,0291227B,92,90,0,2,51,41,5 ème
FINISTERE,PLABENNEC,0292290G,129,127,0,2,58,71,5 ème
FINISTERE,PLEYBEN,0290053A,68,68,0,0,35,33,5 ème
FINISTERE,PLEYBEN,0290130J,0,0,0,0,0,0,5 ème
FINISTERE,PLOUESCAT,0290056D,49,49,0,0,21,28,5 ème
FINISTERE,PLOUGASNOU,0290057E,31,31,0,0,13,18,5 ème
FINISTERE,PLOZEVET,0290331C,71,71,0,0,39,32,5 ème
FINISTERE,PONT-AVEN,0290060H,61,61,0,0,32,29,5 ème
FINISTERE,PONT-CROIX,0290302W,47,47,0,0,21,26,5 ème
FINISTERE,QUIMPER,0291879K,79,79,0,0,29,50,5 ème
FINISTERE,QUIMPER,0292144Y,0,0,0,0,0,0,5 ème
FINISTERE,ROSPORDEN,0291634U,143,143,0,0,72,71,5 ème
FINISTERE,SAINT-POL-DE-LEON,0290333E,90,75,15,0,41,49,5 ème
FINISTERE,SAINT-POL-DE-LEON,0291883P,160,160,0,0,90,70,5 ème
FINISTERE,SCAER,0290088N,60,60,0,0,35,25,5 ème
FINISTERE,SIZUN,0290089P,70,70,0,0,30,40,5 ème
ILLE-ET-VILAINE,BETTON,0352260S,172,172,0,0,93,79,5 ème
ILLE-ET-VILAINE,CESSON-SEVIGNE,0352972R,18,18,0,0,4,14,5 ème
ILLE-ET-VILAINE,CHARTRES-DE-BRETAGNE,0351852Y,148,148,0,0,69,79,5 ème
ILLE-ET-VILAINE,DOL-DE-BRETAGNE,0350009V,0,0,0,0,0,0,5 ème
ILLE-ET-VILAINE,DOL-DE-BRETAGNE,0350767U,172,167,0,5,92,80,5 ème
ILLE-ET-VILAINE,GUIGNEN,0350864Z,95,95,0,0,53,42,5 ème
ILLE-ET-VILAINE,JANZE,0351053E,161,133,28,0,77,84,5 ème
ILLE-ET-VILAINE,LAILLE,0352959B,136,136,0,0,75,61,5 ème
ILLE-ET-VILAINE,LA MEZIERE,0352760K,152,152,0,0,67,85,5 ème
ILLE-ET-VILAINE,LE RHEU,0351847T,179,176,0,3,86,93,5 ème
ILLE-ET-VILAINE,LIFFRE,0350867C,172,172,0,0,95,77,5 ème
ILLE-ET-VILAINE,ORGERES,0352691K,126,126,0,0,62,64,5 ème
ILLE-ET-VILAINE,REDON,0350775C,193,178,13,2,85,108,5 ème
ILLE-ET-VILAINE,REDON,0350790U,0,0,0,0,0,0,5 ème
ILLE-ET-VILAINE,RENNES,0350027P,162,157,0,5,71,91,5 ème
ILLE-ET-VILAINE,RENNES,0350734H,105,105,0,0,55,50,5 ème
ILLE-ET-VILAINE,RENNES,0350836U,90,90,0,0,45,45,5 ème
ILLE-ET-VILAINE,RENNES,0350963G,172,156,16,0,90,82,5 ème
ILLE-ET-VILAINE,RENNES,0351638R,197,195,0,2,102,95,5 ème
ILLE-ET-VILAINE,RENNES,0352069J,206,187,19,0,95,111,5 ème
ILLE-ET-VILAINE,ROMILLE,0350057X,148,148,0,0,81,67,5 ème
ILLE-ET-VILAINE,SAINT-AUBIN-D'AUBIGNE,0350881T,122,122,0,0,52,70,5 ème
ILLE-ET-VILAINE,SAINT-AUBIN-D'AUBIGNE,0351849V,163,141,16,6,71,92,5 ème
ILLE-ET-VILAINE,SAINT-AUBIN-DU-CORMIER,0350039C,134,134,0,0,59,75,5 ème
ILLE-ET-VILAINE,SAINT-GEORGES-DE-REINTEMBAULT,0350885X,38,38,0,0,9,29,5 ème
ILLE-ET-VILAINE,SAINT-JACQUES-DE-LA-LANDE,0352589Z,99,97,0,2,46,53,5 ème
ILLE-ET-VILAINE,SAINT-MALO,0350044H,57,56,0,1,25,32,5 ème
ILLE-ET-VILAINE,SAINT-MALO,0350916F,135,108,24,3,63,72,5 ème
ILLE-ET-VILAINE,VAL-COUESNON,0350848G,47,47,0,0,20,27,5 ème
ILLE-ET-VILAINE,VITRE,0351909K,153,115,32,6,63,90,5 ème
MORBIHAN,ARRADON,0561598H,145,143,0,2,72,73,5 ème
MORBIHAN,AURAY,0560002Y,117,92,16,9,67,50,5 ème
MORBIHAN,CARNAC,0560006C,109,109,0,0,60,49,5 ème
MORBIHAN,CARNAC,0560127J,72,72,0,0,40,32,5 ème
MORBIHAN,ELVEN,0560129L,145,145,0,0,69,76,5 ème
MORBIHAN,GUEMENE-SUR-SCORFF,0560133R,30,30,0,0,11,19,5 ème
MORBIHAN,JOSSELIN,0560019S,0,0,0,0,0,0,5 ème
MORBIHAN,LANESTER,0560022V,101,101,0,0,42,59,5 ème
MORBIHAN,LA TRINITE-PORHOET,0560174K,38,38,0,0,17,21,5 ème
MORBIHAN,LE FAOUET,0560010G,57,55,0,2,24,33,5 ème
MORBIHAN,LOCMINE,0560024X,75,75,0,0,39,36,5 ème
MORBIHAN,LORIENT,0561330S,96,85,8,3,60,36,5 ème
MORBIHAN,PLOUAY,0561403W,68,68,0,0,34,34,5 ème
MORBIHAN,PLUNERET,0561616C,111,111,0,0,50,61,5 ème
MORBIHAN,QUIBERON,0560168D,16,16,0,0,9,7,5 ème
MORBIHAN,SARZEAU,0560048Y,114,114,0,0,58,56,5 ème
MORBIHAN,VANNES,0560053D,0,0,0,0,0,0,5 ème
MORBIHAN,VANNES,0560115W,117,112,0,5,61,56,5 ème
MORBIHAN,VANNES,0561792U,41,41,0,0,24,17,5 ème
CHER,BOURGES,0180777X,176,159,15,2,72,104,5 ème
CHER,DUN-SUR-AURON,0180736C,114,103,8,3,61,53,5 ème
CHER,SAINT-AMAND-MONTROND,0180025E,0,0,0,0,0,0,5 ème
CHER,SAINT-AMAND-MONTROND,0180026F,0,0,0,0,0,0,5 ème
CHER,SANCERGUES,0180745M,61,61,0,0,32,29,5 ème
EURE-ET-LOIR,CHARTRES,0280756V,111,109,0,2,54,57,5 ème
EURE-ET-LOIR,CHATEAUDUN,0280700J,0,0,0,0,0,0,5 ème
EURE-ET-LOIR,CLOYES-LES-TROIS-RIVIERES,0280867R,81,80,0,1,31,50,5 ème
EURE-ET-LOIR,COURVILLE-SUR-EURE,0280018T,140,137,0,3,67,73,5 ème
EURE-ET-LOIR,DREUX,0280658N,124,122,0,2,63,61,5 ème
EURE-ET-LOIR,DREUX,0280925D,0,0,0,0,0,0,5 ème
EURE-ET-LOIR,GALLARDON,0280701K,141,139,0,2,68,73,5 ème
EURE-ET-LOIR,LUCE,0280009H,0,0,0,0,0,0,5 ème
EURE-ET-LOIR,MAINVILLIERS,0280659P,9,0,9,0,4,5,5 ème
EURE-ET-LOIR,MIGNIERES,0280664V,78,74,0,4,37,41,5 ème
EURE-ET-LOIR,NOGENT-LE-ROTROU,0280669A,50,49,0,1,26,24,5 ème
EURE-ET-LOIR,TOURY,0280884J,92,89,0,3,43,49,5 ème
INDRE,BUZANCAIS,0360498W,131,117,9,5,73,58,5 ème
INDRE,CHATEAUROUX,0360543V,95,95,0,0,56,39,5 ème
INDRE,LA CHATRE,0360720M,118,107,9,2,60,58,5 ème
INDRE,VATAN,0360040Y,62,62,0,0,28,34,5 ème
INDRE-ET-LOIRE,AMBOISE,0371123V,0,0,0,0,0,0,5 ème
INDRE-ET-LOIRE,BLERE,0371124W,141,141,0,0,68,73,5 ème
INDRE-ET-LOIRE,CHATEAU-RENAULT,0370007G,187,169,14,4,87,100,5 ème
INDRE-ET-LOIRE,CHINON,0371159J,140,127,13,0,80,60,5 ème
INDRE-ET-LOIRE,CORMERY,0370010K,148,148,0,0,74,74,5 ème
INDRE-ET-LOIRE,ESVRES,0371204H,124,124,0,0,68,56,5 ème
INDRE-ET-LOIRE,JOUE-LES-TOURS,0371098T,82,78,0,4,37,45,5 ème
INDRE-ET-LOIRE,JOUE-LES-TOURS,0371316E,79,77,0,2,40,39,5 ème
INDRE-ET-LOIRE,LOCHES,0370768J,197,167,24,6,84,113,5 ème
INDRE-ET-LOIRE,LUYNES,0371378X,106,106,0,0,56,50,5 ème
INDRE-ET-LOIRE,MONTRESOR,0370051E,54,54,0,0,25,29,5 ème
INDRE-ET-LOIRE,PREUILLY-SUR-CLAISE,0370738B,14,14,0,0,7,7,5 ème
INDRE-ET-LOIRE,TOURS,0370041U,100,96,0,4,48,52,5 ème
INDRE-ET-LOIRE,TOURS,0370053G,0,0,0,0,0,0,5 ème
INDRE-ET-LOIRE,TOURS,0370743G,82,82,0,0,37,45,5 ème
INDRE-ET-LOIRE,VOUVRAY,0371189S,148,145,0,3,73,75,5 ème
LOIRET,CHATEAU-RENARD,0451107J,97,95,0,2,48,49,5 ème
LOIRET,CHECY,0451365P,181,178,0,3,90,91,5 ème
LOIRET,CLERY-SAINT-ANDRE,0451434P,104,99,0,5,49,55,5 ème
LOIRET,FLEURY-LES-AUBRAIS,0450784H,203,184,16,3,95,108,5 ème
LOIRET,GIEN,0451037H,0,0,0,0,0,0,5 ème
LOIRET,ORLEANS,0450109Z,114,110,0,4,51,63,5 ème
LOIRET,PITHIVIERS,0451332D,44,44,0,0,23,21,5 ème
LOIR-ET-CHER,BLOIS,0410693F,0,0,0,0,0,0,5 ème
LOIR-ET-CHER,BLOIS,0410790L,174,156,15,3,85,89,5 ème
LOIR-ET-CHER,BLOIS,0410860M,160,152,0,8,80,80,5 ème
LOIR-ET-CHER,BLOIS,0410952M,94,88,0,6,48,46,5 ème
LOIR-ET-CHER,BRACIEUX,0410005H,108,105,0,3,61,47,5 ème
LOIR-ET-CHER,LE CONTROIS-EN-SOLOGNE,0410595Z,179,172,0,7,94,85,5 ème
LOIR-ET-CHER,MONDOUBLEAU,0410596A,87,83,0,4,45,42,5 ème
LOIR-ET-CHER,ROMORANTIN-LANTHENAY,0410036S,0,0,0,0,0,0,5 ème
LOIR-ET-CHER,ROMORANTIN-LANTHENAY,0410793P,86,83,0,3,42,44,5 ème
LOIR-ET-CHER,SAMBIN,0410677N,130,130,0,0,66,64,5 ème
LOIR-ET-CHER,SELLES-SUR-CHER,0410651K,94,94,0,0,52,42,5 ème
LOIR-ET-CHER,VENDOME,0410031L,0,0,0,0,0,0,5 ème
LOIR-ET-CHER,VINEUIL,0410773T,55,55,0,0,25,30,5 ème
CORSE-DU-SUD,AJACCIO,6200010S,129,129,0,0,67,62,5 ème
CORSE-DU-SUD,BONIFACIO,6200015X,70,70,0,0,36,34,5 ème
CORSE-DU-SUD,SARROLA-CARCOPINO,6200191N,155,155,0,0,73,82,5 ème
HAUTE-CORSE,BASTIA,7200139N,114,114,0,0,56,58,5 ème
HAUTE-CORSE,BIGUGLIA,7200727C,163,148,15,0,71,92,5 ème
MEURTHE-ET-MOSELLE,BACCARAT,0540001H,75,72,0,3,32,43,5 ème
MEURTHE-ET-MOSELLE,BLENOD-LES-PONT-A-MOUSSON,0541576V,165,136,28,1,73,92,5 ème
MEURTHE-ET-MOSELLE,CHAMPIGNEULLES,0541466A,109,88,15,6,56,53,5 ème
MEURTHE-ET-MOSELLE,CIREY-SUR-VEZOUZE,0540011U,81,74,7,0,38,43,5 ème
MEURTHE-ET-MOSELLE,DIEULOUARD,0540013W,115,112,0,3,54,61,5 ème
MEURTHE-ET-MOSELLE,DOMBASLE-SUR-MEURTHE,0540014X,86,80,0,6,40,46,5 ème
MEURTHE-ET-MOSELLE,DOMBASLE-SUR-MEURTHE,0540015Y,0,0,0,0,0,0,5 ème
MEURTHE-ET-MOSELLE,EINVILLE-AU-JARD,0540017A,63,63,0,0,36,27,5 ème
MEURTHE-ET-MOSELLE,FOUG,0540019C,38,38,0,0,15,23,5 ème
MEURTHE-ET-MOSELLE,HEILLECOURT,0542468P,139,133,0,6,73,66,5 ème
MEURTHE-ET-MOSELLE,JARNY,0540025J,183,172,10,1,99,84,5 ème
MEURTHE-ET-MOSELLE,LONGLAVILLE,0541578X,125,125,0,0,57,68,5 ème
MEURTHE-ET-MOSELLE,LONGUYON,0541452K,30,30,0,0,15,15,5 ème
MEURTHE-ET-MOSELLE,LONGWY,0541989U,150,150,0,0,71,79,5 ème
MEURTHE-ET-MOSELLE,LUNEVILLE,0540037X,0,0,0,0,0,0,5 ème
MEURTHE-ET-MOSELLE,MALZEVILLE,0541474J,162,159,0,3,75,87,5 ème
MEURTHE-ET-MOSELLE,NANCY,0541364P,0,0,0,0,0,0,5 ème
MEURTHE-ET-MOSELLE,NANCY,0541819J,113,113,0,0,50,63,5 ème
MEURTHE-ET-MOSELLE,NEUVES-MAISONS,0541573S,155,143,8,4,72,83,5 ème
MEURTHE-ET-MOSELLE,PONT-A-MOUSSON,0541440X,90,90,0,0,52,38,5 ème
MEURTHE-ET-MOSELLE,TOUL,0541330C,113,106,0,7,47,66,5 ème
MEURTHE-ET-MOSELLE,TOUL,0541565H,147,122,21,4,68,79,5 ème
MEURTHE-ET-MOSELLE,VAL DE BRIEY,0541338L,13,0,12,1,6,7,5 ème
MEURTHE-ET-MOSELLE,VILLERS-LES-NANCY,0541776M,90,88,0,2,47,43,5 ème
MEUSE,ANCEMONT,0550859K,79,79,0,0,35,44,5 ème
MEUSE,ANCERVILLE,0550848Y,95,95,0,0,48,47,5 ème
MEUSE,BAR-LE-DUC,0550046B,91,91,0,0,45,46,5 ème
MEUSE,LIGNY-EN-BARROIS,0550052H,24,24,0,0,15,9,5 ème
MEUSE,LIGNY-EN-BARROIS,0550700M,0,0,0,0,0,0,5 ème
MEUSE,VAUCOULEURS,0550023B,107,106,0,1,48,59,5 ème
MOSELLE,AMNEVILLE,0572689N,133,131,0,2,64,69,5 ème
MOSELLE,BOULAY-MOSELLE,0570225K,0,0,0,0,0,0,5 ème
MOSELLE,CHATEAU-SALINS,0570327W,76,71,0,5,38,38,5 ème
MOSELLE,CREUTZWALD,0572022N,0,0,0,0,0,0,5 ème
MOSELLE,FALCK,0572358D,91,91,0,0,51,40,5 ème
MOSELLE,HAM-SOUS-VARSBERG,0572359E,85,85,0,0,51,34,5 ème
MOSELLE,HARTZVILLER,0570038G,79,79,0,0,31,48,5 ème
MOSELLE,HAYANGE,0570077Z,0,0,0,0,0,0,5 ème
MOSELLE,HAYANGE,0572171A,104,102,0,2,41,63,5 ème
MOSELLE,HAYANGE,0572480L,199,196,0,3,105,94,5 ème
MOSELLE,KEDANGE-SUR-CANNER,0570315H,158,158,0,0,80,78,5 ème
MOSELLE,MARLY,0572082D,161,154,0,7,79,82,5 ème
MOSELLE,MARLY,0572754J,84,84,0,0,50,34,5 ème
MOSELLE,METZ,0570127D,103,101,0,2,39,64,5 ème
MOSELLE,METZ,0572809U,174,174,0,0,74,100,5 ème
MOSELLE,METZ,0572925V,238,238,0,0,121,117,5 ème
MOSELLE,METZ,0573688Z,0,0,0,0,0,0,5 ème
MOSELLE,MONTIGNY-LES-METZ,0570144X,0,0,0,0,0,0,5 ème
MOSELLE,MOULINS-LES-METZ,0572477H,81,70,9,2,36,45,5 ème
MOSELLE,PELTRE,0572928Y,49,49,0,0,20,29,5 ème
MOSELLE,PUTTELANGE-AUX-LACS,0572183N,103,96,0,7,44,59,5 ème
MOSELLE,REMILLY,0572013D,132,128,0,4,64,68,5 ème
MOSELLE,SAINT-AVOLD,0570087K,0,0,0,0,0,0,5 ème
MOSELLE,SAINT-AVOLD,0570268G,0,0,0,0,0,0,5 ème
MOSELLE,SARRALBE,0570093S,128,128,0,0,67,61,5 ème
MOSELLE,SARREBOURG,0572816B,150,146,0,4,69,81,5 ème
MOSELLE,SARREGUEMINES,0572021M,87,84,0,3,46,41,5 ème
MOSELLE,TALANGE,0572174D,129,118,8,3,57,72,5 ème
MOSELLE,THIONVILLE,0572812X,105,101,0,4,41,64,5 ème
MOSELLE,THIONVILLE,0572931B,336,336,0,0,175,161,5 ème
MOSELLE,UCKANGE,0570318L,101,97,0,4,55,46,5 ème
VOSGES,BRUYERES,0880106M,38,38,0,0,16,22,5 ème
VOSGES,ELOYES,0881371M,108,107,0,1,60,48,5 ème
VOSGES,EPINAL,0881119N,8,0,8,0,3,5,5 ème
VOSGES,EPINAL,0881146T,184,158,14,12,92,92,5 ème
VOSGES,GOLBEY,0881097P,164,160,0,4,90,74,5 ème
VOSGES,LAMARCHE,0880034J,37,37,0,0,19,18,5 ème
VOSGES,LIFFOL-LE-GRAND,0881103W,36,36,0,0,18,18,5 ème
VOSGES,MONTHUREUX-SUR-SAONE,0881386D,52,52,0,0,25,27,5 ème
VOSGES,NEUFCHATEAU,0880040R,0,0,0,0,0,0,5 ème
VOSGES,PROVENCHERES-ET-COLROY,0880044V,60,60,0,0,30,30,5 ème
VOSGES,RAMBERVILLERS,0880114W,32,28,0,4,17,15,5 ème
VOSGES,RAON-L'ETAPE,0881370L,0,0,0,0,0,0,5 ème
VOSGES,REMIREMONT,0881498A,0,0,0,0,0,0,5 ème
VOSGES,VAGNEY,0881372N,82,78,0,4,37,45,5 ème
ARDENNES,CHARLEVILLE-MEZIERES,0080011U,102,96,0,6,51,51,5 ème
ARDENNES,CHARLEVILLE-MEZIERES,0080082W,0,0,0,0,0,0,5 ème
ARDENNES,CHARLEVILLE-MEZIERES,0080829H,51,51,0,0,34,17,5 ème
ARDENNES,CHARLEVILLE-MEZIERES,0080994M,93,93,0,0,59,34,5 ème
ARDENNES,FUMAY,0080017A,50,42,6,2,29,21,5 ème
ARDENNES,RAUCOURT-ET-FLABA,0081103F,59,59,0,0,30,29,5 ème
ARDENNES,RETHEL,0080897G,88,84,0,4,39,49,5 ème
ARDENNES,SEDAN,0080826E,66,50,14,2,32,34,5 ème
ARDENNES,SEDAN,0080995N,110,110,0,0,64,46,5 ème
ARDENNES,SIGNY-L'ABBAYE,0081104G,85,85,0,0,43,42,5 ème
AUBE,BRIENNE-LE-CHATEAU,0100007D,116,111,5,0,51,65,5 ème
AUBE,MESNIL-SAINT-LOUP,0100051B,32,32,0,0,16,16,5 ème
AUBE,NOGENT-SUR-SEINE,0100786A,160,158,0,2,80,80,5 ème
AUBE,PINEY,0100013K,71,71,0,0,36,35,5 ème
AUBE,TROYES,0100038M,114,113,0,1,62,52,5 ème
AUBE,TROYES,0100056G,62,62,0,0,34,28,5 ème
HAUTE-MARNE,BOURBONNE-LES-BAINS,0520706K,34,30,0,4,16,18,5 ème
HAUTE-MARNE,CHALINDREY,0520794F,55,55,0,0,28,27,5 ème
HAUTE-MARNE,CHAUMONT,0520733P,100,98,0,2,44,56,5 ème
HAUTE-MARNE,CHAUMONT,0520737U,84,82,0,2,36,48,5 ème
HAUTE-MARNE,COLOMBEY LES DEUX EGLISES,0520814C,29,29,0,0,16,13,5 ème
HAUTE-MARNE,LANGRES,0520052Z,81,80,0,1,39,42,5 ème
HAUTE-MARNE,LANGRES,0520967U,47,47,0,0,26,21,5 ème
HAUTE-MARNE,SAINT-DIZIER,0521123N,8,8,0,0,1,7,5 ème
HAUTE-MARNE,VAL-DE-MEUSE,0520023T,42,42,0,0,17,25,5 ème
HAUTE-MARNE,WASSY,0520708M,93,90,0,3,50,43,5 ème
MARNE,BLANCS-COTEAUX,0510059M,68,68,0,0,31,37,5 ème
MARNE,CHALONS-EN-CHAMPAGNE,0511711H,57,55,0,2,25,32,5 ème
MARNE,EPERNAY,0510068X,0,0,0,0,0,0,5 ème
MARNE,FERE-CHAMPENOISE,0510022X,78,73,0,5,34,44,5 ème
MARNE,FISMES,0511176B,73,71,0,2,35,38,5 ème
MARNE,PONTFAVERGER-MORONVILLIERS,0510030F,90,90,0,0,47,43,5 ème
MARNE,REIMS,0511138K,213,211,0,2,112,101,5 ème
MARNE,REIMS,0511146U,0,0,0,0,0,0,5 ème
MARNE,REIMS,0511799D,113,112,0,1,50,63,5 ème
MARNE,REIMS,0511802G,84,76,0,8,41,43,5 ème
MARNE,SERMAIZE-LES-BAINS,0510052E,102,95,7,0,54,48,5 ème
MARNE,SEZANNE,0510053F,0,0,0,0,0,0,5 ème
MARNE,SEZANNE,0510054G,126,106,14,6,63,63,5 ème
MARNE,TINQUEUX,0511187N,175,155,16,4,85,90,5 ème
MARNE,VITRY-LE-FRANCOIS,0511256N,115,91,21,3,56,59,5 ème
BAS-RHIN,BARR,0673006D,90,76,11,3,37,53,5 ème
BAS-RHIN,BISCHHEIM,0671822S,138,131,0,7,68,70,5 ème
BAS-RHIN,BISCHWILLER,0672130B,214,193,11,10,113,101,5 ème
BAS-RHIN,BOUXWILLER,0672076T,131,114,13,4,64,67,5 ème
BAS-RHIN,DIEMERINGEN,0671741D,62,62,0,0,43,19,5 ème
BAS-RHIN,HAGUENAU,0670024M,0,0,0,0,0,0,5 ème
BAS-RHIN,HAGUENAU,0671509B,0,0,0,0,0,0,5 ème
BAS-RHIN,INGWILLER,0670035Z,82,78,0,4,41,41,5 ème
BAS-RHIN,LA WANTZENAU,0671689X,152,152,0,0,82,70,5 ème
BAS-RHIN,OBERNAI,0670050R,0,0,0,0,0,0,5 ème
BAS-RHIN,PFULGRIESHEIM,0672193V,124,121,0,3,53,71,5 ème
BAS-RHIN,SCHILTIGHEIM,0670062D,0,0,0,0,0,0,5 ème
BAS-RHIN,SCHILTIGHEIM,0672602P,0,0,0,0,0,0,5 ème
BAS-RHIN,SELESTAT,0671832C,0,0,0,0,0,0,5 ème
BAS-RHIN,STRASBOURG,0670129B,0,0,0,0,0,0,5 ème
BAS-RHIN,STRASBOURG,0671692A,104,84,17,3,49,55,5 ème
BAS-RHIN,STRASBOURG,0671907J,209,190,15,4,125,84,5 ème
BAS-RHIN,STRASBOURG,0671958P,127,125,0,2,56,71,5 ème
BAS-RHIN,STRASBOURG,0672129A,122,120,0,2,61,61,5 ème
BAS-RHIN,STRASBOURG,0672306T,170,170,0,0,86,84,5 ème
BAS-RHIN,STRASBOURG,0672806L,0,0,0,0,0,0,5 ème
HAUT-RHIN,BUHL,0682018Z,99,97,0,2,53,46,5 ème
HAUT-RHIN,BURNHAUPT-LE-HAUT,0682017Y,157,154,0,3,76,81,5 ème
HAUT-RHIN,CARSPACH,0680154Y,0,0,0,0,0,0,5 ème
HAUT-RHIN,COLMAR,0680009R,117,113,0,4,61,56,5 ème
HAUT-RHIN,COLMAR,0680084X,137,107,25,5,74,63,5 ème
HAUT-RHIN,COLMAR,0681656F,0,0,0,0,0,0,5 ème
HAUT-RHIN,GUEBWILLER,0681318N,160,130,25,5,64,96,5 ème
HAUT-RHIN,HABSHEIM,0681713T,78,78,0,0,26,52,5 ème
HAUT-RHIN,ILLZACH,0681757R,85,85,0,0,48,37,5 ème
HAUT-RHIN,INGERSHEIM,0681654D,118,114,0,4,71,47,5 ème
HAUT-RHIN,KAYSERSBERG VIGNOBLE,0680022E,70,70,0,0,42,28,5 ème
HAUT-RHIN,KINGERSHEIM,0681369U,138,131,0,7,61,77,5 ème
HAUT-RHIN,MASEVAUX-NIEDERBRUCK,0681265F,111,111,0,0,64,47,5 ème
HAUT-RHIN,MULHOUSE,0680037W,0,0,0,0,0,0,5 ème
HAUT-RHIN,MULHOUSE,0681284B,114,114,0,0,51,63,5 ème
HAUT-RHIN,MUNSTER,0681539D,151,151,0,0,78,73,5 ème
HAUT-RHIN,PULVERSHEIM,0681801N,0,0,0,0,0,0,5 ème
HAUT-RHIN,RIEDISHEIM,0680112C,113,111,0,2,50,63,5 ème
HAUT-RHIN,RIXHEIM,0680129W,189,164,18,7,79,110,5 ème
HAUT-RHIN,ROUFFACH,0680139G,89,89,0,0,40,49,5 ème
HAUT-RHIN,SAINTE-MARIE-AUX-MINES,0680068E,0,0,0,0,0,0,5 ème
HAUT-RHIN,SAINTE-MARIE-AUX-MINES,0681394W,89,81,5,3,38,51,5 ème
HAUT-RHIN,WINTZENHEIM,0681365P,132,109,15,8,49,83,5 ème
GUADELOUPE,BAIE-MAHAULT,9710040S,242,239,0,3,117,125,5 ème
GUADELOUPE,BAIE-MAHAULT,9710057K,191,191,0,0,82,109,5 ème
GUADELOUPE,BAIE-MAHAULT,9710593T,0,0,0,0,0,0,5 ème
GUADELOUPE,BASSE-TERRE,9710061P,22,22,0,0,9,13,5 ème
GUADELOUPE,DESHAIES,9710643X,47,47,0,0,21,26,5 ème
GUADELOUPE,GRAND-BOURG,9711012Y,0,0,0,0,0,0,5 ème
GUADELOUPE,LES ABYMES,9711046K,0,0,0,0,0,0,5 ème
GUADELOUPE,MORNE-A-L'EAU,9710709U,0,0,0,0,0,0,5 ème
GUADELOUPE,PETIT-BOURG,9710016R,210,191,15,4,95,115,5 ème
GUADELOUPE,POINTE-A-PITRE,9710661S,62,62,0,0,29,33,5 ème
GUADELOUPE,POINTE-A-PITRE,9710987W,177,177,0,0,92,85,5 ème
GUADELOUPE,POINTE-A-PITRE,9710988X,68,68,0,0,27,41,5 ème
GUADELOUPE,SAINT-BARTHELEMY,9710035L,108,103,0,5,44,64,5 ème
GUADELOUPE,TROIS-RIVIERES,9710707S,87,86,0,1,42,45,5 ème
GUYANE,CAMOPI,9730451C,32,22,9,1,15,17,5 ème
GUYANE,CAYENNE,9730132F,149,149,0,0,76,73,5 ème
GUYANE,MATOURY,9730536V,86,86,0,0,53,33,5 ème
GUYANE,SAINT-LAURENT-DU-MARONI,9730497C,68,68,0,0,36,32,5 ème
GUYANE,SINNAMARY,9730145V,59,43,9,7,35,24,5 ème
AISNE,ANIZY-LE-GRAND,0020002S,124,119,5,0,69,55,5 ème
AISNE,BOHAIN-EN-VERMANDOIS,0020007X,92,73,13,6,51,41,5 ème
AISNE,BOHAIN-EN-VERMANDOIS,0020498F,0,0,0,0,0,0,5 ème
AISNE,CHAUNY,0020469Z,55,55,0,0,24,31,5 ème
AISNE,CHAUNY,0021906L,0,0,0,0,0,0,5 ème
AISNE,CRECY-SUR-SERRE,0021721K,109,109,0,0,48,61,5 ème
AISNE,FONTAINE-LES-VERVINS,0020470A,49,49,0,0,19,30,5 ème
AISNE,FRESNOY-LE-GRAND,0021661V,104,102,0,2,43,61,5 ème
AISNE,GAUCHY,0021494N,100,90,7,3,43,57,5 ème
AISNE,GUISE,0020030X,101,77,16,8,54,47,5 ème
AISNE,GUISE,0021479X,0,0,0,0,0,0,5 ème
AISNE,HIRSON,0020484R,30,30,0,0,18,12,5 ème
AISNE,LAON,0020034B,0,0,0,0,0,0,5 ème
AISNE,LAON,0020471B,63,63,0,0,31,32,5 ème
AISNE,LAON,0021598B,159,138,15,6,76,83,5 ème
AISNE,LAON,0021685W,150,139,0,11,73,77,5 ème
AISNE,MARLE,0021778X,64,60,0,4,31,33,5 ème
AISNE,SAINS-RICHAUMONT,0020044M,38,38,0,0,22,16,5 ème
AISNE,SAINT-QUENTIN,0020055Z,95,79,15,1,36,59,5 ème
AISNE,SAINT-QUENTIN,0020076X,69,69,0,0,28,41,5 ème
AISNE,SOISSONS,0021525X,176,176,0,0,96,80,5 ème
AISNE,SOISSONS,0021535H,105,97,0,8,52,53,5 ème
OISE,AUNEUIL,0601799E,121,108,9,4,47,74,5 ème
OISE,BEAUVAIS,0601139M,157,154,0,3,74,83,5 ème
OISE,BEAUVAIS,0601190T,159,141,16,2,86,73,5 ème
OISE,BREUIL-LE-VERT,0601834T,164,146,16,2,74,90,5 ème
OISE,CHAUMONT-EN-VEXIN,0600012M,83,83,0,0,40,43,5 ème
OISE,CHAUMONT-EN-VEXIN,0601882V,133,133,0,0,62,71,5 ème
OISE,GUISCARD,0602004C,91,91,0,0,40,51,5 ème
OISE,MERU,0601718S,106,103,0,3,45,61,5 ème
OISE,NOGENT-SUR-OISE,0600036N,112,109,0,3,60,52,5 ème
OISE,NOGENT-SUR-OISE,0601179F,164,161,0,3,74,90,5 ème
OISE,SAINTE-GENEVIEVE,0601938F,149,146,0,3,64,85,5 ème
OISE,SENLIS,0600049C,0,0,0,0,0,0,5 ème
OISE,SENLIS,0601150Z,254,251,0,3,134,120,5 ème
OISE,THOUROTTE,0601446W,164,160,0,4,81,83,5 ème
OISE,VERBERIE,0601407D,145,145,0,0,78,67,5 ème
SOMME,ACHEUX-EN-AMIENOIS,0800003U,80,80,0,0,39,41,5 ème
SOMME,AIRAINES,0801510G,69,52,16,1,30,39,5 ème
SOMME,ALBERT,0801786G,71,53,16,2,33,38,5 ème
SOMME,AMIENS,0800017J,129,107,13,9,63,66,5 ème
SOMME,AMIENS,0800018K,157,137,15,5,68,89,5 ème
SOMME,AMIENS,0801208D,47,47,0,0,23,24,5 ème
SOMME,AMIENS,0801211G,136,136,0,0,68,68,5 ème
SOMME,AMIENS,0802134K,86,84,0,2,47,39,5 ème
SOMME,BEAUCAMPS-LE-VIEUX,0801443J,49,47,0,2,23,26,5 ème
SOMME,FLIXECOURT,0801222U,88,88,0,0,38,50,5 ème
SOMME,PERONNE,0801723N,84,84,0,0,43,41,5 ème
SOMME,VILLERS-BOCAGE,0801339W,156,156,0,0,80,76,5 ème
NORD,ANICHE,0590002G,195,181,13,1,102,93,5 ème
NORD,ARMENTIERES,0593246H,166,153,13,0,84,82,5 ème
NORD,AUBY,0594297A,111,96,10,5,48,63,5 ème
NORD,AUBY,0594532F,0,0,0,0,0,0,5 ème
NORD,AULNOYE-AYMERIES,0595383F,42,42,0,0,26,16,5 ème
NORD,AULNOYE-AYMERIES,0596694F,174,162,8,4,74,100,5 ème
NORD,AULNOY-LEZ-VALENCIENNES,0593673X,95,85,7,3,46,49,5 ème
NORD,AVESNES-LES-AUBERT,0593676A,143,140,0,3,71,72,5 ème
NORD,BEAUCAMPS-LIGNY,0595360F,356,356,0,0,159,197,5 ème
NORD,CAMBRAI,0593061G,0,0,0,0,0,0,5 ème
NORD,CAPPELLE-LA-GRANDE,0593181M,113,110,0,3,52,61,5 ème
NORD,CAUDRY,0590046E,177,177,0,0,91,86,5 ème
NORD,CAUDRY,0595277R,152,131,15,6,81,71,5 ème
NORD,COMINES,0592959W,150,150,0,0,77,73,5 ème
NORD,DOUCHY-LES-MINES,0593484S,149,138,8,3,62,87,5 ème
NORD,ESCAUTPONT,0594409X,63,63,0,0,29,34,5 ème
NORD,ESTAIRES,0597005U,0,0,0,0,0,0,5 ème
NORD,FACHES-THUMESNIL,0592830F,101,101,0,0,50,51,5 ème
NORD,FERRIERE-LA-GRANDE,0593681F,123,118,5,0,55,68,5 ème
NORD,FOURNES-EN-WEPPES,0596801X,18,18,0,0,3,15,5 ème
NORD,FRESNES-SUR-ESCAUT,0593486U,101,101,0,0,54,47,5 ème
NORD,GOUZEAUCOURT,0590087Z,66,66,0,0,28,38,5 ème
NORD,GRANDE-SYNTHE,0594652L,0,0,0,0,0,0,5 ème
NORD,HALLUIN,0592850C,0,0,0,0,0,0,5 ème
NORD,HALLUIN,0593125B,111,111,0,0,58,53,5 ème
NORD,HAUBOURDIN,0594386X,85,85,0,0,41,44,5 ème
NORD,HAZEBROUCK,0590103S,168,148,16,4,74,94,5 ème
NORD,HEM,0594632P,148,135,11,2,70,78,5 ème
NORD,HONDSCHOOTE,0593130G,42,42,0,0,18,24,5 ème
NORD,HONDSCHOOTE,0594642A,106,106,0,0,57,49,5 ème
NORD,JEUMONT,0593132J,87,85,0,2,52,35,5 ème
NORD,JEUMONT,0594418G,85,85,0,0,39,46,5 ème
NORD,LA BASSEE,0590252D,0,0,0,0,0,0,5 ème
NORD,LA BASSEE,0593231S,213,197,16,0,103,110,5 ème
NORD,LALLAING,0593482P,106,86,16,4,54,52,5 ème
NORD,LAMBERSART,0593015G,0,0,0,0,0,0,5 ème
NORD,LAMBERSART,0593134L,193,193,0,0,100,93,5 ème
NORD,LILLE,0590271Z,82,74,8,0,39,43,5 ème
NORD,LILLE,0593177H,56,45,11,0,32,24,5 ème
NORD,LILLE,0593180L,225,212,8,5,94,131,5 ème
NORD,LILLE,0594881K,92,86,0,6,48,44,5 ème
NORD,LILLE,0595396V,100,92,0,8,46,54,5 ème
NORD,LOOS,0593030Y,0,0,0,0,0,0,5 ème
NORD,LYS-LEZ-LANNOY,0593240B,146,133,11,2,59,87,5 ème
NORD,LYS-LEZ-LANNOY,0594380R,8,0,8,0,5,3,5 ème
NORD,MARCHIENNES,0590142J,86,86,0,0,37,49,5 ème
NORD,MARCQ-EN-BAROEUL,0594287P,109,100,9,0,62,47,5 ème
NORD,MARLY,0594302F,0,0,0,0,0,0,5 ème
NORD,MORTAGNE-DU-NORD,0594410Y,83,83,0,0,51,32,5 ème
NORD,NEUVILLE-EN-FERRAIN,0594833H,150,150,0,0,70,80,5 ème
NORD,ORCHIES,0590159C,267,254,13,0,136,131,5 ème
NORD,OSTRICOURT,0594290T,71,62,9,0,29,42,5 ème
NORD,POIX-DU-NORD,0594876E,70,70,0,0,35,35,5 ème
NORD,ROUBAIX,0590187H,0,0,0,0,0,0,5 ème
NORD,ROUBAIX,0592907P,156,151,0,5,75,81,5 ème
NORD,ROUBAIX,0592964B,0,0,0,0,0,0,5 ème
NORD,SAINT-AMAND-LES-EAUX,0594304H,127,127,0,0,61,66,5 ème
NORD,SOLESMES,0594648G,171,157,8,6,87,84,5 ème
NORD,TOURCOING,0593140T,204,204,0,0,128,76,5 ème
NORD,TOURCOING,0594293W,121,121,0,0,60,61,5 ème
NORD,TOURCOING,0596846W,190,190,0,0,90,100,5 ème
NORD,TOURCOING,0596860L,131,122,6,3,69,62,5 ème
NORD,TRELON,0594308M,51,51,0,0,27,24,5 ème
NORD,TRITH-SAINT-LEGER,0594534H,69,64,0,5,38,31,5 ème
NORD,VALENCIENNES,0592715F,112,104,0,8,57,55,5 ème
NORD,WALINCOURT-SELVIGNY,0590228C,102,97,0,5,42,60,5 ème
NORD,WAVRIN,0593475G,135,134,0,1,76,59,5 ème
NORD,WORMHOUT,0593163T,90,90,0,0,44,46,5 ème
PAS-DE-CALAIS,ACHICOURT,0622863A,125,119,5,1,75,50,5 ème
PAS-DE-CALAIS,ARQUES,0622093N,130,130,0,0,67,63,5 ème
PAS-DE-CALAIS,ARRAS,0622082B,96,93,0,3,48,48,5 ème
PAS-DE-CALAIS,ARRAS,0622103Z,117,117,0,0,58,59,5 ème
PAS-DE-CALAIS,ARRAS,0623310L,93,93,0,0,49,44,5 ème
PAS-DE-CALAIS,AUCHY-LES-MINES,0622946R,111,111,0,0,46,65,5 ème
PAS-DE-CALAIS,AUDRUICQ,0620024P,122,105,13,4,60,62,5 ème
PAS-DE-CALAIS,BERCK,0622128B,80,80,0,0,38,42,5 ème
PAS-DE-CALAIS,BEUVRY,0622090K,210,192,14,4,117,93,5 ème
PAS-DE-CALAIS,BILLY-MONTIGNY,0622793Z,133,119,14,0,53,80,5 ème
PAS-DE-CALAIS,BOULOGNE-SUR-MER,0622130D,122,122,0,0,69,53,5 ème
PAS-DE-CALAIS,BRUAY-LA-BUISSIERE,0620192X,0,0,0,0,0,0,5 ème
PAS-DE-CALAIS,CALAIS,0620196B,113,109,0,4,63,50,5 ème
PAS-DE-CALAIS,CALAIS,0622273J,82,66,16,0,44,38,5 ème
PAS-DE-CALAIS,CALAIS,0623918X,102,102,0,0,46,56,5 ème
PAS-DE-CALAIS,CALONNE-RICOUART,0620068M,87,87,0,0,37,50,5 ème
PAS-DE-CALAIS,CARVIN,0620071R,125,111,14,0,57,68,5 ème
PAS-DE-CALAIS,CARVIN,0622134H,202,202,0,0,111,91,5 ème
PAS-DE-CALAIS,ETAPLES,0622136K,103,103,0,0,52,51,5 ème
PAS-DE-CALAIS,FAUQUEMBERGUES,0620082C,73,73,0,0,41,32,5 ème
PAS-DE-CALAIS,FREVENT,0622137L,38,38,0,0,12,26,5 ème
PAS-DE-CALAIS,GRENAY,0622424Y,125,104,21,0,60,65,5 ème
PAS-DE-CALAIS,GUINES,0620088J,112,102,10,0,54,58,5 ème
PAS-DE-CALAIS,HENIN-BEAUMONT,0622795B,157,140,14,3,72,85,5 ème
PAS-DE-CALAIS,HEUCHIN,0622866D,58,58,0,0,29,29,5 ème
PAS-DE-CALAIS,LENS,0622417R,100,100,0,0,48,52,5 ème
PAS-DE-CALAIS,LUMBRES,0622574L,237,221,12,4,119,118,5 ème
PAS-DE-CALAIS,OIGNIES,0620150B,0,0,0,0,0,0,5 ème
PAS-DE-CALAIS,OYE-PLAGE,0623759Z,120,120,0,0,55,65,5 ème
PAS-DE-CALAIS,SAINS-EN-GOHELLE,0622578R,85,85,0,0,44,41,5 ème
PAS-DE-CALAIS,SAINT-MARTIN-BOULOGNE,0623573X,110,110,0,0,46,64,5 ème
PAS-DE-CALAIS,SAINT-OMER,0620162P,0,0,0,0,0,0,5 ème
PAS-DE-CALAIS,SAINT-VENANT,0622091L,105,105,0,0,49,56,5 ème
PAS-DE-CALAIS,SALLAUMINES,0620220C,0,0,0,0,0,0,5 ème
PAS-DE-CALAIS,SAMER,0622950V,152,152,0,0,77,75,5 ème
SEINE-ET-MARNE,BRAY-SUR-SEINE,0770003K,158,158,0,0,79,79,5 ème
SEINE-ET-MARNE,BUSSY-SAINT-GEORGES,0772226B,143,143,0,0,78,65,5 ème
SEINE-ET-MARNE,BUSSY-SAINT-GEORGES,0772601J,90,90,0,0,56,34,5 ème
SEINE-ET-MARNE,CHAMPAGNE-SUR-SEINE,0770920G,0,0,0,0,0,0,5 ème
SEINE-ET-MARNE,CHELLES,0771471F,214,211,0,3,118,96,5 ème
SEINE-ET-MARNE,CHELLES,0771759U,161,149,12,0,83,78,5 ème
SEINE-ET-MARNE,COMBS-LA-VILLE,0771959L,151,151,0,0,79,72,5 ème
SEINE-ET-MARNE,COUILLY-PONT-AUX-DAMES,0771236A,48,48,0,0,23,25,5 ème
SEINE-ET-MARNE,COULOMMIERS,0771233X,61,61,0,0,25,36,5 ème
SEINE-ET-MARNE,CROUY-SUR-OURCQ,0772246Y,76,66,9,1,43,33,5 ème
SEINE-ET-MARNE,EMERAINVILLE,0772119K,93,93,0,0,50,43,5 ème
SEINE-ET-MARNE,FAREMOUTIERS,0771519H,142,142,0,0,68,74,5 ème
SEINE-ET-MARNE,FONTAINEBLEAU,0771200L,0,0,0,0,0,0,5 ème
SEINE-ET-MARNE,LA ROCHETTE,0770943G,0,0,0,0,0,0,5 ème
SEINE-ET-MARNE,LESIGNY,0771421B,199,194,0,5,81,118,5 ème
SEINE-ET-MARNE,LOGNES,0771992X,144,140,0,4,62,82,5 ème
SEINE-ET-MARNE,MEAUX,0770032S,127,122,0,5,55,72,5 ème
SEINE-ET-MARNE,MEAUX,0771880A,0,0,0,0,0,0,5 ème
SEINE-ET-MARNE,MEAUX,0772153X,0,0,0,0,0,0,5 ème
SEINE-ET-MARNE,MELUN,0771339M,194,159,32,3,81,113,5 ème
SEINE-ET-MARNE,MITRY-MORY,0772573D,181,181,0,0,80,101,5 ème
SEINE-ET-MARNE,MONTEREAU-FAULT-YONNE,0771761W,125,125,0,0,57,68,5 ème
SEINE-ET-MARNE,MORMANT,0771620T,201,200,0,1,91,110,5 ème
SEINE-ET-MARNE,NEMOURS,0771478N,149,112,32,5,65,84,5 ème
SEINE-ET-MARNE,OISSERY,0771912K,144,126,16,2,60,84,5 ème
SEINE-ET-MARNE,PONTAULT-COMBAULT,0772331R,126,123,0,3,71,55,5 ème
SEINE-ET-MARNE,PROVINS,0771216D,120,120,0,0,65,55,5 ème
SEINE-ET-MARNE,PROVINS,0772481D,94,90,0,4,46,48,5 ème
SEINE-ET-MARNE,ROISSY-EN-BRIE,0771657H,173,150,22,1,87,86,5 ème
SEINE-ET-MARNE,SAINT-MARD,0771615M,190,190,0,0,86,104,5 ème
SEINE-ET-MARNE,SAVIGNY-LE-TEMPLE,0771518G,171,171,0,0,82,89,5 ème
SEINE-ET-MARNE,TORCY,0771656G,138,120,15,3,64,74,5 ème
SEINE-ET-MARNE,TOURNAN-EN-BRIE,0770051M,204,182,19,3,103,101,5 ème
SEINE-ET-MARNE,VILLENEUVE-SUR-BELLOT,0770057U,111,108,0,3,49,62,5 ème
SEINE-ET-MARNE,VILLEPARISIS,0771333F,138,128,0,10,60,78,5 ème
SEINE-SAINT-DENIS,AUBERVILLIERS,0932043R,63,63,0,0,24,39,5 ème
SEINE-SAINT-DENIS,AULNAY-SOUS-BOIS,0931189M,162,159,0,3,77,85,5 ème
SEINE-SAINT-DENIS,BAGNOLET,0931181D,156,138,15,3,94,62,5 ème
SEINE-SAINT-DENIS,BAGNOLET,0931220W,123,123,0,0,55,68,5 ème
SEINE-SAINT-DENIS,BOBIGNY,0931195U,143,138,0,5,65,78,5 ème
SEINE-SAINT-DENIS,BOBIGNY,0931844Z,84,84,0,0,84,0,5 ème
SEINE-SAINT-DENIS,BOBIGNY,0932123C,0,0,0,0,0,0,5 ème
SEINE-SAINT-DENIS,BONDY,0930933J,0,0,0,0,0,0,5 ème
SEINE-SAINT-DENIS,BONDY,0931788N,147,145,0,2,72,75,5 ème
SEINE-SAINT-DENIS,CLICHY-SOUS-BOIS,0931221X,134,118,16,0,60,74,5 ème
SEINE-SAINT-DENIS,DRANCY,0930907F,97,97,0,0,44,53,5 ème
SEINE-SAINT-DENIS,DRANCY,0931202B,141,141,0,0,58,83,5 ème
SEINE-SAINT-DENIS,DRANCY,0931377S,187,171,16,0,91,96,5 ème
SEINE-SAINT-DENIS,GAGNY,0930858C,166,166,0,0,85,81,5 ème
SEINE-SAINT-DENIS,LA COURNEUVE,0931148T,190,172,15,3,78,112,5 ème
SEINE-SAINT-DENIS,LE BLANC-MESNIL,0931204D,191,191,0,0,104,87,5 ème
SEINE-SAINT-DENIS,LE BLANC-MESNIL,0931433C,199,183,16,0,87,112,5 ème
SEINE-SAINT-DENIS,LE BOURGET,0930963S,56,56,0,0,28,28,5 ème
SEINE-SAINT-DENIS,LE BOURGET,0931187K,158,156,0,2,78,80,5 ème
SEINE-SAINT-DENIS,LES PAVILLONS-SOUS-BOIS,0930100D,117,113,0,4,52,65,5 ème
SEINE-SAINT-DENIS,LES PAVILLONS-SOUS-BOIS,0930136T,0,0,0,0,0,0,5 ème
SEINE-SAINT-DENIS,LIVRY-GARGAN,0932695Z,167,165,0,2,85,82,5 ème
SEINE-SAINT-DENIS,MONTREUIL,0930912L,56,56,0,0,31,25,5 ème
SEINE-SAINT-DENIS,MONTREUIL,0930960N,0,0,0,0,0,0,5 ème
SEINE-SAINT-DENIS,MONTREUIL,0931209J,89,89,0,0,45,44,5 ème
SEINE-SAINT-DENIS,NOISY-LE-GRAND,0931978V,146,142,0,4,73,73,5 ème
SEINE-SAINT-DENIS,NOISY-LE-SEC,0930133P,0,0,0,0,0,0,5 ème
SEINE-SAINT-DENIS,PANTIN,0930135S,0,0,0,0,0,0,5 ème
SEINE-SAINT-DENIS,PANTIN,0931216S,94,94,0,0,40,54,5 ème
SEINE-SAINT-DENIS,PANTIN,0931528F,172,147,12,13,80,92,5 ème
SEINE-SAINT-DENIS,SAINT-DENIS,0931489N,135,122,6,7,65,70,5 ème
SEINE-SAINT-DENIS,SAINT-OUEN,0931143M,178,163,15,0,100,78,5 ème
SEINE-SAINT-DENIS,STAINS,0931226C,180,168,12,0,75,105,5 ème
SEINE-SAINT-DENIS,TREMBLAY-EN-FRANCE,0931191P,172,168,0,4,89,83,5 ème
SEINE-SAINT-DENIS,VILLEPINTE,0932263E,190,190,0,0,85,105,5 ème
SEINE-SAINT-DENIS,VILLETANEUSE,0932334G,114,114,0,0,52,62,5 ème
VAL-DE-MARNE,ALFORTVILLE,0941021Z,95,93,0,2,42,53,5 ème
VAL-DE-MARNE,BOISSY-SAINT-LEGER,0941478W,96,96,0,0,48,48,5 ème
VAL-DE-MARNE,CACHAN,0940823J,0,0,0,0,0,0,5 ème
VAL-DE-MARNE,CACHAN,0941100K,164,164,0,0,87,77,5 ème
VAL-DE-MARNE,CACHAN,0941101L,125,123,0,2,62,63,5 ème
VAL-DE-MARNE,CHAMPIGNY-SUR-MARNE,0940132H,0,0,0,0,0,0,5 ème
VAL-DE-MARNE,CHAMPIGNY-SUR-MARNE,0940807S,86,86,0,0,52,34,5 ème
VAL-DE-MARNE,CHAMPIGNY-SUR-MARNE,0941951K,0,0,0,0,0,0,5 ème
VAL-DE-MARNE,CHAMPIGNY-SUR-MARNE,0942499F,85,85,0,0,39,46,5 ème
VAL-DE-MARNE,CHENNEVIERES-SUR-MARNE,0941470M,0,0,0,0,0,0,5 ème
VAL-DE-MARNE,CHEVILLY-LARUE,0940071S,117,112,0,5,57,60,5 ème
VAL-DE-MARNE,CHEVILLY-LARUE,0940581W,118,118,0,0,68,50,5 ème
VAL-DE-MARNE,CHOISY-LE-ROI,0941231C,114,112,0,2,53,61,5 ème
VAL-DE-MARNE,CHOISY-LE-ROI,0941232D,0,0,0,0,0,0,5 ème
VAL-DE-MARNE,CRETEIL,0940114N,0,0,0,0,0,0,5 ème
VAL-DE-MARNE,CRETEIL,0941942A,41,41,0,0,0,41,5 ème
VAL-DE-MARNE,FONTENAY-SOUS-BOIS,0941090Z,130,130,0,0,59,71,5 ème
VAL-DE-MARNE,FRESNES,0940101Z,113,113,0,0,61,52,5 ème
VAL-DE-MARNE,IVRY-SUR-SEINE,0941026E,120,120,0,0,56,64,5 ème
VAL-DE-MARNE,JOINVILLE-LE-PONT,0940038F,109,109,0,0,65,44,5 ème
VAL-DE-MARNE,JOINVILLE-LE-PONT,0942355Z,0,0,0,0,0,0,5 ème
VAL-DE-MARNE,LA QUEUE-EN-BRIE,0941410X,162,162,0,0,69,93,5 ème
VAL-DE-MARNE,LIMEIL-BREVANNES,0941783C,142,138,0,4,60,82,5 ème
VAL-DE-MARNE,MANDRES-LES-ROSES,0942187S,117,117,0,0,55,62,5 ème
VAL-DE-MARNE,NOGENT-SUR-MARNE,0941599C,133,133,0,0,61,72,5 ème
VAL-DE-MARNE,ORLY,0940138P,0,0,0,0,0,0,5 ème
VAL-DE-MARNE,ORLY,0941042X,143,138,0,5,73,70,5 ème
VAL-DE-MARNE,ORLY,0941891V,28,23,0,5,14,14,5 ème
VAL-DE-MARNE,SUCY-EN-BRIE,0940617K,167,156,11,0,85,82,5 ème
VAL-DE-MARNE,SUCY-EN-BRIE,0941716E,182,182,0,0,101,81,5 ème
VAL-DE-MARNE,THIAIS,0940575P,173,138,32,3,73,100,5 ème
VAL-DE-MARNE,THIAIS,0942119T,11,11,0,0,4,7,5 ème
VAL-DE-MARNE,VILLEJUIF,0941036R,108,108,0,0,44,64,5 ème
VAL-DE-MARNE,VINCENNES,0941718G,149,149,0,0,85,64,5 ème
VAL-DE-MARNE,VITRY-SUR-SEINE,0940042K,118,118,0,0,52,66,5 ème
VAL-DE-MARNE,VITRY-SUR-SEINE,0940794C,117,117,0,0,50,67,5 ème
VAL-DE-MARNE,VITRY-SUR-SEINE,0941029H,143,139,0,4,72,71,5 ème
PARIS,PARIS,0752923V,164,164,0,0,81,83,5 ème
PARIS,PARIS,0750608D,115,113,0,2,56,59,5 ème
PARIS,PARIS,0754290F,51,51,0,0,20,31,5 ème
PARIS,PARIS,0752845K,0,0,0,0,0,0,5 ème
PARIS,PARIS,0750525N,114,111,0,3,56,58,5 ème
PARIS,PARIS,0751710B,0,0,0,0,0,0,5 ème
PARIS,PARIS,0752385K,111,95,11,5,50,61,5 ème
PARIS,PARIS,0752539C,111,108,0,3,53,58,5 ème
PARIS,PARIS,0751563S,103,97,0,6,61,42,5 ème
PARIS,PARIS,0752190Y,120,101,15,4,64,56,5 ème
PARIS,PARIS,0756020L,6,4,0,2,3,3,5 ème
PARIS,PARIS,0752551R,127,123,0,4,51,76,5 ème
PARIS,PARIS,0752917N,178,178,0,0,97,81,5 ème
PARIS,PARIS,0753217P,0,0,0,0,0,0,5 ème
PARIS,PARIS,0755192L,30,30,0,0,14,16,5 ème
PARIS,PARIS,0752319N,172,164,0,8,76,96,5 ème
PARIS,PARIS,0754239A,0,0,0,0,0,0,5 ème
PARIS,PARIS,0755030K,74,72,0,2,37,37,5 ème
PARIS,PARIS,0750484U,66,62,0,4,30,36,5 ème
PARIS,PARIS,0750507U,133,120,13,0,56,77,5 ème
PARIS,PARIS,0750802P,0,0,0,0,0,0,5 ème
PARIS,PARIS,0753345D,88,88,0,0,46,42,5 ème
PARIS,PARIS,0754003U,86,86,0,0,51,35,5 ème
PARIS,PARIS,0755095F,70,67,0,3,31,39,5 ème
PARIS,PARIS,0750550R,96,96,0,0,35,61,5 ème
PARIS,PARIS,0753387Z,8,8,0,0,0,8,5 ème
PARIS,PARIS,0750770E,0,0,0,0,0,0,5 ème
PARIS,PARIS,0752523K,112,106,0,6,56,56,5 ème
PARIS,PARIS,0752524L,98,98,0,0,45,53,5 ème
PARIS,PARIS,0752913J,85,85,0,0,38,47,5 ème
PARIS,PARIS,0753840S,0,0,0,0,0,0,5 ème
PARIS,PARIS,0754757N,96,96,0,0,59,37,5 ème
PARIS,PARIS,0752894N,130,130,0,0,68,62,5 ème
PARIS,PARIS,0752899U,126,126,0,0,60,66,5 ème
PARIS,PARIS,0752842G,274,269,0,5,143,131,5 ème
PARIS,PARIS,0752250N,108,101,0,7,53,55,5 ème
ESSONNE,BOUSSY-SAINT-ANTOINE,0911022S,228,228,0,0,123,105,5 ème
ESSONNE,BRETIGNY-SUR-ORGE,0910827E,138,138,0,0,72,66,5 ème
ESSONNE,BRIIS-SOUS-FORGES,0911920T,134,134,0,0,58,76,5 ème
ESSONNE,BRUNOY,0911746D,215,215,0,0,122,93,5 ème
ESSONNE,CHILLY-MAZARIN,0910777A,226,225,0,1,116,110,5 ème
ESSONNE,CORBEIL-ESSONNES,0910752Y,170,170,0,0,78,92,5 ème
ESSONNE,DOURDAN,0911015J,94,94,0,0,50,44,5 ème
ESSONNE,EVRY-COURCOURONNES,0911250P,141,139,0,2,65,76,5 ème
ESSONNE,EVRY-COURCOURONNES,0911729K,119,117,0,2,58,61,5 ème
ESSONNE,GIF-SUR-YVETTE,0910024G,164,161,0,3,79,85,5 ème
ESSONNE,GRIGNY,0912196T,141,138,0,3,69,72,5 ème
ESSONNE,GUIGNEVILLE-SUR-ESSONNE,0911574S,121,101,16,4,56,65,5 ème
ESSONNE,IGNY,0910969J,207,207,0,0,88,119,5 ème
ESSONNE,ITTEVILLE,0912109Y,142,142,0,0,57,85,5 ème
ESSONNE,MASSY,0910632T,0,0,0,0,0,0,5 ème
ESSONNE,MILLY-LA-FORET,0911404G,166,162,0,4,83,83,5 ème
ESSONNE,MONTGERON,0911396Y,164,150,14,0,85,79,5 ème
ESSONNE,MORANGIS,0910041A,199,197,0,2,91,108,5 ème
ESSONNE,ORSAY,0911749G,95,93,0,2,45,50,5 ème
ESSONNE,QUINCY-SOUS-SENART,0911493D,0,0,0,0,0,0,5 ème
ESSONNE,RIS-ORANGIS,0910049J,256,255,0,1,132,124,5 ème
ESSONNE,RIS-ORANGIS,0911025V,224,206,15,3,117,107,5 ème
ESSONNE,RIS-ORANGIS,0911578W,0,0,0,0,0,0,5 ème
ESSONNE,SAINTE-GENEVIEVE-DES-BOIS,0911042N,195,190,0,5,99,96,5 ème
ESSONNE,SAVIGNY-SUR-ORGE,0911889J,2,2,0,0,0,2,5 ème
ESSONNE,VIRY-CHATILLON,0910056S,115,115,0,0,61,54,5 ème
HAUTS-DE-SEINE,ANTONY,0921243B,107,107,0,0,40,67,5 ème
HAUTS-DE-SEINE,ANTONY,0921868F,86,86,0,0,42,44,5 ème
HAUTS-DE-SEINE,ANTONY,0921901S,370,366,0,4,176,194,5 ème
HAUTS-DE-SEINE,BAGNEUX,0921903U,60,60,0,0,28,32,5 ème
HAUTS-DE-SEINE,BOIS-COLOMBES,0922629H,156,154,0,2,79,77,5 ème
HAUTS-DE-SEINE,BOULOGNE-BILLANCOURT,0921236U,203,200,0,3,87,116,5 ème
HAUTS-DE-SEINE,BOULOGNE-BILLANCOURT,0921239X,182,172,10,0,87,95,5 ème
HAUTS-DE-SEINE,CHATILLON,0920880G,150,139,6,5,81,69,5 ème
HAUTS-DE-SEINE,CLICHY,0921228K,188,177,9,2,89,99,5 ème
HAUTS-DE-SEINE,CLICHY,0922595W,142,141,0,1,67,75,5 ème
HAUTS-DE-SEINE,COLOMBES,0921494Z,152,149,0,3,72,80,5 ème
HAUTS-DE-SEINE,COLOMBES,0921675W,131,123,8,0,63,68,5 ème
HAUTS-DE-SEINE,COLOMBES,0921908Z,217,211,6,0,108,109,5 ème
HAUTS-DE-SEINE,COLOMBES,0922662U,120,120,0,0,51,69,5 ème
HAUTS-DE-SEINE,COURBEVOIE,0921496B,166,157,7,2,78,88,5 ème
HAUTS-DE-SEINE,COURBEVOIE,0922482Y,49,49,0,0,0,49,5 ème
HAUTS-DE-SEINE,COURBEVOIE,0922523T,164,163,0,1,82,82,5 ème
HAUTS-DE-SEINE,GENNEVILLIERS,0921621M,185,182,0,3,104,81,5 ème
HAUTS-DE-SEINE,LEVALLOIS-PERRET,0922630J,140,139,0,1,54,86,5 ème
HAUTS-DE-SEINE,MALAKOFF,0920163C,0,0,0,0,0,0,5 ème
HAUTS-DE-SEINE,MEUDON,0921909A,73,73,0,0,35,38,5 ème
HAUTS-DE-SEINE,MEUDON,0922701L,145,137,8,0,73,72,5 ème
HAUTS-DE-SEINE,MONTROUGE,0920164D,0,0,0,0,0,0,5 ème
HAUTS-DE-SEINE,MONTROUGE,0921190U,101,98,0,3,48,53,5 ème
HAUTS-DE-SEINE,NANTERRE,0920077J,151,144,7,0,67,84,5 ème
HAUTS-DE-SEINE,NANTERRE,0920882J,153,153,0,0,85,68,5 ème
HAUTS-DE-SEINE,NANTERRE,0921353W,142,140,0,2,68,74,5 ème
HAUTS-DE-SEINE,NEUILLY-SUR-SEINE,0921015D,95,95,0,0,38,57,5 ème
HAUTS-DE-SEINE,PUTEAUX,0921500F,0,0,0,0,0,0,5 ème
HAUTS-DE-SEINE,RUEIL-MALMAISON,0921234S,143,143,0,0,73,70,5 ème
HAUTS-DE-SEINE,RUEIL-MALMAISON,0921502H,151,148,0,3,67,84,5 ème
HAUTS-DE-SEINE,SAINT-CLOUD,0922276Z,0,0,0,0,0,0,5 ème
HAUTS-DE-SEINE,SCEAUX,0921785R,178,178,0,0,85,93,5 ème
HAUTS-DE-SEINE,SURESNES,0920884L,153,150,0,3,76,77,5 ème
HAUTS-DE-SEINE,VAUCRESSON,0921935D,50,50,0,0,17,33,5 ème
HAUTS-DE-SEINE,VAUCRESSON,0922143E,71,71,0,0,46,25,5 ème
HAUTS-DE-SEINE,VILLENEUVE-LA-GARENNE,0922277A,0,0,0,0,0,0,5 ème
VAL-D'OISE,ARGENTEUIL,0950800D,0,0,0,0,0,0,5 ème
VAL-D'OISE,ARGENTEUIL,0951138W,163,157,0,6,84,79,5 ème
VAL-D'OISE,ARGENTEUIL,0951139X,107,104,0,3,46,61,5 ème
VAL-D'OISE,ARGENTEUIL,0951230W,159,140,13,6,73,86,5 ème
VAL-D'OISE,ARGENTEUIL,0952114G,140,135,0,5,79,61,5 ème
VAL-D'OISE,BEAUMONT-SUR-OISE,0950933Y,150,148,0,2,77,73,5 ème
VAL-D'OISE,BERNES-SUR-OISE,0952087C,124,124,0,0,61,63,5 ème
VAL-D'OISE,BEZONS,0950888Z,196,182,11,3,93,103,5 ème
VAL-D'OISE,BOUFFEMONT,0951822P,106,106,0,0,53,53,5 ème
VAL-D'OISE,ERMONT,0950657Y,0,0,0,0,0,0,5 ème
VAL-D'OISE,EZANVILLE,0952127W,140,140,0,0,76,64,5 ème
VAL-D'OISE,FRANCONVILLE,0950812S,0,0,0,0,0,0,5 ème
VAL-D'OISE,GOUSSAINVILLE,0950026M,181,155,21,5,88,93,5 ème
VAL-D'OISE,HERBLAY,0950932X,201,186,12,3,98,103,5 ème
VAL-D'OISE,LOUVRES,0950908W,152,147,0,5,77,75,5 ème
VAL-D'OISE,LUZARCHES,0951357J,167,162,0,5,85,82,5 ème
VAL-D'OISE,MERY-SUR-OISE,0951725J,159,156,0,3,76,83,5 ème
VAL-D'OISE,MONTIGNY-LES-CORMEILLES,0951800R,170,170,0,0,88,82,5 ème
VAL-D'OISE,PONTOISE,0950894F,175,173,0,2,78,97,5 ème
VAL-D'OISE,PONTOISE,0951507X,114,114,0,0,59,55,5 ème
VAL-D'OISE,SANNOIS,0951508Y,165,165,0,0,84,81,5 ème
VAL-D'OISE,SARCELLES,0950900M,86,83,0,3,44,42,5 ème
VAL-D'OISE,SARCELLES,0950943J,117,98,15,4,56,61,5 ème
VAL-D'OISE,SARCELLES,0951196J,157,153,0,4,74,83,5 ème
VAL-D'OISE,SOISY-SOUS-MONTMORENCY,0950046J,90,90,0,0,47,43,5 ème
VAL-D'OISE,TAVERNY,0951197K,193,190,0,3,88,105,5 ème
VAL-D'OISE,VILLIERS-LE-BEL,0950749Y,124,123,0,1,69,55,5 ème
YVELINES,ACHERES,0783636D,116,116,0,0,59,57,5 ème
YVELINES,BEYNES,0780713B,177,177,0,0,79,98,5 ème
YVELINES,BUC,0780715D,171,171,0,0,81,90,5 ème
YVELINES,BUC,0783546F,95,95,0,0,55,40,5 ème
YVELINES,CARRIERES-SOUS-POISSY,0780032L,136,136,0,0,76,60,5 ème
YVELINES,CARRIERES-SOUS-POISSY,0781817B,86,86,0,0,29,57,5 ème
YVELINES,CHANTELOUP-LES-VIGNES,0781108F,77,61,16,0,35,42,5 ème
YVELINES,CHATOU,0780575B,135,135,0,0,59,76,5 ème
YVELINES,ECQUEVILLY,0781915H,116,114,0,2,64,52,5 ème
YVELINES,ELANCOURT,0782114Z,129,125,0,4,58,71,5 ème
YVELINES,LE MESNIL-SAINT-DENIS,0780512H,120,120,0,0,55,65,5 ème
YVELINES,LES MUREAUX,0780180X,169,169,0,0,95,74,5 ème
YVELINES,MAISONS-LAFFITTE,0780112Y,112,112,0,0,57,55,5 ème
YVELINES,MANTES-LA-VILLE,0783533S,0,0,0,0,0,0,5 ème
YVELINES,MAUREPAS,0780720J,167,161,0,6,85,82,5 ème
YVELINES,MONTFORT-L'AMAURY,0781600R,167,167,0,0,100,67,5 ème
YVELINES,MONTIGNY-LE-BRETONNEUX,0781662H,264,252,12,0,138,126,5 ème
YVELINES,MONTIGNY-LE-BRETONNEUX,0782087V,124,123,0,1,62,62,5 ème
YVELINES,ORGERUS,0781864C,158,157,0,1,73,85,5 ème
YVELINES,POISSY,0781983G,0,0,0,0,0,0,5 ème
YVELINES,PORCHEVILLE,0781948U,0,0,0,0,0,0,5 ème
YVELINES,RAMBOUILLET,0780256E,171,155,16,0,88,83,5 ème
YVELINES,RAMBOUILLET,0781886B,165,163,0,2,79,86,5 ème
YVELINES,SAINT-GERMAIN-EN-LAYE,0780714C,205,205,0,0,103,102,5 ème
YVELINES,SAINT-GERMAIN-EN-LAYE,0781205L,190,190,0,0,96,94,5 ème
YVELINES,SARTROUVILLE,0783463R,122,119,0,3,64,58,5 ème
YVELINES,TRAPPES,0780187E,98,80,14,4,46,52,5 ème
YVELINES,VELIZY-VILLACOUBLAY,0780265P,144,137,7,0,71,73,5 ème
YVELINES,VERNEUIL-SUR-SEINE,0781537X,253,251,0,2,122,131,5 ème
YVELINES,VILLIERS-SAINT-FREDERIC,0782587N,0,0,0,0,0,0,5 ème
LA REUNION,ENTRE-DEUX,9740006N,115,111,0,4,61,54,5 ème
LA REUNION,LA POSSESSION,9740909V,223,190,32,1,122,101,5 ème
LA REUNION,LES TROIS-BASSINS,9740085Z,96,95,0,1,51,45,5 ème
LA REUNION,L'ETANG-SALE,9741387P,129,124,0,5,70,59,5 ème
LA REUNION,PETITE-ILE,9740654T,173,172,0,1,86,87,5 ème
LA REUNION,SAINT-ANDRE,9740703W,140,137,0,3,77,63,5 ème
LA REUNION,SAINT-DENIS,9740072K,336,336,0,0,180,156,5 ème
LA REUNION,SAINT-DENIS,9740595D,124,122,0,2,66,58,5 ème
LA REUNION,SAINT-DENIS,9740645H,249,231,16,2,107,142,5 ème
LA REUNION,SAINT-DENIS,9741308D,0,0,0,0,0,0,5 ème
LA REUNION,SAINTE-MARIE,9740735F,160,124,32,4,67,93,5 ème
LA REUNION,SAINTE-MARIE,9741323V,197,197,0,0,101,96,5 ème
LA REUNION,SAINTE-SUZANNE,9740679V,0,0,0,0,0,0,5 ème
LA REUNION,SAINT-LOUIS,9740841W,208,174,31,3,91,117,5 ème
LA REUNION,SAINT-PAUL,9741763Y,171,170,0,1,83,88,5 ème
LA REUNION,SAINT-PIERRE,9740027L,198,194,0,4,101,97,5 ème
LA REUNION,SAINT-PIERRE,9740835P,264,261,0,3,144,120,5 ème
LA REUNION,SAINT-PIERRE,9741049X,121,120,0,1,68,53,5 ème
LA REUNION,SALAZIE,9740651P,105,88,12,5,49,56,5 ème
MARTINIQUE,FORT-DE-FRANCE,9720007A,57,57,0,0,28,29,5 ème
MARTINIQUE,FORT-DE-FRANCE,9720515C,0,0,0,0,0,0,5 ème
MARTINIQUE,FORT-DE-FRANCE,9720682J,117,99,11,7,52,65,5 ème
MARTINIQUE,FORT-DE-FRANCE,9720897T,85,85,0,0,33,52,5 ème
MARTINIQUE,LA TRINITE,9720430K,0,0,0,0,0,0,5 ème
MARTINIQUE,LE FRANCOIS,9720428H,107,89,10,8,52,55,5 ème
MARTINIQUE,LE LAMENTIN,9720072W,127,127,0,0,73,54,5 ème
MARTINIQUE,LE LAMENTIN,9720083H,91,83,0,8,48,43,5 ème
MARTINIQUE,LE LAMENTIN,9720470D,156,121,29,6,78,78,5 ème
MARTINIQUE,LE LAMENTIN,9720848P,64,60,0,4,30,34,5 ème
MARTINIQUE,LE MARIGOT,9720028Y,23,23,0,0,15,8,5 ème
MARTINIQUE,LE MORNE-ROUGE,9720016K,34,34,0,0,18,16,5 ème
MARTINIQUE,LE ROBERT,9720043P,88,88,0,0,47,41,5 ème
MARTINIQUE,SAINTE-MARIE,9720006Z,56,49,0,7,22,34,5 ème
MARTINIQUE,SAINTE-MARIE,9720692V,0,0,0,0,0,0,5 ème
MARTINIQUE,SCHOELCHER,9720455M,102,102,0,0,51,51,5 ème
MAYOTTE,DZAOUDZI,9760008E,451,420,31,0,244,207,5 ème
MAYOTTE,MAMOUDZOU,9760314M,320,318,0,2,161,159,5 ème
MAYOTTE,MTSAMBORO,9760230W,394,362,28,4,199,195,5 ème
CALVADOS,CAEN,0141159J,132,132,0,0,57,75,5 ème
CALVADOS,CAEN,0141554N,106,106,0,0,57,49,5 ème
CALVADOS,CAEN,0141810S,149,147,0,2,59,90,5 ème
CALVADOS,CAEN,0141866C,0,0,0,0,0,0,5 ème
CALVADOS,CAUMONT-SUR-AURE,0140038R,87,85,0,2,34,53,5 ème
CALVADOS,DIVES-SUR-MER,0141599M,0,0,0,0,0,0,5 ème
CALVADOS,HEROUVILLE-SAINT-CLAIR,0142173L,45,45,0,0,24,21,5 ème
CALVADOS,IFS,0142271T,203,180,16,7,96,107,5 ème
CALVADOS,LE HOM,0141641H,126,126,0,0,55,71,5 ème
CALVADOS,LE MOLAY-LITTRY,0141642J,82,82,0,0,47,35,5 ème
CALVADOS,LISIEUX,0141197A,0,0,0,0,0,0,5 ème
CALVADOS,LISIEUX,0141219Z,41,38,0,3,21,20,5 ème
CALVADOS,LISIEUX,0141275K,0,0,0,0,0,0,5 ème
CALVADOS,LISIEUX,0141868E,0,0,0,0,0,0,5 ème
CALVADOS,MONDEVILLE,0141256P,146,142,0,4,66,80,5 ème
CALVADOS,NOUES DE SIENNE,0140079K,61,61,0,0,32,29,5 ème
CALVADOS,ORBEC,0141171X,27,27,0,0,19,8,5 ème
CALVADOS,OUISTREHAM,0141271F,132,132,0,0,68,64,5 ème
CALVADOS,TREVIERES,0140082N,54,54,0,0,23,31,5 ème
CALVADOS,VILLERS-BOCAGE,0140088V,130,127,0,3,67,63,5 ème
EURE,BEUZEVILLE,0270006K,138,135,0,3,72,66,5 ème
EURE,CORMEILLES,0270013T,109,109,0,0,57,52,5 ème
EURE,EVREUX,0270019Z,168,168,0,0,93,75,5 ème
EURE,EVREUX,0271104D,111,110,0,1,60,51,5 ème
EURE,EVREUX,0271231S,178,178,0,0,95,83,5 ème
EURE,LES ANDELYS,0271585B,0,0,0,0,0,0,5 ème
EURE,LOUVIERS,0271119V,146,146,0,0,78,68,5 ème
EURE,PACY-SUR-EURE,0271322R,127,127,0,0,67,60,5 ème
EURE,VERNON,0271447B,121,121,0,0,75,46,5 ème
MANCHE,CANISY,0500011R,96,89,0,7,47,49,5 ème
MANCHE,CHERBOURG-EN-COTENTIN,0500024E,68,63,0,5,37,31,5 ème
MANCHE,CHERBOURG-EN-COTENTIN,0500080R,151,127,22,2,70,81,5 ème
MANCHE,CHERBOURG-EN-COTENTIN,0500140F,122,122,0,0,52,70,5 ème
MANCHE,CHERBOURG-EN-COTENTIN,0501702D,110,109,0,1,53,57,5 ème
MANCHE,GRANVILLE,0500036T,0,0,0,0,0,0,5 ème
MANCHE,GRANVILLE,0501705G,135,135,0,0,66,69,5 ème
MANCHE,MARIGNY-LE-LOZON,0500046D,77,75,0,2,34,43,5 ème
MANCHE,MONTEBOURG,0500047E,46,46,0,0,16,30,5 ème
MANCHE,MORTAIN-BOCAGE,0500144K,42,42,0,0,20,22,5 ème
MANCHE,SAINT-HILAIRE-DU-HARCOUET,0500087Y,0,0,0,0,0,0,5 ème
MANCHE,SARTILLY-BAIE-BOCAGE,0500075K,58,58,0,0,27,31,5 ème
MANCHE,SOURDEVAL,0500153V,42,42,0,0,24,18,5 ème
MANCHE,VILLEDIEU-LES-POELES-ROUFFIGNY,0500083U,98,87,9,2,43,55,5 ème
ORNE,ALENCON,0610693X,81,81,0,0,31,50,5 ème
ORNE,ALENCON,0610918S,128,112,15,1,61,67,5 ème
ORNE,ALENCON,0611091E,114,114,0,0,52,62,5 ème
ORNE,ARGENTAN,0610721C,0,0,0,0,0,0,5 ème
ORNE,BELLEME,0610010E,69,67,0,2,31,38,5 ème
ORNE,FLERS,0610021S,0,0,0,0,0,0,5 ème
ORNE,FLERS,0610057F,106,89,15,2,42,64,5 ème
ORNE,FLERS,0611092F,150,147,0,3,68,82,5 ème
ORNE,LA FERTE MACE,0610800N,85,83,0,2,40,45,5 ème
ORNE,MORTAGNE-AU-PERCHE,0610033E,119,103,15,1,54,65,5 ème
ORNE,REMALARD EN PERCHE,0610740Y,57,57,0,0,32,25,5 ème
ORNE,SEES,0610040M,87,84,0,3,38,49,5 ème
ORNE,TINCHEBRAY-BOCAGE,0610714V,49,49,0,0,27,22,5 ème
SEINE MARITIME,AUMALE,0761722J,84,83,0,1,39,45,5 ème
SEINE MARITIME,BIHOREL,0761692B,76,73,0,3,33,43,5 ème
SEINE MARITIME,DEVILLE-LES-ROUEN,0761727P,137,137,0,0,64,73,5 ème
SEINE MARITIME,DEVILLE-LES-ROUEN,0762202F,107,107,0,0,45,62,5 ème
SEINE MARITIME,DIEPPE,0760026R,112,94,15,3,55,57,5 ème
SEINE MARITIME,DIEPPE,0762569E,96,96,0,0,42,54,5 ème
SEINE MARITIME,EU,0760032X,0,0,0,0,0,0,5 ème
SEINE MARITIME,EU,0761730T,37,37,0,0,22,15,5 ème
SEINE MARITIME,FECAMP,0761704P,67,61,0,6,35,32,5 ème
SEINE MARITIME,GOURNAY-EN-BRAY,0760046M,108,102,4,2,59,49,5 ème
SEINE MARITIME,GRAND-COURONNE,0762080Y,81,71,7,3,41,40,5 ème
SEINE MARITIME,HARFLEUR,0762129B,138,138,0,0,69,69,5 ème
SEINE MARITIME,LE HAVRE,0760058A,0,0,0,0,0,0,5 ème
SEINE MARITIME,LE HAVRE,0761325C,111,110,0,1,47,64,5 ème
SEINE MARITIME,LE HAVRE,0761697G,94,93,0,1,46,48,5 ème
SEINE MARITIME,LE HAVRE,0761698H,60,56,0,4,20,40,5 ème
SEINE MARITIME,LE HAVRE,0761783A,57,57,0,0,32,25,5 ème
SEINE MARITIME,LE HAVRE,0762765T,0,0,0,0,0,0,5 ème
SEINE MARITIME,LE TREPORT,0762087F,122,119,0,3,56,66,5 ème
SEINE MARITIME,LUNERAY,0762199C,106,106,0,0,52,54,5 ème
SEINE MARITIME,OFFRANVILLE,0762125X,114,111,0,3,51,63,5 ème
SEINE MARITIME,PORT-JEROME-SUR-SEINE,0762176C,165,162,0,3,79,86,5 ème
SEINE MARITIME,ROUEN,0760100W,60,57,0,3,33,27,5 ème
SEINE MARITIME,ROUEN,0761745J,96,96,0,0,49,47,5 ème
SEINE MARITIME,ROUEN,0761780X,108,106,0,2,63,45,5 ème
SEINE MARITIME,ROUEN,0762566B,140,140,0,0,61,79,5 ème
SEINE MARITIME,SAINT-ETIENNE-DU-ROUVRAY,0762133F,120,120,0,0,55,65,5 ème
SEINE MARITIME,SAINT-VALERY-EN-CAUX,0760108E,143,130,11,2,61,82,5 ème
SEINE MARITIME,SOTTEVILLE-LES-ROUEN,0762211R,28,0,28,0,11,17,5 ème
SEINE MARITIME,YVETOT,0761338S,256,256,0,0,115,141,5 ème
DORDOGNE,BERGERAC,0240119Z,128,108,15,5,61,67,5 ème
DORDOGNE,COULOUNIEIX-CHAMIERS,0240047W,84,79,3,2,28,56,5 ème
DORDOGNE,LA COQUILLE,0240045U,35,35,0,0,17,18,5 ème
DORDOGNE,MAREUIL EN PERIGORD,0240016M,34,34,0,0,17,17,5 ème
DORDOGNE,PAYS DE BELVES,0240962R,82,78,4,0,40,42,5 ème
DORDOGNE,PERIGUEUX,0240029B,136,133,0,3,66,70,5 ème
DORDOGNE,PERIGUEUX,0241042C,167,167,0,0,86,81,5 ème
DORDOGNE,SAINT AULAYE-PUYMANGOU,0240055E,61,61,0,0,34,27,5 ème
DORDOGNE,TOCANE-SAINT-APRE,0240073Z,75,75,0,0,38,37,5 ème
DORDOGNE,VELINES,0240106K,63,63,0,0,32,31,5 ème
GIRONDE,ARCACHON,0332487Z,136,135,0,1,70,66,5 ème
GIRONDE,BAZAS,0330011H,0,0,0,0,0,0,5 ème
GIRONDE,BLANQUEFORT,0333129X,28,28,0,0,11,17,5 ème
GIRONDE,BORDEAUX,0330033G,0,0,0,0,0,0,5 ème
GIRONDE,BORDEAUX,0330140Y,144,132,11,1,68,76,5 ème
GIRONDE,BORDEAUX,0332285E,86,75,5,6,47,39,5 ème
GIRONDE,BORDEAUX,0332488A,253,251,0,2,117,136,5 ème
GIRONDE,BORDEAUX,0332746F,124,124,0,0,65,59,5 ème
GIRONDE,BRUGES,0333274E,104,102,0,2,46,58,5 ème
GIRONDE,CADAUJAC,0333133B,173,173,0,0,80,93,5 ème
GIRONDE,CENON,0331885V,180,166,11,3,83,97,5 ème
GIRONDE,LACANAU,0333287U,151,151,0,0,76,75,5 ème
GIRONDE,LA REOLE,0332248P,142,138,0,4,65,77,5 ème
GIRONDE,LA TESTE-DE-BUCH,0330129L,190,188,0,2,91,99,5 ème
GIRONDE,LATRESNE,0331620G,233,231,0,2,103,130,5 ème
GIRONDE,LE BOUSCAT,0331669K,192,172,15,5,92,100,5 ème
GIRONDE,LEGE-CAP-FERRET,0332657J,127,127,0,0,59,68,5 ème
GIRONDE,LE HAILLAN,0333530H,105,105,0,0,53,52,5 ème
GIRONDE,LEOGNAN,0332244K,189,189,0,0,82,107,5 ème
GIRONDE,LORMONT,0331895F,123,117,0,6,60,63,5 ème
GIRONDE,PAUILLAC,0330102G,0,0,0,0,0,0,5 ème
GIRONDE,PESSAC,0331529H,144,144,0,0,75,69,5 ème
GIRONDE,PESSAC,0331623K,197,197,0,0,101,96,5 ème
GIRONDE,PESSAC,0332191C,110,98,10,2,47,63,5 ème
GIRONDE,PESSAC,0332345V,0,0,0,0,0,0,5 ème
GIRONDE,RAUZAN,0331433D,111,109,0,2,58,53,5 ème
GIRONDE,SAINT-AUBIN-DE-MEDOC,0333093H,170,170,0,0,82,88,5 ème
GIRONDE,SAINTE-FOY-LA-GRANDE,0330163Y,121,112,7,2,60,61,5 ème
GIRONDE,SALLES,0331666G,250,250,0,0,133,117,5 ème
GIRONDE,TALENCE,0331500B,116,116,0,0,40,76,5 ème
LANDES,CAPBRETON,0400071K,81,81,0,0,34,47,5 ème
LANDES,LABRIT,0401077D,75,75,0,0,31,44,5 ème
LANDES,LINXE,0401015L,101,99,0,2,53,48,5 ème
LANDES,MORCENX-LA-NOUVELLE,0400093J,65,61,0,4,35,30,5 ème
LANDES,PARENTIS-EN-BORN,0400046H,0,0,0,0,0,0,5 ème
LANDES,SAINT-PAUL-LES-DAX,0400096M,139,105,30,4,61,78,5 ème
LANDES,SAINT-PIERRE-DU-MONT,0400080V,0,0,0,0,0,0,5 ème
LANDES,SAINT-VINCENT-DE-PAUL,0400916D,0,0,0,0,0,0,5 ème
LANDES,VILLENEUVE-DE-MARSAN,0400043E,87,84,0,3,41,46,5 ème
LOT-ET-GARONNE,AGEN,0470677F,134,129,0,5,73,61,5 ème
LOT-ET-GARONNE,AIGUILLON,0470774L,105,103,0,2,50,55,5 ème
LOT-ET-GARONNE,FUMEL,0470046V,87,72,15,0,41,46,5 ème
LOT-ET-GARONNE,MONSEMPRON-LIBOS,0470048X,81,81,0,0,39,42,5 ème
LOT-ET-GARONNE,NERAC,0470029B,0,0,0,0,0,0,5 ème
LOT-ET-GARONNE,PENNE-D'AGENAIS,0470031D,116,115,0,1,55,61,5 ème
PYRENEES-ATLANTIQUES,ARETTE,0640004G,28,28,0,0,13,15,5 ème
PYRENEES-ATLANTIQUES,ARTIX,0640231D,162,158,0,4,74,88,5 ème
PYRENEES-ATLANTIQUES,BAYONNE,0640144J,13,13,0,0,7,6,5 ème
PYRENEES-ATLANTIQUES,BAYONNE,0641652Y,114,113,0,1,58,56,5 ème
PYRENEES-ATLANTIQUES,BIARRITZ,0640078M,136,133,0,3,74,62,5 ème
PYRENEES-ATLANTIQUES,BIDACHE,0640019Y,56,56,0,0,26,30,5 ème
PYRENEES-ATLANTIQUES,HASPARREN,0640119G,82,82,0,0,39,43,5 ème
PYRENEES-ATLANTIQUES,HASPARREN,0640181Z,0,0,0,0,0,0,5 ème
PYRENEES-ATLANTIQUES,JURANCON,0641411L,187,166,14,7,86,101,5 ème
PYRENEES-ATLANTIQUES,LARUNS,0640035R,27,27,0,0,10,17,5 ème
PYRENEES-ATLANTIQUES,NAY,0641509T,200,195,0,5,112,88,5 ème
PYRENEES-ATLANTIQUES,OLORON-SAINTE-MARIE,0640048E,95,94,0,1,46,49,5 ème
PYRENEES-ATLANTIQUES,ORTHEZ,0640128S,23,23,0,0,9,14,5 ème
PYRENEES-ATLANTIQUES,PAU,0640133X,140,140,0,0,81,59,5 ème
PYRENEES-ATLANTIQUES,SAINT-ETIENNE-DE-BAIGORRY,0640064X,19,19,0,0,9,10,5 ème
PYRENEES-ATLANTIQUES,SAINT-ETIENNE-DE-BAIGORRY,0640162D,19,19,0,0,11,8,5 ème
PYRENEES-ATLANTIQUES,SAINT-JEAN-DE-LUZ,0641559X,110,110,0,0,53,57,5 ème
PYRENEES-ATLANTIQUES,SALIES-DE-BEARN,0640170M,23,23,0,0,7,16,5 ème
PYRENEES-ATLANTIQUES,SAUVETERRE-DE-BEARN,0640171N,17,17,0,0,9,8,5 ème
PYRENEES-ATLANTIQUES,TARDETS-SORHOLUS,0640074H,35,35,0,0,19,16,5 ème
PYRENEES-ATLANTIQUES,USTARITZ,0640136A,107,107,0,0,58,49,5 ème
CORREZE,ARGENTAT-SUR-DORDOGNE,0190779U,30,29,0,1,15,15,5 ème
CORREZE,CORREZE,0190016P,27,27,0,0,12,15,5 ème
CORREZE,LARCHE,0190720E,147,147,0,0,68,79,5 ème
CORREZE,TULLE,0190613N,147,129,17,1,78,69,5 ème
CORREZE,UZERCHE,0190568P,88,88,0,0,43,45,5 ème
CREUSE,BOURGANEUF,0230507B,70,58,12,0,41,29,5 ème
CREUSE,CHATELUS-MALVALEIX,0230011M,33,22,11,0,10,23,5 ème
CREUSE,FELLETIN,0230019W,0,0,0,0,0,0,5 ème
HAUTE-VIENNE,AIXE-SUR-VIENNE,0870086W,31,31,0,0,16,15,5 ème
HAUTE-VIENNE,LE DORAT,0870819T,56,55,0,1,19,37,5 ème
HAUTE-VIENNE,LIMOGES,0870058R,0,0,0,0,0,0,5 ème
HAUTE-VIENNE,LIMOGES,0870071E,173,173,0,0,84,89,5 ème
HAUTE-VIENNE,LIMOGES,0870083T,125,122,0,3,62,63,5 ème
HAUTE-VIENNE,LIMOGES,0870729V,58,58,0,0,24,34,5 ème
HAUTE-VIENNE,LIMOGES,0870791M,100,86,9,5,48,52,5 ème
HAUTE-VIENNE,LIMOGES,0871030X,0,0,0,0,0,0,5 ème
HAUTE-VIENNE,NANTIAT,0870031L,97,97,0,0,40,57,5 ème
HAUTE-VIENNE,SAINT-JUNIEN,0870041X,0,0,0,0,0,0,5 ème
HAUTE-VIENNE,SAINT-JUNIEN,0870042Y,161,143,15,3,85,76,5 ème
HAUTE-VIENNE,SAINT-SULPICE-LAURIERE,0870048E,35,35,0,0,19,16,5 ème
HAUTE-VIENNE,SAINT-YRIEIX-LA-PERCHE,0870051H,0,0,0,0,0,0,5 ème
CHARENTE,ANGOULEME,0160884Z,59,59,0,0,26,33,5 ème
CHARENTE,BAIGNES-SAINTE-RADEGONDE,0160895L,26,26,0,0,17,9,5 ème
CHARENTE,COGNAC,0160119T,0,0,0,0,0,0,5 ème
CHARENTE,COGNAC,0160864C,94,79,15,0,42,52,5 ème
CHARENTE,COGNAC,0161050E,95,95,0,0,44,51,5 ème
CHARENTE,COTEAUX-DU-BLANZACAIS,0160012B,41,41,0,0,16,25,5 ème
CHARENTE,LA ROCHEFOUCAULD-EN-ANGOUMOIS,0160867F,113,113,0,0,53,60,5 ème
CHARENTE,PUYMOYEN,0160968R,16,0,16,0,6,10,5 ème
CHARENTE,RUELLE-SUR-TOUVRE,0160094R,148,146,0,2,65,83,5 ème
CHARENTE,RUFFEC,0160039F,74,59,10,5,33,41,5 ème
CHARENTE,SAINT-MICHEL,0160969S,113,111,0,2,47,66,5 ème
CHARENTE,TERRES-DE-HAUTE-CHARENTE,0160793A,46,46,0,0,18,28,5 ème
CHARENTE-MARITIME,ARCHIAC,0170002K,83,83,0,0,44,39,5 ème
CHARENTE-MARITIME,COZES,0170008S,101,101,0,0,52,49,5 ème
CHARENTE-MARITIME,LA ROCHELLE,0170077S,104,99,0,5,59,45,5 ème
CHARENTE-MARITIME,LA ROCHELLE,0170099R,232,229,0,3,102,130,5 ème
CHARENTE-MARITIME,PONS,0170389F,126,111,11,4,58,68,5 ème
CHARENTE-MARITIME,PONT-L'ABBE-D'ARNOULT,0171340P,143,143,0,0,75,68,5 ème
CHARENTE-MARITIME,ROCHEFORT,0170025K,0,0,0,0,0,0,5 ème
CHARENTE-MARITIME,ROCHEFORT,0171057G,140,138,0,2,81,59,5 ème
CHARENTE-MARITIME,SAINT-AGNANT,0170047J,150,150,0,0,79,71,5 ème
CHARENTE-MARITIME,SAINT-PIERRE-D'OLERON,0171215D,95,95,0,0,45,50,5 ème
CHARENTE-MARITIME,SURGERES,0170070J,0,0,0,0,0,0,5 ème
CHARENTE-MARITIME,SURGERES,0170071K,181,165,14,2,99,82,5 ème
DEUX-SEVRES,BRIOUX-SUR-BOUTONNE,0790010G,66,66,0,0,32,34,5 ème
DEUX-SEVRES,CHEF-BOUTONNE,0790015M,0,0,0,0,0,0,5 ème
DEUX-SEVRES,FRONTENAY-ROHAN-ROHAN,0790699F,141,141,0,0,67,74,5 ème
DEUX-SEVRES,MAZIERES-EN-GATINE,0790044U,61,56,0,5,32,29,5 ème
DEUX-SEVRES,NIORT,0790703K,134,131,0,3,64,70,5 ème
DEUX-SEVRES,NIORT,0790928E,0,0,0,0,0,0,5 ème
DEUX-SEVRES,SAINT-MAIXENT-L'ECOLE,0790072Z,74,74,0,0,27,47,5 ème
DEUX-SEVRES,SECONDIGNY,0790074B,36,36,0,0,14,22,5 ème
DEUX-SEVRES,THOUARS,0791002K,119,82,29,8,60,59,5 ème
VIENNE,CIVRAY,0860010U,0,0,0,0,0,0,5 ème
VIENNE,LENCLOITRE,0860020E,137,136,0,1,71,66,5 ème
VIENNE,LOUDUN,0860765P,75,75,0,0,37,38,5 ème
VIENNE,LUSSAC-LES-CHATEAUX,0860026L,120,118,0,2,64,56,5 ème
VIENNE,MONTMORILLON,0860029P,0,0,0,0,0,0,5 ème
VIENNE,MONTMORILLON,0860031S,100,98,0,2,46,54,5 ème
VIENNE,POITIERS,0860774Z,0,0,0,0,0,0,5 ème
VIENNE,POITIERS,0860789R,0,0,0,0,0,0,5 ème
VIENNE,POITIERS,0861447F,88,88,0,0,41,47,5 ème
VIENNE,VOUILLE,0860772X,118,118,0,0,54,64,5 ème
AUDE,CAPENDU,0110003U,92,86,0,6,42,50,5 ème
AUDE,CARCASSONNE,0110045P,0,0,0,0,0,0,5 ème
AUDE,CARCASSONNE,0110672W,183,155,23,5,76,107,5 ème
AUDE,CHALABRE,0110870L,21,21,0,0,10,11,5 ème
AUDE,LIMOUX,0110859Z,243,221,18,4,118,125,5 ème
AUDE,QUILLAN,0110027V,0,0,0,0,0,0,5 ème
GARD,ALES,0300002P,0,0,0,0,0,0,5 ème
GARD,ALES,0300028T,0,0,0,0,0,0,5 ème
GARD,ALES,0301013N,110,83,16,11,55,55,5 ème
GARD,ALES,0301014P,129,115,12,2,69,60,5 ème
GARD,ALES,0301354J,176,172,0,4,87,89,5 ème
GARD,ANDUZE,0300006U,119,119,0,0,66,53,5 ème
GARD,BAGNOLS-SUR-CEZE,0300950V,0,0,0,0,0,0,5 ème
GARD,BAGNOLS-SUR-CEZE,0301211D,161,134,23,4,85,76,5 ème
GARD,BEAUCAIRE,0300011Z,0,0,0,0,0,0,5 ème
GARD,CLARENSAC,0301723K,131,131,0,0,71,60,5 ème
GARD,NIMES,0300058A,0,0,0,0,0,0,5 ème
GARD,NIMES,0301284H,181,177,0,4,92,89,5 ème
GARD,PONT-SAINT-ESPRIT,0300031W,118,110,0,8,66,52,5 ème
GARD,PONT-SAINT-ESPRIT,0300098U,92,92,0,0,50,42,5 ème
GARD,SAINT-CHRISTOL-LES-ALES,0301778V,0,0,0,0,0,0,5 ème
GARD,SAINT-JEAN-DU-GARD,0300042H,36,36,0,0,20,16,5 ème
GARD,SALINDRES,0300043J,167,163,0,4,70,97,5 ème
GARD,SOMMIERES,0300101X,127,127,0,0,68,59,5 ème
GARD,UZES,0301244P,64,64,0,0,30,34,5 ème
GARD,VILLENEUVE-LES-AVIGNON,0300085E,81,81,0,0,43,38,5 ème
HERAULT,BEZIERS,0340012D,0,0,0,0,0,0,5 ème
HERAULT,BEZIERS,0340016H,137,130,0,7,61,76,5 ème
HERAULT,FLORENSAC,0340024S,96,96,0,0,50,46,5 ème
HERAULT,LA GRANDE-MOTTE,0341656R,72,72,0,0,41,31,5 ème
HERAULT,LANSARGUES,0342076X,211,195,16,0,107,104,5 ème
HERAULT,LATTES,0341028H,169,167,0,2,79,90,5 ème
HERAULT,LODEVE,0340117T,154,138,13,3,68,86,5 ème
HERAULT,MARAUSSAN,0342399Y,15,15,0,0,8,7,5 ème
HERAULT,MARSEILLAN,0342130F,89,86,0,3,51,38,5 ème
HERAULT,MARSILLARGUES,0340034C,66,63,0,3,27,39,5 ème
HERAULT,MAUGUIO,0341368C,252,251,0,1,129,123,5 ème
HERAULT,MONTARNAUD,0342051V,176,172,0,4,82,94,5 ème
HERAULT,MONTPELLIER,0340902W,133,130,0,3,73,60,5 ème
HERAULT,MONTPELLIER,0340904Y,121,121,0,0,54,67,5 ème
HERAULT,MONTPELLIER,0341364Y,116,113,0,3,52,64,5 ème
HERAULT,MONTPELLIER,0341385W,0,0,0,0,0,0,5 ème
HERAULT,MONTPELLIER,0342131G,168,164,0,4,79,89,5 ème
HERAULT,MONTPELLIER,0342147Z,3,3,0,0,0,3,5 ème
HERAULT,OLONZAC,0340057C,77,77,0,0,32,45,5 ème
HERAULT,PEROLS,0341537L,149,149,0,0,77,72,5 ème
HERAULT,PIGNAN,0341870Y,199,199,0,0,90,109,5 ème
HERAULT,ROUJAN,0342326U,135,133,0,2,68,67,5 ème
HERAULT,SAINT-CLEMENT-DE-RIVIERE,0340110K,189,186,0,3,79,110,5 ème
HERAULT,SAINT-GELY-DU-FESC,0341764H,237,234,0,3,117,120,5 ème
HERAULT,SAINT-MATHIEU-DE-TREVIERS,0341705U,150,150,0,0,79,71,5 ème
HERAULT,SERVIAN,0341387Y,151,144,0,7,76,75,5 ème
HERAULT,VENDRES,0342050U,179,179,0,0,79,100,5 ème
LOZERE,MENDE,0480019K,0,0,0,0,0,0,5 ème
LOZERE,SAINT-CHELY-D'APCHER,0480013D,112,109,0,3,59,53,5 ème
LOZERE,SAINT-CHELY-D'APCHER,0480688M,0,0,0,0,0,0,5 ème
LOZERE,SAINT-ETIENNE-VALLEE-FRANCAISE,0480015F,22,22,0,0,14,8,5 ème
LOZERE,VILLEFORT,0480017H,22,22,0,0,9,13,5 ème
PYRENEES-ORIENTALES,ARLES-SUR-TECH,0660480N,74,74,0,0,46,28,5 ème
PYRENEES-ORIENTALES,PERPIGNAN,0660051X,80,80,0,0,48,32,5 ème
PYRENEES-ORIENTALES,PERPIGNAN,0660063K,180,180,0,0,98,82,5 ème
PYRENEES-ORIENTALES,PERPIGNAN,0660522J,148,125,18,5,63,85,5 ème
PYRENEES-ORIENTALES,PRADES,0660068R,37,37,0,0,17,20,5 ème
PYRENEES-ORIENTALES,SAINT-ESTEVE,0660431K,226,206,16,4,105,121,5 ème
PYRENEES-ORIENTALES,SAINT-PAUL-DE-FENOUILLET,0660029Y,33,33,0,0,19,14,5 ème
ARIEGE,LE MAS-D'AZIL,0090010M,80,80,0,0,34,46,5 ème
ARIEGE,LEZAT-SUR-LEZE,0090009L,113,113,0,0,54,59,5 ème
ARIEGE,PAMIERS,0090045A,0,0,0,0,0,0,5 ème
ARIEGE,PAMIERS,0090055L,161,158,0,3,78,83,5 ème
ARIEGE,SAINT-GIRONS,0090038T,15,15,0,0,10,5,5 ème
ARIEGE,SAINT-GIRONS,0090574A,182,175,3,4,96,86,5 ème
ARIEGE,TARASCON-SUR-ARIEGE,0090546V,121,117,0,4,58,63,5 ème
AVEYRON,CRANSAC,0120004P,35,29,0,6,21,14,5 ème
AVEYRON,MARCILLAC-VALLON,0120092K,63,61,0,2,32,31,5 ème
AVEYRON,NAUCELLE,0120017D,39,39,0,0,21,18,5 ème
AVEYRON,NAUCELLE,0121174L,18,18,0,0,13,5,5 ème
AVEYRON,RODEZ,0121309H,0,0,0,0,0,0,5 ème
AVEYRON,SAINT-AFFRIQUE,0121256A,71,68,0,3,44,27,5 ème
GERS,AIGNAN,0320001C,23,23,0,0,7,16,5 ème
GERS,AUCH,0320563N,114,110,0,4,53,61,5 ème
GERS,AUCH,0320650H,122,113,6,3,72,50,5 ème
GERS,CONDOM,0320059R,34,34,0,0,13,21,5 ème
GERS,GIMONT,0320013R,99,96,0,3,46,53,5 ème
GERS,L'ISLE-JOURDAIN,0320014S,115,107,0,8,46,69,5 ème
GERS,L'ISLE-JOURDAIN,0320056M,85,85,0,0,40,45,5 ème
GERS,PLAISANCE,0320028G,28,28,0,0,14,14,5 ème
HAUTE-GARONNE,BAGNERES-DE-LUCHON,0310005M,49,47,0,2,21,28,5 ème
HAUTE-GARONNE,BESSIERES,0312799Z,172,167,0,5,92,80,5 ème
HAUTE-GARONNE,BLAGNAC,0311581A,114,110,0,4,52,62,5 ème
HAUTE-GARONNE,CINTEGABELLE,0313045S,80,80,0,0,38,42,5 ème
HAUTE-GARONNE,COLOMIERS,0311092U,0,0,0,0,0,0,5 ème
HAUTE-GARONNE,COLOMIERS,0312191N,0,0,0,0,0,0,5 ème
HAUTE-GARONNE,FENOUILLET,0312423R,119,118,0,1,59,60,5 ème
HAUTE-GARONNE,LE FOUSSERET,0310015Y,100,97,0,3,45,55,5 ème
HAUTE-GARONNE,MURET,0311319R,215,200,15,0,103,112,5 ème
HAUTE-GARONNE,PIBRAC,0311176K,177,177,0,0,78,99,5 ème
HAUTE-GARONNE,PIBRAC,0311263E,147,147,0,0,92,55,5 ème
HAUTE-GARONNE,PINS-JUSTARET,0312220V,226,222,0,4,102,124,5 ème
HAUTE-GARONNE,PLAISANCE-DU-TOUCH,0312071H,223,220,0,3,98,125,5 ème
HAUTE-GARONNE,PORTET-SUR-GARONNE,0311686P,172,169,0,3,79,93,5 ème
HAUTE-GARONNE,REVEL,0311209W,42,42,0,0,22,20,5 ème
HAUTE-GARONNE,RIEUMES,0310029N,128,128,0,0,65,63,5 ème
HAUTE-GARONNE,SAINT-JEAN,0311722D,172,168,0,4,87,85,5 ème
HAUTE-GARONNE,SAINT-JORY,0312842W,158,154,0,4,75,83,5 ème
HAUTE-GARONNE,SALIES-DU-SALAT,0310035V,133,130,0,3,62,71,5 ème
HAUTE-GARONNE,SEILH,0311967V,139,139,0,0,82,57,5 ème
HAUTE-GARONNE,TOULOUSE,0310037X,171,152,14,5,81,90,5 ème
HAUTE-GARONNE,TOULOUSE,0310052N,0,0,0,0,0,0,5 ème
HAUTE-GARONNE,TOULOUSE,0310054R,0,0,0,0,0,0,5 ème
HAUTE-GARONNE,TOULOUSE,0310056T,0,0,0,0,0,0,5 ème
HAUTE-GARONNE,TOULOUSE,0311111P,198,190,0,8,104,94,5 ème
HAUTE-GARONNE,TOULOUSE,0311265G,121,104,13,4,63,58,5 ème
HAUTE-GARONNE,TOULOUSE,0311630D,131,110,17,4,61,70,5 ème
HAUTE-GARONNE,TOULOUSE,0312064A,0,0,0,0,0,0,5 ème
HAUTE-GARONNE,TOULOUSE,0312759F,0,0,0,0,0,0,5 ème
HAUTE-GARONNE,TOULOUSE,0312885T,20,20,0,0,9,11,5 ème
HAUTE-GARONNE,TOULOUSE,0313080E,118,112,0,6,59,59,5 ème
HAUTE-GARONNE,VILLENEUVE-TOLOSANE,0312611V,170,170,0,0,80,90,5 ème
HAUTES-PYRENEES,BAGNERES-DE-BIGORRE,0650089U,152,151,0,1,63,89,5 ème
LOT,CAHORS,0460493L,0,0,0,0,0,0,5 ème
LOT,MARTEL,0460021Y,45,45,0,0,18,27,5 ème
LOT,PRAYSSAC,0460024B,31,31,0,0,18,13,5 ème
TARN,ALBI,0810004P,0,0,0,0,0,0,5 ème
TARN,ALBI,0810051R,123,120,0,3,64,59,5 ème
TARN,ALBI,0811070Y,0,0,0,0,0,0,5 ème
TARN,CARMAUX,0810787R,85,81,0,4,42,43,5 ème
TARN,CASTRES,0810960D,110,106,0,4,52,58,5 ème
TARN,CASTRES,0810961E,108,105,0,3,53,55,5 ème
TARN,GAILLAC,0811331G,109,109,0,0,55,54,5 ème
TARN,MAZAMET,0810108C,0,0,0,0,0,0,5 ème
TARN,MAZAMET,0810127Y,78,78,0,0,42,36,5 ème
TARN,RABASTENS,0810037A,147,144,0,3,82,65,5 ème
TARN-ET-GARONNE,CASTELSARRASIN,0820066B,169,151,16,2,91,78,5 ème
TARN-ET-GARONNE,GRISOLLES,0820683X,163,154,0,9,71,92,5 ème
TARN-ET-GARONNE,MOISSAC,0820753Y,65,63,0,2,29,36,5 ème
TARN-ET-GARONNE,MONTECH,0820891Y,165,161,0,4,82,83,5 ème
TARN-ET-GARONNE,VALENCE,0820029L,212,195,9,8,110,102,5 ème
TARN-ET-GARONNE,VALENCE,0820899G,0,0,0,0,0,0,5 ème
TARN-ET-GARONNE,VERDUN-SUR-GARONNE,0820922G,92,90,0,2,42,50,5 ème
LOIRE-ATLANTIQUE,ANCENIS-SAINT-GEREON,0441928G,198,194,0,4,94,104,5 ème
LOIRE-ATLANTIQUE,BOUAYE,0441858F,176,176,0,0,87,89,5 ème
LOIRE-ATLANTIQUE,CHATEAUBRIANT,0440005S,0,0,0,0,0,0,5 ème
LOIRE-ATLANTIQUE,CHATEAUBRIANT,0440293E,113,110,0,3,55,58,5 ème
LOIRE-ATLANTIQUE,CHATEAUBRIANT,0441929H,177,172,0,5,104,73,5 ème
LOIRE-ATLANTIQUE,CLISSON,0440008V,150,136,11,3,75,75,5 ème
LOIRE-ATLANTIQUE,CLISSON,0442781J,162,157,0,5,76,86,5 ème
LOIRE-ATLANTIQUE,CORDEMAIS,0442023K,180,178,0,2,75,105,5 ème
LOIRE-ATLANTIQUE,DONGES,0441727N,93,90,0,3,38,55,5 ème
LOIRE-ATLANTIQUE,LA CHAPELLE-SUR-ERDRE,0441547T,143,136,0,7,72,71,5 ème
LOIRE-ATLANTIQUE,LOIREAUXENCE,0442921L,109,109,0,0,56,53,5 ème
LOIRE-ATLANTIQUE,NANTES,0440025N,116,114,0,2,62,54,5 ème
LOIRE-ATLANTIQUE,NANTES,0440034Y,0,0,0,0,0,0,5 ème
LOIRE-ATLANTIQUE,NANTES,0440035Z,0,0,0,0,0,0,5 ème
LOIRE-ATLANTIQUE,NANTES,0440284V,124,124,0,0,70,54,5 ème
LOIRE-ATLANTIQUE,NANTES,0441931K,255,255,0,0,126,129,5 ème
LOIRE-ATLANTIQUE,NANTES,0441933M,208,200,8,0,94,114,5 ème
LOIRE-ATLANTIQUE,NANTES,0441935P,219,204,15,0,106,113,5 ème
LOIRE-ATLANTIQUE,NANTES,0441936R,157,155,0,2,94,63,5 ème
LOIRE-ATLANTIQUE,NANTES,0442775C,0,0,0,0,0,0,5 ème
LOIRE-ATLANTIQUE,PAIMBOEUF,0440056X,0,0,0,0,0,0,5 ème
LOIRE-ATLANTIQUE,PONTCHATEAU,0440541Z,0,0,0,0,0,0,5 ème
LOIRE-ATLANTIQUE,PONTCHATEAU,0442807M,150,150,0,0,78,72,5 ème
LOIRE-ATLANTIQUE,REZE,0440063E,0,0,0,0,0,0,5 ème
LOIRE-ATLANTIQUE,REZE,0440229K,204,204,0,0,97,107,5 ème
LOIRE-ATLANTIQUE,REZE,0440274J,0,0,0,0,0,0,5 ème
LOIRE-ATLANTIQUE,SAINTE-PAZANNE,0442625P,217,215,0,2,113,104,5 ème
LOIRE-ATLANTIQUE,SAINT-JOACHIM,0441728P,71,71,0,0,35,36,5 ème
LOIRE-ATLANTIQUE,SAINT-NAZAIRE,0441941W,195,195,0,0,87,108,5 ème
LOIRE-ATLANTIQUE,SAINT-PHILBERT-DE-GRAND-LIEU,0442186M,98,95,0,3,33,65,5 ème
LOIRE-ATLANTIQUE,SAINT-SEBASTIEN-SUR-LOIRE,0440291C,103,101,0,2,49,54,5 ème
LOIRE-ATLANTIQUE,SAVENAY,0440241Y,282,282,0,0,138,144,5 ème
LOIRE-ATLANTIQUE,SAVENAY,0441657M,158,158,0,0,79,79,5 ème
LOIRE-ATLANTIQUE,TRIGNAC,0441616T,139,120,16,3,67,72,5 ème
LOIRE-ATLANTIQUE,VALLET,0442052S,165,162,0,3,75,90,5 ème
LOIRE-ATLANTIQUE,VERTOU,0442595G,160,158,0,2,66,94,5 ème
MAINE-ET-LOIRE,ANGERS,0490843A,120,116,0,4,48,72,5 ème
MAINE-ET-LOIRE,ANGERS,0491825T,135,135,0,0,52,83,5 ème
MAINE-ET-LOIRE,BAUGE-EN-ANJOU,0490010V,100,97,0,3,48,52,5 ème
MAINE-ET-LOIRE,BEAUFORT-EN-ANJOU,0490922L,161,161,0,0,81,80,5 ème
MAINE-ET-LOIRE,BRISSAC LOIRE AUBANCE,0490853L,133,133,0,0,61,72,5 ème
MAINE-ET-LOIRE,CHEMILLE-EN-ANJOU,0491929F,55,55,0,0,30,25,5 ème
MAINE-ET-LOIRE,CHOLET,0490862W,174,174,0,0,83,91,5 ème
MAINE-ET-LOIRE,CHOLET,0490886X,0,0,0,0,0,0,5 ème
MAINE-ET-LOIRE,DURTAL,0490956Y,77,77,0,0,39,38,5 ème
MAINE-ET-LOIRE,LONGUE-JUMELLES,0490867B,139,139,0,0,66,73,5 ème
MAINE-ET-LOIRE,MAUGES-SUR-LOIRE,0490039B,41,40,0,1,24,17,5 ème
MAINE-ET-LOIRE,MONTREVAULT-SUR-EVRE,0490876L,150,150,0,0,66,84,5 ème
MAINE-ET-LOIRE,OREE D'ANJOU,0490057W,130,130,0,0,61,69,5 ème
MAINE-ET-LOIRE,OREE D'ANJOU,0490856P,148,148,0,0,65,83,5 ème
MAINE-ET-LOIRE,SAUMUR,0491648A,82,66,16,0,42,40,5 ème
MAINE-ET-LOIRE,SEGRE-EN-ANJOU BLEU,0490878N,179,179,0,0,89,90,5 ème
MAINE-ET-LOIRE,SEVREMOINE,0490875K,187,187,0,0,99,88,5 ème
MAINE-ET-LOIRE,SEVREMOINE,0491706N,66,66,0,0,36,30,5 ème
MAINE-ET-LOIRE,TRELAZE,0491646Y,0,0,0,0,0,0,5 ème
MAINE-ET-LOIRE,VERRIERES-EN-ANJOU,0491921X,120,119,0,1,55,65,5 ème
MAYENNE,CHATEAU-GONTIER-SUR-MAYENNE,0530779J,146,123,16,7,70,76,5 ème
MAYENNE,COSSE-LE-VIVIEN,0530030V,51,50,0,1,27,24,5 ème
MAYENNE,ERNEE,0530077W,107,83,17,7,50,57,5 ème
MAYENNE,LAVAL,0530015D,112,108,0,4,55,57,5 ème
MAYENNE,LAVAL,0530914F,83,79,0,4,37,46,5 ème
MAYENNE,MESLAY-DU-MAINE,0530063F,77,73,0,4,40,37,5 ème
MAYENNE,PORT-BRILLET,0530021K,81,81,0,0,49,32,5 ème
MAYENNE,PRE-EN-PAIL-SAINT-SAMSON,0530583W,56,56,0,0,31,25,5 ème
SARTHE,ARNAGE,0720903R,111,111,0,0,58,53,5 ème
SARTHE,BALLON-SAINT MARS,0720004N,91,77,11,3,44,47,5 ème
SARTHE,BEAUMONT-SUR-SARTHE,0720904S,61,57,0,4,37,24,5 ème
SARTHE,BONNETABLE,0721093X,138,138,0,0,82,56,5 ème
SARTHE,CHAMPAGNE,0721086P,98,94,0,4,46,52,5 ème
SARTHE,FRESNAY-SUR-SARTHE,0720019E,78,72,0,6,40,38,5 ème
SARTHE,LA FERTE-BERNARD,0720017C,0,0,0,0,0,0,5 ème
SARTHE,LA FERTE-BERNARD,0720806K,105,105,0,0,52,53,5 ème
SARTHE,LA FLECHE,0720062B,100,96,0,4,44,56,5 ème
SARTHE,LE GRAND-LUCE,0721044U,73,69,0,4,39,34,5 ème
SARTHE,LE LUDE,0721226S,65,65,0,0,26,39,5 ème
SARTHE,LE MANS,0720040C,98,98,0,0,50,48,5 ème
SARTHE,LE MANS,0720797A,81,66,15,0,36,45,5 ème
SARTHE,LE MANS,0720798B,122,119,0,3,63,59,5 ème
SARTHE,LE MANS,0720800D,80,75,0,5,36,44,5 ème
SARTHE,LE MANS,0720815V,117,117,0,0,69,48,5 ème
SARTHE,LE MANS,0720836T,112,102,0,10,59,53,5 ème
SARTHE,LE MANS,0720838V,139,139,0,0,67,72,5 ème
SARTHE,LE MANS,0720983C,68,68,0,0,34,34,5 ème
SARTHE,LE MANS,0721262F,86,82,0,4,41,45,5 ème
SARTHE,LOUE,0720024K,110,110,0,0,50,60,5 ème
SARTHE,MAMERS,0720027N,0,0,0,0,0,0,5 ème
SARTHE,MOULINS-LE-CARBONNEL,0720046J,66,66,0,0,42,24,5 ème
SARTHE,PONTVALLAIN,0721304B,84,79,0,5,43,41,5 ème
SARTHE,SABLE-SUR-SARTHE,0721408P,144,135,0,9,68,76,5 ème
SARTHE,SAINT-CALAIS,0720051P,44,40,0,4,18,26,5 ème
VENDEE,AIZENAY,0850090L,122,122,0,0,56,66,5 ème
VENDEE,AIZENAY,0851560J,153,150,0,3,81,72,5 ème
VENDEE,BELLEVIGNY,0851435Y,169,166,0,3,95,74,5 ème
VENDEE,CHANTONNAY,0851191H,208,205,0,3,111,97,5 ème
VENDEE,CHAVAGNES-EN-PAILLERS,0850073T,91,91,0,0,48,43,5 ème
VENDEE,FONTENAY-LE-COMTE,0850074U,183,165,13,5,79,104,5 ème
VENDEE,LA ROCHE-SUR-YON,0850605W,155,153,0,2,69,86,5 ème
VENDEE,LA ROCHE-SUR-YON,0851643Z,0,0,0,0,0,0,5 ème
VENDEE,LES SABLES-D'OLONNE,0850148Z,89,86,0,3,46,43,5 ème
VENDEE,LES SABLES-D'OLONNE,0850149A,125,108,13,4,61,64,5 ème
VENDEE,LUCON,0850069N,85,82,0,3,43,42,5 ème
VENDEE,MONTAIGU-VENDEE,0851662V,134,129,0,5,70,64,5 ème
VENDEE,MORTAGNE-SUR-SEVRE,0851388X,146,146,0,0,72,74,5 ème
VENDEE,SAINTE-HERMINE,0851146J,73,71,0,2,30,43,5 ème
VENDEE,SAINT-GILLES-CROIX-DE-VIE,0850065J,206,191,15,0,94,112,5 ème
VENDEE,TIFFAUGES,0850125Z,114,114,0,0,68,46,5 ème
ALPES-DE-HTE-PROVENCE,BARCELONNETTE,0040419J,82,80,0,2,36,46,5 ème
ALPES-DE-HTE-PROVENCE,LA MOTTE-DU-CAIRE,0040014U,32,32,0,0,19,13,5 ème
ALPES-DE-HTE-PROVENCE,MANOSQUE,0040055N,162,140,18,4,87,75,5 ème
ALPES-DE-HTE-PROVENCE,SISTERON,0040023D,0,0,0,0,0,0,5 ème
BOUCHES-DU-RHONE,AIX-EN-PROVENCE,0130001F,0,0,0,0,0,0,5 ème
BOUCHES-DU-RHONE,AIX-EN-PROVENCE,0131318M,63,59,0,4,32,31,5 ème
BOUCHES-DU-RHONE,AIX-EN-PROVENCE,0131712R,203,180,23,0,88,115,5 ème
BOUCHES-DU-RHONE,AIX-EN-PROVENCE,0132955S,63,63,0,0,31,32,5 ème
BOUCHES-DU-RHONE,AIX-EN-PROVENCE,0132973L,138,138,0,0,66,72,5 ème
BOUCHES-DU-RHONE,ALLAUCH,0133490Y,240,240,0,0,123,117,5 ème
BOUCHES-DU-RHONE,ARLES,0133274N,0,0,0,0,0,0,5 ème
BOUCHES-DU-RHONE,BOUC-BEL-AIR,0132833J,186,182,0,4,84,102,5 ème
BOUCHES-DU-RHONE,CASSIS,0132324F,155,155,0,0,75,80,5 ème
BOUCHES-DU-RHONE,GEMENOS,0133351X,171,171,0,0,85,86,5 ème
BOUCHES-DU-RHONE,ISTRES,0132318Z,179,176,0,3,94,85,5 ème
BOUCHES-DU-RHONE,ISTRES,0132409Y,172,147,25,0,89,83,5 ème
BOUCHES-DU-RHONE,LA CIOTAT,0130022D,145,140,0,5,77,68,5 ème
BOUCHES-DU-RHONE,LES PENNES-MIRABEAU,0131369T,160,157,0,3,82,78,5 ème
BOUCHES-DU-RHONE,MARSEILLE,0131424C,0,0,0,0,0,0,5 ème
BOUCHES-DU-RHONE,MARSEILLE,0131922U,141,141,0,0,70,71,5 ème
BOUCHES-DU-RHONE,MARSEILLE,0131750G,167,167,0,0,78,89,5 ème
BOUCHES-DU-RHONE,MARSEILLE,0131261A,117,109,0,8,50,67,5 ème
BOUCHES-DU-RHONE,MARSEILLE,0131445A,0,0,0,0,0,0,5 ème
BOUCHES-DU-RHONE,MARSEILLE,0132314V,183,178,0,5,88,95,5 ème
BOUCHES-DU-RHONE,MARSEILLE,0132907P,196,192,0,4,105,91,5 ème
BOUCHES-DU-RHONE,MARSEILLE,0132908R,31,31,0,0,14,17,5 ème
BOUCHES-DU-RHONE,MARSEILLE,0130056R,0,0,0,0,0,0,5 ème
BOUCHES-DU-RHONE,MARSEILLE,0132207D,165,163,0,2,83,82,5 ème
BOUCHES-DU-RHONE,MARSEILLE,0132730X,103,102,0,1,46,57,5 ème
BOUCHES-DU-RHONE,MARSEILLE,0131329Z,88,88,0,0,44,44,5 ème
BOUCHES-DU-RHONE,MARSEILLE,0132407W,145,109,32,4,69,76,5 ème
BOUCHES-DU-RHONE,MARSEILLE,0131757P,156,152,0,4,86,70,5 ème
BOUCHES-DU-RHONE,MARSEILLE,0131375Z,60,60,0,0,39,21,5 ème
BOUCHES-DU-RHONE,MARSEILLE,0131884C,150,150,0,0,70,80,5 ème
BOUCHES-DU-RHONE,MARSEILLE,0131935H,141,141,0,0,68,73,5 ème
BOUCHES-DU-RHONE,MARSEILLE,0131381F,136,136,0,0,60,76,5 ème
BOUCHES-DU-RHONE,MARSEILLE,0132315W,140,135,0,5,57,83,5 ème
BOUCHES-DU-RHONE,MARSEILLE,0132923G,135,131,0,4,58,77,5 ème
BOUCHES-DU-RHONE,MARSEILLE,0132946G,124,124,0,0,55,69,5 ème
BOUCHES-DU-RHONE,MARSEILLE,0131689R,60,47,13,0,24,36,5 ème
BOUCHES-DU-RHONE,MARSEILLE,0132909S,92,92,0,0,42,50,5 ème
BOUCHES-DU-RHONE,MARSEILLE,0133374X,57,57,0,0,22,35,5 ème
BOUCHES-DU-RHONE,MARSEILLE,0132205B,109,109,0,0,55,54,5 ème
BOUCHES-DU-RHONE,MARSEILLE,0131923V,296,294,0,2,146,150,5 ème
BOUCHES-DU-RHONE,MARSEILLE,0131382G,103,103,0,0,62,41,5 ème
BOUCHES-DU-RHONE,MARSEILLE,0133866G,38,38,0,0,18,20,5 ème
BOUCHES-DU-RHONE,MARTIGUES,0132496T,136,136,0,0,62,74,5 ème
BOUCHES-DU-RHONE,PORT-DE-BOUC,0130150T,0,0,0,0,0,0,5 ème
BOUCHES-DU-RHONE,PORT-DE-BOUC,0130151U,0,0,0,0,0,0,5 ème
BOUCHES-DU-RHONE,PORT-SAINT-LOUIS-DU-RHONE,0132323E,117,109,6,2,53,64,5 ème
BOUCHES-DU-RHONE,ROGNAC,0131706J,201,201,0,0,88,113,5 ème
BOUCHES-DU-RHONE,ROGNONAS,0131387M,93,93,0,0,51,42,5 ème
BOUCHES-DU-RHONE,SAINT-MARTIN-DE-CRAU,0132834K,308,306,0,2,150,158,5 ème
BOUCHES-DU-RHONE,SALON-DE-PROVENCE,0130161E,0,0,0,0,0,0,5 ème
BOUCHES-DU-RHONE,SIMIANE-COLLONGUE,0133789Y,110,110,0,0,51,59,5 ème
BOUCHES-DU-RHONE,TRETS,0130166K,122,122,0,0,63,59,5 ème
HAUTES-ALPES,EMBRUN,0050023Y,125,119,0,6,58,67,5 ème
HAUTES-ALPES,GUILLESTRE,0050013M,94,94,0,0,43,51,5 ème
HAUTES-ALPES,LA BATIE-NEUVE,0050639T,89,89,0,0,40,49,5 ème
HAUTES-ALPES,SAINT-BONNET-EN-CHAMPSAUR,0050019U,110,110,0,0,54,56,5 ème
HAUTES-ALPES,SAINT-JEAN-SAINT-NICOLAS,0050039R,0,0,0,0,0,0,5 ème
VAUCLUSE,AVIGNON,0840004Y,0,0,0,0,0,0,5 ème
VAUCLUSE,AVIGNON,0840058G,72,72,0,0,32,40,5 ème
VAUCLUSE,AVIGNON,0840060J,192,192,0,0,99,93,5 ème
VAUCLUSE,AVIGNON,0840064N,78,78,0,0,43,35,5 ème
VAUCLUSE,AVIGNON,0840082H,0,0,0,0,0,0,5 ème
VAUCLUSE,BEDARRIDES,0840011F,140,139,0,1,63,77,5 ème
VAUCLUSE,CADENET,0840014J,146,142,0,4,72,74,5 ème
VAUCLUSE,CARPENTRAS,0840114T,197,162,32,3,94,103,5 ème
VAUCLUSE,CARPENTRAS,0840760V,135,127,0,8,58,77,5 ème
VAUCLUSE,MONTEUX,0840066R,135,135,0,0,58,77,5 ème
VAUCLUSE,ORANGE,0840046U,0,0,0,0,0,0,5 ème
VAUCLUSE,ORANGE,0840762X,126,123,0,3,52,74,5 ème
VAUCLUSE,VALREAS,0840700E,0,0,0,0,0,0,5 ème
ALPES-MARITIMES,ANTIBES,0060823M,65,65,0,0,38,27,5 ème
ALPES-MARITIMES,BREIL-SUR-ROYA,0060008B,35,35,0,0,15,20,5 ème
ALPES-MARITIMES,CAGNES-SUR-MER,0060911H,160,149,11,0,77,83,5 ème
ALPES-MARITIMES,CAGNES-SUR-MER,0061280J,198,198,0,0,93,105,5 ème
ALPES-MARITIMES,CAGNES-SUR-MER,0061737F,133,125,0,8,61,72,5 ème
ALPES-MARITIMES,CANNES,0060720A,168,168,0,0,89,79,5 ème
ALPES-MARITIMES,CANNES,0060799L,206,185,16,5,105,101,5 ème
ALPES-MARITIMES,CONTES,0060019N,208,191,13,4,97,111,5 ème
ALPES-MARITIMES,GRASSE,0060023T,0,0,0,0,0,0,5 ème
ALPES-MARITIMES,LE CANNET,0061239P,173,149,17,7,80,93,5 ème
ALPES-MARITIMES,LE ROURET,0061853G,200,197,0,3,100,100,5 ème
ALPES-MARITIMES,MENTON,0061824A,200,183,15,2,114,86,5 ème
ALPES-MARITIMES,MOUGINS,0061068D,223,202,13,8,96,127,5 ème
ALPES-MARITIMES,NICE,0060038J,0,0,0,0,0,0,5 ème
ALPES-MARITIMES,NICE,0060715V,0,0,0,0,0,0,5 ème
ALPES-MARITIMES,NICE,0060753L,96,96,0,0,51,45,5 ème
ALPES-MARITIMES,NICE,0060838D,130,121,0,9,54,76,5 ème
ALPES-MARITIMES,NICE,0061127T,127,127,0,0,65,62,5 ème
ALPES-MARITIMES,PUGET-THENIERS,0060061J,86,86,0,0,44,42,5 ème
ALPES-MARITIMES,SAINT-LAURENT-DU-VAR,0061738G,160,149,11,0,73,87,5 ème
ALPES-MARITIMES,TENDE,0060072W,22,22,0,0,10,12,5 ème
ALPES-MARITIMES,TOURRETTE-LEVENS,0060068S,204,204,0,0,100,104,5 ème
ALPES-MARITIMES,VALBONNE,0061925K,206,206,0,0,108,98,5 ème
VAR,BORMES-LES-MIMOSAS,0830927G,130,130,0,0,66,64,5 ème
VAR,HYERES,0831014B,0,0,0,0,0,0,5 ème
VAR,HYERES,0831563Y,0,0,0,0,0,0,5 ème
VAR,LA CRAU,0830012M,231,231,0,0,95,136,5 ème
VAR,LA VALETTE-DU-VAR,0830182X,187,179,6,2,85,102,5 ème
VAR,LA VALETTE-DU-VAR,0831218Y,149,128,11,10,84,65,5 ème
VAR,LE MUY,0830958R,123,120,0,3,60,63,5 ème
VAR,PUGET-SUR-ARGENS,0830168G,148,148,0,0,67,81,5 ème
VAR,SAINTE-MAXIME,0830039S,136,136,0,0,71,65,5 ème
VAR,SAINT-RAPHAEL,0830108S,143,143,0,0,73,70,5 ème
VAR,SIX-FOURS-LES-PLAGES,0830051E,158,158,0,0,86,72,5 ème
VAR,SOLLIES-PONT,0831355X,77,77,0,0,41,36,5 ème
VAR,TOULON,0830148K,99,99,0,0,40,59,5 ème
MAYOTTE,M'TSANGAMOUJI,9760167C,306,291,13,2,147,159,5 ème
MAYOTTE,TSINGONI,9760274U,346,326,16,4,197,149,5 ème
CALVADOS,BAYEUX,0140006F,187,159,24,4,97,90,5 ème
CALVADOS,BAYEUX,0141762P,115,109,0,6,45,70,5 ème
CALVADOS,BRETTEVILLE-SUR-LAIZE,0141312A,154,154,0,0,73,81,5 ème
CALVADOS,CAEN,0140018U,0,0,0,0,0,0,5 ème
CALVADOS,CAEN,0141597K,129,109,20,0,59,70,5 ème
CALVADOS,CAEN,0141867D,0,0,0,0,0,0,5 ème
CALVADOS,CONDE-EN-NORMANDIE,0141214U,30,30,0,0,14,16,5 ème
CALVADOS,CONDE-EN-NORMANDIE,0141258S,67,60,0,7,33,34,5 ème
CALVADOS,DEAUVILLE,0141763R,53,53,0,0,24,29,5 ème
CALVADOS,FALAISE,0140052F,0,0,0,0,0,0,5 ème
CALVADOS,FALAISE,0141167T,58,58,0,0,35,23,5 ème
CALVADOS,HONFLEUR,0140056K,0,0,0,0,0,0,5 ème
CALVADOS,ISIGNY-SUR-MER,0141257R,41,37,0,4,27,14,5 ème
CALVADOS,LES MONTS D'AUNAY,0141662F,110,100,10,0,48,62,5 ème
CALVADOS,MEZIDON VALLEE D'AUGE,0140070A,135,132,0,3,61,74,5 ème
CALVADOS,MONDEVILLE,0141687H,0,0,0,0,0,0,5 ème
CALVADOS,POTIGNY,0140077H,83,79,0,4,42,41,5 ème
CALVADOS,SALINE,0141684E,142,134,0,8,58,84,5 ème
CALVADOS,SOULEUVRE EN BOCAGE,0140008H,97,97,0,0,44,53,5 ème
CALVADOS,TROUVILLE-SUR-MER,0141273H,83,70,8,5,38,45,5 ème
CALVADOS,VALDALLIERE,0140086T,52,52,0,0,28,24,5 ème
CALVADOS,VIRE NORMANDIE,0141767V,116,93,16,7,53,63,5 ème
EURE,BOURG-ACHARD,0270007L,212,212,0,0,89,123,5 ème
EURE,BRIONNE,0271606Z,0,0,0,0,0,0,5 ème
EURE,EVREUX,0270022C,152,147,0,5,68,84,5 ème
EURE,EVREUX,0270051J,0,0,0,0,0,0,5 ème
EURE,EVREUX,0271095U,124,107,15,2,60,64,5 ème
EURE,EVREUX,0271173D,136,118,16,2,65,71,5 ème
EURE,GRAND BOURGTHEROULDE,0271317K,203,185,15,3,110,93,5 ème
EURE,LE NEUBOURG,0270032N,131,113,15,3,60,71,5 ème
EURE,LE NEUBOURG,0271885C,158,158,0,0,75,83,5 ème
EURE,LE VAUDREUIL,0271632C,160,157,0,3,82,78,5 ème
EURE,LOUVIERS,0271065L,183,183,0,0,98,85,5 ème
EURE,MANNEVILLE-SUR-RISLE,0271284Z,134,119,15,0,54,80,5 ème
EURE,MONTFORT-SUR-RISLE,0270054M,116,116,0,0,60,56,5 ème
EURE,PONT-AUDEMER,0270036T,175,172,0,3,91,84,5 ème
EURE,PONT-DE-L'ARCHE,0270038V,155,154,0,1,73,82,5 ème
EURE,SAINT-ANDRE-DE-L'EURE,0270041Y,166,146,16,4,82,84,5 ème
EURE,SAINT-MARCEL,0271123Z,142,142,0,0,75,67,5 ème
MANCHE,AVRANCHES,0501525L,72,65,5,2,38,34,5 ème
MANCHE,AVRANCHES,0501704F,146,146,0,0,62,84,5 ème
MANCHE,AVRANCHES,0501787W,0,0,0,0,0,0,5 ème
MANCHE,BRECEY,0501302U,69,69,0,0,36,33,5 ème
MANCHE,BREHAL,0501239A,87,85,0,2,47,40,5 ème
MANCHE,CARENTAN-LES-MARAIS,0501941N,0,0,0,0,0,0,5 ème
MANCHE,CHERBOURG-EN-COTENTIN,0500032N,0,0,0,0,0,0,5 ème
MANCHE,CHERBOURG-EN-COTENTIN,0501677B,0,0,0,0,0,0,5 ème
MANCHE,COUTANCES,0501206P,102,81,16,5,51,51,5 ème
MANCHE,COUTANCES,0501703E,124,124,0,0,67,57,5 ème
MANCHE,COUTANCES,0502009M,0,0,0,0,0,0,5 ème
MANCHE,DUCEY-LES CHERIS,0501240B,73,68,0,5,37,36,5 ème
MANCHE,GRANVILLE,0500039W,137,122,9,6,51,86,5 ème
MANCHE,LA HAGUE,0500006K,121,121,0,0,59,62,5 ème
MANCHE,LESSAY,0501458N,89,84,0,5,38,51,5 ème
MANCHE,MORTAIN-BOCAGE,0500050H,78,76,0,2,38,40,5 ème
MANCHE,PERCY-EN-NORMANDIE,0500052K,44,44,0,0,11,33,5 ème
MANCHE,PERIERS,0500053L,50,50,0,0,23,27,5 ème
MANCHE,PONTORSON,0501241C,45,45,0,0,23,22,5 ème
MANCHE,SAINTE-MERE-EGLISE,0500068C,60,47,13,0,28,32,5 ème
MANCHE,SAINT-HILAIRE-DU-HARCOUET,0500061V,86,80,3,3,45,41,5 ème
MANCHE,VALOGNES,0500155X,70,70,0,0,29,41,5 ème
ORNE,ALENCON,0610003X,117,105,9,3,73,44,5 ème
ORNE,ALENCON,0610004Y,0,0,0,0,0,0,5 ème
ORNE,ALENCON,0611026J,85,83,0,2,50,35,5 ème
ORNE,ARGENTAN,0610006A,0,0,0,0,0,0,5 ème
ORNE,BRIOUZE,0611024G,43,43,0,0,21,22,5 ème
ORNE,LA FERTE MACE,0610019P,0,0,0,0,0,0,5 ème
ORNE,LA FERTE MACE,0610996B,12,0,12,0,3,9,5 ème
ORNE,L'AIGLE,0611156A,113,112,0,1,60,53,5 ème
ORNE,MORTAGNE-AU-PERCHE,0611094H,59,59,0,0,28,31,5 ème
ORNE,MOULINS-LA-MARCHE,0610036H,55,55,0,0,32,23,5 ème
ORNE,TINCHEBRAY-BOCAGE,0610042P,66,66,0,0,29,37,5 ème
SEINE MARITIME,CANTELEU,0760017F,107,92,11,4,50,57,5 ème
SEINE MARITIME,CAUDEBEC-LES-ELBEUF,0762919K,96,93,0,3,41,55,5 ème
SEINE MARITIME,CLERES,0762197A,143,143,0,0,75,68,5 ème
SEINE MARITIME,DOUDEVILLE,0762123V,82,80,0,2,43,39,5 ème
SEINE MARITIME,ELBEUF,0760030V,0,0,0,0,0,0,5 ème
SEINE MARITIME,ELBEUF,0762563Y,187,187,0,0,81,106,5 ème
SEINE MARITIME,FECAMP,0760036B,0,0,0,0,0,0,5 ème
SEINE MARITIME,FECAMP,0761731U,164,164,0,0,92,72,5 ème
SEINE MARITIME,FECAMP,0761785C,115,98,17,0,57,58,5 ème
SEINE MARITIME,FECAMP,0762287Y,74,74,0,0,39,35,5 ème
SEINE MARITIME,GRAND-COURONNE,0762461M,76,76,0,0,37,39,5 ème
SEINE MARITIME,GRUCHET-LE-VALASSE,0762861X,113,107,0,6,58,55,5 ème
SEINE MARITIME,LE HAVRE,0760050S,134,134,0,0,64,70,5 ème
SEINE MARITIME,LE HAVRE,0761739C,83,68,15,0,32,51,5 ème
SEINE MARITIME,LE HAVRE,0761782Z,105,86,15,4,62,43,5 ème
SEINE MARITIME,LE HAVRE,0762081Z,8,0,8,0,1,7,5 ème
SEINE MARITIME,LE HAVRE,0762128A,98,82,14,2,51,47,5 ème
SEINE MARITIME,LE PETIT-QUEVILLY,0761737A,87,87,0,0,41,46,5 ème
SEINE MARITIME,LE TRAIT,0762085D,93,93,0,0,54,39,5 ème
SEINE MARITIME,LILLEBONNE,0762738N,72,72,0,0,34,38,5 ème
SEINE MARITIME,MESNIERES-EN-BRAY,0761330H,36,36,0,0,16,20,5 ème
SEINE MARITIME,MONTIVILLIERS,0761331J,120,120,0,0,56,64,5 ème
SEINE MARITIME,MONTIVILLIERS,0762288Z,126,126,0,0,66,60,5 ème
SEINE MARITIME,MONTVILLE,0762090J,108,108,0,0,50,58,5 ème
SEINE MARITIME,NEUFCHATEL-EN-BRAY,0760079Y,127,114,9,4,62,65,5 ème
SEINE MARITIME,OFFRANVILLE,0760082B,0,0,0,0,0,0,5 ème
SEINE MARITIME,OISSEL,0760083C,132,125,0,7,57,75,5 ème
SEINE MARITIME,PETIT-COURONNE,0760086F,122,122,0,0,56,66,5 ème
SEINE MARITIME,ROUEN,0761337R,79,79,0,0,43,36,5 ème
SEINE MARITIME,ROUEN,0762568D,145,142,0,3,64,81,5 ème
SEINE MARITIME,ROUEN,0763406P,134,127,7,0,73,61,5 ème
SEINE MARITIME,SAINT-AUBIN-LES-ELBEUF,0760101X,107,103,0,4,50,57,5 ème
SEINE MARITIME,SAINT-ROMAIN-DE-COLBOSC,0761689Y,204,204,0,0,107,97,5 ème
SEINE MARITIME,VAL-DE-SCIE,0761956N,165,148,17,0,72,93,5 ème
DORDOGNE,BERGERAC,0240004Z,140,134,0,6,68,72,5 ème
DORDOGNE,BERGERAC,0240007C,0,0,0,0,0,0,5 ème
DORDOGNE,EXCIDEUIL,0241007P,79,78,0,1,37,42,5 ème
DORDOGNE,EYMET,0240014K,75,75,0,0,33,42,5 ème
DORDOGNE,MONTPON-MENESTEROL,0240117X,141,137,0,4,63,78,5 ème
DORDOGNE,PERIGUEUX,0240030C,164,137,22,5,81,83,5 ème
DORDOGNE,PERIGUEUX,0240077D,84,84,0,0,39,45,5 ème
DORDOGNE,PERIGUEUX,0240089S,0,0,0,0,0,0,5 ème
DORDOGNE,PERIGUEUX,0241075N,108,107,0,1,54,54,5 ème
DORDOGNE,PIEGUT-PLUVIERS,0240043S,50,50,0,0,24,26,5 ème
DORDOGNE,RIBERAC,0240086N,13,13,0,0,4,9,5 ème
DORDOGNE,RIBERAC,0241011U,99,84,13,2,54,45,5 ème
DORDOGNE,SAINT-ANTOINE-DE-BREUILH,0240087P,46,46,0,0,23,23,5 ème
DORDOGNE,SAINT-ASTIER,0240650B,139,121,13,5,66,73,5 ème
DORDOGNE,SARLAT-LA-CANEDA,0240048X,0,0,0,0,0,0,5 ème
DORDOGNE,SARLAT-LA-CANEDA,0241076P,58,58,0,0,26,32,5 ème
GIRONDE,AMBARES-ET-LAGRAVE,0331617D,240,237,0,3,121,119,5 ème
GIRONDE,ARSAC,0332704K,153,153,0,0,73,80,5 ème
GIRONDE,BEGLES,0331880P,158,139,17,2,81,77,5 ème
GIRONDE,BLANQUEFORT,0331754C,205,185,15,5,98,107,5 ème
GIRONDE,BLANQUEFORT,0332535B,0,0,0,0,0,0,5 ème
GIRONDE,BORDEAUX,0331492T,155,153,0,2,79,76,5 ème
GIRONDE,BORDEAUX,0331519X,60,60,0,0,31,29,5 ème
GIRONDE,BORDEAUX,0331753B,113,113,0,0,49,64,5 ème
GIRONDE,BORDEAUX,0332490C,306,306,0,0,158,148,5 ème
GIRONDE,CADILLAC,0330059K,139,137,0,2,67,72,5 ème
GIRONDE,CENON,0331464M,168,164,0,4,80,88,5 ème
GIRONDE,COUTRAS,0331621H,216,187,24,5,109,107,5 ème
GIRONDE,CREON,0332283C,289,274,10,5,144,145,5 ème
GIRONDE,LA BREDE,0332494G,136,136,0,0,53,83,5 ème
GIRONDE,LE BOUSCAT,0331523B,183,183,0,0,90,93,5 ème
GIRONDE,LE PIAN-MEDOC,0333529G,160,160,0,0,81,79,5 ème
GIRONDE,LESPARRE-MEDOC,0331528G,64,61,0,3,31,33,5 ème
GIRONDE,LE TEICH,0332982M,113,107,0,6,57,56,5 ème
GIRONDE,LIBOURNE,0330089T,0,0,0,0,0,0,5 ème
GIRONDE,MARTIGNAS-SUR-JALLE,0332743C,112,112,0,0,69,43,5 ème
GIRONDE,MERIGNAC,0331435F,197,197,0,0,94,103,5 ème
GIRONDE,PEUJARD,0332723F,141,137,0,4,61,80,5 ème
GIRONDE,SAINT-ANDRE-DE-CUBZAC,0331757F,200,185,14,1,88,112,5 ème
GIRONDE,SAINT-CIERS-SUR-GIRONDE,0330113U,138,135,0,3,64,74,5 ème
GIRONDE,SAINT-MEDARD-DE-GUIZIERES,0331569B,0,0,0,0,0,0,5 ème
GIRONDE,SAINT-MEDARD-EN-JALLES,0332187Y,227,212,14,1,106,121,5 ème
GIRONDE,SAINT-SYMPHORIEN,0330122D,98,94,0,4,52,46,5 ème
GIRONDE,SAUVETERRE-DE-GUYENNE,0331667H,113,95,14,4,59,54,5 ème
GIRONDE,VILLENAVE-D'ORNON,0332246M,204,185,16,3,101,103,5 ème
LANDES,GABARRET,0400010U,47,47,0,0,26,21,5 ème
LANDES,GABARRET,0400883T,0,0,0,0,0,0,5 ème
LANDES,GRENADE-SUR-L'ADOUR,0400012W,106,106,0,0,58,48,5 ème
LANDES,LABOUHEYRE,0400014Y,87,87,0,0,43,44,5 ème
LANDES,PEYREHORADE,0400027M,0,0,0,0,0,0,5 ème
LANDES,ROQUEFORT,0400034V,70,65,0,5,28,42,5 ème
LANDES,SAINT-MARTIN-DE-SEIGNANX,0400874H,126,126,0,0,60,66,5 ème
LANDES,SAINT-SEVER,0400075P,50,50,0,0,23,27,5 ème
LANDES,SAINT-VINCENT-DE-PAUL,0400068G,26,19,4,3,12,14,5 ème
LANDES,TARNOS,0400049L,0,0,0,0,0,0,5 ème
LANDES,TARTAS,0400042D,111,110,0,1,54,57,5 ème
LOT-ET-GARONNE,AGEN,0470004Z,0,0,0,0,0,0,5 ème
LOT-ET-GARONNE,AGEN,0470008D,129,129,0,0,58,71,5 ème
LOT-ET-GARONNE,BON-ENCONTRE,0470720C,214,193,16,5,107,107,5 ème
LOT-ET-GARONNE,CASSENEUIL,0470067T,79,66,13,0,39,40,5 ème
LOT-ET-GARONNE,CASTELJALOUX,0470012H,77,77,0,0,36,41,5 ème
LOT-ET-GARONNE,CASTELJALOUX,0470068U,36,33,0,3,21,15,5 ème
LOT-ET-GARONNE,DURAS,0470017N,52,52,0,0,27,25,5 ème
LOT-ET-GARONNE,MIRAMONT-DE-GUYENNE,0470024W,114,108,0,6,54,60,5 ème
LOT-ET-GARONNE,MONBAHUS,0470071X,27,22,0,5,12,15,5 ème
LOT-ET-GARONNE,PORT-SAINTE-MARIE,0470032E,98,92,0,6,41,57,5 ème
LOT-ET-GARONNE,TONNEINS,0470073Z,56,56,0,0,32,24,5 ème
LOT-ET-GARONNE,VILLENEUVE-SUR-LOT,0470811B,126,126,0,0,71,55,5 ème
PYRENEES-ATLANTIQUES,ANGLET,0640001D,0,0,0,0,0,0,5 ème
PYRENEES-ATLANTIQUES,ARUDY,0640007K,63,63,0,0,26,37,5 ème
PYRENEES-ATLANTIQUES,ARZACQ-ARRAZIGUET,0640008L,89,89,0,0,49,40,5 ème
PYRENEES-ATLANTIQUES,BAYONNE,0640112Z,169,166,0,3,79,90,5 ème
PYRENEES-ATLANTIQUES,BAYONNE,0640143H,88,88,0,0,40,48,5 ème
PYRENEES-ATLANTIQUES,BAYONNE,0640609P,131,118,13,0,62,69,5 ème
PYRENEES-ATLANTIQUES,BIARRITZ,0640146L,52,52,0,0,19,33,5 ème
PYRENEES-ATLANTIQUES,BOUCAU,0640023C,102,102,0,0,42,60,5 ème
PYRENEES-ATLANTIQUES,CIBOURE,0641941M,83,80,0,3,38,45,5 ème
PYRENEES-ATLANTIQUES,GARLIN,0640025E,68,63,0,5,37,31,5 ème
PYRENEES-ATLANTIQUES,HENDAYE,0640151S,77,77,0,0,27,50,5 ème
PYRENEES-ATLANTIQUES,JURANCON,0641405E,52,52,0,0,25,27,5 ème
PYRENEES-ATLANTIQUES,LEMBEYE,0640037T,54,54,0,0,33,21,5 ème
PYRENEES-ATLANTIQUES,LESCAR,0641391P,236,233,0,3,117,119,5 ème
PYRENEES-ATLANTIQUES,MAULEON-LICHARRE,0640039V,92,87,0,5,44,48,5 ème
PYRENEES-ATLANTIQUES,NAVARRENX,0640045B,56,56,0,0,32,24,5 ème
PYRENEES-ATLANTIQUES,OLORON-SAINTE-MARIE,0640049F,0,0,0,0,0,0,5 ème
PYRENEES-ATLANTIQUES,OLORON-SAINTE-MARIE,0641658E,78,78,0,0,40,38,5 ème
PYRENEES-ATLANTIQUES,PAU,0640132W,62,60,0,2,25,37,5 ème
PYRENEES-ATLANTIQUES,PAU,0642095E,55,55,0,0,27,28,5 ème
PYRENEES-ATLANTIQUES,PONTACQ,0640161C,52,52,0,0,23,29,5 ème
PYRENEES-ATLANTIQUES,SAINT-JEAN-PIED-DE-PORT,0640069C,67,58,9,0,37,30,5 ème
PYRENEES-ATLANTIQUES,SAINT-PEE-SUR-NIVELLE,0640169L,68,68,0,0,32,36,5 ème
CORREZE,ARGENTAT-SUR-DORDOGNE,0190002Z,67,67,0,0,38,29,5 ème
CORREZE,BORT-LES-ORGUES,0190009G,37,37,0,0,21,16,5 ème
CORREZE,BRIVE-LA-GAILLARDE,0190012K,0,0,0,0,0,0,5 ème
CORREZE,BRIVE-LA-GAILLARDE,0190014M,169,139,29,1,79,90,5 ème
CORREZE,USSEL,0190615R,153,137,14,2,78,75,5 ème
CREUSE,CHAMBON-SUR-VOUEIZE,0230010L,47,47,0,0,24,23,5 ème
CREUSE,DUN-LE-PALESTEL,0230408U,52,52,0,0,24,28,5 ème
CREUSE,GUERET,0230487E,116,99,17,0,48,68,5 ème
CREUSE,GUERET,0230488F,134,131,0,3,70,64,5 ème
CREUSE,SAINT-VAURY,0230027E,0,0,0,0,0,0,5 ème
HAUTE-VIENNE,CHATEAUPONSAC,0870009M,40,40,0,0,26,14,5 ème
HAUTE-VIENNE,COUZEIX,0870871Z,173,157,0,16,83,90,5 ème
HAUTE-VIENNE,ISLE,0870658T,166,166,0,0,84,82,5 ème
HAUTE-VIENNE,LIMOGES,0870023C,107,103,0,4,39,68,5 ème
HAUTE-VIENNE,LIMOGES,0870919B,0,0,0,0,0,0,5 ème
HAUTE-VIENNE,SAINT-GERMAIN-LES-BELLES,0870039V,50,50,0,0,17,33,5 ème
HAUTE-VIENNE,SAINT-YRIEIX-LA-PERCHE,0870821V,131,118,12,1,73,58,5 ème
CHARENTE,ANGOULEME,0160005U,81,81,0,0,43,38,5 ème
CHARENTE,ANGOULEME,0161106R,84,81,0,3,43,41,5 ème
CHARENTE,CHABANAIS,0160120U,72,61,11,0,38,34,5 ème
CHARENTE,CHATEAUNEUF-SUR-CHARENTE,0160863B,134,134,0,0,65,69,5 ème
CHARENTE,LA COURONNE,0160024P,154,153,0,1,74,80,5 ème
CHARENTE,MANSLE,0160029V,83,81,0,2,37,46,5 ème
CHARENTE,SAINT-AMANT-DE-BOIXE,0160040G,98,97,0,1,56,42,5 ème
CHARENTE,SAINT-YRIEIX-SUR-CHARENTE,0160083D,0,0,0,0,0,0,5 ème
CHARENTE,SOYAUX,0160894K,163,158,0,5,74,89,5 ème
CHARENTE,VILLEBOIS-LAVALETTE,0160043K,82,82,0,0,38,44,5 ème
CHARENTE-MARITIME,BURIE,0170004M,84,84,0,0,35,49,5 ème
CHARENTE-MARITIME,CHATELAILLON-PLAGE,0171211Z,188,186,0,2,88,100,5 ème
CHARENTE-MARITIME,JONZAC,0170011V,106,101,0,5,50,56,5 ème
CHARENTE-MARITIME,LA ROCHELLE,0170031S,0,0,0,0,0,0,5 ème
CHARENTE-MARITIME,LOULAY,0170012W,58,52,0,6,26,32,5 ème
CHARENTE-MARITIME,MARENNES-HIERS-BROUAGE,0170386C,118,101,12,5,61,57,5 ème
CHARENTE-MARITIME,MATHA,0171159T,82,75,0,7,44,38,5 ème
CHARENTE-MARITIME,MONTENDRE,0170390G,119,90,20,9,58,61,5 ème
CHARENTE-MARITIME,MONTGUYON,0171160U,55,55,0,0,32,23,5 ème
CHARENTE-MARITIME,ROCHEFORT,0170113F,53,53,0,0,24,29,5 ème
CHARENTE-MARITIME,ROCHEFORT,0171056F,142,135,0,7,70,72,5 ème
CHARENTE-MARITIME,ROYAN,0171120A,178,152,22,4,93,85,5 ème
CHARENTE-MARITIME,SAINTES,0170063B,204,172,29,3,103,101,5 ème
CHARENTE-MARITIME,SAINTES,0170102U,45,45,0,0,24,21,5 ème
CHARENTE-MARITIME,SAINTES,0170144P,221,218,0,3,102,119,5 ème
CHARENTE-MARITIME,SAINT-GENIS-DE-SAINTONGE,0170049L,86,84,0,2,46,40,5 ème
CHARENTE-MARITIME,SAINT-JEAN-D'ANGELY,0170052P,0,0,0,0,0,0,5 ème
CHARENTE-MARITIME,SAINT-MARTIN-DE-RE,0171034G,149,149,0,0,70,79,5 ème
CHARENTE-MARITIME,SAINT-PORCHAIRE,0170055T,139,138,0,1,70,69,5 ème
CHARENTE-MARITIME,SAUJON,0170387D,171,169,0,2,69,102,5 ème
DEUX-SEVRES,ARGENTONNAY,0790003Z,46,46,0,0,27,19,5 ème
DEUX-SEVRES,L'ABSIE,0790001X,26,26,0,0,12,14,5 ème
DEUX-SEVRES,LA MOTHE-SAINT-HERAY,0790021U,63,59,0,4,32,31,5 ème
DEUX-SEVRES,MONCOUTANT-SUR-SEVRE,0790966W,68,62,0,6,27,41,5 ème
DEUX-SEVRES,NIORT,0790052C,143,121,16,6,58,85,5 ème
DEUX-SEVRES,NIORT,0790089T,130,127,0,3,72,58,5 ème
DEUX-SEVRES,NIORT,0790709S,151,150,0,1,75,76,5 ème
DEUX-SEVRES,NUEIL-LES-AUBIERS,0790061M,82,80,0,2,47,35,5 ème
DEUX-SEVRES,PARTHENAY,0790071Y,78,76,0,2,32,46,5 ème
DEUX-SEVRES,PARTHENAY,0790090U,0,0,0,0,0,0,5 ème
DEUX-SEVRES,PRAHECQ,0790950D,142,139,0,3,71,71,5 ème
DEUX-SEVRES,SAUZE-VAUSSAIS,0790033G,49,49,0,0,22,27,5 ème
DEUX-SEVRES,THOUARS,0791017B,87,87,0,0,47,40,5 ème
VIENNE,BUXEROLLES,0860799B,105,100,0,5,64,41,5 ème
VIENNE,CHARROUX,0860002K,48,48,0,0,25,23,5 ème
VIENNE,CHATELLERAULT,0860702W,99,98,0,1,52,47,5 ème
VIENNE,CHATELLERAULT,0860753B,133,133,0,0,64,69,5 ème
VIENNE,DANGE-SAINT-ROMAIN,0860015Z,76,75,0,1,40,36,5 ème
VIENNE,LOUDUN,0860023H,122,107,12,3,57,65,5 ème
VIENNE,MONTMORILLON,0860768T,55,55,0,0,26,29,5 ème
VIENNE,POITIERS,0860723U,164,163,0,1,82,82,5 ème
VIENNE,POITIERS,0860758G,151,146,0,5,65,86,5 ème
VIENNE,POITIERS,0860791T,193,192,0,1,92,101,5 ème
VIENNE,VOUNEUIL-SOUS-BIARD,0861457S,170,167,0,3,78,92,5 ème
VIENNE,VOUNEUIL-SUR-VIENNE,0860049L,119,116,0,3,59,60,5 ème
AUDE,CARCASSONNE,0110010B,100,100,0,0,51,49,5 ème
AUDE,CARCASSONNE,0110810W,180,161,16,3,86,94,5 ème
AUDE,COURSAN,0110067N,173,164,0,9,80,93,5 ème
AUDE,CUXAC-CABARDES,0110721Z,102,102,0,0,51,51,5 ème
AUDE,LEZIGNAN-CORBIERES,0110686L,170,164,0,6,85,85,5 ème
AUDE,NARBONNE,0110049U,216,212,0,4,112,104,5 ème
AUDE,PORT-LA-NOUVELLE,0110725D,96,87,0,9,48,48,5 ème
AUDE,QUILLAN,0110675Z,42,42,0,0,14,28,5 ème
AUDE,SAINT-NAZAIRE-D'AUDE,0111015U,172,172,0,0,80,92,5 ème
AUDE,SIGEAN,0110724C,144,144,0,0,72,72,5 ème
GARD,ALES,0300125Y,0,0,0,0,0,0,5 ème
GARD,ALES,0300947S,155,130,16,9,79,76,5 ème
GARD,ALES,0300949U,150,148,0,2,82,68,5 ème
GARD,BEAUCAIRE,0301282F,124,108,13,3,59,65,5 ème
GARD,BELLEGARDE,0301827Y,113,110,0,3,51,62,5 ème
GARD,LA GRAND-COMBE,0301012M,85,82,0,3,46,39,5 ème
GARD,LE GRAU-DU-ROI,0301751R,128,125,0,3,59,69,5 ème
GARD,LE VIGAN,0301326D,117,107,10,0,63,54,5 ème
GARD,NIMES,0300025P,74,72,0,2,36,38,5 ème
GARD,NIMES,0300093N,230,213,13,4,109,121,5 ème
GARD,NIMES,0301356L,294,290,0,4,130,164,5 ème
GARD,UZES,0301283G,178,162,16,0,86,92,5 ème
GARD,UZES,0301721H,120,116,0,4,55,65,5 ème
GARD,VAUVERT,0301096D,279,252,24,3,138,141,5 ème
HERAULT,BEZIERS,0340891J,47,47,0,0,22,25,5 ème
HERAULT,BEZIERS,0341321B,161,139,15,7,74,87,5 ème
HERAULT,CAPESTANG,0341367B,148,140,0,8,62,86,5 ème
HERAULT,CLAPIERS,0341826A,158,155,0,3,64,94,5 ème
HERAULT,CLERMONT-L'HERAULT,0341366A,213,210,0,3,111,102,5 ème
HERAULT,FRONTIGNAN,0342052W,147,143,0,4,71,76,5 ème
HERAULT,GANGES,0340896P,62,62,0,0,26,36,5 ème
HERAULT,LOUPIAN,0342224H,146,130,16,0,64,82,5 ème
HERAULT,LUNEL,0340031Z,183,179,0,4,88,95,5 ème
HERAULT,MONTPELLIER,0340874R,212,212,0,0,101,111,5 ème
HERAULT,MONTPELLIER,0340876T,128,128,0,0,59,69,5 ème
HERAULT,MONTPELLIER,0340996Y,173,163,10,0,84,89,5 ème
HERAULT,MONTPELLIER,0340998A,124,119,0,5,64,60,5 ème
HERAULT,MONTPELLIER,0342012C,35,35,0,0,11,24,5 ème
HERAULT,PAULHAN,0340974Z,180,180,0,0,107,73,5 ème
HERAULT,PEZENAS,0340061G,0,0,0,0,0,0,5 ème
HERAULT,PEZENAS,0340907B,86,86,0,0,42,44,5 ème
HERAULT,SAINT-CHINIAN,0340065L,76,70,0,6,40,36,5 ème
HERAULT,SETE,0340076Y,0,0,0,0,0,0,5 ème
HERAULT,SETE,0341065Y,124,108,13,3,66,58,5 ème
LOZERE,MARVEJOLS,0480024R,74,74,0,0,34,40,5 ème
LOZERE,SAINT-CHELY-D'APCHER,0480038F,47,47,0,0,21,26,5 ème
LOZERE,VIALAS,0480016G,6,6,0,0,0,6,5 ème
PYRENEES-ORIENTALES,ARGELES-SUR-MER,0660001T,143,125,17,1,68,75,5 ème
PYRENEES-ORIENTALES,CERET,0660004W,0,0,0,0,0,0,5 ème
PYRENEES-ORIENTALES,ESTAGEL,0660007Z,83,83,0,0,48,35,5 ème
PYRENEES-ORIENTALES,ILLE-SUR-TET,0660008A,145,141,0,4,79,66,5 ème
PYRENEES-ORIENTALES,LE SOLER,0660653B,143,142,0,1,72,71,5 ème
PYRENEES-ORIENTALES,MILLAS,0660925X,167,166,0,1,81,86,5 ème
PYRENEES-ORIENTALES,PERPIGNAN,0660012E,154,127,16,11,61,93,5 ème
PYRENEES-ORIENTALES,PERPIGNAN,0660017K,111,111,0,0,51,60,5 ème
PYRENEES-ORIENTALES,PERPIGNAN,0660018L,143,140,0,3,73,70,5 ème
PYRENEES-ORIENTALES,PERPIGNAN,0660019M,183,162,17,4,87,96,5 ème
PYRENEES-ORIENTALES,PERPIGNAN,0660049V,175,173,0,2,94,81,5 ème
PYRENEES-ORIENTALES,PERPIGNAN,0660061H,149,146,0,3,79,70,5 ème
PYRENEES-ORIENTALES,PERPIGNAN,0660809W,0,0,0,0,0,0,5 ème
PYRENEES-ORIENTALES,SAINT-CYPRIEN,0660848N,181,180,0,1,93,88,5 ème
PYRENEES-ORIENTALES,TOULOUGES,0660864F,180,180,0,0,96,84,5 ème
ARIEGE,PAMIERS,0090056M,145,142,0,3,73,72,5 ème
ARIEGE,PAMIERS,0090591U,91,91,0,0,46,45,5 ème
ARIEGE,SAVERDUN,0090023B,107,105,0,2,51,56,5 ème
AVEYRON,BARAQUEVILLE,0120032V,112,106,0,6,52,60,5 ème
AVEYRON,BARAQUEVILLE,0120080X,14,14,0,0,9,5,5 ème
AVEYRON,BELMONT-SUR-RANCE,0120081Y,38,38,0,0,21,17,5 ème
AVEYRON,CAPDENAC-GARE,0120002M,64,64,0,0,36,28,5 ème
AVEYRON,CASSAGNES-BEGONHES,0120084B,21,21,0,0,4,17,5 ème
AVEYRON,LAGUIOLE,0120091J,15,15,0,0,8,7,5 ème
AVEYRON,MILLAU,0121259D,175,170,0,5,94,81,5 ème
AVEYRON,MUR-DE-BARREZ,0120016C,26,26,0,0,15,11,5 ème
AVEYRON,REQUISTA,0120019F,43,43,0,0,22,21,5 ème
AVEYRON,REQUISTA,0120068J,21,21,0,0,7,14,5 ème
AVEYRON,RODEZ,0120038B,0,0,0,0,0,0,5 ème
AVEYRON,RODEZ,0120101V,197,187,0,10,106,91,5 ème
AVEYRON,RODEZ,0121430P,218,199,7,12,99,119,5 ème
AVEYRON,SAINT-AMANS-DES-COTS,0121295T,37,36,0,1,16,21,5 ème
AVEYRON,SAINT GENIEZ D'OLT ET D'AUBRAC,0120028R,31,31,0,0,14,17,5 ème
AVEYRON,SALLES-CURAN,0120077U,25,25,0,0,12,13,5 ème
GERS,AUCH,0320006H,113,110,0,3,57,56,5 ème
GERS,EAUZE,0320011N,81,77,0,4,38,43,5 ème
GERS,LECTOURE,0320015T,0,0,0,0,0,0,5 ème
GERS,MIELAN,0320074G,38,38,0,0,22,16,5 ème
HAUTE-GARONNE,ASPET,0310001H,53,51,0,2,32,21,5 ème
HAUTE-GARONNE,BLAGNAC,0311237B,147,145,0,2,78,69,5 ème
HAUTE-GARONNE,BLAGNAC,0311965T,120,120,0,0,55,65,5 ème
HAUTE-GARONNE,CADOURS,0310008R,144,144,0,0,70,74,5 ème
HAUTE-GARONNE,COLOMIERS,0311160T,122,122,0,0,69,53,5 ème
HAUTE-GARONNE,COLOMIERS,0312092F,91,86,0,5,49,42,5 ème
HAUTE-GARONNE,CUGNAUX,0311093V,223,215,0,8,115,108,5 ème
HAUTE-GARONNE,FRONTON,0311721C,206,201,0,5,97,109,5 ème
HAUTE-GARONNE,GRATENTOUR,0312478A,174,171,0,3,90,84,5 ème
HAUTE-GARONNE,GRENADE,0311769E,183,165,12,6,81,102,5 ème
HAUTE-GARONNE,L'ISLE-EN-DODON,0310019C,45,45,0,0,27,18,5 ème
HAUTE-GARONNE,L'UNION,0311094W,236,221,12,3,125,111,5 ème
HAUTE-GARONNE,MONTASTRUC-LA-CONSEILLERE,0310021E,144,139,0,5,79,65,5 ème
HAUTE-GARONNE,MONTESQUIEU-VOLVESTRE,0310022F,86,86,0,0,42,44,5 ème
HAUTE-GARONNE,MURET,0312822Z,0,0,0,0,0,0,5 ème
HAUTE-GARONNE,REVEL,0311846N,143,143,0,0,70,73,5 ème
HAUTE-GARONNE,SAINT-GAUDENS,0310033T,0,0,0,0,0,0,5 ème
HAUTE-GARONNE,SAINT-ORENS-DE-GAMEVILLE,0312140H,171,171,0,0,89,82,5 ème
HAUTE-GARONNE,TOULOUSE,0310093H,148,141,0,7,63,85,5 ème
HAUTE-GARONNE,TOULOUSE,0311112R,170,156,11,3,87,83,5 ème
HAUTE-GARONNE,TOULOUSE,0311144A,111,109,0,2,50,61,5 ème
HAUTE-GARONNE,TOULOUSE,0311150G,91,91,0,0,54,37,5 ème
HAUTE-GARONNE,TOULOUSE,0311169C,86,82,0,4,46,40,5 ème
HAUTE-GARONNE,TOULOUSE,0311171E,115,115,0,0,58,57,5 ème
HAUTE-GARONNE,TOULOUSE,0311219G,0,0,0,0,0,0,5 ème
HAUTE-GARONNE,TOULOUSE,0311327Z,98,79,14,5,41,57,5 ème
HAUTE-GARONNE,TOULOUSE,0311582B,117,117,0,0,58,59,5 ème
HAUTE-GARONNE,TOULOUSE,0311972A,279,272,7,0,110,169,5 ème
HAUTE-GARONNE,TOURNEFEUILLE,0312746S,0,0,0,0,0,0,5 ème
HAUTE-GARONNE,VILLEFRANCHE-DE-LAURAGAIS,0311634H,197,193,0,4,91,106,5 ème
HAUTE-GARONNE,VILLEMUR-SUR-TARN,0311689T,116,104,12,0,50,66,5 ème
HAUTES-PYRENEES,PIERREFITTE-NESTALAS,0650020U,28,28,0,0,17,11,5 ème
HAUTES-PYRENEES,SEMEAC,0650088T,146,142,0,4,70,76,5 ème
HAUTES-PYRENEES,TARBES,0650029D,0,0,0,0,0,0,5 ème
HAUTES-PYRENEES,TRIE-SUR-BAISE,0650037M,43,43,0,0,17,26,5 ème
HAUTES-PYRENEES,VIC-EN-BIGORRE,0650075D,23,23,0,0,14,9,5 ème
LOT,CAHORS,0460006G,173,164,0,9,85,88,5 ème
LOT,CAHORS,0460528Z,153,127,22,4,86,67,5 ème
LOT,CAJARC,0460001B,64,64,0,0,28,36,5 ème
LOT,CASTELNAU MONTRATIER-STE ALAUZIE,0460008J,68,68,0,0,36,32,5 ème
LOT,FIGEAC,0460621A,87,87,0,0,40,47,5 ème
LOT,GOURDON,0460013P,0,0,0,0,0,0,5 ème
LOT,LUZECH,0460020X,108,108,0,0,48,60,5 ème
LOT,MONTCUQ-EN-QUERCY-BLANC,0460022Z,32,32,0,0,18,14,5 ème
LOT,PUY-L'EVEQUE,0460530B,55,55,0,0,27,28,5 ème
LOT,SAINT-CERE,0460593V,98,82,13,3,48,50,5 ème
LOT,SALVIAC,0460027E,37,37,0,0,13,24,5 ème
TARN,ALBI,0810100U,0,0,0,0,0,0,5 ème
TARN,CASTRES,0811064S,105,103,0,2,46,59,5 ème
TARN,GAILLAC,0810993P,190,170,16,4,99,91,5 ème
TARN,GRAULHET,0810995S,0,0,0,0,0,0,5 ème
TARN,LABRUGUIERE,0810026N,91,88,0,3,52,39,5 ème
TARN,LISLE-SUR-TARN,0811340S,120,116,0,4,45,75,5 ème
TARN,MAZAMET,0811324Z,0,0,0,0,0,0,5 ème
TARN,VALENCE-D'ALBIGEOIS,0810043G,53,53,0,0,23,30,5 ème
TARN,VIELMUR-SUR-AGOUT,0810044H,82,82,0,0,38,44,5 ème
TARN-ET-GARONNE,BEAUMONT-DE-LOMAGNE,0820001F,0,0,0,0,0,0,5 ème
TARN-ET-GARONNE,BEAUMONT-DE-LOMAGNE,0820067C,118,113,0,5,54,64,5 ème
TARN-ET-GARONNE,CASTELSARRASIN,0820004J,0,0,0,0,0,0,5 ème
TARN-ET-GARONNE,CAUSSADE,0820048G,93,93,0,0,46,47,5 ème
TARN-ET-GARONNE,LAFRANCAISE,0820011S,143,139,0,4,67,76,5 ème
TARN-ET-GARONNE,LAUZERTE,0820014V,79,76,0,3,32,47,5 ème
LOIRE-ATLANTIQUE,ANCENIS-SAINT-GEREON,0440001M,0,0,0,0,0,0,5 ème
LOIRE-ATLANTIQUE,ANCENIS-SAINT-GEREON,0440147W,207,180,16,11,111,96,5 ème
LOIRE-ATLANTIQUE,BLAIN,0440182J,188,182,0,6,92,96,5 ème
LOIRE-ATLANTIQUE,BLAIN,0440308W,163,128,32,3,76,87,5 ème
LOIRE-ATLANTIQUE,CARQUEFOU,0440422V,199,193,0,6,101,98,5 ème
LOIRE-ATLANTIQUE,CHATEAUBRIANT,0440348P,165,148,16,1,88,77,5 ème
LOIRE-ATLANTIQUE,COUERON,0440010X,210,210,0,0,110,100,5 ème
LOIRE-ATLANTIQUE,COUERON,0440190T,169,169,0,0,85,84,5 ème
LOIRE-ATLANTIQUE,GUEMENE-PENFAO,0440013A,101,98,0,3,46,55,5 ème
LOIRE-ATLANTIQUE,GUEMENE-PENFAO,0440192V,78,78,0,0,32,46,5 ème
LOIRE-ATLANTIQUE,GUERANDE,0440538W,169,163,0,6,88,81,5 ème
LOIRE-ATLANTIQUE,HAUTE-GOULAINE,0440153C,94,94,0,0,35,59,5 ème
LOIRE-ATLANTIQUE,LA MONTAGNE,0440347N,120,116,0,4,58,62,5 ème
LOIRE-ATLANTIQUE,LEGE,0441612N,59,59,0,0,35,24,5 ème
LOIRE-ATLANTIQUE,MACHECOUL-SAINT-MEME,0440352U,0,0,0,0,0,0,5 ème
LOIRE-ATLANTIQUE,NANTES,0440023L,223,204,15,4,109,114,5 ème
LOIRE-ATLANTIQUE,NANTES,0440203G,49,49,0,0,23,26,5 ème
LOIRE-ATLANTIQUE,NANTES,0440206K,36,36,0,0,15,21,5 ème
LOIRE-ATLANTIQUE,NANTES,0440207L,36,36,0,0,12,24,5 ème
LOIRE-ATLANTIQUE,NANTES,0441820P,82,82,0,0,38,44,5 ème
LOIRE-ATLANTIQUE,NANTES,0441821R,59,59,0,0,30,29,5 ème
LOIRE-ATLANTIQUE,NORT-SUR-ERDRE,0441654J,188,186,0,2,103,85,5 ème
LOIRE-ATLANTIQUE,PONTCHATEAU,0440224E,172,172,0,0,86,86,5 ème
LOIRE-ATLANTIQUE,PONTCHATEAU,0440540Y,138,102,32,4,65,73,5 ème
LOIRE-ATLANTIQUE,PORNIC,0440226G,189,189,0,0,92,97,5 ème
LOIRE-ATLANTIQUE,PORNIC,0440289A,182,181,0,1,81,101,5 ème
LOIRE-ATLANTIQUE,REZE,0440534S,123,104,16,3,63,60,5 ème
LOIRE-ATLANTIQUE,RIAILLE,0440232N,116,116,0,0,57,59,5 ème
LOIRE-ATLANTIQUE,SAINT-BREVIN-LES-PINS,0440066H,141,137,0,4,67,74,5 ème
LOIRE-ATLANTIQUE,SAINT-HERBLAIN,0440287Y,119,119,0,0,52,67,5 ème
LOIRE-ATLANTIQUE,SAINT-HERBLAIN,0440311Z,137,121,16,0,67,70,5 ème
LOIRE-ATLANTIQUE,SAINT-HERBLAIN,0441610L,151,129,16,6,78,73,5 ème
LOIRE-ATLANTIQUE,SAINT-NAZAIRE,0442759K,172,168,0,4,85,87,5 ème
LOIRE-ATLANTIQUE,SAINT-SEBASTIEN-SUR-LOIRE,0441548U,226,212,14,0,102,124,5 ème
LOIRE-ATLANTIQUE,SAINT-SEBASTIEN-SUR-LOIRE,0441653H,0,0,0,0,0,0,5 ème
LOIRE-ATLANTIQUE,VALLET,0440242Z,181,181,0,0,98,83,5 ème
MAINE-ET-LOIRE,ANGERS,0490003M,0,0,0,0,0,0,5 ème
MAINE-ET-LOIRE,ANGERS,0492432C,0,0,0,0,0,0,5 ème
MAINE-ET-LOIRE,AVRILLE,0491674D,170,152,16,2,87,83,5 ème
MAINE-ET-LOIRE,BEAUPREAU-EN-MAUGES,0490865Z,73,73,0,0,34,39,5 ème
MAINE-ET-LOIRE,CHEMILLE-EN-ANJOU,0490017C,103,100,0,3,56,47,5 ème
MAINE-ET-LOIRE,CHOLET,0490022H,84,83,0,1,52,32,5 ème
MAINE-ET-LOIRE,CHOLET,0490054T,0,0,0,0,0,0,5 ème
MAINE-ET-LOIRE,CHOLET,0490860U,149,115,34,0,59,90,5 ème
MAINE-ET-LOIRE,CHOLET,0491859E,132,107,16,9,53,79,5 ème
MAINE-ET-LOIRE,LOIRE-AUTHION,0490013Y,0,0,0,0,0,0,5 ème
MAINE-ET-LOIRE,MAUGES-SUR-LOIRE,0491928E,266,243,17,6,144,122,5 ème
MAINE-ET-LOIRE,MONTREUIL-BELLAY,0491262F,106,95,10,1,48,58,5 ème
MAINE-ET-LOIRE,SAINT-BARTHELEMY-D'ANJOU,0490957Z,177,174,0,3,80,97,5 ème
MAINE-ET-LOIRE,SAUMUR,0490910Y,0,0,0,0,0,0,5 ème
MAINE-ET-LOIRE,SEICHES-SUR-LE-LOIR,0491024X,177,175,0,2,90,87,5 ème
MAINE-ET-LOIRE,SEVREMOINE,0490842Z,118,118,0,0,57,61,5 ème
MAINE-ET-LOIRE,VERRIERES-EN-ANJOU,0492420P,0,0,0,0,0,0,5 ème
MAYENNE,CHATEAU-GONTIER-SUR-MAYENNE,0530827L,135,135,0,0,61,74,5 ème
MAYENNE,COSSE-LE-VIVIEN,0530054W,115,115,0,0,48,67,5 ème
MAYENNE,CRAON,0530005T,81,65,16,0,43,38,5 ème
MAYENNE,CRAON,0530055X,119,113,0,6,57,62,5 ème
MAYENNE,EVRON,0530949U,0,0,0,0,0,0,5 ème
MAYENNE,LANDIVY,0530804L,50,50,0,0,23,27,5 ème
MAYENNE,LAVAL,0530068L,0,0,0,0,0,0,5 ème
MAYENNE,LAVAL,0530790W,122,114,0,8,64,58,5 ème
MAYENNE,MAYENNE,0530078X,141,125,15,1,61,80,5 ème
MAYENNE,MAYENNE,0530079Y,0,0,0,0,0,0,5 ème
MAYENNE,VILLAINES-LA-JUHEL,0530066J,46,46,0,0,20,26,5 ème
SARTHE,ARNAGE,0720003M,0,0,0,0,0,0,5 ème
SARTHE,BOULOIRE,0720007S,120,104,16,0,61,59,5 ème
SARTHE,COULAINES,0720906U,127,125,0,2,84,43,5 ème
SARTHE,LA SUZE-SUR-SARTHE,0720905T,154,151,0,3,85,69,5 ème
SARTHE,LE MANS,0720822C,0,0,0,0,0,0,5 ème
SARTHE,LE MANS,0720825F,0,0,0,0,0,0,5 ème
SARTHE,LE MANS,0721090U,103,87,16,0,47,56,5 ème
SARTHE,LOUE,0720808M,72,72,0,0,36,36,5 ème
SARTHE,MAMERS,0720069J,99,83,16,0,44,55,5 ème
SARTHE,MAMERS,0721657K,47,47,0,0,25,22,5 ème
SARTHE,SABLE-SUR-SARTHE,0720070K,128,128,0,0,61,67,5 ème
SARTHE,SABLE-SUR-SARTHE,0720843A,0,0,0,0,0,0,5 ème
SARTHE,SAINT-CALAIS,0720803G,29,29,0,0,8,21,5 ème
VENDEE,CHALLANS,0850146X,0,0,0,0,0,0,5 ème
VENDEE,ESSARTS EN BOCAGE,0850099W,174,174,0,0,80,94,5 ème
VENDEE,FONTENAY-LE-COMTE,0850067L,131,112,16,3,65,66,5 ème
VENDEE,LA CHATAIGNERAIE,0851163C,54,54,0,0,20,34,5 ème
VENDEE,LA ROCHE-SUR-YON,0850028U,0,0,0,0,0,0,5 ème
VENDEE,LA ROCHE-SUR-YON,0850114M,172,172,0,0,89,83,5 ème
VENDEE,LA ROCHE-SUR-YON,0851304F,145,135,7,3,56,89,5 ème
VENDEE,LES BROUZILS,0850091M,87,87,0,0,44,43,5 ème
VENDEE,LES HERBIERS,0851159Y,377,355,16,6,167,210,5 ème
VENDEE,LES SABLES-D'OLONNE,0850043K,0,0,0,0,0,0,5 ème
VENDEE,L'ILE-D'YEU,0850015E,29,29,0,0,12,17,5 ème
VENDEE,L'ILE-D'YEU,0850103A,20,20,0,0,7,13,5 ème
VENDEE,POUZAUGES,0851160Z,198,196,0,2,92,106,5 ème
VENDEE,SAINTE-HERMINE,0850122W,69,69,0,0,37,32,5 ème
VENDEE,SAINT-LAURENT-SUR-SEVRE,0851504Y,0,0,0,0,0,0,5 ème
ALPES-DE-HTE-PROVENCE,DIGNE-LES-BAINS,0040022C,173,151,21,1,81,92,5 ème
ALPES-DE-HTE-PROVENCE,DIGNE-LES-BAINS,0040461E,57,57,0,0,29,28,5 ème
BOUCHES-DU-RHONE,AIX-EN-PROVENCE,0130007M,137,105,32,0,62,75,5 ème
BOUCHES-DU-RHONE,AIX-EN-PROVENCE,0132009N,143,140,0,3,68,75,5 ème
BOUCHES-DU-RHONE,AUBAGNE,0131266F,149,146,0,3,69,80,5 ème
BOUCHES-DU-RHONE,AURIOL,0133510V,174,173,0,1,89,85,5 ème
BOUCHES-DU-RHONE,CARNOUX-EN-PROVENCE,0133335E,110,110,0,0,60,50,5 ème
BOUCHES-DU-RHONE,CHATEAURENARD,0131366P,115,115,0,0,58,57,5 ème
BOUCHES-DU-RHONE,CHATEAURENARD,0131881Z,272,268,0,4,127,145,5 ème
BOUCHES-DU-RHONE,GARDANNE,0131701D,93,93,0,0,44,49,5 ème
BOUCHES-DU-RHONE,ISTRES,0133203L,144,144,0,0,77,67,5 ème
BOUCHES-DU-RHONE,MALLEMORT,0130032P,161,161,0,0,87,74,5 ème
BOUCHES-DU-RHONE,MARSEILLE,0134022B,140,118,16,6,52,88,5 ème
BOUCHES-DU-RHONE,MARSEILLE,0132403S,93,93,0,0,43,50,5 ème
BOUCHES-DU-RHONE,MARSEILLE,0133881Y,165,162,0,3,71,94,5 ème
BOUCHES-DU-RHONE,MARSEILLE,0131260Z,95,93,0,2,47,48,5 ème
BOUCHES-DU-RHONE,MARSEILLE,0131262B,166,142,23,1,70,96,5 ème
BOUCHES-DU-RHONE,MARSEILLE,0132313U,96,87,0,9,38,58,5 ème
BOUCHES-DU-RHONE,MARSEILLE,0130065A,0,0,0,0,0,0,5 ème
BOUCHES-DU-RHONE,MARSEILLE,0131704G,156,138,15,3,67,89,5 ème
BOUCHES-DU-RHONE,MARSEILLE,0131887F,92,86,0,6,49,43,5 ème
BOUCHES-DU-RHONE,MARSEILLE,0130039X,0,0,0,0,0,0,5 ème
BOUCHES-DU-RHONE,MARSEILLE,0131931D,103,103,0,0,53,50,5 ème
BOUCHES-DU-RHONE,MARSEILLE,0132283L,61,61,0,0,32,29,5 ème
BOUCHES-DU-RHONE,MARSEILLE,0130110Z,111,111,0,0,53,58,5 ème
BOUCHES-DU-RHONE,MARSEILLE,0131403E,0,0,0,0,0,0,5 ème
BOUCHES-DU-RHONE,MARSEILLE,0132958V,127,127,0,0,52,75,5 ème
BOUCHES-DU-RHONE,MARSEILLE,0133396W,0,0,0,0,0,0,5 ème
BOUCHES-DU-RHONE,MARSEILLE,0130049H,0,0,0,0,0,0,5 ème
BOUCHES-DU-RHONE,MARSEILLE,0130071G,0,0,0,0,0,0,5 ème
BOUCHES-DU-RHONE,MARSEILLE,0131371V,64,64,0,0,32,32,5 ème
BOUCHES-DU-RHONE,MARSEILLE,0131548M,180,159,16,5,73,107,5 ème
BOUCHES-DU-RHONE,MARSEILLE,0131602W,165,165,0,0,79,86,5 ème
BOUCHES-DU-RHONE,MARSEILLE,0132310R,134,134,0,0,56,78,5 ème
BOUCHES-DU-RHONE,MARSEILLE,0132951M,117,117,0,0,69,48,5 ème
BOUCHES-DU-RHONE,MARTIGUES,0131789Z,111,109,0,2,45,66,5 ème
BOUCHES-DU-RHONE,MARTIGUES,0132210G,0,0,0,0,0,0,5 ème
BOUCHES-DU-RHONE,MIRAMAS,0130146N,0,0,0,0,0,0,5 ème
BOUCHES-DU-RHONE,MIRAMAS,0132326H,130,126,0,4,64,66,5 ème
BOUCHES-DU-RHONE,MIRAMAS,0132327J,112,90,22,0,51,61,5 ème
BOUCHES-DU-RHONE,MIRAMAS,0134245U,67,67,0,0,30,37,5 ème
BOUCHES-DU-RHONE,PORT-DE-BOUC,0132212J,85,69,16,0,28,57,5 ème
BOUCHES-DU-RHONE,SAINT-CHAMAS,0130157A,0,0,0,0,0,0,5 ème
BOUCHES-DU-RHONE,SALON-DE-PROVENCE,0131265E,118,118,0,0,61,57,5 ème
BOUCHES-DU-RHONE,SAUSSET-LES-PINS,0133449D,208,208,0,0,95,113,5 ème
BOUCHES-DU-RHONE,SEPTEMES-LES-VALLONS,0131675A,0,0,0,0,0,0,5 ème
BOUCHES-DU-RHONE,SEPTEMES-LES-VALLONS,0133765X,133,127,0,6,59,74,5 ème
BOUCHES-DU-RHONE,TARASCON,0131388N,60,60,0,0,33,27,5 ème
HAUTES-ALPES,BRIANCON,0050043V,107,107,0,0,56,51,5 ème
HAUTES-ALPES,GAP,0050009H,0,0,0,0,0,0,5 ème
HAUTES-ALPES,GAP,0050562J,142,142,0,0,83,59,5 ème
VAUCLUSE,AVIGNON,0840006A,81,80,0,1,33,48,5 ème
VAUCLUSE,AVIGNON,0840108L,128,88,30,10,62,66,5 ème
VAUCLUSE,AVIGNON,0840697B,99,98,0,1,50,49,5 ème
VAUCLUSE,CARPENTRAS,0840015K,0,0,0,0,0,0,5 ème
VAUCLUSE,LE THOR,0840915N,155,150,0,5,76,79,5 ème
VAUCLUSE,MORIERES-LES-AVIGNON,0841116G,199,197,0,2,98,101,5 ème
VAUCLUSE,ORANGE,0840116V,187,163,24,0,93,94,5 ème
VAUCLUSE,ORANGE,0840853W,187,187,0,0,97,90,5 ème
VAUCLUSE,PERNES-LES-FONTAINES,0840028Z,144,141,0,3,69,75,5 ème
VAUCLUSE,SAULT,0840032D,38,36,0,2,18,20,5 ème
VAUCLUSE,SORGUES,0840068T,175,153,18,4,85,90,5 ème
ALPES-MARITIMES,ANTIBES,0060002V,0,0,0,0,0,0,5 ème
ALPES-MARITIMES,ANTIBES,0060842H,209,197,11,1,98,111,5 ème
ALPES-MARITIMES,ANTIBES,0061119J,151,151,0,0,77,74,5 ème
ALPES-MARITIMES,BEAULIEU-SUR-MER,0061209G,141,139,0,2,65,76,5 ème
ALPES-MARITIMES,BIOT,0061670H,204,204,0,0,108,96,5 ème
ALPES-MARITIMES,CAGNES-SUR-MER,0061635V,0,0,0,0,0,0,5 ème
ALPES-MARITIMES,CANNES,0061279H,119,119,0,0,53,66,5 ème
ALPES-MARITIMES,CANNES,0061342B,120,120,0,0,54,66,5 ème
ALPES-MARITIMES,CANNES,0062122Z,13,13,0,0,6,7,5 ème
ALPES-MARITIMES,GRASSE,0060021R,112,107,0,5,48,64,5 ème
ALPES-MARITIMES,LE CANNET,0061723R,131,131,0,0,65,66,5 ème
ALPES-MARITIMES,MOUANS-SARTOUX,0061795U,178,178,0,0,76,102,5 ème
ALPES-MARITIMES,NICE,0060032C,142,141,0,1,70,72,5 ème
ALPES-MARITIMES,NICE,0060042N,0,0,0,0,0,0,5 ème
ALPES-MARITIMES,NICE,0060050X,195,191,0,4,102,93,5 ème
ALPES-MARITIMES,NICE,0061002G,164,161,0,3,79,85,5 ème
ALPES-MARITIMES,NICE,0061006L,269,269,0,0,142,127,5 ème
ALPES-MARITIMES,NICE,0061129V,118,118,0,0,63,55,5 ème
ALPES-MARITIMES,NICE,0061277F,191,170,15,6,95,96,5 ème
ALPES-MARITIMES,NICE,0061694J,215,209,0,6,93,122,5 ème
ALPES-MARITIMES,PEYMEINADE,0061796V,180,180,0,0,86,94,5 ème
ALPES-MARITIMES,ROQUEBRUNE-CAP-MARTIN,0061458C,132,132,0,0,58,74,5 ème
ALPES-MARITIMES,SAINT-ETIENNE-DE-TINEE,0060063L,45,45,0,0,22,23,5 ème
ALPES-MARITIMES,SAINT-LAURENT-DU-VAR,0061134A,177,173,0,4,84,93,5 ème
ALPES-MARITIMES,SAINT-MARTIN-DU-VAR,0061400P,137,132,0,5,65,72,5 ème
ALPES-MARITIMES,VILLENEUVE-LOUBET,0061825B,176,174,0,2,67,109,5 ème
VAR,CARCES,0831709G,148,143,0,5,65,83,5 ème
VAR,CARQUEIRANNE,0830836H,188,188,0,0,93,95,5 ème
VAR,COGOLIN,0831424X,105,105,0,0,52,53,5 ème
VAR,CUERS,0830013N,175,160,13,2,85,90,5 ème
VAR,CUERS,0830114Y,0,0,0,0,0,0,5 ème
VAR,DRAGUIGNAN,0830016S,0,0,0,0,0,0,5 ème
VAR,DRAGUIGNAN,0831274J,191,173,16,2,87,104,5 ème
VAR,FAYENCE,0830019V,139,138,0,1,66,73,5 ème
VAR,FIGANIERES,0831609Y,132,132,0,0,64,68,5 ème
VAR,FREJUS,0830023Z,168,168,0,0,81,87,5 ème
VAR,FREJUS,0830834F,136,123,0,13,63,73,5 ème
VAR,GASSIN,0831537V,162,162,0,0,80,82,5 ème
VAR,LA FARLEDE,0831514V,132,127,0,5,65,67,5 ème
VAR,LE CASTELLET,0831644L,90,90,0,0,46,44,5 ème
VAR,LE LUC,0830163B,223,212,10,1,104,119,5 ème
VAR,OLLIOULES,0830922B,135,135,0,0,60,75,5 ème
VAR,SAINT-CYR-SUR-MER,0830106P,94,94,0,0,48,46,5 ème
VAR,SAINT-TROPEZ,0830996G,49,49,0,0,25,24,5 ème
VAR,SIX-FOURS-LES-PLAGES,0831354W,0,0,0,0,0,0,5 ème
VAR,TOULON,0830069Z,225,210,12,3,103,122,5 ème
VAR,TOULON,0830181W,134,117,11,6,65,69,5 ème
VAR,TOULON,0830661T,0,0,0,0,0,0,5 ème
VAR,TOULON,0830954L,126,126,0,0,55,71,5 ème
CALVADOS,BAYEUX,0141274J,0,0,0,0,0,0,5 ème
CALVADOS,CAEN,0140025B,131,127,0,4,73,58,5 ème
CALVADOS,CAEN,0141163N,146,146,0,0,59,87,5 ème
CALVADOS,CAEN,0141268C,160,157,0,3,72,88,5 ème
CALVADOS,CAEN,0142133T,0,0,0,0,0,0,5 ème
CALVADOS,DOUVRES-LA-DELIVRANDE,0141193W,0,0,0,0,0,0,5 ème
CALVADOS,FALAISE,0141764S,216,198,14,4,92,124,5 ème
CALVADOS,GIBERVILLE,0141964J,123,119,0,4,55,68,5 ème
CALVADOS,HEROUVILLE-SAINT-CLAIR,0141136J,72,68,0,4,45,27,5 ème
CALVADOS,HEROUVILLE-SAINT-CLAIR,0141363F,93,88,0,5,43,50,5 ème
CALVADOS,LE HOM,0141228J,74,73,0,1,36,38,5 ème
CALVADOS,LIVAROT-PAYS-D'AUGE,0140067X,62,62,0,0,30,32,5 ème
CALVADOS,MERVILLE-FRANCEVILLE-PLAGE,0140069Z,101,101,0,0,51,50,5 ème
CALVADOS,TROUVILLE-SUR-MER,0141863Z,139,139,0,0,67,72,5 ème
EURE,BEAUMONT-LE-ROGER,0271056B,53,53,0,0,28,25,5 ème
EURE,EVREUX,0270018Y,0,0,0,0,0,0,5 ème
EURE,EZY-SUR-EURE,0271238Z,151,147,0,4,75,76,5 ème
EURE,FLEURY-SUR-ANDELLE,0271098X,173,152,16,5,85,88,5 ème
EURE,GISORS,0271321P,138,122,14,2,67,71,5 ème
EURE,GISORS,0271631B,137,137,0,0,80,57,5 ème
EURE,GRAVIGNY,0271172C,158,154,0,4,75,83,5 ème
EURE,LA SAUSSAYE,0271105E,127,127,0,0,54,73,5 ème
EURE,LES ANDELYS,0271320N,141,140,0,1,73,68,5 ème
EURE,MESNIL-EN-OUCHE,0271121X,70,67,0,3,38,32,5 ème
EURE,PONT-AUDEMER,0271097W,0,0,0,0,0,0,5 ème
EURE,ROUTOT,0271285A,94,94,0,0,57,37,5 ème
EURE,RUGLES,0270040X,67,65,0,2,35,32,5 ème
EURE,VAL-DE-REUIL,0271286B,123,101,16,6,52,71,5 ème
EURE,VERNEUIL D'AVRE ET D'ITON,0271319M,0,0,0,0,0,0,5 ème
EURE,VERNON,0271073V,0,0,0,0,0,0,5 ème
EURE,VERNON,0271288D,81,81,0,0,38,43,5 ème
MANCHE,AGNEAUX,0501825M,0,0,0,0,0,0,5 ème
MANCHE,CHERBOURG-EN-COTENTIN,0500132X,0,0,0,0,0,0,5 ème
MANCHE,FLAMANVILLE,0501799J,64,64,0,0,27,37,5 ème
MANCHE,LA HAYE-PESNEL,0500042Z,81,81,0,0,51,30,5 ème
MANCHE,LES PIEUX,0501220E,85,83,0,2,42,43,5 ème
MANCHE,MONTMARTIN-SUR-MER,0500048F,71,68,0,3,36,35,5 ème
MANCHE,SAINT-JAMES,0500149R,15,15,0,0,3,12,5 ème
MANCHE,SAINT-JAMES,0501242D,88,81,7,0,46,42,5 ème
MANCHE,SAINT-LO,0500095G,92,70,18,4,48,44,5 ème
MANCHE,SAINT-LO,0500121K,115,114,0,1,49,66,5 ème
MANCHE,SAINT-SAUVEUR-LE-VICOMTE,0500152U,66,66,0,0,31,35,5 ème
MANCHE,TESSY-BOCAGE,0500078N,78,78,0,0,44,34,5 ème
MANCHE,VILLEDIEU-LES-POELES-ROUFFIGNY,0500123M,40,40,0,0,23,17,5 ème
ORNE,ALENCON,0610692W,0,0,0,0,0,0,5 ème
ORNE,CARROUGES,0610012G,36,36,0,0,16,20,5 ème
ORNE,CEAUCE,0611220V,35,35,0,0,13,22,5 ème
ORNE,FLERS,0610023U,137,137,0,0,77,60,5 ème
ORNE,GACE,0610710R,16,16,0,0,9,7,5 ème
ORNE,L'AIGLE,0610745D,97,81,14,2,46,51,5 ème
ORNE,TRUN,0610044S,65,64,0,1,32,33,5 ème
ORNE,VIMOUTIERS,0610045T,53,53,0,0,32,21,5 ème
SEINE MARITIME,BIHOREL,0761724L,79,79,0,0,30,49,5 ème
SEINE MARITIME,BLANGY-SUR-BRESLE,0760009X,99,79,15,5,49,50,5 ème
SEINE MARITIME,BOIS-GUILLAUME,0761950G,170,156,7,7,74,96,5 ème
SEINE MARITIME,BONSECOURS,0760010Y,97,97,0,0,49,48,5 ème
SEINE MARITIME,BOOS,0762816Y,127,127,0,0,55,72,5 ème
SEINE MARITIME,CANTELEU,0762089H,104,104,0,0,52,52,5 ème
SEINE MARITIME,CANY-BARVILLE,0762126Y,136,135,0,1,72,64,5 ème
SEINE MARITIME,CLEON,0762679Z,110,95,14,1,59,51,5 ème
SEINE MARITIME,CRIQUETOT-L'ESNEVAL,0761784B,214,210,0,4,108,106,5 ème
SEINE MARITIME,DARNETAL,0761778V,105,86,12,7,46,59,5 ème
SEINE MARITIME,DUCLAIR,0760136K,155,151,0,4,74,81,5 ème
SEINE MARITIME,ELBEUF,0761347B,0,0,0,0,0,0,5 ème
SEINE MARITIME,ELBEUF,0762459K,159,140,16,3,85,74,5 ème
SEINE MARITIME,FORGES-LES-EAUX,0761695E,125,117,8,0,69,56,5 ème
SEINE MARITIME,GONFREVILLE-L'ORCHER,0761954L,140,123,16,1,69,71,5 ème
SEINE MARITIME,GOURNAY-EN-BRAY,0761734X,45,45,0,0,18,27,5 ème
SEINE MARITIME,LE GRAND-QUEVILLY,0761690Z,110,106,0,4,50,60,5 ème
SEINE MARITIME,LE HAVRE,0760053V,186,182,0,4,101,85,5 ème
SEINE MARITIME,LE HAVRE,0760069M,111,111,0,0,52,59,5 ème
SEINE MARITIME,LE HAVRE,0761696F,95,95,0,0,44,51,5 ème
SEINE MARITIME,LE HAVRE,0761711X,172,164,0,8,79,93,5 ème
SEINE MARITIME,LE HAVRE,0762226G,80,80,0,0,41,39,5 ème
SEINE MARITIME,LE MESNIL-ESNARD,0761343X,0,0,0,0,0,0,5 ème
SEINE MARITIME,LE MESNIL-ESNARD,0762229K,184,184,0,0,90,94,5 ème
SEINE MARITIME,LONDINIERES,0760137L,60,60,0,0,28,32,5 ème
SEINE MARITIME,LONGUEVILLE-SUR-SCIE,0762086E,117,115,0,2,58,59,5 ème
SEINE MARITIME,MAROMME,0760022L,0,0,0,0,0,0,5 ème
SEINE MARITIME,MONT-SAINT-AIGNAN,0760077W,123,121,0,2,55,68,5 ème
SEINE MARITIME,PAVILLY,0761694D,141,139,0,2,71,70,5 ème
SEINE MARITIME,ROUEN,0761356L,0,0,0,0,0,0,5 ème
SEINE MARITIME,ROUEN,0761720G,136,132,0,4,74,62,5 ème
SEINE MARITIME,ROUEN,0762091K,223,204,16,3,115,108,5 ème
SEINE MARITIME,ROUEN,0762602R,0,0,0,0,0,0,5 ème
SEINE MARITIME,SAINTE-ADRESSE,0762405B,66,66,0,0,25,41,5 ème
SEINE MARITIME,SAINT-ETIENNE-DU-ROUVRAY,0761777U,124,123,0,1,61,63,5 ème
SEINE MARITIME,SAINT-ETIENNE-DU-ROUVRAY,0762964J,0,0,0,0,0,0,5 ème
SEINE MARITIME,SAINT-NICOLAS-D'ALIERMONT,0760105B,182,170,11,1,95,87,5 ème
SEINE MARITIME,SAINT-PIERRE-LES-ELBEUF,0761776T,124,124,0,0,69,55,5 ème
SEINE MARITIME,SAINT-SAENS,0761953K,114,108,0,6,47,67,5 ème
SEINE MARITIME,VALMONT,0760116N,99,99,0,0,40,59,5 ème
SEINE MARITIME,YERVILLE,0761951H,149,135,5,9,81,68,5 ème
SEINE MARITIME,YVETOT,0760118R,206,186,16,4,103,103,5 ème
DORDOGNE,BRANTOME EN PERIGORD,0240010F,85,85,0,0,44,41,5 ème
DORDOGNE,LA ROCHE-CHALAIS,0240083K,29,29,0,0,20,9,5 ème
DORDOGNE,NONTRON,0241041B,102,96,4,2,55,47,5 ème
DORDOGNE,PERIGUEUX,0240984P,0,0,0,0,0,0,5 ème
DORDOGNE,THIVIERS,0240039M,0,0,0,0,0,0,5 ème
DORDOGNE,VERGT,0240056F,89,89,0,0,43,46,5 ème
GIRONDE,ANDERNOS-LES-BAINS,0331890A,192,179,10,3,87,105,5 ème
GIRONDE,ARVEYRES,0332085M,182,182,0,0,79,103,5 ème
GIRONDE,AUDENGE,0330008E,131,131,0,0,70,61,5 ème
GIRONDE,BASSENS,0331884U,153,139,12,2,64,89,5 ème
GIRONDE,BAZAS,0332288H,192,174,14,4,111,81,5 ème
GIRONDE,BLAYE,0332781U,0,0,0,0,0,0,5 ème
GIRONDE,BORDEAUX,0330065S,147,138,0,9,79,68,5 ème
GIRONDE,BORDEAUX,0331461J,171,163,0,8,72,99,5 ème
GIRONDE,BORDEAUX,0331618E,86,85,0,1,43,43,5 ème
GIRONDE,BORDEAUX,0332489B,61,61,0,0,33,28,5 ème
GIRONDE,BORDEAUX,0332493F,272,270,0,2,138,134,5 ème
GIRONDE,BORDEAUX,0332768E,163,161,0,2,79,84,5 ème
GIRONDE,BORDEAUX,0332806W,85,81,0,4,35,50,5 ème
GIRONDE,BORDEAUX,0333532K,46,46,0,0,19,27,5 ème
GIRONDE,CADILLAC,0331524C,61,61,0,0,30,31,5 ème
GIRONDE,CARIGNAN-DE-BORDEAUX,0331490R,124,122,0,2,63,61,5 ème
GIRONDE,CASTELNAU-DE-MEDOC,0330062N,169,167,0,2,93,76,5 ème
GIRONDE,EYSINES,0330076D,0,0,0,0,0,0,5 ème
GIRONDE,EYSINES,0332084L,235,235,0,0,114,121,5 ème
GIRONDE,FLOIRAC,0332189A,99,99,0,0,42,57,5 ème
GIRONDE,FLOIRAC,0332486Y,177,176,0,1,82,95,5 ème
GIRONDE,GRADIGNAN,0331622J,241,241,0,0,125,116,5 ème
GIRONDE,GUITRES,0330138W,123,119,0,4,65,58,5 ème
GIRONDE,GUJAN-MESTRAS,0332870R,0,0,0,0,0,0,5 ème
GIRONDE,LA BREDE,0332343T,108,108,0,0,52,56,5 ème
GIRONDE,LE BOUSCAT,0333108Z,93,93,0,0,43,50,5 ème
GIRONDE,LE HAILLAN,0332437V,81,81,0,0,45,36,5 ème
GIRONDE,LIBOURNE,0333213N,147,130,14,3,74,73,5 ème
GIRONDE,LORMONT,0331619F,124,111,13,0,53,71,5 ème
GIRONDE,LORMONT,0332441Z,0,0,0,0,0,0,5 ème
GIRONDE,MERIGNAC,0330146E,157,157,0,0,87,70,5 ème
GIRONDE,MERIGNAC,0332090T,163,142,15,6,85,78,5 ème
GIRONDE,MIOS,0333329P,218,218,0,0,106,112,5 ème
GIRONDE,PELLEGRUE,0330105K,44,44,0,0,21,23,5 ème
GIRONDE,SAINT-ANDRE-DE-CUBZAC,0332346W,0,0,0,0,0,0,5 ème
GIRONDE,SAINTE-EULALIE,0332705L,116,111,0,5,56,60,5 ème
GIRONDE,SAINT-JEAN-D'ILLAC,0333134C,121,121,0,0,64,57,5 ème
GIRONDE,SAINT-MEDARD-EN-JALLES,0331664E,142,141,0,1,70,72,5 ème
GIRONDE,SAINT-YZAN-DE-SOUDIAC,0331888Y,163,159,0,4,67,96,5 ème
GIRONDE,VERAC,0332706M,217,216,0,1,108,109,5 ème
LANDES,AIRE-SUR-L'ADOUR,0400002K,0,0,0,0,0,0,5 ème
LANDES,BISCARROSSE,0400092H,123,117,0,6,60,63,5 ème
LANDES,CAPBRETON,0400004M,0,0,0,0,0,0,5 ème
LANDES,GABARRET,0400072L,47,47,0,0,21,26,5 ème
LANDES,MIMIZAN,0400105X,129,124,0,5,64,65,5 ème
LANDES,PEYREHORADE,0400028N,141,137,0,4,68,73,5 ème
LANDES,SAINT-GEOURS-DE-MAREMNE,0401070W,133,129,0,4,61,72,5 ème
LANDES,SAINT-PIERRE-DU-MONT,0400103V,139,110,26,3,69,70,5 ème
LANDES,SAINT-SEVER,0400038Z,109,107,0,2,46,63,5 ème
LANDES,TARTAS,0400077S,48,48,0,0,21,27,5 ème
LOT-ET-GARONNE,AGEN,0470005A,146,140,0,6,79,67,5 ème
LOT-ET-GARONNE,AGEN,0470066S,161,151,9,1,87,74,5 ème
LOT-ET-GARONNE,CASTELMORON-SUR-LOT,0470732R,54,54,0,0,31,23,5 ème
LOT-ET-GARONNE,CASTILLONNES,0470014K,51,51,0,0,24,27,5 ème
LOT-ET-GARONNE,FUMEL,0470641S,0,0,0,0,0,0,5 ème
LOT-ET-GARONNE,MARMANDE,0470020S,0,0,0,0,0,0,5 ème
LOT-ET-GARONNE,MARMANDE,0470103G,166,148,16,2,91,75,5 ème
LOT-ET-GARONNE,MEZIN,0470023V,47,47,0,0,20,27,5 ème
LOT-ET-GARONNE,MONFLANQUIN,0470026Y,81,81,0,0,41,40,5 ème
LOT-ET-GARONNE,SAINTE-LIVRADE-SUR-LOT,0470102F,57,54,0,3,27,30,5 ème
LOT-ET-GARONNE,TONNEINS,0470104H,141,121,16,4,62,79,5 ème
LOT-ET-GARONNE,VILLENEUVE-SUR-LOT,0470678G,119,100,13,6,55,64,5 ème
PYRENEES-ATLANTIQUES,BAYONNE,0640179X,0,0,0,0,0,0,5 ème
PYRENEES-ATLANTIQUES,BAYONNE,0641907A,0,0,0,0,0,0,5 ème
PYRENEES-ATLANTIQUES,BAYONNE,0642114A,50,50,0,0,31,19,5 ème
PYRENEES-ATLANTIQUES,CAMBO-LES-BAINS,0640147M,87,87,0,0,47,40,5 ème
PYRENEES-ATLANTIQUES,JURANCON,0640031L,0,0,0,0,0,0,5 ème
PYRENEES-ATLANTIQUES,MORLAAS,0641412M,203,196,0,7,100,103,5 ème
PYRENEES-ATLANTIQUES,NAY,0641657D,116,116,0,0,61,55,5 ème
PYRENEES-ATLANTIQUES,PAU,0640184C,0,0,0,0,0,0,5 ème
PYRENEES-ATLANTIQUES,PAU,0641653Z,146,143,0,3,72,74,5 ème
PYRENEES-ATLANTIQUES,SAINT-JEAN-PIED-DE-PORT,0640165G,30,30,0,0,16,14,5 ème
PYRENEES-ATLANTIQUES,SAINT-JEAN-PIED-DE-PORT,0641844G,0,0,0,0,0,0,5 ème
PYRENEES-ATLANTIQUES,SAINT-PIERRE-D'IRUBE,0642038T,175,175,0,0,95,80,5 ème
CORREZE,BRIVE-LA-GAILLARDE,0190740B,114,112,0,2,59,55,5 ème
CORREZE,LUBERSAC,0190695C,69,69,0,0,36,33,5 ème
CORREZE,MEYMAC,0190089U,6,6,0,0,2,4,5 ème
CORREZE,NEUVIC,0190821P,46,46,0,0,18,28,5 ème
CORREZE,TULLE,0190034J,0,0,0,0,0,0,5 ème
CREUSE,BOURGANEUF,0230008J,0,0,0,0,0,0,5 ème
CREUSE,CHENERAILLES,0230012N,43,43,0,0,17,26,5 ème
CREUSE,CROCQ,0230014R,25,25,0,0,14,11,5 ème
CREUSE,LA SOUTERRAINE,0230032K,104,90,13,1,41,63,5 ème
CREUSE,PARSAC-RIMONDEIX,0230023A,44,44,0,0,24,20,5 ème
HAUTE-VIENNE,AIXE-SUR-VIENNE,0870001D,166,166,0,0,82,84,5 ème
HAUTE-VIENNE,BELLAC,0870120H,102,81,16,5,36,66,5 ème
HAUTE-VIENNE,BESSINES-SUR-GARTEMPE,0870006J,68,68,0,0,30,38,5 ème
HAUTE-VIENNE,CHATEAUNEUF-LA-FORET,0870008L,46,46,0,0,15,31,5 ème
HAUTE-VIENNE,LIMOGES,0870072F,186,182,0,4,96,90,5 ème
HAUTE-VIENNE,LIMOGES,0870960W,73,70,0,3,33,40,5 ème
HAUTE-VIENNE,LIMOGES,0875087G,51,51,0,0,24,27,5 ème
HAUTE-VIENNE,SAINT-LEONARD-DE-NOBLAT,0870820U,113,113,0,0,67,46,5 ème
HAUTE-VIENNE,SAINT-SULPICE-LES-FEUILLES,0870049F,38,38,0,0,18,20,5 ème
CHARENTE,ANGOULEME,0160049S,0,0,0,0,0,0,5 ème
CHARENTE,ANGOULEME,0161048C,173,173,0,0,88,85,5 ème
CHARENTE,ANGOULEME,0161075G,106,101,0,5,60,46,5 ème
CHARENTE,BARBEZIEUX-SAINT-HILAIRE,0160866E,111,92,16,3,47,64,5 ème
CHARENTE,CHASSENEUIL-SUR-BONNIEURE,0160882X,106,88,10,8,56,50,5 ème
CHARENTE,COGNAC,0160116P,115,115,0,0,54,61,5 ème
CHARENTE,CONFOLENS,0160944P,85,81,0,4,48,37,5 ème
CHARENTE,LA ROCHEFOUCAULD-EN-ANGOUMOIS,0160076W,52,52,0,0,34,18,5 ème
CHARENTE,MONTBRON,0160030W,49,49,0,0,21,28,5 ème
CHARENTE-MARITIME,AULNAY,0171213B,50,50,0,0,24,26,5 ème
CHARENTE-MARITIME,COZES,0170111D,27,27,0,0,13,14,5 ème
CHARENTE-MARITIME,JONZAC,0170135E,0,0,0,0,0,0,5 ème
CHARENTE-MARITIME,LA ROCHELLE,0170035W,241,221,15,5,111,130,5 ème
CHARENTE-MARITIME,LA ROCHELLE,0170100S,0,0,0,0,0,0,5 ème
CHARENTE-MARITIME,LA ROCHELLE,0170142M,82,65,14,3,42,40,5 ème
CHARENTE-MARITIME,LA ROCHELLE,0171117X,148,144,0,4,80,68,5 ème
CHARENTE-MARITIME,MARANS,0171022U,161,161,0,0,78,83,5 ème
CHARENTE-MARITIME,MIRAMBEAU,0170016A,58,58,0,0,28,30,5 ème
CHARENTE-MARITIME,ROYAN,0171122C,154,149,0,5,82,72,5 ème
CHARENTE-MARITIME,ROYAN,0171571R,0,0,0,0,0,0,5 ème
CHARENTE-MARITIME,SAINTES,0170059X,181,174,0,7,91,90,5 ème
CHARENTE-MARITIME,SAINTES,0170078T,0,0,0,0,0,0,5 ème
CHARENTE-MARITIME,SAINTES,0170392J,16,0,16,0,9,7,5 ème
CHARENTE-MARITIME,SAINT-HILAIRE-DE-VILLEFRANCHE,0170050M,74,69,0,5,28,46,5 ème
CHARENTE-MARITIME,SAINT-JEAN-D'ANGELY,0171118Y,140,107,27,6,72,68,5 ème
CHARENTE-MARITIME,SAINT-SAVINIEN,0170056U,80,80,0,0,42,38,5 ème
CHARENTE-MARITIME,SURGERES,0170120N,65,65,0,0,28,37,5 ème
CHARENTE-MARITIME,TONNAY-BOUTONNE,0170082X,74,74,0,0,42,32,5 ème
DEUX-SEVRES,ARGENTONNAY,0790060L,59,59,0,0,26,33,5 ème
DEUX-SEVRES,CHAMPDENIERS-SAINT-DENIS,0790013K,69,69,0,0,33,36,5 ème
DEUX-SEVRES,LA CRECHE,0790965V,157,157,0,0,65,92,5 ème
DEUX-SEVRES,LEZAY,0790017P,65,65,0,0,35,30,5 ème
DEUX-SEVRES,NIORT,0790027A,112,108,0,4,47,65,5 ème
DEUX-SEVRES,NIORT,0790710T,122,103,16,3,61,61,5 ème
DEUX-SEVRES,NIORT,0791134D,158,142,16,0,79,79,5 ème
DEUX-SEVRES,SAINT-AUBIN-LE-CLOUD,0790979K,15,0,15,0,7,8,5 ème
DEUX-SEVRES,SAINT-VARENT,0790032F,71,71,0,0,35,36,5 ème
VIENNE,CHATELLERAULT,0860876K,153,136,17,0,69,84,5 ème
VIENNE,CHATELLERAULT,0860984C,167,147,17,3,95,72,5 ème
VIENNE,CIVRAY,0860053R,73,56,17,0,40,33,5 ème
VIENNE,JAUNAY-MARIGNY,0860764N,85,85,0,0,44,41,5 ème
VIENNE,LA ROCHE-POSAY,0860043E,76,76,0,0,48,28,5 ème
VIENNE,MIREBEAU,0860027M,118,116,0,2,65,53,5 ème
VIENNE,POITIERS,0860039A,0,0,0,0,0,0,5 ème
VIENNE,POITIERS,0860756E,119,119,0,0,51,68,5 ème
VIENNE,POITIERS,0861072Y,179,160,17,2,93,86,5 ème
VIENNE,SAINT-GERVAIS-LES-TROIS-CLOCHERS,0860044F,71,71,0,0,34,37,5 ème
VIENNE,SAINT-SAVIN,0860046H,47,47,0,0,23,24,5 ème
AUDE,CARCASSONNE,0110037F,95,95,0,0,48,47,5 ème
AUDE,CARCASSONNE,0110044N,150,150,0,0,82,68,5 ème
AUDE,CARCASSONNE,0110666P,177,174,0,3,84,93,5 ème
AUDE,CARCASSONNE,0110823K,0,0,0,0,0,0,5 ème
AUDE,CASTELNAUDARY,0110825M,187,169,14,4,94,93,5 ème
AUDE,LEZIGNAN-CORBIERES,0111048E,0,0,0,0,0,0,5 ème
AUDE,NARBONNE,0110025T,110,110,0,0,60,50,5 ème
AUDE,NARBONNE,0110068P,130,130,0,0,70,60,5 ème
GARD,AIGUES-MORTES,0300001N,160,157,0,3,74,86,5 ème
GARD,ALES,0300922P,158,158,0,0,96,62,5 ème
GARD,ALES,0301728R,24,24,0,0,12,12,5 ème
GARD,CALVISSON,0301671D,159,159,0,0,68,91,5 ème
GARD,LE VIGAN,0300052U,0,0,0,0,0,0,5 ème
GARD,MANDUEL,0301746K,128,128,0,0,60,68,5 ème
GARD,NIMES,0300062E,132,127,0,5,66,66,5 ème
GARD,NIMES,0300096S,88,88,0,0,36,52,5 ème
GARD,NIMES,0300929X,132,113,16,3,51,81,5 ème
GARD,NIMES,0300945P,201,201,0,0,91,110,5 ème
GARD,NIMES,0301357M,129,129,0,0,69,60,5 ème
GARD,REMOULINS,0300033Y,164,164,0,0,76,88,5 ème
GARD,ROQUEMAURE,0301213F,182,182,0,0,86,96,5 ème
GARD,SAINT-GILLES,0300037C,196,178,15,3,99,97,5 ème
GARD,SAINT-HIPPOLYTE-DU-FORT,0300039E,85,81,0,4,39,46,5 ème
GARD,SAINT-JEAN-DU-GARD,0300041G,0,0,0,0,0,0,5 ème
GARD,VILLENEUVE-LES-AVIGNON,0301214G,225,225,0,0,107,118,5 ème
HERAULT,AGDE,0341032M,117,115,0,2,65,52,5 ème
HERAULT,BEZIERS,0340869K,178,172,0,6,101,77,5 ème
HERAULT,BEZIERS,0340872N,118,118,0,0,61,57,5 ème
HERAULT,CASTRIES,0341280G,163,163,0,0,81,82,5 ème
HERAULT,FRONTIGNAN,0340025T,160,141,16,3,63,97,5 ème
HERAULT,FRONTIGNAN,0340894M,99,99,0,0,53,46,5 ème
HERAULT,LODEVE,0340028W,0,0,0,0,0,0,5 ème
HERAULT,LUNEL,0340897R,122,122,0,0,60,62,5 ème
HERAULT,MAGALAS,0340032A,111,107,0,4,58,53,5 ème
HERAULT,MONTFERRIER-SUR-LEZ,0342297M,62,62,0,0,25,37,5 ème
HERAULT,MONTPELLIER,0340045P,0,0,0,0,0,0,5 ème
HERAULT,MONTPELLIER,0340883A,120,117,0,3,66,54,5 ème
HERAULT,MONTPELLIER,0340955D,192,170,16,6,80,112,5 ème
HERAULT,MONTPELLIER,0341030K,97,97,0,0,51,46,5 ème
HERAULT,MONTPELLIER,0341592W,158,142,15,1,70,88,5 ème
HERAULT,POUSSAN,0340062H,216,214,0,2,113,103,5 ème
HERAULT,SETE,0340078A,0,0,0,0,0,0,5 ème
HERAULT,SETE,0340885C,130,130,0,0,61,69,5 ème
HERAULT,SETE,0340972X,106,98,0,8,50,56,5 ème
HERAULT,VILLENEUVE-LES-MAGUELONE,0342078Z,140,140,0,0,68,72,5 ème
LOZERE,LANGOGNE,0480004U,53,53,0,0,23,30,5 ème
LOZERE,LANGOGNE,0480678B,18,18,0,0,11,7,5 ème
LOZERE,MENDE,0480032Z,90,90,0,0,44,46,5 ème
LOZERE,SAINT-CHELY-D'APCHER,0480680D,0,0,0,0,0,0,5 ème
PYRENEES-ORIENTALES,ARGELES-SUR-MER,0660924W,0,0,0,0,0,0,5 ème
PYRENEES-ORIENTALES,ELNE,0660523K,236,234,0,2,103,133,5 ème
PYRENEES-ORIENTALES,FONT-ROMEU-ODEILLO-VIA,0660057D,0,0,0,0,0,0,5 ème
PYRENEES-ORIENTALES,PERPIGNAN,0660016J,112,108,0,4,51,61,5 ème
PYRENEES-ORIENTALES,PERPIGNAN,0660058E,277,277,0,0,164,113,5 ème
PYRENEES-ORIENTALES,PERPIGNAN,0660077A,0,0,0,0,0,0,5 ème
PYRENEES-ORIENTALES,PERPIGNAN,0660078B,16,0,16,0,5,11,5 ème
PYRENEES-ORIENTALES,PERPIGNAN,0660520G,0,0,0,0,0,0,5 ème
PYRENEES-ORIENTALES,PIA,0660866H,198,195,0,3,96,102,5 ème
PYRENEES-ORIENTALES,PORT-VENDRES,0660038H,81,81,0,0,45,36,5 ème
PYRENEES-ORIENTALES,THUIR,0660030Z,283,261,17,5,152,131,5 ème
ARIEGE,FERRIERES-SUR-ARIEGE,0090003E,0,0,0,0,0,0,5 ème
ARIEGE,PAMIERS,0090015T,0,0,0,0,0,0,5 ème
ARIEGE,SEIX,0090025D,38,38,0,0,14,24,5 ème
AVEYRON,CAPDENAC-GARE,0120082Z,46,46,0,0,23,23,5 ème
AVEYRON,DECAZEVILLE,0120622L,117,103,11,3,49,68,5 ème
AVEYRON,DECAZEVILLE,0121257B,39,37,0,2,19,20,5 ème
AVEYRON,ESPALION,0121176N,86,82,0,4,40,46,5 ème
AVEYRON,ESPALION,0121258C,59,59,0,0,31,28,5 ème
AVEYRON,LA FOUILLADE,0120090H,27,27,0,0,13,14,5 ème
AVEYRON,MARCILLAC-VALLON,0120011X,93,86,0,7,45,48,5 ème
AVEYRON,MILLAU,0120105Z,0,0,0,0,0,0,5 ème
AVEYRON,ONET-LE-CHATEAU,0121500R,88,88,0,0,42,46,5 ème
AVEYRON,RIEUPEYROUX,0120055V,27,27,0,0,15,12,5 ème
AVEYRON,RODEZ,0120037A,0,0,0,0,0,0,5 ème
AVEYRON,SAINT-AFFRIQUE,0120025M,0,0,0,0,0,0,5 ème
AVEYRON,SAINT-AFFRIQUE,0121297V,105,96,7,2,52,53,5 ème
AVEYRON,SEVERAC D'AVEYRON,0120029S,53,53,0,0,29,24,5 ème
AVEYRON,VILLEFRANCHE-DE-ROUERGUE,0121178R,11,0,11,0,5,6,5 ème
GERS,AUCH,0320067Z,0,0,0,0,0,0,5 ème
GERS,CONDOM,0320010M,105,98,0,7,53,52,5 ème
GERS,LECTOURE,0320651J,51,51,0,0,18,33,5 ème
GERS,L'ISLE-JOURDAIN,0320740F,146,136,9,1,68,78,5 ème
GERS,MASSEUBE,0320004F,54,54,0,0,24,30,5 ème
HAUTE-GARONNE,AUSSONNE,0312729Y,205,200,0,5,100,105,5 ème
HAUTE-GARONNE,BAGNERES-DE-LUCHON,0311334G,0,0,0,0,0,0,5 ème
HAUTE-GARONNE,CARBONNE,0311580Z,137,117,13,7,70,67,5 ème
HAUTE-GARONNE,COLOMIERS,0311325X,108,86,22,0,57,51,5 ème
HAUTE-GARONNE,LA SALVETAT-SAINT-GILLES,0312612W,190,172,14,4,93,97,5 ème
HAUTE-GARONNE,LEGUEVIN,0312063Z,0,0,0,0,0,0,5 ème
HAUTE-GARONNE,LHERM,0312697N,166,160,0,6,86,80,5 ème
HAUTE-GARONNE,MONTRABE,0312698P,109,105,0,4,53,56,5 ème
HAUTE-GARONNE,MURET,0310025J,215,211,0,4,113,102,5 ème
HAUTE-GARONNE,PECHBONNIEU,0312700S,229,226,0,3,109,120,5 ème
HAUTE-GARONNE,RAMONVILLE-SAINT-AGNE,0311633G,167,151,13,3,81,86,5 ème
HAUTE-GARONNE,REVEL,0310088C,0,0,0,0,0,0,5 ème
HAUTE-GARONNE,SAINT-BEAT-LEZ,0310031R,37,37,0,0,21,16,5 ème
HAUTE-GARONNE,SAINT-GAUDENS,0311131L,0,0,0,0,0,0,5 ème
HAUTE-GARONNE,SAINT-JORY,0311162V,115,115,0,0,58,57,5 ème
HAUTE-GARONNE,SEYSSES,0313081F,120,116,0,4,59,61,5 ème
HAUTE-GARONNE,TOULOUSE,0310051M,0,0,0,0,0,0,5 ème
HAUTE-GARONNE,TOULOUSE,0310085Z,156,153,0,3,68,88,5 ème
HAUTE-GARONNE,TOULOUSE,0310086A,108,103,0,5,55,53,5 ème
HAUTE-GARONNE,TOULOUSE,0311148E,82,82,0,0,41,41,5 ème
HAUTE-GARONNE,TOULOUSE,0311332E,115,113,0,2,62,53,5 ème
HAUTE-GARONNE,TOULOUSE,0311338L,140,133,0,7,69,71,5 ème
HAUTE-GARONNE,TOULOUSE,0311584D,87,84,0,3,43,44,5 ème
HAUTE-GARONNE,TOULOUSE,0311718Z,141,131,0,10,86,55,5 ème
HAUTE-GARONNE,TOULOUSE,0311963R,129,129,0,0,44,85,5 ème
HAUTE-GARONNE,TOULOUSE,0311964S,183,183,0,0,100,83,5 ème
HAUTE-GARONNE,VERNET,0312610U,134,130,0,4,53,81,5 ème
HAUTES-PYRENEES,LUZ-SAINT-SAUVEUR,0650018S,14,14,0,0,8,6,5 ème
HAUTES-PYRENEES,MONLEON-MAGNOAC,0650885J,0,0,0,0,0,0,5 ème
HAUTES-PYRENEES,TARBES,0650740B,151,131,20,0,71,80,5 ème
HAUTES-PYRENEES,TARBES,0650835E,146,140,0,6,75,71,5 ème
HAUTES-PYRENEES,TARBES,0650880D,117,113,0,4,54,63,5 ème
LOT,GRAMAT,0460565P,78,78,0,0,46,32,5 ème
LOT,LACAPELLE-MARIVAL,0460015S,61,56,0,5,26,35,5 ème
LOT,VAYRAC,0460030H,40,40,0,0,25,15,5 ème
TARN,ALBI,0810003N,0,0,0,0,0,0,5 ème
TARN,ALBI,0810052S,146,145,0,1,63,83,5 ème
TARN,CARMAUX,0810012Y,0,0,0,0,0,0,5 ème
TARN,CASTRES,0811063R,147,136,11,0,66,81,5 ème
TARN,GAILLAC,0811065T,103,103,0,0,51,52,5 ème
TARN,LABASTIDE-ROUAIROUX,0810025M,39,39,0,0,17,22,5 ème
TARN,LACAUNE,0810027P,62,58,4,0,27,35,5 ème
TARN,MASSAC-SERAN,0811066U,52,52,0,0,21,31,5 ème
TARN,RABASTENS,0810092K,50,50,0,0,20,30,5 ème
TARN,SAINT-JUERY,0810124V,193,190,0,3,93,100,5 ème
TARN,SAINT-SULPICE-LA-POINTE,0810122T,59,48,11,0,19,40,5 ème
TARN-ET-GARONNE,BEAUMONT-DE-LOMAGNE,0820047F,44,44,0,0,28,16,5 ème
TARN-ET-GARONNE,CASTELSARRASIN,0820713E,101,100,0,1,60,41,5 ème
TARN-ET-GARONNE,MONTAUBAN,0820684Y,140,135,0,5,66,74,5 ème
TARN-ET-GARONNE,MONTAUBAN,0820755A,118,118,0,0,60,58,5 ème
TARN-ET-GARONNE,NEGREPELISSE,0820824A,162,158,0,4,71,91,5 ème
TARN-ET-GARONNE,SAINT-ANTONIN-NOBLE-VAL,0820704V,82,82,0,0,43,39,5 ème
LOIRE-ATLANTIQUE,AIGREFEUILLE-SUR-MAINE,0440179F,142,139,0,3,66,76,5 ème
LOIRE-ATLANTIQUE,CARQUEFOU,0442029S,221,221,0,0,104,117,5 ème
LOIRE-ATLANTIQUE,COUERON,0440310Y,0,0,0,0,0,0,5 ème
LOIRE-ATLANTIQUE,DERVAL,0440423W,104,104,0,0,49,55,5 ème
LOIRE-ATLANTIQUE,GUERANDE,0440193W,212,211,0,1,106,106,5 ème
LOIRE-ATLANTIQUE,HERIC,0442728B,167,163,0,4,78,89,5 ème
LOIRE-ATLANTIQUE,LA BAULE-ESCOUBLAC,0441859G,105,89,16,0,47,58,5 ème
LOIRE-ATLANTIQUE,LA CHAPELLE-SUR-ERDRE,0442011X,162,159,0,3,71,91,5 ème
LOIRE-ATLANTIQUE,LA CHAPELLE-SUR-ERDRE,0442388G,4,4,0,0,2,2,5 ème
LOIRE-ATLANTIQUE,LEGE,0440196Z,72,72,0,0,24,48,5 ème
LOIRE-ATLANTIQUE,LIGNE,0442691L,187,187,0,0,79,108,5 ème
LOIRE-ATLANTIQUE,LOIREAUXENCE,0440243A,78,78,0,0,36,42,5 ème
LOIRE-ATLANTIQUE,MACHECOUL-SAINT-MEME,0440018F,97,77,16,4,55,42,5 ème
LOIRE-ATLANTIQUE,MACHECOUL-SAINT-MEME,0441930J,210,194,16,0,93,117,5 ème
LOIRE-ATLANTIQUE,NANTES,0440211R,55,51,0,4,26,29,5 ème
LOIRE-ATLANTIQUE,NANTES,0440283U,110,94,16,0,51,59,5 ème
LOIRE-ATLANTIQUE,NANTES,0440285W,136,136,0,0,63,73,5 ème
LOIRE-ATLANTIQUE,NANTES,0440286X,67,67,0,0,34,33,5 ème
LOIRE-ATLANTIQUE,NANTES,0441932L,196,196,0,0,99,97,5 ème
LOIRE-ATLANTIQUE,NANTES,0441937S,116,116,0,0,45,71,5 ème
LOIRE-ATLANTIQUE,NANTES,0442119P,19,19,0,0,5,14,5 ème
LOIRE-ATLANTIQUE,NANTES,0442835T,137,130,0,7,69,68,5 ème
LOIRE-ATLANTIQUE,PORNICHET,0440228J,120,120,0,0,54,66,5 ème
LOIRE-ATLANTIQUE,SAINTE-PAZANNE,0440236T,122,122,0,0,67,55,5 ème
LOIRE-ATLANTIQUE,SAINT-GILDAS-DES-BOIS,0441939U,175,175,0,0,83,92,5 ème
LOIRE-ATLANTIQUE,SAINT-HERBLAIN,0440016D,159,157,0,2,91,68,5 ème
LOIRE-ATLANTIQUE,SAINT-HERBLAIN,0442637C,23,23,0,0,10,13,5 ème
LOIRE-ATLANTIQUE,SAINT-NAZAIRE,0440074S,0,0,0,0,0,0,5 ème
LOIRE-ATLANTIQUE,SAINT-NAZAIRE,0440235S,151,134,17,0,87,64,5 ème
LOIRE-ATLANTIQUE,SAINT-NAZAIRE,0440314C,182,164,16,2,81,101,5 ème
LOIRE-ATLANTIQUE,SAINT-NAZAIRE,0441613P,88,71,16,1,31,57,5 ème
LOIRE-ATLANTIQUE,SAVENAY,0442806L,139,136,0,3,68,71,5 ème
LOIRE-ATLANTIQUE,VALLONS-DE-L'ERDRE,0441655K,82,76,0,6,44,38,5 ème
MAINE-ET-LOIRE,ANGERS,0490004N,139,135,0,4,84,55,5 ème
MAINE-ET-LOIRE,ANGERS,0490061A,121,120,0,1,51,70,5 ème
MAINE-ET-LOIRE,ANGERS,0490783K,93,90,0,3,50,43,5 ème
MAINE-ET-LOIRE,ANGERS,0490844B,211,193,16,2,102,109,5 ème
MAINE-ET-LOIRE,ANGERS,0491703K,77,58,16,3,29,48,5 ème
MAINE-ET-LOIRE,ANGERS,0491922Y,174,174,0,0,83,91,5 ème
MAINE-ET-LOIRE,ANGERS,0491924A,204,204,0,0,103,101,5 ème
MAINE-ET-LOIRE,BAUGE-EN-ANJOU,0490849G,105,105,0,0,49,56,5 ème
MAINE-ET-LOIRE,BELLEVIGNE-EN-LAYON,0490046J,81,81,0,0,31,50,5 ème
MAINE-ET-LOIRE,BRISSAC LOIRE AUBANCE,0490014Z,130,130,0,0,68,62,5 ème
MAINE-ET-LOIRE,CANDE,0490854M,98,98,0,0,45,53,5 ème
MAINE-ET-LOIRE,CHOLET,0490829K,147,142,0,5,68,79,5 ème
MAINE-ET-LOIRE,DOUE-EN-ANJOU,0490023J,99,97,0,2,48,51,5 ème
MAINE-ET-LOIRE,LE LION-D'ANGERS,0490027N,144,140,0,4,77,67,5 ème
MAINE-ET-LOIRE,LE MAY-SUR-EVRE,0490869D,104,104,0,0,54,50,5 ème
MAINE-ET-LOIRE,LES HAUTS-D'ANJOU,0491705M,154,151,0,3,81,73,5 ème
MAINE-ET-LOIRE,LES PONTS-DE-CE,0491260D,161,155,0,6,52,109,5 ème
MAINE-ET-LOIRE,LONGUE-JUMELLES,0490028P,112,93,16,3,45,67,5 ème
MAINE-ET-LOIRE,SAINT-BARTHELEMY-D'ANJOU,0490925P,16,0,16,0,3,13,5 ème
MAINE-ET-LOIRE,SAINT-GEORGES-SUR-LOIRE,0491645X,142,142,0,0,65,77,5 ème
MAINE-ET-LOIRE,SAUMUR,0491826U,53,53,0,0,26,27,5 ème
MAINE-ET-LOIRE,SEGRE-EN-ANJOU BLEU,0490782J,0,0,0,0,0,0,5 ème
MAINE-ET-LOIRE,SEGRE-EN-ANJOU BLEU,0490840X,0,0,0,0,0,0,5 ème
MAINE-ET-LOIRE,SEGRE-EN-ANJOU BLEU,0491927D,15,15,0,0,10,5,5 ème
MAYENNE,BAIS,0530003R,53,53,0,0,26,27,5 ème
MAYENNE,EVRON,0530007V,94,72,14,8,49,45,5 ème
MAYENNE,GREZ-EN-BOUERE,0530031W,59,59,0,0,29,30,5 ème
MAYENNE,LAVAL,0530041G,121,103,15,3,62,59,5 ème
MAYENNE,LAVAL,0530051T,227,222,0,5,93,134,5 ème
MAYENNE,LAVAL,0530082B,144,141,0,3,69,75,5 ème
MAYENNE,LAVAL,0530778H,0,0,0,0,0,0,5 ème
MAYENNE,LAVAL,0530904V,0,0,0,0,0,0,5 ème
MAYENNE,MAYENNE,0530053V,158,140,16,2,74,84,5 ème
MAYENNE,SAINT-PIERRE-LA-COUR,0530065H,104,104,0,0,32,72,5 ème
SARTHE,ANCINNES,0720002L,93,93,0,0,47,46,5 ème
SARTHE,BEAUMONT-SUR-SARTHE,0721655H,57,57,0,0,29,28,5 ème
SARTHE,BESSE-SUR-BRAYE,0721089T,37,37,0,0,17,20,5 ème
SARTHE,LA FERTE-BERNARD,0721364S,176,161,13,2,81,95,5 ème
SARTHE,LE MANS,0720068H,91,91,0,0,37,54,5 ème
SARTHE,LE MANS,0720081X,83,83,0,0,42,41,5 ème
SARTHE,LE MANS,0720799C,113,110,0,3,58,55,5 ème
SARTHE,LE MANS,0720835S,103,103,0,0,49,54,5 ème
SARTHE,LE MANS,0720984D,154,150,0,4,71,83,5 ème
SARTHE,LE MANS,0720987G,93,91,0,2,42,51,5 ème
SARTHE,LE MANS,0721363R,116,116,0,0,57,59,5 ème
SARTHE,MAYET,0720988H,58,58,0,0,32,26,5 ème
SARTHE,MONTVAL-SUR-LOIR,0720013Y,0,0,0,0,0,0,5 ème
SARTHE,MONTVAL-SUR-LOIR,0720067G,119,99,16,4,51,68,5 ème
SARTHE,MULSANNE,0721281B,88,88,0,0,48,40,5 ème
SARTHE,NOYEN-SUR-SARTHE,0721263G,128,128,0,0,53,75,5 ème
SARTHE,SABLE-SUR-SARTHE,0720989J,145,126,16,3,70,75,5 ème
SARTHE,SAINT-COSME-EN-VAIRAIS,0720053S,58,53,0,5,31,27,5 ème
SARTHE,VIBRAYE,0720058X,75,75,0,0,27,48,5 ème
VENDEE,AUBIGNY-LES CLOUZEAUX,0851620Z,168,165,0,3,88,80,5 ème
VENDEE,FONTENAY-LE-COMTE,0850068M,0,0,0,0,0,0,5 ème
VENDEE,FONTENAY-LE-COMTE,0851344Z,0,0,0,0,0,0,5 ème
VENDEE,LA ROCHE-SUR-YON,0850063G,174,160,12,2,80,94,5 ème
VENDEE,LA ROCHE-SUR-YON,0850082C,203,178,24,1,89,114,5 ème
VENDEE,LE POIRE-SUR-VIE,0850111J,180,180,0,0,79,101,5 ème
VENDEE,LES SABLES-D'OLONNE,0850084E,117,117,0,0,62,55,5 ème
VENDEE,LES SABLES-D'OLONNE,0851220P,182,182,0,0,92,90,5 ème
VENDEE,L'ILE-D'ELLE,0850014D,65,65,0,0,30,35,5 ème
VENDEE,LUCON,0850607Y,90,73,17,0,35,55,5 ème
VENDEE,POUZAUGES,0850024P,113,111,0,2,48,65,5 ème
VENDEE,ROCHESERVIERE,0850113L,145,145,0,0,67,78,5 ème
VENDEE,SAINTE-CECILE,0851295W,19,19,0,0,0,19,5 ème
VENDEE,SAINT-GILLES-CROIX-DE-VIE,0851181X,263,258,0,5,125,138,5 ème
ALPES-DE-HTE-PROVENCE,BEVONS,0040378P,17,0,17,0,3,14,5 ème
ALPES-DE-HTE-PROVENCE,CASTELLANE,0040004H,51,51,0,0,28,23,5 ème
ALPES-DE-HTE-PROVENCE,DIGNE-LES-BAINS,0040034R,0,0,0,0,0,0,5 ème
ALPES-DE-HTE-PROVENCE,DIGNE-LES-BAINS,0040044B,85,82,0,3,46,39,5 ème
ALPES-DE-HTE-PROVENCE,ORAISON,0040051J,106,100,0,6,53,53,5 ème
ALPES-DE-HTE-PROVENCE,SISTERON,0040420K,146,141,0,5,67,79,5 ème
ALPES-DE-HTE-PROVENCE,VOLX,0040535K,121,118,0,3,57,64,5 ème
BOUCHES-DU-RHONE,AIX-EN-PROVENCE,0132568W,205,205,0,0,113,92,5 ème
BOUCHES-DU-RHONE,AIX-EN-PROVENCE,0132915Y,178,178,0,0,106,72,5 ème
BOUCHES-DU-RHONE,ARLES,0130171R,0,0,0,0,0,0,5 ème
BOUCHES-DU-RHONE,AUBAGNE,0131622T,177,174,0,3,87,90,5 ème
BOUCHES-DU-RHONE,BERRE-L'ETANG,0131705H,188,173,15,0,87,101,5 ème
BOUCHES-DU-RHONE,CHATEAUNEUF-LES-MARTIGUES,0132494R,239,236,0,3,116,123,5 ème
BOUCHES-DU-RHONE,GARDANNE,0131700C,164,164,0,0,87,77,5 ème
BOUCHES-DU-RHONE,GARDANNE,0133244F,0,0,0,0,0,0,5 ème
BOUCHES-DU-RHONE,GIGNAC-LA-NERTHE,0133381E,188,183,0,5,81,107,5 ème
BOUCHES-DU-RHONE,LA FARE-LES-OLIVIERS,0133016H,171,170,0,1,81,90,5 ème
BOUCHES-DU-RHONE,LES PENNES-MIRABEAU,0132565T,169,169,0,0,75,94,5 ème
BOUCHES-DU-RHONE,MARIGNANE,0132921E,218,214,0,4,99,119,5 ème
BOUCHES-DU-RHONE,MARSEILLE,0130072H,0,0,0,0,0,0,5 ème
BOUCHES-DU-RHONE,MARSEILLE,0132732Z,150,150,0,0,65,85,5 ème
BOUCHES-DU-RHONE,MARSEILLE,0132947H,169,169,0,0,75,94,5 ème
BOUCHES-DU-RHONE,MARSEILLE,0132404T,118,118,0,0,59,59,5 ème
BOUCHES-DU-RHONE,MARSEILLE,0131606A,0,0,0,0,0,0,5 ème
BOUCHES-DU-RHONE,MARSEILLE,0130058T,0,0,0,0,0,0,5 ème
BOUCHES-DU-RHONE,MARSEILLE,0130136C,65,64,0,1,30,35,5 ème
BOUCHES-DU-RHONE,MARSEILLE,0132954R,89,89,0,0,47,42,5 ème
BOUCHES-DU-RHONE,MARSEILLE,0130093F,140,132,0,8,75,65,5 ème
BOUCHES-DU-RHONE,MARSEILLE,0131336G,91,91,0,0,33,58,5 ème
BOUCHES-DU-RHONE,MARSEILLE,0131434N,0,0,0,0,0,0,5 ème
BOUCHES-DU-RHONE,MARSEILLE,0132561N,91,88,0,3,50,41,5 ème
BOUCHES-DU-RHONE,MARSEILLE,0130063Y,0,0,0,0,0,0,5 ème
BOUCHES-DU-RHONE,MARTIGUES,0132208E,120,103,17,0,43,77,5 ème
BOUCHES-DU-RHONE,MIRAMAS,0132497U,104,104,0,0,59,45,5 ème
BOUCHES-DU-RHONE,ORGON,0132217P,157,142,15,0,72,85,5 ème
BOUCHES-DU-RHONE,PELISSANNE,0133114P,168,163,0,5,86,82,5 ème
BOUCHES-DU-RHONE,PORT-SAINT-LOUIS-DU-RHONE,0132280H,0,0,0,0,0,0,5 ème
BOUCHES-DU-RHONE,SAINT-VICTORET,0132007L,172,166,0,6,94,78,5 ème
BOUCHES-DU-RHONE,SALON-DE-PROVENCE,0131485U,0,0,0,0,0,0,5 ème
HAUTES-ALPES,BRIANCON,0050519M,162,147,12,3,78,84,5 ème
HAUTES-ALPES,GAP,0050010J,125,117,0,8,60,65,5 ème
HAUTES-ALPES,GAP,0050025A,147,129,14,4,70,77,5 ème
VAUCLUSE,APT,0840070V,62,62,0,0,31,31,5 ème
VAUCLUSE,AVIGNON,0840041N,0,0,0,0,0,0,5 ème
VAUCLUSE,AVIGNON,0840051Z,101,101,0,0,53,48,5 ème
VAUCLUSE,AVIGNON,0840073Y,129,125,0,4,72,57,5 ème
VAUCLUSE,AVIGNON,0840738W,133,128,0,5,58,75,5 ème
VAUCLUSE,AVIGNON,0840758T,124,124,0,0,70,54,5 ème
VAUCLUSE,AVIGNON,0840970Y,115,110,0,5,55,60,5 ème
VAUCLUSE,BOLLENE,0840699D,123,123,0,0,66,57,5 ème
VAUCLUSE,CABRIERES-D'AVIGNON,0841019B,188,188,0,0,85,103,5 ème
VAUCLUSE,CARPENTRAS,0840016L,0,0,0,0,0,0,5 ème
VAUCLUSE,CAVAILLON,0840020R,163,159,0,4,72,91,5 ème
VAUCLUSE,ORANGE,0840763Y,0,0,0,0,0,0,5 ème
VAUCLUSE,PERTUIS,0840029A,126,113,13,0,59,67,5 ème
VAUCLUSE,PERTUIS,0840918S,0,0,0,0,0,0,5 ème
VAUCLUSE,VAISON-LA-ROMAINE,0840035G,179,179,0,0,83,96,5 ème
ALPES-MARITIMES,ANTIBES,0060076A,90,87,0,3,43,47,5 ème
ALPES-MARITIMES,ANTIBES,0061133Z,114,110,0,4,51,63,5 ème
ALPES-MARITIMES,GRASSE,0061240R,132,132,0,0,65,67,5 ème
ALPES-MARITIMES,GRASSE,0061459D,228,223,0,5,117,111,5 ème
ALPES-MARITIMES,L'ESCARENE,0061826C,92,89,0,3,43,49,5 ème
ALPES-MARITIMES,MENTON,0060028Y,0,0,0,0,0,0,5 ème
ALPES-MARITIMES,MENTON,0060744B,83,82,0,1,41,42,5 ème
ALPES-MARITIMES,NICE,0060045S,126,125,0,1,62,64,5 ème
ALPES-MARITIMES,NICE,0060048V,241,235,0,6,112,129,5 ème
ALPES-MARITIMES,NICE,0060776L,0,0,0,0,0,0,5 ème
ALPES-MARITIMES,NICE,0060841G,163,145,18,0,60,103,5 ème
ALPES-MARITIMES,NICE,0061131X,196,171,16,9,92,104,5 ème
ALPES-MARITIMES,NICE,0061461F,148,148,0,0,71,77,5 ème
ALPES-MARITIMES,NICE,0061722P,18,18,0,0,12,6,5 ème
ALPES-MARITIMES,NICE,0061772U,26,26,0,0,16,10,5 ème
ALPES-MARITIMES,SAINT-SAUVEUR-SUR-TINEE,0060066P,48,48,0,0,23,25,5 ème
ALPES-MARITIMES,SAINT-VALLIER-DE-THIEY,0061986B,106,106,0,0,51,55,5 ème
ALPES-MARITIMES,SOSPEL,0060067R,45,45,0,0,21,24,5 ème
ALPES-MARITIMES,VALDEBLORE,0061987C,0,0,0,0,0,0,5 ème
ALPES-MARITIMES,VENCE,0061135B,207,207,0,0,105,102,5 ème
VAR,COGOLIN,0830837J,204,183,16,5,86,118,5 ème
VAR,LA LONDE-LES-MAURES,0830031H,89,89,0,0,41,48,5 ème
VAR,LA SEYNE-SUR-MER,0830180V,153,131,17,5,84,69,5 ème
VAR,LA SEYNE-SUR-MER,0830925E,203,198,0,5,104,99,5 ème
VAR,MONTAUROUX,0831610Z,167,153,9,5,82,85,5 ème
VAR,OLLIOULES,0831187P,0,0,0,0,0,0,5 ème
VAR,SAINT-MAXIMIN-LA-SAINTE-BAUME,0831442S,251,248,0,3,118,133,5 ème
VAR,SAINT-MAXIMIN-LA-SAINTE-BAUME,0831559U,0,0,0,0,0,0,5 ème
VAR,SAINT-RAPHAEL,0830075F,117,117,0,0,56,61,5 ème
VAR,SIX-FOURS-LES-PLAGES,0831012Z,174,156,13,5,77,97,5 ème
VAR,SOLLIES-PONT,0830831C,206,206,0,0,108,98,5 ème
VAR,TOULON,0830116A,0,0,0,0,0,0,5 ème
VAR,TOULON,0830128N,0,0,0,0,0,0,5 ème
VAR,TOULON,0830955M,82,76,0,6,49,33,5 ème
VAR,TOULON,0831053U,155,131,16,8,70,85,5 ème
ALLIER,CUSSET,0030010V,184,166,16,2,92,92,5 ème
ALLIER,DOMERAT,0030956Y,94,92,0,2,47,47,5 ème
ALLIER,GANNAT,0030905T,0,0,0,0,0,0,5 ème
ALLIER,LE DONJON,0030014Z,31,31,0,0,16,15,5 ème
ALLIER,MONTLUCON,0030026M,0,0,0,0,0,0,5 ème
ALLIER,MONTLUCON,0030105Y,0,0,0,0,0,0,5 ème
ALLIER,MOULINS,0030062B,141,139,0,2,73,68,5 ème
ALLIER,TRONGET,0030046J,37,37,0,0,23,14,5 ème
ALLIER,VALLON-EN-SULLY,0030047K,44,44,0,0,15,29,5 ème
CANTAL,AURILLAC,0150005Z,113,109,0,4,45,68,5 ème
CANTAL,AURILLAC,0150006A,0,0,0,0,0,0,5 ème
CANTAL,MURAT,0150023U,26,26,0,0,15,11,5 ème
CANTAL,NEUSSARGUES EN PINATELLE,0150065P,14,14,0,0,5,9,5 ème
CANTAL,PLEAUX,0150025W,15,15,0,0,6,9,5 ème
CANTAL,SAINT-CERNIN,0150028Z,33,31,0,2,16,17,5 ème
CANTAL,SAINT-FLOUR,0150030B,0,0,0,0,0,0,5 ème
CANTAL,SAINT-FLOUR,0150666T,79,79,0,0,35,44,5 ème
HAUTE-LOIRE,AUREC-SUR-LOIRE,0430052Y,71,71,0,0,35,36,5 ème
HAUTE-LOIRE,BLESLE,0430002U,17,17,0,0,7,10,5 ème
HAUTE-LOIRE,BRIVES-CHARENSAC,0430899U,104,90,11,3,56,48,5 ème
HAUTE-LOIRE,LANDOS,0430012E,47,47,0,0,22,25,5 ème
HAUTE-LOIRE,LE PUY-EN-VELAY,0431009N,90,90,0,0,36,54,5 ème
HAUTE-LOIRE,PAULHAGUET,0430019M,21,21,0,0,9,12,5 ème
HAUTE-LOIRE,SAUGUES,0430092S,11,11,0,0,4,7,5 ème
HAUTE-LOIRE,TENCE,0430034D,39,39,0,0,18,21,5 ème
PUY-DE-DOME,AIGUEPERSE,0630079U,178,178,0,0,81,97,5 ème
PUY-DE-DOME,AIGUEPERSE,0631084L,20,20,0,0,6,14,5 ème
PUY-DE-DOME,BILLOM,0631080G,57,51,0,6,27,30,5 ème
PUY-DE-DOME,BRASSAC-LES-MINES,0630012W,0,0,0,0,0,0,5 ème
PUY-DE-DOME,BRASSAC-LES-MINES,0631503S,47,47,0,0,30,17,5 ème
PUY-DE-DOME,CHAMALIERES,0631125F,205,194,0,11,110,95,5 ème
PUY-DE-DOME,CLERMONT-FERRAND,0631099C,61,61,0,0,33,28,5 ème
PUY-DE-DOME,CLERMONT-FERRAND,0631199L,116,110,0,6,59,57,5 ème
PUY-DE-DOME,CLERMONT-FERRAND,0631408N,0,0,0,0,0,0,5 ème
PUY-DE-DOME,CLERMONT-FERRAND,0631411S,111,111,0,0,53,58,5 ème
PUY-DE-DOME,ISSOIRE,0631448G,116,109,0,7,56,60,5 ème
PUY-DE-DOME,LA MONNERIE-LE-MONTEL,0631762Y,62,62,0,0,38,24,5 ème
PUY-DE-DOME,MURAT-LE-QUAIRE,0630010U,38,34,0,4,18,20,5 ème
PUY-DE-DOME,RIOM,0631735U,137,134,0,3,72,65,5 ème
PUY-DE-DOME,RIOM,0631985R,0,0,0,0,0,0,5 ème
PUY-DE-DOME,SAINT-GERMAIN-L'HERM,0630064C,34,34,0,0,13,21,5 ème
PUY-DE-DOME,THIERS,0631407M,48,48,0,0,20,28,5 ème
ARDECHE,ANNONAY,0070059B,167,166,0,1,78,89,5 ème
ARDECHE,ANNONAY,0070060C,177,177,0,0,89,88,5 ème
ARDECHE,ANNONAY,0071300A,106,99,0,7,46,60,5 ème
ARDECHE,AUBENAS,0071245R,79,77,0,2,40,39,5 ème
ARDECHE,BOURG-SAINT-ANDEOL,0070860X,139,136,0,3,64,75,5 ème
ARDECHE,CHOMERAC,0070009X,0,0,0,0,0,0,5 ème
ARDECHE,LARGENTIERE,0070080Z,50,49,0,1,20,30,5 ème
ARDECHE,LE CHEYLARD,0070861Y,31,31,0,0,11,20,5 ème
ARDECHE,PRIVAS,0070114L,0,0,0,0,0,0,5 ème
ARDECHE,PRIVAS,0071246S,255,244,0,11,145,110,5 ème
ARDECHE,PRIVAS,0071281E,45,45,0,0,23,22,5 ème
ARDECHE,SAINT-AGREVE,0070023M,28,28,0,0,14,14,5 ème
ARDECHE,TOURNON-SUR-RHONE,0070031W,0,0,0,0,0,0,5 ème
DROME,CHABEUIL,0260003M,152,150,0,2,75,77,5 ème
DROME,CHATEAUNEUF-DE-GALAURE,0261134S,48,48,0,0,0,48,5 ème
DROME,CREST,0260006R,0,0,0,0,0,0,5 ème
DROME,CREST,0260945L,110,110,0,0,59,51,5 ème
DROME,CREST,0261030D,182,161,15,6,88,94,5 ème
DROME,LE GRAND-SERRE,0260011W,83,83,0,0,37,46,5 ème
DROME,LIVRON-SUR-DROME,0260096N,154,154,0,0,83,71,5 ème
DROME,NYONS,0261089T,139,136,0,3,65,74,5 ème
DROME,PIERRELATTE,0260098R,122,122,0,0,54,68,5 ème
DROME,PIERRELATTE,0261010G,119,97,16,6,58,61,5 ème
DROME,ROMANS-SUR-ISERE,0260067G,107,107,0,0,56,51,5 ème
DROME,SAINT-DONAT-SUR-L'HERBASSE,0260099S,91,91,0,0,50,41,5 ème
DROME,SAINT-JEAN-EN-ROYANS,0260027N,83,83,0,0,39,44,5 ème
DROME,VALENCE,0260117L,98,98,0,0,46,52,5 ème
HAUTE SAVOIE,ABONDANCE,0740001Z,53,53,0,0,30,23,5 ème
HAUTE SAVOIE,ANNECY,0740083N,122,118,0,4,73,49,5 ème
HAUTE SAVOIE,ANNECY,0740274W,176,173,0,3,77,99,5 ème
HAUTE SAVOIE,ANNECY,0741101V,0,0,0,0,0,0,5 ème
HAUTE SAVOIE,ANNECY,0741164N,0,0,0,0,0,0,5 ème
HAUTE SAVOIE,ANNECY,0741285V,0,0,0,0,0,0,5 ème
HAUTE SAVOIE,ANNEMASSE,0741165P,281,280,0,1,148,133,5 ème
HAUTE SAVOIE,EVIAN-LES-BAINS,0740021W,215,198,16,1,105,110,5 ème
HAUTE SAVOIE,FAVERGES-SEYTHENEX,0740023Y,139,134,0,5,69,70,5 ème
HAUTE SAVOIE,MARIGNIER,0741501E,177,171,0,6,94,83,5 ème
HAUTE SAVOIE,SAINT-JEAN-D'AULPS,0740034K,98,98,0,0,47,51,5 ème
HAUTE SAVOIE,SALLANCHES,0740155S,0,0,0,0,0,0,5 ème
HAUTE SAVOIE,SEYSSEL,0740041T,144,144,0,0,80,64,5 ème
ISERE,BEAUREPAIRE,0382101C,149,145,0,4,68,81,5 ème
ISERE,CROLLES,0382781S,146,142,0,4,74,72,5 ème
ISERE,EYBENS,0383494S,138,134,0,4,70,68,5 ème
ISERE,GRENOBLE,0381696M,120,120,0,0,66,54,5 ème
ISERE,GRENOBLE,0382035F,179,157,21,1,93,86,5 ème
ISERE,GRENOBLE,0382111N,132,132,0,0,59,73,5 ème
ISERE,JARRIE,0382782T,147,143,0,4,64,83,5 ème
ISERE,LA COTE-SAINT-ANDRE,0381689E,181,178,0,3,92,89,5 ème
ISERE,LE BOURG-D'OISANS,0380007B,112,112,0,0,60,52,5 ème
ISERE,LE PONT-DE-BEAUVOISIN,0381703V,116,116,0,0,49,67,5 ème
ISERE,L'ISLE-D'ABEAU,0382786X,123,108,14,1,58,65,5 ème
ISERE,MENS,0380039L,50,50,0,0,27,23,5 ème
ISERE,PONT-DE-CHERUY,0381602K,0,0,0,0,0,0,5 ème
ISERE,SAINT-CHEF,0383301G,164,164,0,0,75,89,5 ème
ISERE,SAINT-MARTIN-D'HERES,0380065P,139,136,0,3,61,78,5 ème
ISERE,SAINT-MARTIN-D'HERES,0381812N,123,119,0,4,51,72,5 ème
ISERE,SAINT-QUENTIN-FALLAVIER,0382706K,127,125,0,2,52,75,5 ème
ISERE,SAINT-SIMEON-DE-BRESSIEUX,0380068T,104,102,0,2,41,63,5 ème
ISERE,TULLINS,0380067S,131,131,0,0,67,64,5 ème
ISERE,VIENNE,0381907S,181,153,23,5,91,90,5 ème
ISERE,VILLEFONTAINE,0382864G,102,102,0,0,51,51,5 ème
ISERE,VOIRON,0380092U,0,0,0,0,0,0,5 ème
ISERE,VOIRON,0381710C,177,177,0,0,79,98,5 ème
ISERE,VOREPPE,0381805F,0,0,0,0,0,0,5 ème
ISERE,VOREPPE,0382663N,118,118,0,0,58,60,5 ème
SAVOIE,AIX-LES-BAINS,0731041K,152,152,0,0,73,79,5 ème
SAVOIE,AIX-LES-BAINS,0731271K,8,8,0,0,8,0,5 ème
SAVOIE,ALBERTVILLE,0731224J,88,83,0,5,42,46,5 ème
SAVOIE,CHAMBERY,0730764J,252,247,0,5,129,123,5 ème
SAVOIE,CHAMBERY,0730901H,163,163,0,0,78,85,5 ème
SAVOIE,CHAMBERY,0731042L,176,174,0,2,90,86,5 ème
SAVOIE,ENTRELACS,0730004H,139,130,0,9,66,73,5 ème
SAVOIE,LA MOTTE-SERVOLEX,0731441V,165,162,0,3,84,81,5 ème
SAVOIE,LA RAVOIRE,0730032N,0,0,0,0,0,0,5 ème
SAVOIE,LA RAVOIRE,0730765K,101,83,18,0,37,64,5 ème
SAVOIE,MOUTIERS,0730029K,0,0,0,0,0,0,5 ème
SAVOIE,NOVALAISE,0730031M,74,74,0,0,44,30,5 ème
SAVOIE,SAINT-MICHEL-DE-MAURIENNE,0730984Y,49,49,0,0,17,32,5 ème
AIN,AMBERIEU-EN-BUGEY,0010002X,188,183,0,5,94,94,5 ème
AIN,AMBERIEU-EN-BUGEY,0010076C,110,108,0,2,54,56,5 ème
AIN,BOURG-EN-BRESSE,0010021T,0,0,0,0,0,0,5 ème
AIN,BOURG-EN-BRESSE,0010082J,213,210,0,3,100,113,5 ème
AIN,BOURG-EN-BRESSE,0010823P,102,102,0,0,49,53,5 ème
AIN,MARBOZ,0010089S,28,28,0,0,21,7,5 ème
AIN,MIRIBEL,0010964T,135,120,15,0,67,68,5 ème
AIN,MONTREAL-LA-CLUSE,0011325K,168,165,0,3,87,81,5 ème
AIN,NANTUA,0010032E,0,0,0,0,0,0,5 ème
AIN,OYONNAX,0010034G,0,0,0,0,0,0,5 ème
AIN,OYONNAX,0010035H,148,148,0,0,69,79,5 ème
AIN,PERON,0011388D,217,214,0,3,112,105,5 ème
AIN,PONT-DE-VEYLE,0010820L,111,110,0,1,55,56,5 ème
AIN,SAINT-DIDIER-SUR-CHALARONNE,0010095Y,143,143,0,0,57,86,5 ème
AIN,SAINT-GENIS-POUILLY,0010975E,175,172,0,3,74,101,5 ème
AIN,SAINT-TRIVIER-DE-COURTES,0010040N,77,76,0,1,34,43,5 ème
AIN,THOISSEY,0010042R,122,121,0,1,71,51,5 ème
AIN,VALSERHONE,0010008D,167,143,16,8,82,85,5 ème
AIN,VALSERHONE,0011066D,190,186,0,4,92,98,5 ème
AIN,VILLARS-LES-DOMBES,0010939R,149,146,0,3,67,82,5 ème
LOIRE,ANDREZIEUX-BOUTHEON,0421487N,220,202,12,6,121,99,5 ème
LOIRE,BOEN-SUR-LIGNON,0421085B,137,133,0,4,81,56,5 ème
LOIRE,BOURG-ARGENTAL,0421043F,49,49,0,0,20,29,5 ème
LOIRE,CHARLIEU,0420008F,0,0,0,0,0,0,5 ème
LOIRE,CHARLIEU,0421800D,112,112,0,0,47,65,5 ème
LOIRE,FEURS,0421057W,133,133,0,0,68,65,5 ème
LOIRE,LA GRAND-CROIX,0421086C,171,168,0,3,82,89,5 ème
LOIRE,LA RICAMARIE,0421689H,59,54,0,5,31,28,5 ème
LOIRE,LA TALAUDIERE,0421171V,217,215,0,2,112,105,5 ème
LOIRE,LE COTEAU,0421489R,0,0,0,0,0,0,5 ème
LOIRE,MABLY,0421852K,108,87,16,5,50,58,5 ème
LOIRE,MONTBRISON,0421032U,143,140,0,3,66,77,5 ème
LOIRE,RENAISON,0421735H,134,134,0,0,72,62,5 ème
LOIRE,RIVE-DE-GIER,0420029D,0,0,0,0,0,0,5 ème
LOIRE,RIVE-DE-GIER,0421014Z,130,130,0,0,63,67,5 ème
LOIRE,RIVE-DE-GIER,0421680Y,103,101,0,2,54,49,5 ème
LOIRE,ROANNE,0420076E,0,0,0,0,0,0,5 ème
LOIRE,ROANNE,0420978K,120,120,0,0,67,53,5 ème
LOIRE,SAINT-CHAMOND,0420078G,0,0,0,0,0,0,5 ème
LOIRE,SAINT-CHAMOND,0420996E,0,0,0,0,0,0,5 ème
LOIRE,SAINT-CHAMOND,0421799C,300,299,0,1,132,168,5 ème
LOIRE,SAINT-ETIENNE,0420916T,131,111,16,4,63,68,5 ème
LOIRE,SAINT-ETIENNE,0420958N,0,0,0,0,0,0,5 ème
LOIRE,SAINT-ETIENNE,0420991Z,0,0,0,0,0,0,5 ème
LOIRE,SAINT-ETIENNE,0421016B,59,59,0,0,33,26,5 ème
LOIRE,SAINT-ETIENNE,0421678W,224,221,0,3,92,132,5 ème
LOIRE,SAINT-ETIENNE,0421679X,121,117,0,4,55,66,5 ème
LOIRE,SAINT-HEAND,0421565Y,208,208,0,0,102,106,5 ème
LOIRE,SORBIERS,0421608V,0,0,0,0,0,0,5 ème
RHONE,AMPLEPUIS,0690001B,74,68,0,6,33,41,5 ème
RHONE,BRIGNAIS,0690008J,0,0,0,0,0,0,5 ème
RHONE,BRON,0690010L,0,0,0,0,0,0,5 ème
RHONE,CLAVEISOLLES,0690585L,27,27,0,0,8,19,5 ème
RHONE,CONDRIEU,0690015S,133,131,0,2,60,73,5 ème
RHONE,DARDILLY,0693504J,0,0,0,0,0,0,5 ème
RHONE,DECINES-CHARPIEU,0691495A,129,123,0,6,66,63,5 ème
RHONE,DECINES-CHARPIEU,0692800U,0,0,0,0,0,0,5 ème
RHONE,ECULLY,0690510E,187,184,0,3,80,107,5 ème
RHONE,FONTAINES-SUR-SAONE,0691736M,156,152,0,4,71,85,5 ème
RHONE,GIVORS,0690210D,91,91,0,0,44,47,5 ème
RHONE,LA MULATIERE,0692923C,103,103,0,0,37,66,5 ème
RHONE,LENTILLY,0693286X,192,190,0,2,103,89,5 ème
RHONE,LIMAS,0692420F,179,160,15,4,83,96,5 ème
RHONE,LYON,0692928H,185,185,0,0,108,77,5 ème
RHONE,LYON,0690053H,160,143,15,2,71,89,5 ème
RHONE,LYON,0690131T,112,112,0,0,62,50,5 ème
RHONE,LYON,0692411W,142,137,0,5,69,73,5 ème
RHONE,LYON,0692921A,461,454,0,7,223,238,5 ème
RHONE,LYON,0692936S,158,158,0,0,70,88,5 ème
RHONE,LYON,0693371P,0,0,0,0,0,0,5 ème
RHONE,LYON,0690046A,0,0,0,0,0,0,5 ème
RHONE,LYON,0692578C,123,121,0,2,66,57,5 ème
RHONE,LYON,0690092A,0,0,0,0,0,0,5 ème
RHONE,MEYZIEU,0692704P,161,159,0,2,68,93,5 ème
RHONE,RILLIEUX-LA-PAPE,0691626T,0,0,0,0,0,0,5 ème
RHONE,RILLIEUX-LA-PAPE,0691651V,152,149,0,3,71,81,5 ème
RHONE,SAINTE-FOY-L'ARGENTIERE,0690078K,111,104,0,7,43,68,5 ème
RHONE,SAINT-GENIS-LAVAL,0693287Y,68,68,0,0,30,38,5 ème
RHONE,SAINT-PRIEST,0693094N,0,0,0,0,0,0,5 ème
RHONE,SOUCIEU-EN-JARREST,0693046L,169,163,0,6,85,84,5 ème
RHONE,TARARE,0690085T,0,0,0,0,0,0,5 ème
RHONE,VAULX-EN-VELIN,0693045K,0,0,0,0,0,0,5 ème
RHONE,VENISSIEUX,0690094C,166,163,0,3,93,73,5 ème
RHONE,VENISSIEUX,0691480J,168,166,0,2,86,82,5 ème
RHONE,VENISSIEUX,0691730F,176,174,0,2,90,86,5 ème
RHONE,VENISSIEUX,0692343X,176,159,15,2,81,95,5 ème
RHONE,VILLEURBANNE,0690103M,0,0,0,0,0,0,5 ème
RHONE,VILLEURBANNE,0690109U,0,0,0,0,0,0,5 ème
RHONE,VILLEURBANNE,0690280E,112,107,0,5,57,55,5 ème
RHONE,VILLEURBANNE,0692390Y,7,6,0,1,3,4,5 ème
RHONE,VILLEURBANNE,0694497N,123,123,0,0,61,62,5 ème
DOUBS,BESANCON,0251573Z,230,228,0,2,122,108,5 ème
DOUBS,BETHONCOURT,0251209D,91,91,0,0,54,37,5 ème
DOUBS,CHATILLON-LE-DUC,0251857H,152,146,0,6,80,72,5 ème
DOUBS,LES FONTENELLES,0251064W,15,15,0,0,6,9,5 ème
DOUBS,MONTBELIARD,0250035C,124,119,0,5,63,61,5 ème
DOUBS,MONTBELIARD,0251057N,116,116,0,0,49,67,5 ème
DOUBS,MORTEAU,0251067Z,111,111,0,0,44,67,5 ème
DOUBS,PAYS-DE-CLERVAL,0250016G,42,42,0,0,17,25,5 ème
DOUBS,POUILLEY-LES-VIGNES,0251673H,160,160,0,0,81,79,5 ème
DOUBS,VOUJEAUCOURT,0251130T,158,140,16,2,76,82,5 ème
HAUTE-SAONE,FAVERNEY,0700006B,73,70,0,3,33,40,5 ème
HAUTE-SAONE,HERICOURT,0700063N,83,83,0,0,38,45,5 ème
HAUTE-SAONE,LURE,0700065R,53,53,0,0,25,28,5 ème
HAUTE-SAONE,SCEY-SUR-SAONE-ET-SAINT-ALBIN,0700894S,97,94,0,3,51,46,5 ème
JURA,CHAMPAGNOLE,0390075V,84,84,0,0,42,42,5 ème
JURA,CROTENAY,0390055Y,16,0,16,0,6,10,5 ème
JURA,HAUTS DE BIENNE,0390028U,74,66,5,3,31,43,5 ème
JURA,HAUTS DE BIENNE,0390081B,43,43,0,0,27,16,5 ème
JURA,LONS-LE-SAUNIER,0391003D,55,55,0,0,25,30,5 ème
JURA,MOIRANS-EN-MONTAGNE,0390024P,0,0,0,0,0,0,5 ème
JURA,POLIGNY,0390072S,17,17,0,0,12,5,5 ème
JURA,POLIGNY,0390798F,119,99,17,3,55,64,5 ème
JURA,SAINT-LAURENT-EN-GRANDVAUX,0390916J,80,78,0,2,46,34,5 ème
TERRITOIRE DE BELFORT,BELFORT,0900006T,149,147,0,2,77,72,5 ème
TERRITOIRE DE BELFORT,BELFORT,0900425Y,0,0,0,0,0,0,5 ème
TERRITOIRE DE BELFORT,GIROMAGNY,0900009W,111,108,0,3,59,52,5 ème
COTE D'OR,AUXONNE,0211452P,167,148,16,3,83,84,5 ème
COTE D'OR,BEAUNE,0211230Y,185,164,16,5,85,100,5 ème
COTE D'OR,BRAZEY-EN-PLAINE,0211756V,105,89,16,0,51,54,5 ème
COTE D'OR,CHENOVE,0211096C,74,74,0,0,41,33,5 ème
COTE D'OR,CHENOVE,0211356K,0,0,0,0,0,0,5 ème
COTE D'OR,DIJON,0211151M,242,240,0,2,127,115,5 ème
COTE D'OR,DIJON,0211526V,114,114,0,0,64,50,5 ème
COTE D'OR,FONTAINE-FRANCAISE,0210027R,39,39,0,0,20,19,5 ème
COTE D'OR,IS-SUR-TILLE,0210029T,189,172,13,4,86,103,5 ème
COTE D'OR,LAIGNES,0210030U,24,24,0,0,12,12,5 ème
COTE D'OR,POUILLY-EN-AUXOIS,0210041F,70,70,0,0,40,30,5 ème
COTE D'OR,SELONGEY,0211557D,73,73,0,0,37,36,5 ème
COTE D'OR,SEMUR-EN-AUXOIS,0211527W,95,78,15,2,44,51,5 ème
NIEVRE,COSNE-COURS-SUR-LOIRE,0580014A,0,0,0,0,0,0,5 ème
NIEVRE,COSNE-COURS-SUR-LOIRE,0580066G,56,56,0,0,25,31,5 ème
NIEVRE,DECIZE,0580017D,130,109,16,5,57,73,5 ème
NIEVRE,DECIZE,0580761M,0,0,0,0,0,0,5 ème
NIEVRE,DONZY,0580018E,20,20,0,0,9,11,5 ème
NIEVRE,LORMES,0580026N,35,35,0,0,21,14,5 ème
NIEVRE,NEVERS,0580061B,144,141,0,3,70,74,5 ème
NIEVRE,POUILLY-SUR-LOIRE,0580035Y,46,46,0,0,27,19,5 ème
NIEVRE,SAINT-AMAND-EN-PUISAYE,0580037A,25,25,0,0,17,8,5 ème
NIEVRE,VARZY,0581009G,34,22,9,3,14,20,5 ème
SAONE-ET-LOIRE,AUTUN,0711350G,60,58,0,2,30,30,5 ème
SAONE-ET-LOIRE,BLANZY,0711384U,0,0,0,0,0,0,5 ème
SAONE-ET-LOIRE,CHALON-SUR-SAONE,0710106E,227,227,0,0,105,122,5 ème
SAONE-ET-LOIRE,CHALON-SUR-SAONE,0710537Y,104,101,0,3,53,51,5 ème
SAONE-ET-LOIRE,CHALON-SUR-SAONE,0711448N,169,169,0,0,99,70,5 ème
SAONE-ET-LOIRE,CHARNAY-LES-MACON,0711050F,24,0,24,0,10,14,5 ème
SAONE-ET-LOIRE,CUISERY,0710034B,103,103,0,0,50,53,5 ème
SAONE-ET-LOIRE,ETANG-SUR-ARROUX,0710038F,50,50,0,0,24,26,5 ème
SAONE-ET-LOIRE,LA CLAYETTE,0710022N,56,56,0,0,25,31,5 ème
SAONE-ET-LOIRE,LOUHANS,0711925G,85,85,0,0,39,46,5 ème
SAONE-ET-LOIRE,MACON,0710110J,180,180,0,0,77,103,5 ème
SAONE-ET-LOIRE,MACON,0711052H,177,175,0,2,89,88,5 ème
SAONE-ET-LOIRE,MACON,0711053J,150,145,0,5,65,85,5 ème
SAONE-ET-LOIRE,SAINT-GERMAIN-DU-PLAIN,0710067M,137,134,0,3,58,79,5 ème
SAONE-ET-LOIRE,SAINT-MARTIN-EN-BRESSE,0711451S,82,81,0,1,39,43,5 ème
SAONE-ET-LOIRE,SAINT-VALLIER,0711296Y,157,157,0,0,76,81,5 ème
SAONE-ET-LOIRE,SENNECEY-LE-GRAND,0710070R,98,98,0,0,43,55,5 ème
YONNE,AVALLON,0890009B,74,72,0,2,38,36,5 ème
YONNE,AVALLON,0891053L,38,38,0,0,13,25,5 ème
YONNE,CHARNY OREE DE PUISAYE,0890014G,47,47,0,0,22,25,5 ème
YONNE,SAINT-FARGEAU,0890022R,106,103,0,3,59,47,5 ème
YONNE,SAINT-GEORGES-SUR-BAULCHE,0891043A,157,156,0,1,78,79,5 ème
YONNE,SENS,0890053Z,0,0,0,0,0,0,5 ème
YONNE,SENS,0890067P,0,0,0,0,0,0,5 ème
YONNE,TOUCY,0890035E,104,88,16,0,52,52,5 ème
COTES D'ARMOR,BROONS,0221127F,147,142,0,5,64,83,5 ème
COTES D'ARMOR,CHATELAUDREN-PLOUAGAT,0220006M,198,195,0,3,87,111,5 ème
COTES D'ARMOR,GUERLEDAN,0220032R,58,58,0,0,34,24,5 ème
COTES D'ARMOR,GUINGAMP,0220098M,176,174,0,2,86,90,5 ème
COTES D'ARMOR,LANNION,0220082V,152,124,28,0,69,83,5 ème
COTES D'ARMOR,LANVOLLON,0220144M,78,78,0,0,40,38,5 ème
COTES D'ARMOR,LOUDEAC,0221509W,161,141,16,4,72,89,5 ème
COTES D'ARMOR,LOUDEAC,0221747E,92,88,0,4,35,57,5 ème
COTES D'ARMOR,MATIGNON,0220029M,40,40,0,0,25,15,5 ème
COTES D'ARMOR,PLEMET,0221037H,41,37,0,4,20,21,5 ème
COTES D'ARMOR,PLESTIN-LES-GREVES,0221541F,90,90,0,0,47,43,5 ème
COTES D'ARMOR,PLOEUC-L'HERMITAGE,0220157B,52,52,0,0,23,29,5 ème
COTES D'ARMOR,PLOEUC-L'HERMITAGE,0221568K,98,94,0,4,54,44,5 ème
COTES D'ARMOR,PLOUARET,0220045E,69,69,0,0,40,29,5 ème
COTES D'ARMOR,PONTRIEUX,0221542G,44,42,0,2,16,28,5 ème
COTES D'ARMOR,SAINT-BRIEUC,0220117H,0,0,0,0,0,0,5 ème
COTES D'ARMOR,SAINT-BRIEUC,0221999D,35,34,0,1,12,23,5 ème
FINISTERE,BREST,0290243G,90,88,0,2,47,43,5 ème
FINISTERE,BREST,0291089B,88,69,16,3,31,57,5 ème
FINISTERE,BREST,0291103S,8,8,0,0,2,6,5 ème
FINISTERE,BREST,0291595B,137,137,0,0,58,79,5 ème
FINISTERE,BREST,0291866W,51,51,0,0,23,28,5 ème
FINISTERE,BRIEC,0290019N,106,106,0,0,56,50,5 ème
FINISTERE,CHATEAULIN,0291590W,126,120,0,6,75,51,5 ème
FINISTERE,CHATEAULIN,0291872C,99,95,0,4,51,48,5 ème
FINISTERE,CHATEAUNEUF-DU-FAOU,0292006Y,69,67,0,2,39,30,5 ème
FINISTERE,GUILERS,0291716H,75,75,0,0,42,33,5 ème
FINISTERE,GUILVINEC,0291631R,64,64,0,0,34,30,5 ème
FINISTERE,MORLAIX,0290105G,0,0,0,0,0,0,5 ème
FINISTERE,MORLAIX,0290163V,85,85,0,0,40,45,5 ème
FINISTERE,PLEYBEN,0290288F,32,32,0,0,14,18,5 ème
FINISTERE,PLOUGASTEL-DAOULAS,0290297R,108,108,0,0,47,61,5 ème
FINISTERE,PONT-L'ABBE,0290064M,219,204,15,0,117,102,5 ème
FINISTERE,PONT-L'ABBE,0291877H,108,102,0,6,54,54,5 ème
FINISTERE,QUIMPER,0291878J,183,179,0,4,94,89,5 ème
FINISTERE,QUIMPER,0291880L,190,173,16,1,82,108,5 ème
FINISTERE,QUIMPERLE,0290078C,0,0,0,0,0,0,5 ème
FINISTERE,QUIMPERLE,0290307B,22,22,0,0,5,17,5 ème
FINISTERE,QUIMPERLE,0291635V,157,142,14,1,86,71,5 ème
FINISTERE,QUIMPERLE,0291881M,129,129,0,0,73,56,5 ème
FINISTERE,SAINT-RENAN,0290314J,234,231,0,3,117,117,5 ème
FINISTERE,SAINT-THEGONNEC LOC-EGUINER,0290316L,46,46,0,0,21,25,5 ème
ILLE-ET-VILAINE,FOUGERES,0350762N,170,167,0,3,72,98,5 ème
ILLE-ET-VILAINE,REDON,0350732F,15,0,15,0,3,12,5 ème
ILLE-ET-VILAINE,REDON,0350969N,95,79,16,0,53,42,5 ème
ILLE-ET-VILAINE,RENNES,0350033W,124,120,0,4,53,71,5 ème
ILLE-ET-VILAINE,RENNES,0350747X,15,0,15,0,7,8,5 ème
ILLE-ET-VILAINE,RENNES,0350895H,100,83,16,1,53,47,5 ème
ILLE-ET-VILAINE,RENNES,0351796M,136,136,0,0,64,72,5 ème
ILLE-ET-VILAINE,RENNES,0351851X,160,138,16,6,84,76,5 ème
ILLE-ET-VILAINE,RENNES,0352070K,260,253,0,7,127,133,5 ème
ILLE-ET-VILAINE,SAINT-GEORGES-DE-REINTEMBAULT,0350041E,37,37,0,0,18,19,5 ème
ILLE-ET-VILAINE,SAINT-GREGOIRE,0350780H,233,230,0,3,121,112,5 ème
ILLE-ET-VILAINE,SAINT-MALO,0350773A,144,142,0,2,73,71,5 ème
ILLE-ET-VILAINE,SAINT-MALO,0350896J,97,93,0,4,45,52,5 ème
ILLE-ET-VILAINE,SAINT-MEEN-LE-GRAND,0350887Z,58,58,0,0,26,32,5 ème
ILLE-ET-VILAINE,SAINT-MEEN-LE-GRAND,0351850W,94,94,0,0,49,45,5 ème
ILLE-ET-VILAINE,TINTENIAC,0350051R,141,140,0,1,73,68,5 ème
ILLE-ET-VILAINE,VAL-COUESNON,0350052S,48,48,0,0,26,22,5 ème
ILLE-ET-VILAINE,VITRE,0350892E,110,106,0,4,58,52,5 ème
ILLE-ET-VILAINE,VITRE,0351785A,271,271,0,0,132,139,5 ème
MORBIHAN,ARRADON,0560122D,88,88,0,0,42,46,5 ème
MORBIHAN,GRAND-CHAMP,0560132P,116,116,0,0,59,57,5 ème
MORBIHAN,GUEMENE-SUR-SCORFF,0561358X,95,86,9,0,55,40,5 ème
MORBIHAN,HENNEBONT,0560214D,128,106,16,6,57,71,5 ème
MORBIHAN,LANESTER,0560215E,92,76,16,0,46,46,5 ème
MORBIHAN,LA ROCHE-BERNARD,0560169E,166,166,0,0,77,89,5 ème
MORBIHAN,LE FAOUET,0560158T,38,38,0,0,17,21,5 ème
MORBIHAN,LOCMINE,0561377T,141,141,0,0,63,78,5 ème
MORBIHAN,LORIENT,0560181T,0,0,0,0,0,0,5 ème
MORBIHAN,MALESTROIT,0560150J,176,170,0,6,76,100,5 ème
MORBIHAN,PLOERMEL,0560105K,0,0,0,0,0,0,5 ème
MORBIHAN,QUESTEMBERT,0560166B,154,147,6,1,72,82,5 ème
MORBIHAN,ROHAN,0560171G,83,83,0,0,32,51,5 ème
MORBIHAN,SAINT-JEAN-BREVELAY,0560063P,54,54,0,0,23,31,5 ème
MORBIHAN,SAINT-JEAN-BREVELAY,0560172H,107,107,0,0,43,64,5 ème
MORBIHAN,THEIX-NOYALO,0561940E,123,123,0,0,69,54,5 ème
MORBIHAN,VANNES,0560223N,125,110,15,0,65,60,5 ème
MORBIHAN,VANNES,0561544Z,194,194,0,0,84,110,5 ème
CHER,BOURGES,0180568V,17,14,0,3,4,13,5 ème
CHER,BOURGES,0180571Y,0,0,0,0,0,0,5 ème
CHER,BOURGES,0180721L,151,151,0,0,82,69,5 ème
CHER,HENRICHEMONT,0180019Y,107,103,0,4,46,61,5 ème
CHER,LIGNIERES,0180020Z,50,50,0,0,24,26,5 ème
CHER,SAINT-DOULCHARD,0180643B,166,163,0,3,96,70,5 ème
CHER,VIERZON,0180037T,117,111,0,6,56,61,5 ème
EURE-ET-LOIR,CHATEAUDUN,0280679L,83,83,0,0,39,44,5 ème
EURE-ET-LOIR,CHATEAUDUN,0280957N,122,116,0,6,63,59,5 ème
EURE-ET-LOIR,JANVILLE-EN-BEAUCE,0280680M,86,86,0,0,42,44,5 ème
EURE-ET-LOIR,LA LOUPE,0280869T,102,90,12,0,47,55,5 ème
EURE-ET-LOIR,LUCE,0280803W,117,115,0,2,56,61,5 ème
EURE-ET-LOIR,MAINVILLIERS,0280034K,119,113,0,6,61,58,5 ème
EURE-ET-LOIR,NOGENT-LE-ROTROU,0280903E,95,79,14,2,45,50,5 ème
EURE-ET-LOIR,NOGENT-LE-ROTROU,0281021H,0,0,0,0,0,0,5 ème
INDRE,ARDENTES,0360573C,57,57,0,0,36,21,5 ème
INDRE,CHATEAUROUX,0360050J,11,0,11,0,6,5,5 ème
INDRE,CHATEAUROUX,0360690E,120,117,0,3,59,61,5 ème
INDRE,ISSOUDUN,0360544W,89,86,0,3,40,49,5 ème
INDRE,SAINT-BENOIT-DU-SAULT,0360033R,33,33,0,0,16,17,5 ème
INDRE,SAINTE-SEVERE-SUR-INDRE,0360037V,29,29,0,0,14,15,5 ème
INDRE,TOURNON-SAINT-MARTIN,0360038W,32,32,0,0,15,17,5 ème
INDRE-ET-LOIRE,AVOINE,0370994E,114,110,0,4,61,53,5 ème
INDRE-ET-LOIRE,BALLAN-MIRE,0371403Z,143,143,0,0,69,74,5 ème
INDRE-ET-LOIRE,CHINON,0371100V,0,0,0,0,0,0,5 ème
INDRE-ET-LOIRE,JOUE-LES-TOURS,0370740D,172,172,0,0,72,100,5 ème
INDRE-ET-LOIRE,JOUE-LES-TOURS,0370791J,59,57,0,2,29,30,5 ème
INDRE-ET-LOIRE,JOUE-LES-TOURS,0370888P,0,0,0,0,0,0,5 ème
INDRE-ET-LOIRE,MONTBAZON,0370793L,187,185,0,2,94,93,5 ème
INDRE-ET-LOIRE,MONTLOUIS-SUR-LOIRE,0370799T,195,191,0,4,99,96,5 ème
INDRE-ET-LOIRE,MONTS,0370993D,178,178,0,0,90,88,5 ème
INDRE-ET-LOIRE,RICHELIEU,0370739C,39,39,0,0,20,19,5 ème
INDRE-ET-LOIRE,SAVIGNE-SUR-LATHAN,0370034L,94,94,0,0,41,53,5 ème
INDRE-ET-LOIRE,TOURS,0370033K,159,130,25,4,68,91,5 ème
INDRE-ET-LOIRE,TOURS,0370039S,40,40,0,0,23,17,5 ème
INDRE-ET-LOIRE,TOURS,0370886M,141,135,0,6,72,69,5 ème
INDRE-ET-LOIRE,TOURS,0371327S,144,144,0,0,68,76,5 ème
LOIRET,BEAUGENCY,0450759F,0,0,0,0,0,0,5 ème
LOIRET,BRIARE,0450008P,103,88,11,4,37,66,5 ème
LOIRET,CHALETTE-SUR-LOING,0450840U,174,159,11,4,82,92,5 ème
LOIRET,CHALETTE-SUR-LOING,0451442Y,0,0,0,0,0,0,5 ème
LOIRET,FLEURY-LES-AUBRAIS,0451544J,106,106,0,0,59,47,5 ème
LOIRET,GIEN,0451331C,84,84,0,0,38,46,5 ème
LOIRET,INGRE,0451068S,237,233,0,4,117,120,5 ème
LOIRET,MEUNG-SUR-LOIRE,0451735S,58,58,0,0,26,32,5 ème
LOIRET,MONTARGIS,0450789N,91,87,0,4,38,53,5 ème
LOIRET,OLIVET,0450118J,151,151,0,0,89,62,5 ème
LOIRET,OLIVET,0451499K,121,116,0,5,56,65,5 ème
LOIRET,ORLEANS,0450758E,0,0,0,0,0,0,5 ème
LOIRET,ORLEANS,0451333E,125,125,0,0,64,61,5 ème
LOIRET,POILLY-LEZ-GIEN,0451286D,93,76,16,1,47,46,5 ème
LOIRET,SAINT-JEAN-DE-BRAYE,0451072W,180,163,16,1,91,89,5 ème
LOIRET,SAINT-JEAN-DE-LA-RUELLE,0450066C,0,0,0,0,0,0,5 ème
LOIRET,SAINT-JEAN-DE-LA-RUELLE,0450069F,100,94,0,6,38,62,5 ème
LOIR-ET-CHER,BEAUCE LA ROMAINE,0410016V,128,125,0,3,51,77,5 ème
LOIR-ET-CHER,BLOIS,0410832G,0,0,0,0,0,0,5 ème
LOIR-ET-CHER,MER,0410631N,115,114,0,1,68,47,5 ème
LOIR-ET-CHER,MONTRICHARD VAL DE CHER,0410632P,116,114,0,2,53,63,5 ème
LOIR-ET-CHER,MOREE,0410013S,102,97,0,5,54,48,5 ème
LOIR-ET-CHER,ROMORANTIN-LANTHENAY,0410684W,73,73,0,0,38,35,5 ème
LOIR-ET-CHER,SAINT-AMAND-LONGPRE,0410024D,68,63,0,5,30,38,5 ème
LOIR-ET-CHER,VEUZAIN-SUR-LOIRE,0410716F,134,129,0,5,69,65,5 ème
LOIR-ET-CHER,VINEUIL,0410715E,166,166,0,0,86,80,5 ème
CORSE-DU-SUD,PORTO-VECCHIO,6200040Z,197,197,0,0,91,106,5 ème
CORSE-DU-SUD,PROPRIANO,6200041A,64,58,5,1,30,34,5 ème
CORSE-DU-SUD,SANTA-MARIA-SICHE,6200045E,35,35,0,0,15,20,5 ème
CORSE-DU-SUD,SARTENE,6200055R,44,44,0,0,23,21,5 ème
HAUTE-CORSE,BASTIA,7200013B,172,156,13,3,91,81,5 ème
HAUTE-CORSE,LURI,7200027S,32,32,0,0,20,12,5 ème
HAUTE-CORSE,MOLTIFAO,7200028T,27,27,0,0,12,15,5 ème
HAUTE-CORSE,PRUNELLI-DI-FIUMORBO,7200086F,178,170,4,4,84,94,5 ème
MEURTHE-ET-MOSELLE,AUDUN-LE-ROMAN,0541470E,87,87,0,0,31,56,5 ème
MEURTHE-ET-MOSELLE,BLAINVILLE-SUR-L'EAU,0540005M,134,108,24,2,54,80,5 ème
MEURTHE-ET-MOSELLE,DOMBASLE-SUR-MEURTHE,0541325X,78,78,0,0,37,41,5 ème
MEURTHE-ET-MOSELLE,ESSEY-LES-NANCY,0541211Y,127,127,0,0,65,62,5 ème
MEURTHE-ET-MOSELLE,LAXOU,0540047H,78,75,0,3,34,44,5 ème
MEURTHE-ET-MOSELLE,LAXOU,0541469D,68,64,0,4,40,28,5 ème
MEURTHE-ET-MOSELLE,LONGWY,0541334G,83,80,0,3,46,37,5 ème
MEURTHE-ET-MOSELLE,LUNEVILLE,0541329B,142,101,39,2,63,79,5 ème
MEURTHE-ET-MOSELLE,LUNEVILLE,0542293Z,0,0,0,0,0,0,5 ème
MEURTHE-ET-MOSELLE,MONT-SAINT-MARTIN,0540088C,45,45,0,0,22,23,5 ème
MEURTHE-ET-MOSELLE,NANCY,0541339M,142,142,0,0,73,69,5 ème
MEURTHE-ET-MOSELLE,NANCY,0541568L,79,79,0,0,35,44,5 ème
MEURTHE-ET-MOSELLE,NANCY,0541778P,115,110,0,5,61,54,5 ème
MEURTHE-ET-MOSELLE,NANCY,0541994Z,76,76,0,0,52,24,5 ème
MEURTHE-ET-MOSELLE,POMPEY,0540085Z,0,0,0,0,0,0,5 ème
MEURTHE-ET-MOSELLE,PONT-SAINT-VINCENT,0540060X,0,0,0,0,0,0,5 ème
MEURTHE-ET-MOSELLE,PULNOY,0541956H,147,138,0,9,66,81,5 ème
MEURTHE-ET-MOSELLE,THIAUCOURT-REGNIEVILLE,0540064B,57,57,0,0,29,28,5 ème
MEURTHE-ET-MOSELLE,TOMBLAINE,0541569M,147,147,0,0,81,66,5 ème
MEURTHE-ET-MOSELLE,VAL DE BRIEY,0540008R,83,83,0,0,46,37,5 ème
MEUSE,BAR-LE-DUC,0550890U,99,94,0,5,53,46,5 ème
MEUSE,BOULIGNY,0550006H,42,42,0,0,22,20,5 ème
MEUSE,DAMVILLERS,0550009L,51,51,0,0,29,22,5 ème
MEUSE,ETAIN,0550011N,115,97,16,2,55,60,5 ème
MEUSE,FRESNES-EN-WOEVRE,0550012P,74,71,0,3,42,32,5 ème
MEUSE,GONDRECOURT-LE-CHATEAU,0550013R,32,32,0,0,13,19,5 ème
MEUSE,LIGNY-EN-BARROIS,0550014S,80,80,0,0,40,40,5 ème
MEUSE,VAUBECOURT,0550022A,51,51,0,0,22,29,5 ème
MEUSE,VERDUN,0550891V,0,0,0,0,0,0,5 ème
MOSELLE,ALGRANGE,0572169Y,77,77,0,0,37,40,5 ème
MOSELLE,ARS-SUR-MOSELLE,0572015F,120,116,0,4,65,55,5 ème
MOSELLE,BITCHE,0573361U,140,129,8,3,63,77,5 ème
MOSELLE,BOULAY-MOSELLE,0570010B,193,177,13,3,92,101,5 ème
MOSELLE,BOUZONVILLE,0570248K,0,0,0,0,0,0,5 ème
MOSELLE,COCHEREN,0572490X,93,91,0,2,47,46,5 ème
MOSELLE,CREUTZWALD,0572690P,122,112,6,4,58,64,5 ème
MOSELLE,FAULQUEMONT,0570026U,78,78,0,0,42,36,5 ème
MOSELLE,FORBACH,0572813Y,115,109,0,6,66,49,5 ème
MOSELLE,HOMBOURG-HAUT,0572491Y,64,64,0,0,31,33,5 ème
MOSELLE,L'HOPITAL,0572487U,85,85,0,0,42,43,5 ème
MOSELLE,MARANGE-SILVANGE,0572586B,79,79,0,0,43,36,5 ème
MOSELLE,METZ,0570055A,92,91,0,1,46,46,5 ème
MOSELLE,METZ,0570124A,0,0,0,0,0,0,5 ème
MOSELLE,METZ,0572640K,107,101,0,6,46,61,5 ème
MOSELLE,METZ,0572923T,118,118,0,0,56,62,5 ème
MOSELLE,MONTIGNY-LES-METZ,0572927X,232,232,0,0,103,129,5 ème
MOSELLE,MOUSSEY,0570074W,46,46,0,0,16,30,5 ème
MOSELLE,MOYEUVRE-GRANDE,0572017H,92,83,9,0,43,49,5 ème
MOSELLE,PHALSBOURG,0572929Z,97,97,0,0,39,58,5 ème
MOSELLE,ROHRBACH-LES-BITCHE,0572496D,130,125,0,5,64,66,5 ème
MOSELLE,ROMBAS,0570146Z,0,0,0,0,0,0,5 ème
MOSELLE,SAINT-AVOLD,0570223H,72,72,0,0,37,35,5 ème
MOSELLE,SAINTE-MARIE-AUX-CHENES,0570091P,154,154,0,0,83,71,5 ème
MOSELLE,SARREBOURG,0570095U,0,0,0,0,0,0,5 ème
MOSELLE,SARREGUEMINES,0570099Y,0,0,0,0,0,0,5 ème
MOSELLE,SIERCK-LES-BAINS,0572026T,159,159,0,0,69,90,5 ème
MOSELLE,THIONVILLE,0572355A,128,108,15,5,66,62,5 ème
MOSELLE,THIONVILLE,0572932C,303,303,0,0,162,141,5 ème
MOSELLE,VIGY,0572354Z,116,116,0,0,64,52,5 ème
MOSELLE,YUTZ,0570115R,211,210,0,1,96,115,5 ème
VOSGES,CHATENOIS,0880011J,62,62,0,0,33,29,5 ème
VOSGES,CONTREXEVILLE,0880013L,0,0,0,0,0,0,5 ème
VOSGES,CORCIEUX,0880014M,46,42,0,4,20,26,5 ème
VOSGES,CORNIMONT,0881397R,80,80,0,0,37,43,5 ème
VOSGES,EPINAL,0881530K,0,0,0,0,0,0,5 ème
VOSGES,GERARDMER,0881446U,111,111,0,0,47,64,5 ème
VOSGES,MIRECOURT,0880035K,137,132,0,5,70,67,5 ème
VOSGES,NEUFCHATEAU,0880041S,114,104,6,4,48,66,5 ème
VOSGES,NEUFCHATEAU,0880112U,20,20,0,0,13,7,5 ème
VOSGES,REMIREMONT,0880096B,67,62,0,5,35,32,5 ème
VOSGES,REMIREMONT,0880155R,103,96,0,7,45,58,5 ème
VOSGES,SAINT-DIE-DES-VOSGES,0880098D,83,83,0,0,36,47,5 ème
VOSGES,SAINT-DIE-DES-VOSGES,0881099S,116,113,0,3,57,59,5 ème
ARDENNES,ATTIGNY,0081100C,77,77,0,0,47,30,5 ème
ARDENNES,CHARLEVILLE-MEZIERES,0080894D,93,79,14,0,38,55,5 ème
ARDENNES,CHARLEVILLE-MEZIERES,0080954U,73,70,0,3,38,35,5 ème
ARDENNES,MONTHERME,0080827F,60,60,0,0,37,23,5 ème
ARDENNES,NOUVION-SUR-MEUSE,0080896F,99,96,0,3,48,51,5 ème
ARDENNES,RETHEL,0080039Z,0,0,0,0,0,0,5 ème
ARDENNES,REVIN,0080040A,0,0,0,0,0,0,5 ème
ARDENNES,SEDAN,0080046G,75,71,0,4,35,40,5 ème
ARDENNES,SEDAN,0080047H,0,0,0,0,0,0,5 ème
ARDENNES,SIGNY-LE-PETIT,0081105H,88,88,0,0,40,48,5 ème
ARDENNES,VILLERS-SEMEUSE,0081001V,78,75,0,3,35,43,5 ème
ARDENNES,VOUZIERS,0080089D,39,39,0,0,20,19,5 ème
AUBE,ARCIS-SUR-AUBE,0100665U,160,160,0,0,76,84,5 ème
AUBE,BAR-SUR-AUBE,0100003Z,0,0,0,0,0,0,5 ème
AUBE,CHAOURCE,0100008E,42,42,0,0,21,21,5 ème
AUBE,ERVY-LE-CHATEL,0100010G,66,66,0,0,32,34,5 ème
AUBE,LA CHAPELLE-SAINT-LUC,0100807Y,156,135,19,2,89,67,5 ème
AUBE,TROYES,0100078F,0,0,0,0,0,0,5 ème
AUBE,TROYES,0100962S,121,121,0,0,54,67,5 ème
AUBE,VENDEUVRE-SUR-BARSE,0100028B,73,73,0,0,42,31,5 ème
HAUTE-MARNE,BOURMONT-ENTRE-MEUSE-ET-MOUZON,0520004X,38,38,0,0,21,17,5 ème
HAUTE-MARNE,FAYL-BILLOT,0520017L,42,42,0,0,19,23,5 ème
HAUTE-MARNE,LE MONTSAUGEONNAIS,0520026W,64,64,0,0,33,31,5 ème
HAUTE-MARNE,NOGENT,0520025V,73,69,0,4,33,40,5 ème
HAUTE-MARNE,SAINT-DIZIER,0520029Z,0,0,0,0,0,0,5 ème
HAUTE-MARNE,SAINT-DIZIER,0520049W,76,61,13,2,36,40,5 ème
HAUTE-MARNE,WASSY,0520709N,16,0,16,0,6,10,5 ème
MARNE,AVIZE,0510002A,90,90,0,0,51,39,5 ème
MARNE,AY-CHAMPAGNE,0511432E,104,104,0,0,54,50,5 ème
MARNE,CHALONS-EN-CHAMPAGNE,0510007F,0,0,0,0,0,0,5 ème
MARNE,CORMONTREUIL,0511961E,162,161,0,1,94,68,5 ème
MARNE,EPERNAY,0510016R,121,117,0,4,63,58,5 ème
MARNE,EPERNAY,0511173Y,139,139,0,0,84,55,5 ème
MARNE,EPERNAY,0511189R,109,99,7,3,45,64,5 ème
MARNE,FRIGNICOURT,0511474A,87,85,0,2,47,40,5 ème
MARNE,MAREUIL-LE-PORT,0510028D,84,84,0,0,39,45,5 ème
MARNE,MOURMELON-LE-GRAND,0510029E,153,137,10,6,76,77,5 ème
MARNE,REIMS,0510037N,0,0,0,0,0,0,5 ème
MARNE,REIMS,0510044W,123,118,0,5,67,56,5 ème
MARNE,REIMS,0511085C,175,172,0,3,80,95,5 ème
MARNE,REIMS,0511108C,138,114,15,9,67,71,5 ème
MARNE,REIMS,0511139L,142,142,0,0,68,74,5 ème
MARNE,REIMS,0511531M,100,95,0,5,53,47,5 ème
MARNE,SAINTE-MENEHOULD,0511191T,116,103,8,5,54,62,5 ème
MARNE,VITRY-LE-FRANCOIS,0511476C,113,109,0,4,62,51,5 ème
BAS-RHIN,BARR,0672133E,108,108,0,0,58,50,5 ème
BAS-RHIN,BRUMATH,0670009W,154,150,0,4,83,71,5 ème
BAS-RHIN,DETTWILLER,0672197Z,58,58,0,0,27,31,5 ème
BAS-RHIN,ECKBOLSHEIM,0670016D,116,116,0,0,56,60,5 ème
BAS-RHIN,LINGOLSHEIM,0672765S,172,170,0,2,85,87,5 ème
BAS-RHIN,MARCKOLSHEIM,0671600A,134,132,0,2,61,73,5 ème
BAS-RHIN,MUNDOLSHEIM,0672013Z,135,119,12,4,68,67,5 ème
BAS-RHIN,OBERNAI,0672078V,141,123,18,0,80,61,5 ème
BAS-RHIN,SARRE-UNION,0672614C,0,0,0,0,0,0,5 ème
BAS-RHIN,SAVERNE,0670058Z,0,0,0,0,0,0,5 ème
BAS-RHIN,SCHILTIGHEIM,0670065G,106,106,0,0,53,53,5 ème
BAS-RHIN,SELESTAT,0671696E,0,0,0,0,0,0,5 ème
BAS-RHIN,SELTZ,0671597X,140,119,16,5,63,77,5 ème
BAS-RHIN,STRASBOURG,0670105A,137,128,8,1,70,67,5 ème
BAS-RHIN,STRASBOURG,0671608J,294,294,0,0,148,146,5 ème
BAS-RHIN,STRASBOURG,0671691Z,159,130,24,5,76,83,5 ème
BAS-RHIN,STRASBOURG,0672303P,90,90,0,0,54,36,5 ème
BAS-RHIN,WISSEMBOURG,0670114K,0,0,0,0,0,0,5 ème
HAUT-RHIN,CERNAY,0681810Y,0,0,0,0,0,0,5 ème
HAUT-RHIN,COLMAR,0680132Z,115,112,0,3,54,61,5 ème
HAUT-RHIN,DANNEMARIE,0680012U,122,119,0,3,54,68,5 ème
HAUT-RHIN,FESSENHEIM,0681965S,89,89,0,0,42,47,5 ème
HAUT-RHIN,GUEBWILLER,0680016Y,0,0,0,0,0,0,5 ème
HAUT-RHIN,ILLFURTH,0681932F,108,108,0,0,51,57,5 ème
HAUT-RHIN,MASEVAUX-NIEDERBRUCK,0680027K,0,0,0,0,0,0,5 ème
HAUT-RHIN,MULHOUSE,0681661L,166,166,0,0,81,85,5 ème
HAUT-RHIN,OTTMARSHEIM,0680056S,85,85,0,0,37,48,5 ème
HAUT-RHIN,RIBEAUVILLE,0680137E,40,40,0,0,15,25,5 ème
HAUT-RHIN,SAINT-LOUIS,0680065B,119,116,0,3,51,68,5 ème
HAUT-RHIN,ZILLISHEIM,0681663N,192,192,0,0,90,102,5 ème
GUADELOUPE,BOUILLANTE,9710026B,75,60,13,2,27,48,5 ème
GUADELOUPE,CAPESTERRE-BELLE-EAU,9711231L,88,83,0,5,47,41,5 ème
GUADELOUPE,GOYAVE,9710644Y,74,71,0,3,36,38,5 ème
GUADELOUPE,LA DESIRADE,9710033J,14,14,0,0,5,9,5 ème
GUADELOUPE,LE MOULE,9710064T,106,106,0,0,55,51,5 ème
GUADELOUPE,LE MOULE,9711218X,164,164,0,0,70,94,5 ème
GUADELOUPE,LES ABYMES,9710405N,131,110,17,4,57,74,5 ème
GUADELOUPE,LES ABYMES,9710710V,184,163,14,7,88,96,5 ème
GUADELOUPE,PORT-LOUIS,9710584H,63,63,0,0,35,28,5 ème
GUADELOUPE,SAINT-MARTIN,9711087E,115,96,13,6,52,63,5 ème
GUYANE,APATOU,9730337D,151,140,11,0,79,72,5 ème
GUYANE,CAYENNE,9730130D,146,142,0,4,76,70,5 ème
GUYANE,KOUROU,9730306V,96,91,0,5,54,42,5 ème
GUYANE,MACOURIA,9730374U,228,187,31,10,98,130,5 ème
GUYANE,MARIPASOULA,9730193X,157,146,11,0,74,83,5 ème
GUYANE,MATOURY,9730182K,210,203,0,7,115,95,5 ème
GUYANE,MATOURY,9730218Z,172,166,0,6,94,78,5 ème
GUYANE,SAINT-LAURENT-DU-MARONI,9730248G,235,234,0,1,123,112,5 ème
AISNE,CHARLY-SUR-MARNE,0020011B,186,180,0,6,98,88,5 ème
AISNE,CHAUNY,0020015F,100,100,0,0,47,53,5 ème
AISNE,CONDE-EN-BRIE,0020016G,81,81,0,0,43,38,5 ème
AISNE,COUCY-LE-CHATEAU-AUFFRIQUE,0020018J,81,79,0,2,44,37,5 ème
AISNE,LA FERE,0021518P,113,107,0,6,51,62,5 ème
AISNE,LAON,0020090M,157,141,16,0,72,85,5 ème
AISNE,MONTCORNET,0021489H,48,48,0,0,28,20,5 ème
AISNE,ROZOY-SUR-SERRE,0020043L,36,36,0,0,16,20,5 ème
AISNE,SAINT-QUENTIN,0020054Y,91,86,0,5,49,42,5 ème
AISNE,SAINT-QUENTIN,0021823W,89,83,0,6,43,46,5 ème
AISNE,TERGNIER,0022113L,19,13,0,6,11,8,5 ème
AISNE,VAILLY-SUR-AISNE,0020065K,65,65,0,0,39,26,5 ème
AISNE,VERMAND,0020066L,99,99,0,0,58,41,5 ème
AISNE,VIC-SUR-AISNE,0021722L,101,101,0,0,49,52,5 ème
OISE,BEAUVAIS,0600003C,0,0,0,0,0,0,5 ème
OISE,BRETEUIL,0601406C,137,131,0,6,75,62,5 ème
OISE,COMPIEGNE,0600016S,0,0,0,0,0,0,5 ème
OISE,COMPIEGNE,0600018U,135,135,0,0,71,64,5 ème
OISE,COMPIEGNE,0601142R,265,264,0,1,118,147,5 ème
OISE,COMPIEGNE,0601501F,71,71,0,0,35,36,5 ème
OISE,CREPY-EN-VALOIS,0601833S,135,131,0,4,69,66,5 ème
OISE,FROISSY,0601176C,105,102,0,3,48,57,5 ème
OISE,GRANDVILLIERS,0601897L,0,0,0,0,0,0,5 ème
OISE,LACROIX-SAINT-OUEN,0601937E,150,147,0,3,63,87,5 ème
OISE,LIANCOURT,0600032J,157,152,0,5,69,88,5 ème
OISE,MARSEILLE-EN-BEAUVAISIS,0601365H,115,115,0,0,55,60,5 ème
OISE,MERU,0601157G,128,128,0,0,66,62,5 ème
OISE,MERU,0601470X,0,0,0,0,0,0,5 ème
OISE,MONTATAIRE,0601870G,0,0,0,0,0,0,5 ème
OISE,NEUILLY-EN-THELLE,0601847G,238,222,16,0,115,123,5 ème
OISE,NOGENT-SUR-OISE,0601846F,54,54,0,0,23,31,5 ème
OISE,PONT-SAINTE-MAXENCE,0601896K,0,0,0,0,0,0,5 ème
OISE,RESSONS-SUR-MATZ,0600045Y,130,130,0,0,66,64,5 ème
SOMME,AILLY-SUR-SOMME,0801325F,120,118,0,2,68,52,5 ème
SOMME,AMIENS,0801210F,110,108,0,2,61,49,5 ème
SOMME,AMIENS,0801264P,125,105,14,6,58,67,5 ème
SOMME,AMIENS,0801437C,217,210,0,7,114,103,5 ème
SOMME,AMIENS,0801616X,87,63,16,8,41,46,5 ème
SOMME,BERNAVILLE,0800022P,72,72,0,0,36,36,5 ème
SOMME,DOMART-EN-PONTHIEU,0801485E,91,76,8,7,35,56,5 ème
SOMME,DOULLENS,0801213J,60,60,0,0,28,32,5 ème
SOMME,FEUQUIERES-EN-VIMEU,0801371F,114,97,13,4,54,60,5 ème
SOMME,FRIVILLE-ESCARBOTIN,0801864S,0,0,0,0,0,0,5 ème
SOMME,LONGUEAU,0800038G,119,114,0,5,62,57,5 ème
SOMME,MONTDIDIER,0800041K,130,112,12,6,73,57,5 ème
SOMME,MOREUIL,0801439E,132,126,0,6,67,65,5 ème
SOMME,PERONNE,0801537L,172,148,17,7,82,90,5 ème
SOMME,RIVERY,0801373H,184,166,15,3,87,97,5 ème
SOMME,ROYE,0801227Z,91,91,0,0,37,54,5 ème
SOMME,RUE,0801228A,35,33,0,2,20,15,5 ème
SOMME,SAINT-VALERY-SUR-SOMME,0801490K,89,87,0,2,42,47,5 ème
SOMME,VILLERS-BRETONNEUX,0800057C,121,119,0,2,59,62,5 ème
NORD,BAILLEUL,0592930P,169,169,0,0,93,76,5 ème
NORD,BOUCHAIN,0593672W,182,172,10,0,87,95,5 ème
NORD,BOURBOURG,0594640Y,88,80,8,0,45,43,5 ème
NORD,BRAY-DUNES,0590030M,111,101,8,2,58,53,5 ème
NORD,CAMBRAI,0592611T,0,0,0,0,0,0,5 ème
NORD,CAMBRAI,0595174D,138,138,0,0,70,68,5 ème
NORD,CASSEL,0594872A,141,139,0,2,66,75,5 ème
NORD,COMINES,0593244F,105,95,8,2,53,52,5 ème
NORD,COUSOLRE,0590055P,30,30,0,0,13,17,5 ème
NORD,CROCHTE,0595595L,87,75,12,0,44,43,5 ème
NORD,DENAIN,0590062X,135,125,7,3,61,74,5 ème
NORD,DENAIN,0594299C,99,99,0,0,47,52,5 ème
NORD,DENAIN,0594300D,83,69,9,5,35,48,5 ème
NORD,DOUAI,0592733A,94,77,12,5,39,55,5 ème
NORD,DOUAI,0593071T,0,0,0,0,0,0,5 ème
NORD,DUNKERQUE,0590179Z,91,88,0,3,49,42,5 ème
NORD,DUNKERQUE,0592713D,112,112,0,0,60,52,5 ème
NORD,DUNKERQUE,0595389M,108,108,0,0,46,62,5 ème
NORD,DUNKERQUE,0595918M,0,0,0,0,0,0,5 ème
NORD,ESCAUDAIN,0592751V,122,122,0,0,60,62,5 ème
NORD,FEIGNIES,0594168K,75,74,0,1,39,36,5 ème
NORD,GONDECOURT,0595166V,133,133,0,0,59,74,5 ème
NORD,GRANDE-SYNTHE,0590088A,83,83,0,0,44,39,5 ème
NORD,GRAVELINES,0590090C,132,125,0,7,75,57,5 ème
NORD,HAUBOURDIN,0596059R,183,167,11,5,105,78,5 ème
NORD,HAZEBROUCK,0590102R,0,0,0,0,0,0,5 ème
NORD,HOUPLINES,0594638W,149,134,12,3,66,83,5 ème
NORD,LAMBERSART,0593226L,94,91,0,3,48,46,5 ème
NORD,LAMBERSART,0595393S,157,153,0,4,88,69,5 ème
NORD,LILLE,0592890W,105,105,0,0,46,59,5 ème
NORD,LILLE,0593168Y,181,181,0,0,82,99,5 ème
NORD,LILLE,0595286A,214,214,0,0,102,112,5 ème
NORD,LILLE,0595394T,59,59,0,0,19,40,5 ème
NORD,LILLE,0595397W,191,191,0,0,92,99,5 ème
NORD,LILLE,0595483P,11,0,11,0,6,5,5 ème
NORD,LILLE,0596833G,114,110,0,4,55,59,5 ème
NORD,LOUVROIL,0593034C,0,0,0,0,0,0,5 ème
NORD,MARCQ-EN-BAROEUL,0595993U,72,72,0,0,38,34,5 ème
NORD,MARLY,0593674Y,149,137,9,3,70,79,5 ème
NORD,MARQUETTE-LEZ-LILLE,0593474F,156,156,0,0,71,85,5 ème
NORD,MAUBEUGE,0590150T,117,112,0,5,67,50,5 ème
NORD,MERVILLE,0594294X,85,75,7,3,43,42,5 ème
NORD,NEUVILLE-EN-FERRAIN,0594537L,74,71,0,3,41,33,5 ème
NORD,NIEPPE,0594505B,87,87,0,0,40,47,5 ème
NORD,PERENCHIES,0592901H,81,81,0,0,42,39,5 ème
NORD,PETITE-FORET,0590007M,133,133,0,0,67,66,5 ème
NORD,PROVIN,0595758N,118,114,0,4,53,65,5 ème
NORD,RONCHIN,0593237Y,131,116,10,5,58,73,5 ème
NORD,ROUBAIX,0590183D,93,89,0,4,49,44,5 ème
NORD,ROUBAIX,0592973L,0,0,0,0,0,0,5 ème
NORD,ROUBAIX,0594389A,124,110,14,0,53,71,5 ème
NORD,ROUBAIX,0595168X,127,127,0,0,68,59,5 ème
NORD,SAINS-DU-NORD,0594538M,57,52,0,5,23,34,5 ème
NORD,SECLIN,0593145Y,200,198,0,2,95,105,5 ème
NORD,SOLESMES,0595401A,137,137,0,0,66,71,5 ème
NORD,SOMAIN,0590248Z,153,149,0,4,82,71,5 ème
NORD,SOMAIN,0594405T,160,140,16,4,70,90,5 ème
NORD,STEENVOORDE,0593147A,52,52,0,0,27,25,5 ème
NORD,STEENVOORDE,0593992U,131,131,0,0,57,74,5 ème
NORD,TOURCOING,0594394F,141,129,9,3,72,69,5 ème
NORD,VALENCIENNES,0590270Y,0,0,0,0,0,0,5 ème
NORD,VILLERS-OUTREAUX,0593157L,58,58,0,0,25,33,5 ème
NORD,WALLERS,0593678C,137,137,0,0,69,68,5 ème
NORD,WASQUEHAL,0593241C,114,114,0,0,73,41,5 ème
NORD,WATTEN,0594650J,118,118,0,0,61,57,5 ème
NORD,WATTIGNIES,0594524X,74,67,7,0,39,35,5 ème
PAS-DE-CALAIS,ANNEZIN,0622797D,163,163,0,0,93,70,5 ème
PAS-DE-CALAIS,ARRAS,0622083C,134,134,0,0,67,67,5 ème
PAS-DE-CALAIS,ARRAS,0622864B,107,107,0,0,54,53,5 ème
PAS-DE-CALAIS,AUCHEL,0620021L,113,94,16,3,45,68,5 ème
PAS-DE-CALAIS,BAPAUME,0620030W,0,0,0,0,0,0,5 ème
PAS-DE-CALAIS,BAPAUME,0620031X,169,165,0,4,79,90,5 ème
PAS-DE-CALAIS,BAPAUME,0622104A,89,89,0,0,39,50,5 ème
PAS-DE-CALAIS,BARLIN,0622268D,146,134,12,0,82,64,5 ème
PAS-DE-CALAIS,BEAURAINVILLE,0622435K,129,129,0,0,72,57,5 ème
PAS-DE-CALAIS,BERCK,0620036C,174,158,12,4,88,86,5 ème
PAS-DE-CALAIS,BETHUNE,0622425Z,150,146,0,4,74,76,5 ème
PAS-DE-CALAIS,BETHUNE,0623569T,164,161,0,3,80,84,5 ème
PAS-DE-CALAIS,BIACHE-SAINT-VAAST,0620047P,167,167,0,0,84,83,5 ème
PAS-DE-CALAIS,BOULOGNE-SUR-MER,0620051U,103,88,11,4,56,47,5 ème
PAS-DE-CALAIS,BOULOGNE-SUR-MER,0620055Y,80,67,13,0,42,38,5 ème
PAS-DE-CALAIS,BOURLON,0622132F,64,64,0,0,34,30,5 ème
PAS-DE-CALAIS,BRUAY-LA-BUISSIERE,0622428C,126,108,16,2,60,66,5 ème
PAS-DE-CALAIS,BULLY-LES-MINES,0620197C,167,164,0,3,88,79,5 ème
PAS-DE-CALAIS,CALAIS,0623570U,161,161,0,0,75,86,5 ème
PAS-DE-CALAIS,COURRIERES,0622264Z,132,110,17,5,67,65,5 ème
PAS-DE-CALAIS,DAINVILLE,0620014D,170,164,5,1,72,98,5 ème
PAS-DE-CALAIS,DOURGES,0623322Z,150,150,0,0,64,86,5 ème
PAS-DE-CALAIS,ETAPLES,0622572J,135,119,16,0,63,72,5 ème
PAS-DE-CALAIS,HENIN-BEAUMONT,0622581U,103,103,0,0,46,57,5 ème
PAS-DE-CALAIS,HOUDAIN,0622871J,151,136,12,3,73,78,5 ème
PAS-DE-CALAIS,LEFOREST,0622085E,153,153,0,0,77,76,5 ème
PAS-DE-CALAIS,LIEVIN,0620119T,165,149,16,0,81,84,5 ème
PAS-DE-CALAIS,LILLERS,0622799F,128,109,16,3,63,65,5 ème
PAS-DE-CALAIS,LONGUENESSE,0622575M,110,106,0,4,39,71,5 ème
PAS-DE-CALAIS,MARQUION,0620130E,134,119,13,2,57,77,5 ème
PAS-DE-CALAIS,NOEUX-LES-MINES,0622269E,156,135,17,4,84,72,5 ème
PAS-DE-CALAIS,OIGNIES,0623018U,112,100,12,0,48,64,5 ème
PAS-DE-CALAIS,SAINT-ETIENNE-AU-MONT,0623115Z,138,130,4,4,73,65,5 ème
PAS-DE-CALAIS,SAINT-MARTIN-BOULOGNE,0622434J,120,116,0,4,67,53,5 ème
PAS-DE-CALAIS,SAINT-OMER,0623574Y,88,88,0,0,53,35,5 ème
PAS-DE-CALAIS,SAINT-POL-SUR-TERNOISE,0620167V,0,0,0,0,0,0,5 ème
PAS-DE-CALAIS,SALLAUMINES,0620170Y,97,85,12,0,39,58,5 ème
PAS-DE-CALAIS,VENDIN-LE-VIEIL,0622792Y,147,144,0,3,70,77,5 ème
SEINE-ET-MARNE,BAILLY-ROMAINVILLIERS,0772548B,122,122,0,0,55,67,5 ème
SEINE-ET-MARNE,BRIE-COMTE-ROBERT,0771225N,49,49,0,0,23,26,5 ème
SEINE-ET-MARNE,BROU-SUR-CHANTEREINE,0770005M,80,76,0,4,38,42,5 ème
SEINE-ET-MARNE,CHAMPS-SUR-MARNE,0772090D,104,87,12,5,55,49,5 ème
SEINE-ET-MARNE,CHELLES,0772923J,0,0,0,0,0,0,5 ème
SEINE-ET-MARNE,CLAYE-SOUILLY,0770014X,124,124,0,0,66,58,5 ème
SEINE-ET-MARNE,CLAYE-SOUILLY,0771911J,155,152,0,3,66,89,5 ème
SEINE-ET-MARNE,CLAYE-SOUILLY,0771995A,0,0,0,0,0,0,5 ème
SEINE-ET-MARNE,COMBS-LA-VILLE,0771997C,0,0,0,0,0,0,5 ème
SEINE-ET-MARNE,CONGIS-SUR-THEROUANNE,0771658J,0,0,0,0,0,0,5 ème
SEINE-ET-MARNE,COULOMMIERS,0771760V,122,117,0,5,61,61,5 ème
SEINE-ET-MARNE,DAMMARIE-LES-LYS,0771027Y,0,0,0,0,0,0,5 ème
SEINE-ET-MARNE,DAMMARIE-LES-LYS,0771476L,148,148,0,0,71,77,5 ème
SEINE-ET-MARNE,DAMMARTIN-EN-GOELE,0772190M,182,181,0,1,91,91,5 ème
SEINE-ET-MARNE,DONNEMARIE-DONTILLY,0770020D,121,116,0,5,59,62,5 ème
SEINE-ET-MARNE,FONTAINEBLEAU,0770928R,223,223,0,0,115,108,5 ème
SEINE-ET-MARNE,FONTENAY-TRESIGNY,0772227C,128,128,0,0,61,67,5 ème
SEINE-ET-MARNE,LAGNY-SUR-MARNE,0770027L,143,140,0,3,73,70,5 ème
SEINE-ET-MARNE,LIZY-SUR-OURCQ,0771362M,103,103,0,0,40,63,5 ème
SEINE-ET-MARNE,MEAUX,0771172F,131,110,16,5,55,76,5 ème
SEINE-ET-MARNE,MEAUX,0771921V,337,337,0,0,173,164,5 ème
SEINE-ET-MARNE,MELUN,0770033T,116,116,0,0,59,57,5 ème
SEINE-ET-MARNE,MOISSY-CRAMAYEL,0771618R,106,106,0,0,55,51,5 ème
SEINE-ET-MARNE,MONTEVRAIN,0772819W,172,167,0,5,99,73,5 ème
SEINE-ET-MARNE,NANDY,0772126T,112,109,0,3,49,63,5 ème
SEINE-ET-MARNE,NOISIEL,0771841H,113,109,0,4,51,62,5 ème
SEINE-ET-MARNE,OZOIR-LA-FERRIERE,0771217E,253,253,0,0,111,142,5 ème
SEINE-ET-MARNE,PONTAULT-COMBAULT,0771175J,220,215,0,5,137,83,5 ème
SEINE-ET-MARNE,REBAIS,0771770F,116,112,0,4,53,63,5 ème
SEINE-ET-MARNE,ROZAY-EN-BRIE,0771514C,157,157,0,0,76,81,5 ème
SEINE-ET-MARNE,SAINT-PIERRE-LES-NEMOURS,0771218F,111,111,0,0,55,56,5 ème
SEINE-ET-MARNE,SOUPPES-SUR-LOING,0770048J,66,66,0,0,27,39,5 ème
SEINE-ET-MARNE,TORCY,0771991W,123,119,0,4,64,59,5 ème
SEINE-ET-MARNE,TOURNAN-EN-BRIE,0772342C,0,0,0,0,0,0,5 ème
SEINE-ET-MARNE,VARENNES-SUR-SEINE,0770945J,0,0,0,0,0,0,5 ème
SEINE-ET-MARNE,VERT-SAINT-DENIS,0771365R,223,220,0,3,110,113,5 ème
SEINE-ET-MARNE,VILLENEUVE-LE-COMTE,0772650M,11,11,0,0,7,4,5 ème
SEINE-ET-MARNE,VILLEPARISIS,0772868Z,133,133,0,0,70,63,5 ème
SEINE-SAINT-DENIS,AUBERVILLIERS,0931024H,0,0,0,0,0,0,5 ème
SEINE-SAINT-DENIS,AUBERVILLIERS,0931185H,171,171,0,0,87,84,5 ème
SEINE-SAINT-DENIS,AUBERVILLIERS,0931709C,90,90,0,0,42,48,5 ème
SEINE-SAINT-DENIS,AUBERVILLIERS,0932694Y,113,111,0,2,64,49,5 ème
SEINE-SAINT-DENIS,AUBERVILLIERS,0932726H,113,112,0,1,43,70,5 ème
SEINE-SAINT-DENIS,AULNAY-SOUS-BOIS,0930859D,201,201,0,0,103,98,5 ème
SEINE-SAINT-DENIS,AULNAY-SOUS-BOIS,0930891N,146,128,15,3,70,76,5 ème
SEINE-SAINT-DENIS,AULNAY-SOUS-BOIS,0931843Y,206,206,0,0,109,97,5 ème
SEINE-SAINT-DENIS,AULNAY-SOUS-BOIS,0932578X,176,176,0,0,81,95,5 ème
SEINE-SAINT-DENIS,BOBIGNY,0931196V,131,131,0,0,61,70,5 ème
SEINE-SAINT-DENIS,BONDY,0930906E,117,117,0,0,66,51,5 ème
SEINE-SAINT-DENIS,DRANCY,0931200Z,180,163,17,0,79,101,5 ème
SEINE-SAINT-DENIS,DUGNY,0931573E,0,0,0,0,0,0,5 ème
SEINE-SAINT-DENIS,EPINAY-SUR-SEINE,0930893R,194,176,16,2,91,103,5 ème
SEINE-SAINT-DENIS,LA COURNEUVE,0931429Y,166,163,0,3,65,101,5 ème
SEINE-SAINT-DENIS,LE BLANC-MESNIL,0930611J,114,114,0,0,54,60,5 ème
SEINE-SAINT-DENIS,LE BLANC-MESNIL,0930831Y,0,0,0,0,0,0,5 ème
SEINE-SAINT-DENIS,LE BLANC-MESNIL,0930884F,205,202,0,3,97,108,5 ème
SEINE-SAINT-DENIS,L'ILE-SAINT-DENIS,0931765N,82,82,0,0,31,51,5 ème
SEINE-SAINT-DENIS,LIVRY-GARGAN,0930620U,202,186,16,0,87,115,5 ème
SEINE-SAINT-DENIS,MONTFERMEIL,0931707A,175,159,16,0,87,88,5 ème
SEINE-SAINT-DENIS,MONTREUIL,0931151W,117,101,16,0,55,62,5 ème
SEINE-SAINT-DENIS,MONTREUIL,0931448U,141,130,0,11,69,72,5 ème
SEINE-SAINT-DENIS,MONTREUIL,0931712F,114,114,0,0,55,59,5 ème
SEINE-SAINT-DENIS,MONTREUIL,0932696A,130,126,0,4,67,63,5 ème
SEINE-SAINT-DENIS,NEUILLY-SUR-MARNE,0931485J,155,153,0,2,73,82,5 ème
SEINE-SAINT-DENIS,NOISY-LE-GRAND,0931214P,184,165,16,3,91,93,5 ème
SEINE-SAINT-DENIS,NOISY-LE-SEC,0932725G,155,155,0,0,68,87,5 ème
SEINE-SAINT-DENIS,ROMAINVILLE,0931381W,190,174,16,0,97,93,5 ème
SEINE-SAINT-DENIS,ROSNY-SOUS-BOIS,0930586G,146,142,0,4,78,68,5 ème
SEINE-SAINT-DENIS,SAINT-DENIS,0931490P,95,92,0,3,43,52,5 ème
SEINE-SAINT-DENIS,SAINT-OUEN,0931144N,91,88,0,3,41,50,5 ème
SEINE-SAINT-DENIS,SEVRAN,0930897V,170,164,0,6,81,89,5 ème
SEINE-SAINT-DENIS,STAINS,0930920V,121,121,0,0,56,65,5 ème
SEINE-SAINT-DENIS,STAINS,0931147S,144,137,0,7,78,66,5 ème
SEINE-SAINT-DENIS,TREMBLAY-EN-FRANCE,0931497X,140,128,10,2,75,65,5 ème
SEINE-SAINT-DENIS,VILLEMOMBLE,0930043S,133,133,0,0,69,64,5 ème
SEINE-SAINT-DENIS,VILLEMOMBLE,0931846B,230,230,0,0,132,98,5 ème
SEINE-SAINT-DENIS,VILLEPINTE,0932260B,0,0,0,0,0,0,5 ème
SEINE-SAINT-DENIS,VILLETANEUSE,0931206F,132,129,0,3,64,68,5 ème
VAL-DE-MARNE,ABLON-SUR-SEINE,0941709X,98,98,0,0,50,48,5 ème
VAL-DE-MARNE,ALFORTVILLE,0941020Y,123,121,0,2,66,57,5 ème
VAL-DE-MARNE,BRY-SUR-MARNE,0940887D,123,123,0,0,66,57,5 ème
VAL-DE-MARNE,BRY-SUR-MARNE,0941014S,173,173,0,0,83,90,5 ème
VAL-DE-MARNE,CACHAN,0940806R,84,84,0,0,38,46,5 ème
VAL-DE-MARNE,CHAMPIGNY-SUR-MARNE,0940786U,113,113,0,0,51,62,5 ème
VAL-DE-MARNE,CHOISY-LE-ROI,0941040V,111,111,0,0,46,65,5 ème
VAL-DE-MARNE,FONTENAY-SOUS-BOIS,0941298A,0,0,0,0,0,0,5 ème
VAL-DE-MARNE,FRESNES,0940094S,81,81,0,0,34,47,5 ème
VAL-DE-MARNE,FRESNES,0940582X,120,120,0,0,59,61,5 ème
VAL-DE-MARNE,IVRY-SUR-SEINE,0941972H,0,0,0,0,0,0,5 ème
VAL-DE-MARNE,L'HAY-LES-ROSES,0940551N,158,144,14,0,75,83,5 ème
VAL-DE-MARNE,MAISONS-ALFORT,0941023B,65,65,0,0,29,36,5 ème
VAL-DE-MARNE,MAISONS-ALFORT,0941712A,179,179,0,0,88,91,5 ème
VAL-DE-MARNE,NOGENT-SUR-MARNE,0940137N,0,0,0,0,0,0,5 ème
VAL-DE-MARNE,NOGENT-SUR-MARNE,0940810V,77,77,0,0,32,45,5 ème
VAL-DE-MARNE,NOGENT-SUR-MARNE,0941091A,134,132,0,2,68,66,5 ème
VAL-DE-MARNE,NOGENT-SUR-MARNE,0941713B,156,156,0,0,80,76,5 ème
VAL-DE-MARNE,SAINT-MAUR-DES-FOSSES,0941093C,190,190,0,0,93,97,5 ème
VAL-DE-MARNE,SAINT-MAUR-DES-FOSSES,0941220R,190,170,14,6,91,99,5 ème
VAL-DE-MARNE,SANTENY,0941782B,118,113,0,5,58,60,5 ème
VAL-DE-MARNE,THIAIS,0940853S,0,0,0,0,0,0,5 ème
VAL-DE-MARNE,THIAIS,0941233E,111,111,0,0,46,65,5 ème
VAL-DE-MARNE,VALENTON,0942482M,162,162,0,0,77,85,5 ème
VAL-DE-MARNE,VILLEJUIF,0941037S,137,137,0,0,66,71,5 ème
VAL-DE-MARNE,VINCENNES,0941598B,115,115,0,0,55,60,5 ème
PARIS,PARIS,0750584C,92,92,0,0,51,41,5 ème
PARIS,PARIS,0750609E,134,134,0,0,72,62,5 ème
PARIS,PARIS,0752189X,110,110,0,0,63,47,5 ème
PARIS,PARIS,0752542F,112,109,0,3,58,54,5 ème
PARIS,PARIS,0753936W,118,104,14,0,52,66,5 ème
PARIS,PARIS,0750553U,0,0,0,0,0,0,5 ème
PARIS,PARIS,0752694W,108,108,0,0,50,58,5 ème
PARIS,PARIS,0752906B,160,160,0,0,89,71,5 ème
PARIS,PARIS,0752799K,0,0,0,0,0,0,5 ème
PARIS,PARIS,0752901W,100,99,0,1,59,41,5 ème
PARIS,PARIS,0752935H,199,199,0,0,96,103,5 ème
PARIS,PARIS,0753256G,0,0,0,0,0,0,5 ème
PARIS,PARIS,0750588G,0,0,0,0,0,0,5 ème
PARIS,PARIS,0752547L,77,74,0,3,37,40,5 ème
PARIS,PARIS,0752550P,189,189,0,0,94,95,5 ème
PARIS,PARIS,0752926Y,157,157,0,0,57,100,5 ème
PARIS,PARIS,0752553T,212,212,0,0,104,108,5 ème
PARIS,PARIS,0752927Z,183,183,0,0,84,99,5 ème
PARIS,PARIS,0750546L,89,89,0,0,51,38,5 ème
PARIS,PARIS,0752252R,11,0,11,0,2,9,5 ème
PARIS,PARIS,0753206C,41,37,0,4,41,0,5 ème
PARIS,PARIS,0753381T,195,195,0,0,97,98,5 ème
PARIS,PARIS,0755433Y,90,74,14,2,43,47,5 ème
PARIS,PARIS,0752695X,107,107,0,0,50,57,5 ème
PARIS,PARIS,0753369E,100,100,0,0,80,20,5 ème
PARIS,PARIS,0755747P,98,95,0,3,55,43,5 ème
PARIS,PARIS,0751703U,80,72,0,8,38,42,5 ème
PARIS,PARIS,0750478M,101,91,10,0,39,62,5 ème
PARIS,PARIS,0750508V,0,0,0,0,0,0,5 ème
PARIS,PARIS,0750591K,130,128,0,2,62,68,5 ème
PARIS,PARIS,0750808W,0,0,0,0,0,0,5 ème
PARIS,PARIS,0750828T,0,0,0,0,0,0,5 ème
PARIS,PARIS,0752557X,84,84,0,0,39,45,5 ème
PARIS,PARIS,0752696Y,135,130,0,5,71,64,5 ème
PARIS,PARIS,0754007Y,127,127,0,0,51,76,5 ème
PARIS,PARIS,0754355B,106,97,8,1,49,57,5 ème
PARIS,PARIS,0751790N,149,146,0,3,76,73,5 ème
PARIS,PARIS,0752187V,75,74,0,1,37,38,5 ème
PARIS,PARIS,0752874S,169,169,0,0,90,79,5 ème
PARIS,PARIS,0754025T,0,0,0,0,0,0,5 ème
PARIS,PARIS,0752534X,101,98,0,3,59,42,5 ème
ESSONNE,ATHIS-MONS,0910025H,159,155,0,4,73,86,5 ème
ESSONNE,BRETIGNY-SUR-ORGE,0911490A,134,118,16,0,51,83,5 ème
ESSONNE,BRUNOY,0910009R,191,172,16,3,95,96,5 ème
ESSONNE,BURES-SUR-YVETTE,0910967G,137,137,0,0,68,69,5 ème
ESSONNE,CORBEIL-ESSONNES,0910829G,249,244,0,5,133,116,5 ème
ESSONNE,CORBEIL-ESSONNES,0911024U,139,137,0,2,75,64,5 ème
ESSONNE,DRAVEIL,0910016Y,209,209,0,0,102,107,5 ème
ESSONNE,EPINAY-SUR-ORGE,0910017Z,154,154,0,0,89,65,5 ème
ESSONNE,ETRECHY,0911447D,134,131,0,3,68,66,5 ème
ESSONNE,EVRY-COURCOURONNES,0911444A,137,134,0,3,66,71,5 ème
ESSONNE,EVRY-COURCOURONNES,0911865H,160,156,0,4,89,71,5 ème
ESSONNE,GIF-SUR-YVETTE,0911354C,192,190,0,2,104,88,5 ème
ESSONNE,JUVISY-SUR-ORGE,0911028Y,148,148,0,0,77,71,5 ème
ESSONNE,LA NORVILLE,0911152H,206,206,0,0,90,116,5 ème
ESSONNE,LARDY,0912276E,121,117,0,4,61,60,5 ème
ESSONNE,LA VILLE-DU-BOIS,0911751J,256,252,0,4,127,129,5 ème
ESSONNE,LIMOURS,0910028L,235,235,0,0,117,118,5 ème
ESSONNE,MARCOUSSIS,0911032C,140,135,0,5,76,64,5 ème
ESSONNE,MAROLLES-EN-HUREPOIX,0911572P,176,175,0,1,82,94,5 ème
ESSONNE,MONTGERON,0910817U,169,169,0,0,78,91,5 ème
ESSONNE,MONTLHERY,0911345T,254,250,0,4,112,142,5 ème
ESSONNE,MORSANG-SUR-ORGE,0911488Y,135,135,0,0,73,62,5 ème
ESSONNE,ORSAY,0911143Y,144,144,0,0,80,64,5 ème
ESSONNE,PALAISEAU,0911034E,186,184,0,2,101,85,5 ème
ESSONNE,SAINT-GERMAIN-LES-ARPAJON,0911899V,139,137,0,2,62,77,5 ème
ESSONNE,SAVIGNY-SUR-ORGE,0910716J,67,67,0,0,36,31,5 ème
ESSONNE,SAVIGNY-SUR-ORGE,0911252S,261,244,16,1,122,139,5 ème
ESSONNE,SAVIGNY-SUR-ORGE,0912142J,0,0,0,0,0,0,5 ème
ESSONNE,SOISY-SUR-SEINE,0912086Y,127,125,0,2,60,67,5 ème
ESSONNE,VIGNEUX-SUR-SEINE,0911146B,161,145,16,0,79,82,5 ème
ESSONNE,VILLABE,0912257J,141,140,0,1,64,77,5 ème
ESSONNE,VILLEBON-SUR-YVETTE,0911750H,125,125,0,0,59,66,5 ème
HAUTS-DE-SEINE,ASNIERES-SUR-SEINE,0921622N,199,199,0,0,107,92,5 ème
HAUTS-DE-SEINE,BAGNEUX,0921778H,99,99,0,0,53,46,5 ème
HAUTS-DE-SEINE,BOULOGNE-BILLANCOURT,0920905J,216,216,0,0,109,107,5 ème
HAUTS-DE-SEINE,BOULOGNE-BILLANCOURT,0922443F,0,0,0,0,0,0,5 ème
HAUTS-DE-SEINE,CHATENAY-MALABRY,0921181J,152,147,0,5,61,91,5 ème
HAUTS-DE-SEINE,CLAMART,0920068Z,191,191,0,0,93,98,5 ème
HAUTS-DE-SEINE,CLAMART,0920854D,147,147,0,0,71,76,5 ème
HAUTS-DE-SEINE,COLOMBES,0920592U,152,145,0,7,75,77,5 ème
HAUTS-DE-SEINE,COURBEVOIE,0921625S,0,0,0,0,0,0,5 ème
HAUTS-DE-SEINE,GARCHES,0920810F,0,0,0,0,0,0,5 ème
HAUTS-DE-SEINE,GARCHES,0920881H,145,143,0,2,74,71,5 ème
HAUTS-DE-SEINE,GENNEVILLIERS,0921541A,188,173,15,0,88,100,5 ème
HAUTS-DE-SEINE,ISSY-LES-MOULINEAUX,0920877D,129,128,0,1,68,61,5 ème
HAUTS-DE-SEINE,ISSY-LES-MOULINEAUX,0921396T,146,145,0,1,67,79,5 ème
HAUTS-DE-SEINE,ISSY-LES-MOULINEAUX,0922610M,124,123,0,1,62,62,5 ème
HAUTS-DE-SEINE,LA GARENNE-COLOMBES,0921162N,166,166,0,0,81,85,5 ème
HAUTS-DE-SEINE,LEVALLOIS-PERRET,0921007V,254,254,0,0,132,122,5 ème
HAUTS-DE-SEINE,LEVALLOIS-PERRET,0922751R,21,21,0,0,0,21,5 ème
HAUTS-DE-SEINE,MEUDON,0921554P,112,112,0,0,57,55,5 ème
HAUTS-DE-SEINE,MEUDON,0922340U,15,15,0,0,2,13,5 ème
HAUTS-DE-SEINE,MONTROUGE,0920855E,108,100,8,0,54,54,5 ème
HAUTS-DE-SEINE,NANTERRE,0921589C,99,99,0,0,53,46,5 ème
HAUTS-DE-SEINE,NEUILLY-SUR-SEINE,0921781L,147,145,0,2,65,82,5 ème
HAUTS-DE-SEINE,NEUILLY-SUR-SEINE,0921912D,108,108,0,0,108,0,5 ème
HAUTS-DE-SEINE,RUEIL-MALMAISON,0921915G,295,295,0,0,0,295,5 ème
HAUTS-DE-SEINE,SAINT-CLOUD,0920700L,107,105,0,2,47,60,5 ème
HAUTS-DE-SEINE,SAINT-CLOUD,0921020J,40,40,0,0,0,40,5 ème
HAUTS-DE-SEINE,SCEAUX,0921918K,151,151,0,0,84,67,5 ème
HAUTS-DE-SEINE,SEVRES,0921244C,232,232,0,0,118,114,5 ème
HAUTS-DE-SEINE,VANVES,0921240Y,150,144,0,6,63,87,5 ème
HAUTS-DE-SEINE,VANVES,0921783N,147,147,0,0,70,77,5 ème
VAL-D'OISE,ARGENTEUIL,0950884V,111,110,0,1,54,57,5 ème
VAL-D'OISE,ARGENTEUIL,0951094Y,194,182,0,12,102,92,5 ème
VAL-D'OISE,ARGENTEUIL,0951356H,192,189,0,3,102,90,5 ème
VAL-D'OISE,ARNOUVILLE,0951143B,141,139,0,2,79,62,5 ème
VAL-D'OISE,AUVERS-SUR-OISE,0951823R,120,119,0,1,56,64,5 ème
VAL-D'OISE,BEAUCHAMP,0952086B,143,143,0,0,69,74,5 ème
VAL-D'OISE,BEZONS,0950887Y,192,189,0,3,93,99,5 ème
VAL-D'OISE,BEZONS,0952173W,0,0,0,0,0,0,5 ème
VAL-D'OISE,CERGY,0951617S,156,152,0,4,74,82,5 ème
VAL-D'OISE,CERGY,0952282P,34,34,0,0,11,23,5 ème
VAL-D'OISE,COURDIMANCHE,0951724H,158,158,0,0,86,72,5 ème
VAL-D'OISE,DEUIL-LA-BARRE,0950682A,180,178,0,2,93,87,5 ème
VAL-D'OISE,DEUIL-LA-BARRE,0952140K,100,97,0,3,51,49,5 ème
VAL-D'OISE,ECOUEN,0950752B,117,117,0,0,65,52,5 ème
VAL-D'OISE,ENGHIEN-LES-BAINS,0951504U,259,259,0,0,131,128,5 ème
VAL-D'OISE,ERMONT,0950739M,192,180,12,0,93,99,5 ème
VAL-D'OISE,FRANCONVILLE,0950022H,148,146,0,2,73,75,5 ème
VAL-D'OISE,FRANCONVILLE,0951100E,185,165,15,5,92,93,5 ème
VAL-D'OISE,FRANCONVILLE,0952088D,126,120,0,6,51,75,5 ème
VAL-D'OISE,GARGES-LES-GONESSE,0950023J,182,169,11,2,95,87,5 ème
VAL-D'OISE,GARGES-LES-GONESSE,0950711G,139,136,0,3,72,67,5 ème
VAL-D'OISE,GARGES-LES-GONESSE,0951098C,176,159,12,5,88,88,5 ème
VAL-D'OISE,GARGES-LES-GONESSE,0951787B,0,0,0,0,0,0,5 ème
VAL-D'OISE,GONESSE,0951920W,119,117,0,2,61,58,5 ème
VAL-D'OISE,GOUSSAINVILLE,0951050A,148,145,0,3,63,85,5 ème
VAL-D'OISE,GOUSSAINVILLE,0952128X,135,130,0,5,69,66,5 ème
VAL-D'OISE,HERBLAY,0951696C,125,119,0,6,72,53,5 ème
VAL-D'OISE,HERBLAY,0952205F,137,137,0,0,87,50,5 ème
VAL-D'OISE,MARGENCY,0951505V,204,204,0,0,111,93,5 ème
VAL-D'OISE,MERIEL,0951991Y,142,136,0,6,78,64,5 ème
VAL-D'OISE,MONTIGNY-LES-CORMEILLES,0951154N,161,158,0,3,75,86,5 ème
VAL-D'OISE,MONTMAGNY,0951909J,146,143,0,3,63,83,5 ème
VAL-D'OISE,MONTMORENCY,0951799P,119,119,0,0,56,63,5 ème
VAL-D'OISE,PERSAN,0950934Z,196,174,22,0,99,97,5 ème
VAL-D'OISE,PISCOP,0951817J,53,53,0,0,29,24,5 ème
VAL-D'OISE,SAINT-OUEN-L'AUMONE,0951195H,196,177,16,3,95,101,5 ème
VAL-D'OISE,SANNOIS,0950722U,169,167,0,2,86,83,5 ème
VAL-D'OISE,SANNOIS,0952136F,16,16,0,0,2,14,5 ème
VAL-D'OISE,SARCELLES,0950045H,137,120,12,5,66,71,5 ème
VAL-D'OISE,SARCELLES,0950947N,0,0,0,0,0,0,5 ème
VAL-D'OISE,SARCELLES,0951682M,26,26,0,0,26,0,5 ème
VAL-D'OISE,SARCELLES,0951945Y,100,99,0,1,50,50,5 ème
VAL-D'OISE,VAUREAL,0951636M,115,115,0,0,50,65,5 ème
VAL-D'OISE,VILLIERS-LE-BEL,0951916S,70,70,0,0,28,42,5 ème
YVELINES,AUBERGENVILLE,0780506B,212,197,14,1,94,118,5 ème
YVELINES,BONNELLES,0781846H,90,90,0,0,46,44,5 ème
YVELINES,CHAMBOURCY,0781683F,145,145,0,0,67,78,5 ème
YVELINES,CROISSY-SUR-SEINE,0780847X,101,101,0,0,56,45,5 ème
YVELINES,FONTENAY-LE-FLEURY,0780185C,135,117,15,3,64,71,5 ème
YVELINES,GUYANCOURT,0780581H,139,138,0,1,73,66,5 ème
YVELINES,GUYANCOURT,0783378Y,79,77,0,2,54,25,5 ème
YVELINES,HOUILLES,0780269U,209,205,0,4,93,116,5 ème
YVELINES,HOUILLES,0783253M,161,161,0,0,82,79,5 ème
YVELINES,LA CELLE-SAINT-CLOUD,0780036R,153,152,0,1,72,81,5 ème
YVELINES,LE CHESNAY-ROCQUENCOURT,0781586A,264,264,0,0,153,111,5 ème
YVELINES,LES ESSARTS-LE-ROI,0780574A,187,184,0,3,91,96,5 ème
YVELINES,LES MUREAUX,0780572Y,161,145,16,0,70,91,5 ème
YVELINES,LES MUREAUX,0781914G,135,130,0,5,64,71,5 ème
YVELINES,LE VESINET,0781105C,174,174,0,0,74,100,5 ème
YVELINES,LIMAY,0782115A,179,160,16,3,93,86,5 ème
YVELINES,MANTES-LA-JOLIE,0781896M,94,94,0,0,47,47,5 ème
YVELINES,MANTES-LA-JOLIE,0783774D,161,152,9,0,83,78,5 ème
YVELINES,MARLY-LE-ROI,0780119F,230,230,0,0,93,137,5 ème
YVELINES,MAUREPAS,0780419G,162,147,15,0,85,77,5 ème
YVELINES,MEULAN-EN-YVELINES,0780571X,180,162,16,2,96,84,5 ème
YVELINES,MONTIGNY-LE-BRETONNEUX,0781263Z,116,116,0,0,45,71,5 ème
YVELINES,MONTIGNY-LE-BRETONNEUX,0783592F,29,29,0,0,21,8,5 ème
YVELINES,POISSY,0783358B,209,206,0,3,99,110,5 ème
YVELINES,RAMBOUILLET,0780846W,69,69,0,0,34,35,5 ème
YVELINES,RAMBOUILLET,0783338E,182,182,0,0,98,84,5 ème
YVELINES,ROSNY-SUR-SEINE,0781916J,137,134,0,3,73,64,5 ème
YVELINES,SAINT-GERMAIN-EN-LAYE,0781204K,229,229,0,0,120,109,5 ème
YVELINES,SAINT-GERMAIN-EN-LAYE,0781620M,228,226,0,2,126,102,5 ème
YVELINES,SARTROUVILLE,0780577D,103,103,0,0,49,54,5 ème
YVELINES,SARTROUVILLE,0780579F,135,132,0,3,63,72,5 ème
YVELINES,TRAPPES,0781618K,125,123,0,2,68,57,5 ème
YVELINES,VELIZY-VILLACOUBLAY,0780210E,145,138,0,7,67,78,5 ème
YVELINES,VERSAILLES,0781106D,160,160,0,0,85,75,5 ème
YVELINES,VERSAILLES,0781298M,86,82,0,4,36,50,5 ème
YVELINES,VILLEPREUX,0780260J,177,177,0,0,84,93,5 ème
YVELINES,VOISINS-LE-BRETONNEUX,0781789W,115,112,0,3,57,58,5 ème
LA REUNION,LA POSSESSION,9740084Y,195,191,0,4,103,92,5 ème
LA REUNION,SAINT-ANDRE,9740598G,256,220,32,4,122,134,5 ème
LA REUNION,SAINT-BENOIT,9740065C,124,121,0,3,63,61,5 ème
LA REUNION,SAINTE-MARIE,9741649Z,99,99,0,0,59,40,5 ème
LA REUNION,SAINTE-SUZANNE,9740094J,181,145,30,6,81,100,5 ème
LA REUNION,SAINT-JOSEPH,9740577J,262,226,32,4,138,124,5 ème
LA REUNION,SAINT-LEU,9740546A,254,250,0,4,117,137,5 ème
LA REUNION,SAINT-PAUL,9740069G,151,149,0,2,74,77,5 ème
LA REUNION,SAINT-PAUL,9740469S,191,191,0,0,97,94,5 ème
LA REUNION,SAINT-PAUL,9740596E,165,141,16,8,93,72,5 ème
LA REUNION,SAINT-PIERRE,9741346V,174,156,16,2,98,76,5 ème
MARTINIQUE,BASSE-POINTE,9720472F,59,55,4,0,37,22,5 ème
MARTINIQUE,FORT-DE-FRANCE,9720411P,103,99,0,4,44,59,5 ème
MARTINIQUE,FORT-DE-FRANCE,9720708M,93,92,0,1,50,43,5 ème
MARTINIQUE,FORT-DE-FRANCE,9720774J,168,168,0,0,154,14,5 ème
MARTINIQUE,LE DIAMANT,9720035F,62,61,0,1,22,40,5 ème
MARTINIQUE,LE LAMENTIN,9720091S,0,0,0,0,0,0,5 ème
MARTINIQUE,LE LORRAIN,9720445B,63,60,0,3,37,26,5 ème
MARTINIQUE,LES TROIS-ILETS,9720498J,96,96,0,0,42,54,5 ème
MARTINIQUE,LE VAUCLIN,9720031B,75,75,0,0,37,38,5 ème
MARTINIQUE,SCHOELCHER,9720424D,0,0,0,0,0,0,5 ème
MARTINIQUE,SCHOELCHER,9720684L,66,66,0,0,29,37,5 ème
MAYOTTE,BANDRABOUA,9760094Y,306,303,0,3,164,142,5 ème
MAYOTTE,KANI-KELI,9760166B,195,194,0,1,103,92,5 ème
MAYOTTE,KOUNGOU,9760244L,484,461,20,3,252,232,5 ème
MAYOTTE,MAMOUDZOU,9760219J,430,422,0,8,224,206,5 ème
ALLIER,COSNE-D'ALLIER,0030009U,67,64,0,3,31,36,5 ème
ALLIER,CUSSET,0031082K,0,0,0,0,0,0,5 ème
ALLIER,DESERTINES,0030860U,127,110,15,2,67,60,5 ème
ALLIER,GANNAT,0030980Z,43,43,0,0,21,22,5 ème
ALLIER,LURCY-LEVIS,0030021G,52,52,0,0,23,29,5 ème
ALLIER,MONTLUCON,0030119N,50,50,0,0,25,25,5 ème
ALLIER,MOULINS,0030112F,0,0,0,0,0,0,5 ème
ALLIER,NERIS-LES-BAINS,0030042E,66,66,0,0,38,28,5 ème
ALLIER,YZEURE,0030038A,0,0,0,0,0,0,5 ème
CANTAL,AURILLAC,0150613K,4,0,4,0,1,3,5 ème
CANTAL,AURILLAC,0150708N,85,85,0,0,48,37,5 ème
CANTAL,AURILLAC,0150729L,129,107,17,5,59,70,5 ème
CANTAL,AURILLAC,0150760V,0,0,0,0,0,0,5 ème
CANTAL,CHAUDES-AIGUES,0150010E,23,23,0,0,9,14,5 ème
CANTAL,LAROQUEBROU,0150013H,28,28,0,0,13,15,5 ème
CANTAL,MAURS,0150018N,49,45,0,4,21,28,5 ème
CANTAL,SAINT-MAMET-LA-SALVETAT,0150581A,55,55,0,0,29,26,5 ème
HAUTE-LOIRE,ALLEGRE,0430001T,57,57,0,0,29,28,5 ème
HAUTE-LOIRE,AUREC-SUR-LOIRE,0430987P,51,51,0,0,29,22,5 ème
HAUTE-LOIRE,BRIOUDE,0430003V,0,0,0,0,0,0,5 ème
HAUTE-LOIRE,DUNIERES,0430069S,46,46,0,0,24,22,5 ème
HAUTE-LOIRE,LE PUY-EN-VELAY,0430020N,0,0,0,0,0,0,5 ème
HAUTE-LOIRE,LE PUY-EN-VELAY,0430024T,0,0,0,0,0,0,5 ème
HAUTE-LOIRE,LE PUY-EN-VELAY,0430043N,147,138,0,9,76,71,5 ème
HAUTE-LOIRE,SAINT-DIDIER-EN-VELAY,0430084H,88,88,0,0,39,49,5 ème
HAUTE-LOIRE,SAINT-JULIEN-CHAPTEUIL,0430030Z,90,87,0,3,44,46,5 ème
HAUTE-LOIRE,TENCE,0430093T,48,48,0,0,22,26,5 ème
PUY-DE-DOME,AMBERT,0631083K,27,27,0,0,10,17,5 ème
PUY-DE-DOME,AMBERT,0631153L,88,73,12,3,42,46,5 ème
PUY-DE-DOME,AUBIERE,0631451K,237,214,15,8,124,113,5 ème
PUY-DE-DOME,BOURG-LASTIC,0630011V,30,30,0,0,17,13,5 ème
PUY-DE-DOME,CHAMALIERES,0631730N,124,124,0,0,56,68,5 ème
PUY-DE-DOME,CHAMPEIX,0630016A,99,92,0,7,50,49,5 ème
PUY-DE-DOME,CLERMONT-FERRAND,0630022G,0,0,0,0,0,0,5 ème
PUY-DE-DOME,LES ANCIZES-COMPS,0631482U,59,59,0,0,26,33,5 ème
PUY-DE-DOME,MARINGUES,0631097A,32,32,0,0,16,16,5 ème
PUY-DE-DOME,PIONSAT,0630046H,12,12,0,0,6,6,5 ème
PUY-DE-DOME,PONT-DU-CHATEAU,0631101E,85,85,0,0,50,35,5 ème
PUY-DE-DOME,ROCHEFORT-MONTAGNE,0630056U,54,54,0,0,26,28,5 ème
PUY-DE-DOME,SAINT-AMANT-ROCHE-SAVINE,0630057V,0,0,0,0,0,0,5 ème
PUY-DE-DOME,SAINT-GERMAIN-LEMBRON,0630062A,124,119,0,5,60,64,5 ème
PUY-DE-DOME,SAINT-GERVAIS-D'AUVERGNE,0630065D,34,30,0,4,14,20,5 ème
PUY-DE-DOME,THIERS,0630078T,0,0,0,0,0,0,5 ème
PUY-DE-DOME,VIC-LE-COMTE,0630072L,104,103,0,1,49,55,5 ème
ARDECHE,ANNONAY,0070001N,0,0,0,0,0,0,5 ème
ARDECHE,CRUAS,0070010Y,82,82,0,0,43,39,5 ème
ARDECHE,LAMASTRE,0070872K,62,62,0,0,41,21,5 ème
ARDECHE,LARGENTIERE,0070016E,0,0,0,0,0,0,5 ème
ARDECHE,LA VOULTE-SUR-RHONE,0070042H,135,120,15,0,71,64,5 ème
ARDECHE,LE CHEYLARD,0070849K,71,71,0,0,40,31,5 ème
ARDECHE,LE TEIL,0070847H,161,155,0,6,84,77,5 ème
ARDECHE,MONTPEZAT-SOUS-BAUZON,0070018G,50,50,0,0,25,25,5 ème
ARDECHE,SAINT-CIRGUES-EN-MONTAGNE,0070024N,20,20,0,0,8,12,5 ème
ARDECHE,SAINT-SAUVEUR-DE-MONTAGUT,0070025P,57,57,0,0,20,37,5 ème
ARDECHE,TOURNON-SUR-RHONE,0070092M,126,126,0,0,62,64,5 ème
ARDECHE,VALS-LES-BAINS,0070846G,89,88,0,1,42,47,5 ème
ARDECHE,VERNOUX-EN-VIVARAIS,0070890E,67,67,0,0,35,32,5 ème
DROME,BOURG-LES-VALENCE,0260766S,190,169,21,0,103,87,5 ème
DROME,BUIS-LES-BARONNIES,0260002L,51,51,0,0,28,23,5 ème
DROME,CHATEAUNEUF-DE-GALAURE,0261133R,39,39,0,0,39,0,5 ème
DROME,LA CHAPELLE-EN-VERCORS,0260004N,54,54,0,0,22,32,5 ème
DROME,LORIOL-SUR-DROME,0260012X,103,103,0,0,45,58,5 ème
DROME,MONTELIMAR,0261135T,119,119,0,0,69,50,5 ème
DROME,PIERRELATTE,0261090U,95,95,0,0,47,48,5 ème
DROME,ROMANS-SUR-ISERE,0260850H,194,173,16,5,87,107,5 ème
DROME,ROMANS-SUR-ISERE,0260997T,165,143,16,6,76,89,5 ème
DROME,SAINT-PAUL-TROIS-CHATEAUX,0261032F,165,165,0,0,86,79,5 ème
DROME,SAINT-SORLIN-EN-VALLOIRE,0260030S,131,128,0,3,60,71,5 ème
DROME,VALENCE,0261095Z,107,103,0,4,56,51,5 ème
DROME,VALENCE,0261137V,168,168,0,0,84,84,5 ème
HAUTE SAVOIE,ALBY-SUR-CHERAN,0740002A,152,152,0,0,81,71,5 ème
HAUTE SAVOIE,ANNECY,0740071A,172,144,23,5,81,91,5 ème
HAUTE SAVOIE,ANNECY,0740105M,178,178,0,0,90,88,5 ème
HAUTE SAVOIE,CLUSES,0740112V,171,171,0,0,81,90,5 ème
HAUTE SAVOIE,CLUSES,0740911N,243,237,0,6,117,126,5 ème
HAUTE SAVOIE,COLLONGES-SOUS-SALEVE,0740144E,0,0,0,0,0,0,5 ème
HAUTE SAVOIE,DOUVAINE,0740020V,160,160,0,0,85,75,5 ème
HAUTE SAVOIE,RUMILLY,0740126K,180,180,0,0,79,101,5 ème
HAUTE SAVOIE,RUMILLY,0741757H,149,145,0,4,75,74,5 ème
HAUTE SAVOIE,SAINT-PAUL-EN-CHABLAIS,0741308V,147,143,0,4,82,65,5 ème
HAUTE SAVOIE,SAMOENS,0740040S,46,46,0,0,19,27,5 ème
HAUTE SAVOIE,THONES,0741187N,154,154,0,0,78,76,5 ème
HAUTE SAVOIE,THONON-LES-BAINS,0740059M,0,0,0,0,0,0,5 ème
HAUTE SAVOIE,VILLE-LA-GRAND,0741284U,231,230,0,1,111,120,5 ème
ISERE,BOURGOIN-JALLIEU,0382271M,0,0,0,0,0,0,5 ème
ISERE,CORENC,0382041M,129,124,0,5,73,56,5 ème
ISERE,CORENC,0382579X,151,149,0,2,70,81,5 ème
ISERE,COUBLEVIE,0382495F,221,203,15,3,109,112,5 ème
ISERE,ECHIROLLES,0382031B,0,0,0,0,0,0,5 ème
ISERE,FONTAINE,0380356F,100,97,0,3,48,52,5 ème
ISERE,GIERES,0381694K,151,148,0,3,77,74,5 ème
ISERE,GONCELIN,0383300F,133,131,0,2,68,65,5 ème
ISERE,GRENOBLE,0383370G,132,132,0,0,69,63,5 ème
ISERE,LA COTE-SAINT-ANDRE,0382147C,149,124,22,3,71,78,5 ème
ISERE,LA MURE,0381701T,78,78,0,0,35,43,5 ème
ISERE,LA TOUR-DU-PIN,0380278W,204,169,32,3,96,108,5 ème
ISERE,LA TOUR-DU-PIN,0381706Y,160,156,0,4,81,79,5 ème
ISERE,LE TOUVET,0382204P,157,157,0,0,80,77,5 ème
ISERE,L'ISLE-D'ABEAU,0383455Z,146,141,0,5,73,73,5 ème
ISERE,MEYLAN,0381777A,156,153,0,3,78,78,5 ème
ISERE,MOIRANS,0381908T,136,133,0,3,54,82,5 ème
ISERE,SAINT-GEORGES-D'ESPERANCHE,0383141H,114,114,0,0,54,60,5 ème
ISERE,SAINT-JEAN-DE-MOIRANS,0381704W,77,77,0,0,40,37,5 ème
ISERE,SAINT-JEAN-DE-SOUDAIN,0382621T,161,161,0,0,84,77,5 ème
ISERE,SAINT-MARCELLIN,0380063M,0,0,0,0,0,0,5 ème
ISERE,TIGNIEU-JAMEYZIEU,0382705J,186,183,0,3,92,94,5 ème
ISERE,VIENNE,0380083J,0,0,0,0,0,0,5 ème
ISERE,VILLEFONTAINE,0382104F,135,107,24,4,66,69,5 ème
ISERE,VILLEFONTAINE,0382506T,141,138,0,3,59,82,5 ème
ISERE,VILLEMOIRIEU,0383475W,127,127,0,0,65,62,5 ème
ISERE,VIZILLE,0381779C,196,179,10,7,93,103,5 ème
ISERE,VOIRON,0382169B,0,0,0,0,0,0,5 ème
ISERE,VOIRON,0382584C,91,91,0,0,54,37,5 ème
SAVOIE,ALBERTVILLE,0730904L,177,160,14,3,89,88,5 ème
SAVOIE,ALBERTVILLE,0731045P,30,0,30,0,9,21,5 ème
SAVOIE,BOURG-SAINT-MAURICE,0730009N,166,166,0,0,87,79,5 ème
SAVOIE,BOZEL,0730010P,77,77,0,0,38,39,5 ème
SAVOIE,CHAMBERY,0730016W,0,0,0,0,0,0,5 ème
SAVOIE,CHAMBERY,0730762G,86,86,0,0,31,55,5 ème
SAVOIE,CHAMBERY,0730855H,96,93,0,3,50,46,5 ème
SAVOIE,LA MOTTE-SERVOLEX,0730028J,95,93,0,2,40,55,5 ème
SAVOIE,LA RAVOIRE,0730982W,96,80,14,2,49,47,5 ème
SAVOIE,MODANE,0730049G,111,111,0,0,50,61,5 ème
SAVOIE,SAINT-JEAN-DE-MAURIENNE,0730037U,0,0,0,0,0,0,5 ème
SAVOIE,SAINT-JEAN-DE-MAURIENNE,0730903K,164,144,16,4,78,86,5 ème
SAVOIE,SAINT-PIERRE-D'ALBIGNY,0730042Z,133,128,0,5,65,68,5 ème
SAVOIE,VAL-D'ARC,0730001E,84,80,0,4,44,40,5 ème
AIN,BELLEY,0011067E,220,206,11,3,92,128,5 ème
AIN,BEYNOST,0011360Y,135,131,0,4,58,77,5 ème
AIN,BOURG-EN-BRESSE,0010079F,119,116,0,3,44,75,5 ème
AIN,BOURG-EN-BRESSE,0010099C,0,0,0,0,0,0,5 ème
AIN,BOURG-EN-BRESSE,0010966V,16,0,16,0,8,8,5 ème
AIN,BRIORD,0011429Y,141,140,0,1,74,67,5 ème
AIN,CESSY,0010878Z,0,0,0,0,0,0,5 ème
AIN,CEYZERIAT,0011387C,176,173,0,3,85,91,5 ème
AIN,CHATILLON-SUR-CHALARONNE,0010084L,47,47,0,0,19,28,5 ème
AIN,DAGNEUX,0010083K,185,185,0,0,80,105,5 ème
AIN,DIVONNE-LES-BAINS,0011011U,129,129,0,0,71,58,5 ème
AIN,GEX,0010088R,233,230,0,3,139,94,5 ème
AIN,MONTCEAUX,0011415H,195,189,0,6,84,111,5 ème
AIN,MONTREVEL-EN-BRESSE,0010895T,198,195,0,3,90,108,5 ème
AIN,OYONNAX,0010092V,126,120,0,6,59,67,5 ème
AIN,OYONNAX,0010802S,197,160,32,5,103,94,5 ème
AIN,PONT-D'AIN,0010037K,147,142,0,5,76,71,5 ème
AIN,PREVESSIN-MOENS,0011301J,203,202,0,1,101,102,5 ème
LOIRE,CHARLIEU,0421572F,173,173,0,0,89,84,5 ème
LOIRE,FIRMINY,0420073B,0,0,0,0,0,0,5 ème
LOIRE,MONTBRISON,0420075D,0,0,0,0,0,0,5 ème
LOIRE,PELUSSIN,0421049M,57,57,0,0,32,25,5 ème
LOIRE,REGNY,0421490S,103,103,0,0,49,54,5 ème
LOIRE,RIVE-DE-GIER,0420982P,0,0,0,0,0,0,5 ème
LOIRE,ROANNE,0420035K,174,155,17,2,76,98,5 ème
LOIRE,ROANNE,0420077F,0,0,0,0,0,0,5 ème
LOIRE,ROANNE,0421683B,118,117,0,1,57,61,5 ème
LOIRE,ROANNE,0421684C,86,86,0,0,37,49,5 ème
LOIRE,ROANNE,0421797A,207,188,15,4,95,112,5 ème
LOIRE,ROCHE-LA-MOLIERE,0421174Y,176,173,0,3,85,91,5 ème
LOIRE,SAINT-BONNET-LE-CHATEAU,0420038N,131,131,0,0,61,70,5 ème
LOIRE,SAINT-CHAMOND,0421006R,0,0,0,0,0,0,5 ème
LOIRE,SAINT-ETIENNE,0420058K,194,187,0,7,83,111,5 ème
LOIRE,SAINT-ETIENNE,0421452A,229,227,0,2,115,114,5 ème
LOIRE,SAINT-ETIENNE,0421677V,120,120,0,0,56,64,5 ème
LOIRE,SAINT-ETIENNE,0421798B,111,100,11,0,53,58,5 ème
LOIRE,SAINT-ETIENNE,0421980Z,0,0,0,0,0,0,5 ème
LOIRE,SAINT-GENEST-MALIFAUX,0421059Y,108,108,0,0,46,62,5 ème
LOIRE,SAINT-GERMAIN-LAVAL,0420060M,60,60,0,0,34,26,5 ème
LOIRE,SAINT-ROMAIN-LE-PUY,0422136U,192,187,0,5,102,90,5 ème
LOIRE,UNIEUX,0421068H,138,136,0,2,61,77,5 ème
LOIRE,VEAUCHE,0422293P,195,193,0,2,91,104,5 ème
RHONE,AMPLEPUIS,0690672F,112,112,0,0,54,58,5 ème
RHONE,BRINDAS,0693890D,197,194,0,3,104,93,5 ème
RHONE,BRON,0692576A,132,116,14,2,55,77,5 ème
RHONE,BRON,0693834T,146,142,0,4,73,73,5 ème
RHONE,CHASSIEU,0691614E,188,187,0,1,83,105,5 ème
RHONE,DECINES-CHARPIEU,0691649T,123,123,0,0,61,62,5 ème
RHONE,DECINES-CHARPIEU,0692157V,149,134,12,3,77,72,5 ème
RHONE,FEYZIN,0692520P,114,113,0,1,62,52,5 ème
RHONE,GIVORS,0692583H,145,131,12,2,61,84,5 ème
RHONE,GRIGNY,0692419E,143,127,11,5,66,77,5 ème
RHONE,L'ARBRESLE,0691482L,172,155,14,3,90,82,5 ème
RHONE,LYON,0692932M,177,176,0,1,85,92,5 ème
RHONE,LYON,0690597Z,85,85,0,0,43,42,5 ème
RHONE,LYON,0692933N,306,304,0,2,141,165,5 ème
RHONE,LYON,0692694D,73,70,0,3,27,46,5 ème
RHONE,LYON,0692934P,85,82,0,3,45,40,5 ème
RHONE,LYON,0690534F,179,179,0,0,90,89,5 ème
RHONE,LYON,0692338S,180,177,0,3,83,97,5 ème
RHONE,LYON,0690040U,0,0,0,0,0,0,5 ème
RHONE,LYON,0690651H,0,0,0,0,0,0,5 ème
RHONE,LYON,0693374T,0,0,0,0,0,0,5 ème
RHONE,LYON,0690036P,128,113,10,5,69,59,5 ème
RHONE,MIONS,0692579D,169,167,0,2,86,83,5 ème
RHONE,MORNANT,0690611P,126,126,0,0,65,61,5 ème
RHONE,MORNANT,0692346A,180,180,0,0,88,92,5 ème
RHONE,OULLINS,0690281F,0,0,0,0,0,0,5 ème
RHONE,OULLINS,0690653K,0,0,0,0,0,0,5 ème
RHONE,OULLINS,0692942Y,52,52,0,0,18,34,5 ème
RHONE,PIERRE-BENITE,0690076H,83,80,0,3,37,46,5 ème
RHONE,SAINT-FONS,0692342W,232,215,16,1,123,109,5 ème
RHONE,SAINT-GENIS-LAVAL,0692521R,97,95,0,2,55,42,5 ème
RHONE,SAINT-GEORGES-DE-RENEINS,0690080M,196,182,14,0,93,103,5 ème
RHONE,SAINT-LAURENT-DE-CHAMOUSSET,0690614T,89,89,0,0,48,41,5 ème
RHONE,SAINT-MARTIN-EN-HAUT,0690615U,115,115,0,0,57,58,5 ème
RHONE,SAINT-PRIEST,0692160Y,155,137,14,4,63,92,5 ème
RHONE,SAINT-SYMPHORIEN-D'OZON,0691496B,196,192,0,4,105,91,5 ème
RHONE,SAINT-SYMPHORIEN-SUR-COISE,0692925E,121,116,0,5,57,64,5 ème
RHONE,TARARE,0690618X,112,109,0,3,54,58,5 ème
RHONE,TARARE,0692700K,183,174,6,3,97,86,5 ème
RHONE,VAULX-EN-VELIN,0691793Z,119,116,0,3,67,52,5 ème
RHONE,VILLEURBANNE,0692155T,170,152,16,2,74,96,5 ème
RHONE,VILLEURBANNE,0693491V,28,28,0,0,18,10,5 ème
RHONE,VILLIE-MORGON,0690117C,137,136,0,1,79,58,5 ème
DOUBS,BAUME-LES-DAMES,0250005V,133,111,16,6,56,77,5 ème
DOUBS,BESANCON,0250011B,0,0,0,0,0,0,5 ème
DOUBS,BESANCON,0250012C,110,110,0,0,49,61,5 ème
DOUBS,BESANCON,0251208C,161,142,15,4,98,63,5 ème
DOUBS,FRASNE,0250018J,101,101,0,0,49,52,5 ème
DOUBS,HERIMONCOURT,0251375J,97,97,0,0,53,44,5 ème
DOUBS,LE RUSSEY,0251058P,24,24,0,0,9,15,5 ème
DOUBS,MAICHE,0251053J,96,96,0,0,48,48,5 ème
DOUBS,MONTBELIARD,0251395F,155,137,16,2,79,76,5 ème
DOUBS,MORTEAU,0251090Z,272,246,17,9,127,145,5 ème
DOUBS,PIREY,0251063V,108,108,0,0,51,57,5 ème
DOUBS,PONTARLIER,0251112Y,0,0,0,0,0,0,5 ème
DOUBS,SANCEY,0250055Z,48,48,0,0,27,21,5 ème
HAUTE-SAONE,HERICOURT,0700787A,179,163,12,4,100,79,5 ème
HAUTE-SAONE,LUXEUIL-LES-BAINS,0701192R,119,102,14,3,59,60,5 ème
HAUTE-SAONE,PESMES,0700027Z,88,88,0,0,50,38,5 ème
HAUTE-SAONE,VESOUL,0700038L,0,0,0,0,0,0,5 ème
HAUTE-SAONE,VESOUL,0700785Y,136,134,0,2,64,72,5 ème
JURA,CLAIRVAUX-LES-LACS,0390009Y,57,57,0,0,39,18,5 ème
JURA,DOLE,0390013C,0,0,0,0,0,0,5 ème
JURA,DOLE,0390800H,124,122,0,2,74,50,5 ème
JURA,DOLE,0390883Y,137,118,19,0,76,61,5 ème
JURA,LAVANS-LES-SAINT-CLAUDE,0391035N,67,67,0,0,31,36,5 ème
JURA,LONS-LE-SAUNIER,0390020K,0,0,0,0,0,0,5 ème
JURA,MOIRANS-EN-MONTAGNE,0390025R,55,51,0,4,30,25,5 ème
JURA,SAINT-CLAUDE,0390786T,0,0,0,0,0,0,5 ème
JURA,SALINS-LES-BAINS,0390962J,122,115,0,7,56,66,5 ème
JURA,TAVAUX,0390823H,73,73,0,0,34,39,5 ème
TERRITOIRE DE BELFORT,BELFORT,0900236T,0,0,0,0,0,0,5 ème
TERRITOIRE DE BELFORT,BELFORT,0900351T,85,69,16,0,39,46,5 ème
TERRITOIRE DE BELFORT,ROUGEMONT-LE-CHATEAU,0900013A,78,78,0,0,39,39,5 ème
COTE D'OR,BEAUNE,0210006T,0,0,0,0,0,0,5 ème
COTE D'OR,BEAUNE,0211626D,175,173,0,2,86,89,5 ème
COTE D'OR,CHATILLON-SUR-SEINE,0210014B,126,114,9,3,62,64,5 ème
COTE D'OR,DIJON,0210024M,127,126,0,1,62,65,5 ème
COTE D'OR,DIJON,0211089V,0,0,0,0,0,0,5 ème
COTE D'OR,DIJON,0211091X,0,0,0,0,0,0,5 ème
COTE D'OR,DIJON,0211357L,147,147,0,0,82,65,5 ème
COTE D'OR,DIJON,0211389W,184,184,0,0,87,97,5 ème
COTE D'OR,DIJON,0211525U,131,131,0,0,68,63,5 ème
COTE D'OR,DIJON,0211986V,0,0,0,0,0,0,5 ème
COTE D'OR,DIJON,0212119P,173,173,0,0,78,95,5 ème
COTE D'OR,ECHENON,0211358M,78,78,0,0,36,42,5 ème
COTE D'OR,LIERNAIS,0211524T,13,13,0,0,4,9,5 ème
COTE D'OR,MIREBEAU-SUR-BEZE,0210033X,107,106,0,1,46,61,5 ème
COTE D'OR,NUITS-SAINT-GEORGES,0210038C,187,183,0,4,97,90,5 ème
COTE D'OR,QUETIGNY,0211477S,178,164,14,0,76,102,5 ème
COTE D'OR,RECEY-SUR-OURCE,0210043H,36,36,0,0,18,18,5 ème
COTE D'OR,SEURRE,0210050R,78,78,0,0,34,44,5 ème
COTE D'OR,VENAREY-LES-LAUMES,0211184Y,73,73,0,0,37,36,5 ème
NIEVRE,CERCY-LA-TOUR,0580002M,26,26,0,0,13,13,5 ème
NIEVRE,CHATEAU-CHINON (VILLE),0580005R,39,27,9,3,21,18,5 ème
NIEVRE,FOURCHAMBAULT,0580020G,0,0,0,0,0,0,5 ème
NIEVRE,FOURCHAMBAULT,0580553L,138,117,16,5,63,75,5 ème
NIEVRE,LA CHARITE-SUR-LOIRE,0580610Y,104,86,15,3,51,53,5 ème
NIEVRE,MONTSAUCHE-LES-SETTONS,0580029S,25,25,0,0,15,10,5 ème
NIEVRE,NEVERS,0580034X,72,72,0,0,32,40,5 ème
NIEVRE,NEVERS,0580542Z,95,92,0,3,42,53,5 ème
NIEVRE,NEVERS,0580682B,97,95,0,2,55,42,5 ème
NIEVRE,PREMERY,0580036Z,27,27,0,0,13,14,5 ème
NIEVRE,SAINT-BENIN-D'AZY,0580038B,36,36,0,0,20,16,5 ème
NIEVRE,SAINT-SAULGE,0580040D,19,19,0,0,12,7,5 ème
SAONE-ET-LOIRE,BOURBON-LANCY,0710005V,85,85,0,0,49,36,5 ème
SAONE-ET-LOIRE,CHALON-SUR-SAONE,0710536X,109,92,15,2,56,53,5 ème
SAONE-ET-LOIRE,CHATENOY-LE-ROYAL,0711585M,74,70,0,4,36,38,5 ème
SAONE-ET-LOIRE,CHAUFFAILLES,0710121W,28,28,0,0,14,14,5 ème
SAONE-ET-LOIRE,GENELARD,0710039G,80,80,0,0,50,30,5 ème
SAONE-ET-LOIRE,LE CREUSOT,0710026T,0,0,0,0,0,0,5 ème
SAONE-ET-LOIRE,LE CREUSOT,0711324D,78,77,0,1,41,37,5 ème
SAONE-ET-LOIRE,MACON,0710048S,0,0,0,0,0,0,5 ème
SAONE-ET-LOIRE,MACON,0711249X,0,0,0,0,0,0,5 ème
SAONE-ET-LOIRE,MONTCHANIN,0710060E,117,116,0,1,53,64,5 ème
SAONE-ET-LOIRE,PARAY-LE-MONIAL,0710087J,0,0,0,0,0,0,5 ème
SAONE-ET-LOIRE,PIERRE-DE-BRESSE,0710063H,65,65,0,0,34,31,5 ème
SAONE-ET-LOIRE,SAINT-REMY,0711293V,150,132,16,2,68,82,5 ème
SAONE-ET-LOIRE,SANVIGNES-LES-MINES,0710069P,61,61,0,0,35,26,5 ème
YONNE,AUXERRE,0890005X,0,0,0,0,0,0,5 ème
YONNE,AUXERRE,0891054M,187,180,0,7,91,96,5 ème
YONNE,CHABLIS,0890013F,108,108,0,0,47,61,5 ème
YONNE,MIGENNES,0890977D,111,95,16,0,53,58,5 ème
YONNE,NOYERS,0890019M,34,34,0,0,14,20,5 ème
YONNE,PARON,0891235J,132,129,0,3,62,70,5 ème
YONNE,SAINT-FLORENTIN,0890024T,124,122,0,2,59,65,5 ème
YONNE,SENS,0890790A,212,196,16,0,104,108,5 ème
COTES D'ARMOR,BEGARD,0221518F,138,138,0,0,72,66,5 ème
COTES D'ARMOR,BELLE-ISLE-EN-TERRE,0221539D,50,50,0,0,20,30,5 ème
COTES D'ARMOR,BOURBRIAC,0220003J,43,43,0,0,20,23,5 ème
COTES D'ARMOR,CALLAC,0221540E,33,33,0,0,15,18,5 ème
COTES D'ARMOR,DINAN,0221743A,124,121,0,3,56,68,5 ème
COTES D'ARMOR,ERQUY,0220015X,39,39,0,0,18,21,5 ème
COTES D'ARMOR,GUINGAMP,0220019B,0,0,0,0,0,0,5 ème
COTES D'ARMOR,LANNION,0220104U,219,199,18,2,118,101,5 ème
COTES D'ARMOR,LANNION,0221931E,100,94,0,6,54,46,5 ème
COTES D'ARMOR,MERDRIGNAC,0220149T,29,29,0,0,15,14,5 ème
COTES D'ARMOR,PAIMPOL,0220151V,84,82,0,2,36,48,5 ème
COTES D'ARMOR,PLENEE-JUGON,0220154Y,22,22,0,0,6,16,5 ème
COTES D'ARMOR,PLENEUF-VAL-ANDRE,0221126E,59,59,0,0,25,34,5 ème
COTES D'ARMOR,PLEUMEUR-BODOU,0221819H,69,69,0,0,43,26,5 ème
COTES D'ARMOR,PLOUASNE,0220046F,67,67,0,0,35,32,5 ème
COTES D'ARMOR,PLOUBAZLANEC,0221866J,0,0,0,0,0,0,5 ème
COTES D'ARMOR,PLOUER-SUR-RANCE,0220047G,164,164,0,0,69,95,5 ème
COTES D'ARMOR,PONTRIEUX,0220166L,21,21,0,0,4,17,5 ème
COTES D'ARMOR,QUINTIN,0221028Y,89,83,0,6,47,42,5 ème
COTES D'ARMOR,QUINTIN,0221748F,206,182,24,0,96,110,5 ème
COTES D'ARMOR,ROSTRENEN,0221038J,56,56,0,0,30,26,5 ème
COTES D'ARMOR,SAINT-BRIEUC,0220185G,149,146,0,3,71,78,5 ème
COTES D'ARMOR,SAINT-BRIEUC,0221867K,0,0,0,0,0,0,5 ème
FINISTERE,BREST,0290131K,66,63,0,3,33,33,5 ème
FINISTERE,CROZON,0290256W,54,54,0,0,25,29,5 ème
FINISTERE,FOUESNANT,0291101P,212,212,0,0,98,114,5 ème
FINISTERE,GUILVINEC,0290674A,41,41,0,0,16,25,5 ème
FINISTERE,GUIPAVAS,0291968G,105,101,0,4,42,63,5 ème
FINISTERE,LE CONQUET,0290106H,39,39,0,0,26,13,5 ème
FINISTERE,LE RELECQ-KERHUON,0290151G,103,87,16,0,43,60,5 ème
FINISTERE,PLOUDALMEZEAU,0291638Y,73,73,0,0,32,41,5 ème
FINISTERE,PLOUESCAT,0290293L,72,72,0,0,31,41,5 ème
FINISTERE,PLOUZANE,0291656T,63,63,0,0,31,32,5 ème
FINISTERE,PLOUZANE,0291929P,112,112,0,0,58,54,5 ème
FINISTERE,PONT-DE-BUIS-LES-QUIMERCH,0290093U,71,71,0,0,36,35,5 ème
FINISTERE,POULDREUZIC,0290304Y,65,65,0,0,36,29,5 ème
FINISTERE,QUIMPER,0290306A,78,78,0,0,29,49,5 ème
FINISTERE,QUIMPER,0290347V,16,0,16,0,3,13,5 ème
FINISTERE,ROSPORDEN,0290310E,41,41,0,0,18,23,5 ème
ILLE-ET-VILAINE,ARGENTRE-DU-PLESSIS,0350849H,143,143,0,0,66,77,5 ème
ILLE-ET-VILAINE,BAIN-DE-BRETAGNE,0350851K,198,197,0,1,90,108,5 ème
ILLE-ET-VILAINE,BAIN-DE-BRETAGNE,0350970P,129,96,32,1,56,73,5 ème
ILLE-ET-VILAINE,BRUZ,0350002M,168,136,32,0,84,84,5 ème
ILLE-ET-VILAINE,BRUZ,0350852L,340,340,0,0,161,179,5 ème
ILLE-ET-VILAINE,CANCALE,0350003N,95,95,0,0,45,50,5 ème
ILLE-ET-VILAINE,CESSON-SEVIGNE,0350793X,0,0,0,0,0,0,5 ème
ILLE-ET-VILAINE,CHATEAUGIRON,0350855P,168,164,0,4,65,103,5 ème
ILLE-ET-VILAINE,COMBOURG,0350857S,112,112,0,0,53,59,5 ème
ILLE-ET-VILAINE,FOUGERES,0350761M,0,0,0,0,0,0,5 ème
ILLE-ET-VILAINE,GUIPRY-MESSAC,0352957Z,102,102,0,0,44,58,5 ème
ILLE-ET-VILAINE,JANZE,0350866B,184,177,0,7,74,110,5 ème
ILLE-ET-VILAINE,LA RICHARDAIS,0353036K,146,146,0,0,67,79,5 ème
ILLE-ET-VILAINE,LIFFRE,0351790F,201,201,0,0,106,95,5 ème
ILLE-ET-VILAINE,MAEN ROCH,0350040D,50,48,0,2,20,30,5 ème
ILLE-ET-VILAINE,MONTAUBAN-DE-BRETAGNE,0352247C,178,171,0,7,85,93,5 ème
ILLE-ET-VILAINE,MORDELLES,0350874K,196,191,0,5,91,105,5 ème
ILLE-ET-VILAINE,MORDELLES,0352030S,133,131,0,2,55,78,5 ème
ILLE-ET-VILAINE,NOYAL-SUR-VILAINE,0352167R,137,137,0,0,68,69,5 ème
ILLE-ET-VILAINE,PACE,0352274G,189,185,0,4,85,104,5 ème
ILLE-ET-VILAINE,RENNES,0350030T,0,0,0,0,0,0,5 ème
ILLE-ET-VILAINE,RENNES,0350032V,0,0,0,0,0,0,5 ème
ILLE-ET-VILAINE,RENNES,0350839X,127,126,0,1,66,61,5 ème
ILLE-ET-VILAINE,RENNES,0350913C,103,87,16,0,51,52,5 ème
ILLE-ET-VILAINE,RENNES,0350965J,115,110,0,5,53,62,5 ème
ILLE-ET-VILAINE,SAINT-AUBIN-DU-CORMIER,0350882U,79,79,0,0,43,36,5 ème
ILLE-ET-VILAINE,SAINT-MALO,0350062C,0,0,0,0,0,0,5 ème
ILLE-ET-VILAINE,SAINT-MALO,0350889B,68,68,0,0,38,30,5 ème
ILLE-ET-VILAINE,SAINT-MALO,0352072M,0,0,0,0,0,0,5 ème
ILLE-ET-VILAINE,TINTENIAC,0350891D,225,207,18,0,113,112,5 ème
ILLE-ET-VILAINE,VAL D'ANAST,0350869E,68,68,0,0,37,31,5 ème
MORBIHAN,BRECH,0560023W,211,211,0,0,98,113,5 ème
MORBIHAN,CAUDAN,0560128K,100,100,0,0,48,52,5 ème
MORBIHAN,ELVEN,0561965G,130,130,0,0,69,61,5 ème
MORBIHAN,ETEL,0560008E,0,0,0,0,0,0,5 ème
MORBIHAN,GUIDEL,0560136U,176,172,0,4,71,105,5 ème
MORBIHAN,HENNEBONT,0560018R,139,139,0,0,75,64,5 ème
MORBIHAN,HENNEBONT,0561401U,173,167,0,6,84,89,5 ème
MORBIHAN,JOSSELIN,0561378U,79,79,0,0,38,41,5 ème
MORBIHAN,LANGUIDIC,0560143B,88,88,0,0,37,51,5 ème
MORBIHAN,MALANSAC,0561410D,61,57,0,4,31,30,5 ème
MORBIHAN,MALESTROIT,0560058J,69,69,0,0,32,37,5 ème
MORBIHAN,MAURON,0560152L,33,33,0,0,15,18,5 ème
MORBIHAN,MUZILLAC,0560033G,126,126,0,0,48,78,5 ème
MORBIHAN,MUZILLAC,0560153M,106,106,0,0,41,65,5 ème
MORBIHAN,PLOEMEUR,0560104J,119,119,0,0,46,73,5 ème
MORBIHAN,PLOERMEL,0560226S,92,77,10,5,39,53,5 ème
MORBIHAN,PLOUAY,0560037L,109,109,0,0,60,49,5 ème
MORBIHAN,PONTIVY,0560110R,218,200,16,2,100,118,5 ème
MORBIHAN,PONTIVY,0560182U,0,0,0,0,0,0,5 ème
MORBIHAN,PORT-LOUIS,0561379V,114,114,0,0,49,65,5 ème
MORBIHAN,PRIZIAC,0560197K,0,0,0,0,0,0,5 ème
MORBIHAN,QUIBERON,0561329R,32,32,0,0,15,17,5 ème
MORBIHAN,ROHAN,0560047X,57,57,0,0,34,23,5 ème
MORBIHAN,VANNES,0560198L,0,0,0,0,0,0,5 ème
CHER,AUBIGNY-SUR-NERE,0180002E,142,132,10,0,67,75,5 ème
CHER,AVORD,0180004G,93,93,0,0,43,50,5 ème
CHER,BOURGES,0180010N,0,0,0,0,0,0,5 ème
CHER,BOURGES,0180591V,154,153,0,1,74,80,5 ème
CHER,SAINT-AMAND-MONTROND,0180646E,106,102,0,4,53,53,5 ème
CHER,SAINT-AMAND-MONTROND,0180769N,129,113,11,5,72,57,5 ème
CHER,SANCERRE,0180031L,89,81,5,3,44,45,5 ème
CHER,VIERZON,0180644C,136,134,0,2,66,70,5 ème
EURE-ET-LOIR,ANET,0281038B,129,127,0,2,65,64,5 ème
EURE-ET-LOIR,AUNEAU-BLEURY-SAINT-SYMPHORIEN,0280001Z,180,164,16,0,84,96,5 ème
EURE-ET-LOIR,BONNEVAL,0280866P,158,155,0,3,72,86,5 ème
EURE-ET-LOIR,BREZOLLES,0280005D,101,99,0,2,53,48,5 ème
EURE-ET-LOIR,CHARTRES,0280044W,0,0,0,0,0,0,5 ème
EURE-ET-LOIR,CHARTRES,0280751P,124,108,15,1,61,63,5 ème
EURE-ET-LOIR,CHARTRES,0280883H,108,103,0,5,48,60,5 ème
EURE-ET-LOIR,CHATEAUDUN,0280656L,71,68,0,3,33,38,5 ème
EURE-ET-LOIR,CHATEAUNEUF-EN-THYMERAIS,0280016R,129,123,0,6,59,70,5 ème
EURE-ET-LOIR,DREUX,0280865N,125,112,13,0,69,56,5 ème
EURE-ET-LOIR,EPERNON,0280889P,105,105,0,0,53,52,5 ème
EURE-ET-LOIR,MAINTENON,0280033J,142,140,0,2,75,67,5 ème
EURE-ET-LOIR,NOGENT-LE-ROTROU,0280924C,94,90,0,4,52,42,5 ème
EURE-ET-LOIR,SAINT-MAURICE-SAINT-GERMAIN,0280741D,41,37,4,0,16,25,5 ème
EURE-ET-LOIR,VERNOUILLET,0280024Z,114,111,0,3,56,58,5 ème
INDRE,CHATEAUROUX,0360016X,101,98,0,3,51,50,5 ème
INDRE,CHATEAUROUX,0360567W,99,97,0,2,49,50,5 ème
INDRE,EGUZON-CHANTOME,0360023E,56,56,0,0,29,27,5 ème
INDRE,ISSOUDUN,0360568X,36,36,0,0,14,22,5 ème
INDRE,SAINT-GAULTIER,0360546Y,46,46,0,0,27,19,5 ème
INDRE-ET-LOIRE,AMBOISE,0371248F,122,117,0,5,61,61,5 ème
INDRE-ET-LOIRE,BOURGUEIL,0370733W,28,28,0,0,18,10,5 ème
INDRE-ET-LOIRE,BOURGUEIL,0370995F,115,115,0,0,54,61,5 ème
INDRE-ET-LOIRE,CHAMBRAY-LES-TOURS,0370741E,90,90,0,0,60,30,5 ème
INDRE-ET-LOIRE,CHATEAU-LA-VALLIERE,0370006F,77,64,13,0,36,41,5 ème
INDRE-ET-LOIRE,DESCARTES,0371192V,57,54,0,3,28,29,5 ème
INDRE-ET-LOIRE,LIGUEIL,0370015R,103,100,0,3,54,49,5 ème
INDRE-ET-LOIRE,L'ILE-BOUCHARD,0370013N,61,61,0,0,33,28,5 ème
INDRE-ET-LOIRE,LOCHES,0371329U,50,50,0,0,25,25,5 ème
INDRE-ET-LOIRE,NEUILLE-PONT-PIERRE,0370022Y,138,134,0,4,70,68,5 ème
INDRE-ET-LOIRE,NOUATRE,0370024A,40,40,0,0,19,21,5 ème
INDRE-ET-LOIRE,PREUILLY-SUR-CLAISE,0370026C,56,56,0,0,29,27,5 ème
INDRE-ET-LOIRE,SAINT-AVERTIN,0370887N,169,169,0,0,78,91,5 ème
INDRE-ET-LOIRE,SAINT-CYR-SUR-LOIRE,0370792K,83,76,0,7,39,44,5 ème
INDRE-ET-LOIRE,SAINT-PIERRE-DES-CORPS,0370767H,105,85,15,5,55,50,5 ème
INDRE-ET-LOIRE,TOURS,0370729S,206,191,12,3,107,99,5 ème
INDRE-ET-LOIRE,TOURS,0370745J,147,147,0,0,82,65,5 ème
INDRE-ET-LOIRE,TOURS,0370769K,96,96,0,0,51,45,5 ème
INDRE-ET-LOIRE,TOURS,0370771M,0,0,0,0,0,0,5 ème
INDRE-ET-LOIRE,TOURS,0371099U,0,0,0,0,0,0,5 ème
LOIRET,BEAUGENCY,0450005L,172,170,0,2,82,90,5 ème
LOIRET,CHALETTE-SUR-LOING,0451148D,133,131,0,2,77,56,5 ème
LOIRET,FLEURY-LES-AUBRAIS,0451067R,0,0,0,0,0,0,5 ème
LOIRET,JARGEAU,0451069T,169,169,0,0,85,84,5 ème
LOIRET,MEUNG-SUR-LOIRE,0450038X,147,128,14,5,79,68,5 ème
LOIRET,ORLEANS,0450936Y,167,148,16,3,93,74,5 ème
LOIRET,ORLEANS,0451070U,151,127,15,9,80,71,5 ème
LOIRET,ORLEANS,0451334F,236,236,0,0,107,129,5 ème
LOIRET,ORLEANS,0451421A,131,131,0,0,59,72,5 ème
LOIRET,PUISEAUX,0450063Z,119,117,0,2,60,59,5 ème
LOIRET,SAINTE-GENEVIEVE-DES-BOIS,0450016Y,120,119,0,1,60,60,5 ème
LOIRET,SAINT-JEAN-DE-BRAYE,0450064A,0,0,0,0,0,0,5 ème
LOIRET,SAINT-JEAN-DE-LA-RUELLE,0451241E,125,111,14,0,53,72,5 ème
LOIRET,SAINT-JEAN-LE-BLANC,0451074Y,112,108,0,4,48,64,5 ème
LOIRET,SARAN,0451038J,160,153,0,7,67,93,5 ème
LOIRET,SULLY-SUR-LOIRE,0450790P,117,114,0,3,55,62,5 ème
LOIR-ET-CHER,BLOIS,0410001D,0,0,0,0,0,0,5 ème
LOIR-ET-CHER,BLOIS,0410593X,173,149,16,8,85,88,5 ème
LOIR-ET-CHER,MER,0410681T,52,49,0,3,26,26,5 ème
LOIR-ET-CHER,ROMORANTIN-LANTHENAY,0410019Y,236,216,16,4,108,128,5 ème
LOIR-ET-CHER,SAINT-AIGNAN,0410718H,0,0,0,0,0,0,5 ème
LOIR-ET-CHER,VENDOME,0410688A,80,80,0,0,31,49,5 ème
CORSE-DU-SUD,AJACCIO,6200185G,68,68,0,0,33,35,5 ème
HAUTE-CORSE,BASTIA,7200624R,105,102,0,3,53,52,5 ème
HAUTE-CORSE,CORTE,7200004S,84,80,2,2,41,43,5 ème
HAUTE-CORSE,LUCCIANA,7200053V,182,177,0,5,90,92,5 ème
HAUTE-CORSE,PENTA-DI-CASINCA,7200160L,118,111,7,0,64,54,5 ème
HAUTE-CORSE,SAINT-FLORENT,7200044K,55,55,0,0,30,25,5 ème
MEURTHE-ET-MOSELLE,ART-SUR-MEURTHE,0542449U,20,20,0,0,9,11,5 ème
MEURTHE-ET-MOSELLE,BAYON,0541852V,132,132,0,0,59,73,5 ème
MEURTHE-ET-MOSELLE,FLAVIGNY-SUR-MOSELLE,0541268K,27,21,0,6,8,19,5 ème
MEURTHE-ET-MOSELLE,FROUARD,0541326Y,84,80,0,4,36,48,5 ème
MEURTHE-ET-MOSELLE,HOMECOURT,0541471F,109,109,0,0,61,48,5 ème
MEURTHE-ET-MOSELLE,JARNY,0541331D,109,109,0,0,50,59,5 ème
MEURTHE-ET-MOSELLE,LONGLAVILLE,0541605B,0,0,0,0,0,0,5 ème
MEURTHE-ET-MOSELLE,LONGWY,0540030P,0,0,0,0,0,0,5 ème
MEURTHE-ET-MOSELLE,NANCY,0540081V,0,0,0,0,0,0,5 ème
MEURTHE-ET-MOSELLE,NANCY,0540110B,117,102,15,0,49,68,5 ème
MEURTHE-ET-MOSELLE,NANCY,0541327Z,62,62,0,0,25,37,5 ème
MEURTHE-ET-MOSELLE,NANCY,0541501N,108,106,0,2,48,60,5 ème
MEURTHE-ET-MOSELLE,NANCY,0541995A,185,185,0,0,84,101,5 ème
MEURTHE-ET-MOSELLE,NANCY,0542409A,41,39,0,2,14,27,5 ème
MEURTHE-ET-MOSELLE,NOMENY,0540054R,95,95,0,0,47,48,5 ème
MEURTHE-ET-MOSELLE,PAGNY-SUR-MOSELLE,0541567K,93,93,0,0,38,55,5 ème
MEURTHE-ET-MOSELLE,PIENNES,0541332E,77,77,0,0,41,36,5 ème
MEURTHE-ET-MOSELLE,PONT-A-MOUSSON,0540112D,146,141,0,5,78,68,5 ème
MEURTHE-ET-MOSELLE,TOMBLAINE,0540061Y,0,0,0,0,0,0,5 ème
MEURTHE-ET-MOSELLE,TOUL,0540067E,0,0,0,0,0,0,5 ème
MEURTHE-ET-MOSELLE,TUCQUEGNIEUX,0541333F,82,78,0,4,50,32,5 ème
MEURTHE-ET-MOSELLE,VAL DE BRIEY,0541985P,94,94,0,0,41,53,5 ème
MEURTHE-ET-MOSELLE,VILLERUPT,0542418K,201,188,11,2,83,118,5 ème
MEUSE,BAR-LE-DUC,0550701N,64,50,7,7,28,36,5 ème
MEUSE,REVIGNY-SUR-ORNAIN,0550018W,64,60,0,4,36,28,5 ème
MEUSE,VERDUN,0550024C,116,104,0,12,53,63,5 ème
MEUSE,VERDUN,0550758A,44,38,6,0,25,19,5 ème
MOSELLE,ALBESTROFF,0572691R,79,79,0,0,32,47,5 ème
MOSELLE,BEHREN-LES-FORBACH,0573268T,74,68,6,0,37,37,5 ème
MOSELLE,CATTENOM,0571994H,91,91,0,0,47,44,5 ème
MOSELLE,DIEUZE,0570279U,0,0,0,0,0,0,5 ème
MOSELLE,DIEUZE,0572814Z,99,92,0,7,46,53,5 ème
MOSELLE,FAMECK,0573269U,198,196,0,2,90,108,5 ème
MOSELLE,FLORANGE,0570317K,146,131,11,4,61,85,5 ème
MOSELLE,FONTOY,0572009Z,116,97,15,4,55,61,5 ème
MOSELLE,HETTANGE-GRANDE,0572025S,193,191,0,2,94,99,5 ème
MOSELLE,LE BAN-SAINT-MARTIN,0570128E,158,156,0,2,74,84,5 ème
MOSELLE,LEMBERG,0572020L,78,78,0,0,39,39,5 ème
MOSELLE,MAIZIERES-LES-METZ,0572164T,231,219,8,4,121,110,5 ème
MOSELLE,METZ,0570061G,0,0,0,0,0,0,5 ème
MOSELLE,METZ,0572348T,103,94,8,1,51,52,5 ème
MOSELLE,METZ,0572350V,138,124,9,5,74,64,5 ème
MOSELLE,MORHANGE,0570073V,86,74,9,3,44,42,5 ème
MOSELLE,PETITE-ROSSELLE,0572493A,74,74,0,0,37,37,5 ème
MOSELLE,PHALSBOURG,0572815A,138,135,0,3,75,63,5 ème
MOSELLE,SAINT-AVOLD,0570143W,75,74,0,1,41,34,5 ème
MOSELLE,SARREBOURG,0570097W,115,99,12,4,57,58,5 ème
MOSELLE,SARREGUEMINES,0572930A,111,111,0,0,54,57,5 ème
MOSELLE,STIRING-WENDEL,0570104D,134,124,0,10,67,67,5 ème
MOSELLE,WOIPPY,0572579U,100,97,0,3,43,57,5 ème
VOSGES,BRUYERES,0880005C,140,123,8,9,71,69,5 ème
VOSGES,BRUYERES,0880133S,0,0,0,0,0,0,5 ème
VOSGES,EPINAL,0880021V,0,0,0,0,0,0,5 ème
VOSGES,EPINAL,0880150K,149,149,0,0,86,63,5 ème
VOSGES,EPINAL,0881496Y,160,160,0,0,81,79,5 ème
VOSGES,FRAIZE,0881410E,91,89,0,2,50,41,5 ème
VOSGES,LA BRESSE,0880105L,43,43,0,0,21,22,5 ème
VOSGES,LE THOLY,0881148V,42,42,0,0,17,25,5 ème
VOSGES,MARTIGNY-LES-BAINS,0880108P,27,27,0,0,14,13,5 ème
VOSGES,RUPT-SUR-MOSELLE,0880054F,35,35,0,0,21,14,5 ème
VOSGES,SAINT-DIE-DES-VOSGES,0880057J,0,0,0,0,0,0,5 ème
VOSGES,SAINT-DIE-DES-VOSGES,0880100F,58,53,0,5,30,28,5 ème
VOSGES,XERTIGNY,0881369K,98,85,9,4,45,53,5 ème
ARDENNES,CHARLEVILLE-MEZIERES,0080028M,0,0,0,0,0,0,5 ème
ARDENNES,CHARLEVILLE-MEZIERES,0080079T,56,45,11,0,30,26,5 ème
ARDENNES,CHARLEVILLE-MEZIERES,0080925M,68,65,0,3,32,36,5 ème
ARDENNES,DOUZY,0080016Z,82,82,0,0,34,48,5 ème
ARDENNES,GIVET,0080948M,92,92,0,0,49,43,5 ème
ARDENNES,RETHEL,0080088C,44,44,0,0,18,26,5 ème
ARDENNES,REVIN,0080949N,86,80,0,6,41,45,5 ème
ARDENNES,ROCROI,0081098A,45,45,0,0,31,14,5 ème
ARDENNES,VOUZIERS,0081097Z,100,87,8,5,47,53,5 ème
AUBE,BAR-SUR-AUBE,0100902B,117,110,3,4,61,56,5 ème
AUBE,ROMILLY-SUR-SEINE,0100054E,85,85,0,0,41,44,5 ème
AUBE,SAINTE-SAVINE,0100055F,64,64,0,0,35,29,5 ème
AUBE,TROYES,0100081J,215,197,17,1,100,115,5 ème
AUBE,TROYES,0100945Y,0,0,0,0,0,0,5 ème
AUBE,TROYES,0100961R,102,102,0,0,61,41,5 ème
HAUTE-MARNE,LANGRES,0520040L,102,88,13,1,52,50,5 ème
MARNE,CHALONS-EN-CHAMPAGNE,0510010J,171,166,0,5,80,91,5 ème
MARNE,CHALONS-EN-CHAMPAGNE,0511129A,198,193,5,0,95,103,5 ème
MARNE,EPERNAY,0511327R,128,109,13,6,55,73,5 ème
MARNE,FISMES,0511188P,139,132,7,0,72,67,5 ème
MARNE,REIMS,0511145T,0,0,0,0,0,0,5 ème
MARNE,REIMS,0511178D,140,137,0,3,76,64,5 ème
MARNE,REIMS,0511179E,140,136,0,4,71,69,5 ème
MARNE,REIMS,0511180F,127,127,0,0,63,64,5 ème
MARNE,REIMS,0511214T,109,93,11,5,50,59,5 ème
MARNE,REIMS,0511470W,159,139,11,9,77,82,5 ème
MARNE,SAINT-THIERRY,0510051D,128,125,0,3,63,65,5 ème
MARNE,SUIPPES,0510056J,91,88,0,3,50,41,5 ème
MARNE,VERZY,0510060N,95,95,0,0,41,54,5 ème
BAS-RHIN,ACHENHEIM,0671686U,146,141,0,5,66,80,5 ème
BAS-RHIN,BENFELD,0670003P,235,231,0,4,109,126,5 ème
BAS-RHIN,DAMBACH-LA-VILLE,0670011Y,124,118,0,6,62,62,5 ème
BAS-RHIN,DRUSENHEIM,0672074R,115,115,0,0,57,58,5 ème
BAS-RHIN,DUTTLENHEIM,0672896J,124,124,0,0,58,66,5 ème
BAS-RHIN,HAGUENAU,0672136H,189,183,0,6,98,91,5 ème
BAS-RHIN,HAGUENAU,0672298J,126,126,0,0,75,51,5 ème
BAS-RHIN,HERRLISHEIM,0671911N,77,77,0,0,38,39,5 ème
BAS-RHIN,ILLKIRCH-GRAFFENSTADEN,0670087F,0,0,0,0,0,0,5 ème
BAS-RHIN,MERTZWILLER,0671912P,53,52,0,1,26,27,5 ème
BAS-RHIN,MOLSHEIM,0672131C,91,87,0,4,36,55,5 ème
BAS-RHIN,MUTZIG,0671828Y,164,159,0,5,85,79,5 ème
BAS-RHIN,OBERNAI,0672132D,122,116,0,6,59,63,5 ème
BAS-RHIN,OSTWALD,0672072N,123,121,0,2,68,55,5 ème
BAS-RHIN,ROSHEIM,0671913R,180,180,0,0,94,86,5 ème
BAS-RHIN,SARRE-UNION,0670056X,127,113,11,3,56,71,5 ème
BAS-RHIN,SAVERNE,0671986V,114,90,17,7,54,60,5 ème
BAS-RHIN,SCHILTIGHEIM,0670066H,195,174,16,5,92,103,5 ème
BAS-RHIN,SCHIRMECK,0670068K,85,82,0,3,39,46,5 ème
BAS-RHIN,SCHWEIGHOUSE-SUR-MODER,0671960S,111,107,0,4,53,58,5 ème
BAS-RHIN,SELESTAT,0672134F,123,117,0,6,64,59,5 ème
BAS-RHIN,STRASBOURG,0671590P,215,197,16,2,95,120,5 ème
BAS-RHIN,STRASBOURG,0671825V,147,147,0,0,66,81,5 ème
BAS-RHIN,STRASBOURG,0671909L,119,114,0,5,60,59,5 ème
BAS-RHIN,STRASBOURG,0671915T,184,184,0,0,91,93,5 ème
BAS-RHIN,STRASBOURG,0672301M,192,192,0,0,89,103,5 ème
BAS-RHIN,STRASBOURG,0672459J,112,92,17,3,57,55,5 ème
BAS-RHIN,STRASBOURG,0673079H,77,77,0,0,43,34,5 ème
BAS-RHIN,STRASBOURG,0673178R,52,52,0,0,18,34,5 ème
BAS-RHIN,SUNDHOUSE,0670106B,133,129,0,4,75,58,5 ème
BAS-RHIN,TRUCHTERSHEIM,0670107C,143,143,0,0,79,64,5 ème
BAS-RHIN,WOERTH,0671596W,104,101,0,3,49,55,5 ème
HAUT-RHIN,ALTKIRCH,0680001G,0,0,0,0,0,0,5 ème
HAUT-RHIN,CERNAY,0680006M,190,188,0,2,94,96,5 ème
HAUT-RHIN,COLMAR,0680010S,0,0,0,0,0,0,5 ème
HAUT-RHIN,COLMAR,0680088B,141,135,0,6,74,67,5 ème
HAUT-RHIN,COLMAR,0681123B,203,171,28,4,103,100,5 ème
HAUT-RHIN,COLMAR,0681659J,178,178,0,0,73,105,5 ème
HAUT-RHIN,ENSISHEIM,0680013V,195,176,15,4,88,107,5 ème
HAUT-RHIN,HEGENHEIM,0681268J,204,204,0,0,92,112,5 ème
HAUT-RHIN,INGERSHEIM,0681817F,0,0,0,0,0,0,5 ème
HAUT-RHIN,LANDSER,0681660K,149,149,0,0,70,79,5 ème
HAUT-RHIN,MULHOUSE,0680039Y,0,0,0,0,0,0,5 ème
HAUT-RHIN,MULHOUSE,0680111B,173,134,30,9,64,109,5 ème
HAUT-RHIN,MULHOUSE,0681127F,155,135,14,6,70,85,5 ème
HAUT-RHIN,PFASTATT,0681267H,111,107,0,4,56,55,5 ème
HAUT-RHIN,RIBEAUVILLE,0680101R,176,168,7,1,70,106,5 ème
HAUT-RHIN,RIEDISHEIM,0680136D,167,167,0,0,96,71,5 ème
HAUT-RHIN,ROUFFACH,0681366R,104,102,0,2,47,57,5 ème
HAUT-RHIN,THANN,0681368T,160,118,37,5,81,79,5 ème
HAUT-RHIN,WITTELSHEIM,0681888H,0,0,0,0,0,0,5 ème
GUADELOUPE,ANSE-BERTRAND,9710025A,51,51,0,0,30,21,5 ème
GUADELOUPE,BAIE-MAHAULT,9711086D,186,181,0,5,94,92,5 ème
GUADELOUPE,BAILLIF,9710041T,50,50,0,0,28,22,5 ème
GUADELOUPE,BASSE-TERRE,9710985U,124,124,0,0,67,57,5 ème
GUADELOUPE,CAPESTERRE-DE-MARIE-GALANTE,9710032H,18,18,0,0,9,9,5 ème
GUADELOUPE,LE MOULE,9710015P,164,148,13,3,63,101,5 ème
GUADELOUPE,PETIT-CANAL,9710028D,79,76,0,3,42,37,5 ème
GUADELOUPE,POINTE-A-PITRE,9710686U,82,63,16,3,34,48,5 ème
GUADELOUPE,POINTE-A-PITRE,9710722H,0,0,0,0,0,0,5 ème
GUADELOUPE,POINTE-NOIRE,9710029E,65,65,0,0,37,28,5 ème
GUADELOUPE,SAINT-CLAUDE,9710036M,122,122,0,0,50,72,5 ème
GUADELOUPE,SAINTE-ANNE,9710687V,76,72,0,4,45,31,5 ème
GUADELOUPE,SAINT-MARTIN,9710022X,211,190,15,6,110,101,5 ème
GUADELOUPE,TERRE-DE-HAUT,9711155D,9,9,0,0,3,6,5 ème
GUYANE,CAYENNE,9730091L,214,211,0,3,106,108,5 ème
GUYANE,IRACOUBO,9730219A,38,29,8,1,13,25,5 ème
GUYANE,REMIRE-MONTJOLY,9730370P,162,147,0,15,71,91,5 ème
GUYANE,ROURA,9730289B,35,35,0,0,18,17,5 ème
GUYANE,SAINT-LAURENT-DU-MARONI,9730329V,301,276,21,4,158,143,5 ème
AISNE,BELLEU,0021659T,134,134,0,0,65,69,5 ème
AISNE,BOHAIN-EN-VERMANDOIS,0022131F,52,52,0,0,26,26,5 ème
AISNE,CHATEAU-THIERRY,0021724N,165,160,0,5,84,81,5 ème
AISNE,CHAUNY,0022008X,0,0,0,0,0,0,5 ème
AISNE,LA CAPELLE,0021595Y,93,89,0,4,51,42,5 ème
AISNE,LA FERE,0022210S,0,0,0,0,0,0,5 ème
AISNE,LE NOUVION-EN-THIERACHE,0020039G,67,62,0,5,35,32,5 ème
AISNE,LIESSE-NOTRE-DAME,0020472C,38,38,0,0,16,22,5 ème
AISNE,SAINT-GOBAIN,0020046P,75,72,0,3,37,38,5 ème
AISNE,SAINT-MICHEL,0021663X,56,56,0,0,32,24,5 ème
AISNE,SAINT-QUENTIN,0020079A,0,0,0,0,0,0,5 ème
AISNE,SISSONNE,0021686X,101,101,0,0,44,57,5 ème
AISNE,SOISSONS,0021492L,126,111,15,0,72,54,5 ème
AISNE,SOISSONS,0021691C,126,120,0,6,57,69,5 ème
AISNE,SOISSONS,0022180J,9,9,0,0,4,5,5 ème
AISNE,VILLERS-COTTERETS,0021688Z,119,106,8,5,59,60,5 ème
AISNE,WASSIGNY,0020072T,49,48,0,1,15,34,5 ème
OISE,AGNETZ,0601155E,220,218,0,2,97,123,5 ème
OISE,BEAUVAIS,0600007G,151,150,0,1,74,77,5 ème
OISE,BEAUVAIS,0601162M,0,0,0,0,0,0,5 ème
OISE,BORNEL,0602077G,121,116,0,5,60,61,5 ème
OISE,BREUIL-LE-VERT,0601787S,0,0,0,0,0,0,5 ème
OISE,CAUFFRY,0601607W,156,145,9,2,69,87,5 ème
OISE,COMPIEGNE,0601524F,99,78,16,5,46,53,5 ème
OISE,COULOISY,0600028E,132,132,0,0,66,66,5 ème
OISE,CREIL,0600022Y,175,175,0,0,88,87,5 ème
OISE,CREIL,0601177D,181,161,16,4,90,91,5 ème
OISE,ESTREES-SAINT-DENIS,0601432F,238,235,0,3,93,145,5 ème
OISE,FORMERIE,0601469W,110,91,15,4,57,53,5 ème
OISE,GRANDVILLIERS,0600030G,105,99,0,6,51,54,5 ème
OISE,LA CHAPELLE-EN-SERVAL,0601766U,81,81,0,0,36,45,5 ème
OISE,LASSIGNY,0601970R,100,100,0,0,61,39,5 ème
OISE,MAIGNELAY-MONTIGNY,0601180G,100,97,0,3,55,45,5 ème
OISE,MARGNY-LES-COMPIEGNE,0601193W,165,147,16,2,89,76,5 ème
OISE,NOAILLES,0601443T,162,159,0,3,81,81,5 ème
OISE,NOYON,0600041U,0,0,0,0,0,0,5 ème
OISE,NOYON,0601158H,95,95,0,0,50,45,5 ème
OISE,NOYON,0601605U,173,171,0,2,91,82,5 ème
OISE,PONT-SAINTE-MAXENCE,0601296H,115,111,0,4,51,64,5 ème
OISE,SENLIS,0600050D,110,110,0,0,32,78,5 ème
OISE,SENLIS,0601367K,102,89,13,0,54,48,5 ème
SOMME,ABBEVILLE,0801368C,91,91,0,0,43,48,5 ème
SOMME,ABBEVILLE,0801512J,177,156,17,4,78,99,5 ème
SOMME,AILLY-LE-HAUT-CLOCHER,0801372G,85,82,0,3,54,31,5 ème
SOMME,ALBERT,0801375K,99,85,0,14,51,48,5 ème
SOMME,AMIENS,0800013E,0,0,0,0,0,0,5 ème
SOMME,AMIENS,0801263N,113,110,0,3,47,66,5 ème
SOMME,AMIENS,0801533G,116,111,0,5,63,53,5 ème
SOMME,AMIENS,0801628K,0,0,0,0,0,0,5 ème
SOMME,AMIENS,0801949J,0,0,0,0,0,0,5 ème
SOMME,HAM,0801252B,0,0,0,0,0,0,5 ème
SOMME,MONTDIDIER,0801853E,0,0,0,0,0,0,5 ème
SOMME,OISEMONT,0800045P,75,75,0,0,39,36,5 ème
SOMME,PERONNE,0801951L,0,0,0,0,0,0,5 ème
SOMME,ROSIERES-EN-SANTERRE,0800051W,87,85,0,2,49,38,5 ème
SOMME,RUE,0801489J,71,71,0,0,35,36,5 ème
NORD,ANICHE,0592610S,0,0,0,0,0,0,5 ème
NORD,ANZIN,0590006L,144,144,0,0,74,70,5 ème
NORD,ARLEUX,0594401N,192,186,3,3,90,102,5 ème
NORD,ARMENTIERES,0592946G,66,66,0,0,31,35,5 ème
NORD,AVESNES-SUR-HELPE,0595384G,72,72,0,0,28,44,5 ème
NORD,BAVAY,0593490Y,145,140,0,5,71,74,5 ème
NORD,BERGUES,0592933T,121,121,0,0,59,62,5 ème
NORD,BRUAY-SUR-L'ESCAUT,0590031N,138,124,11,3,74,64,5 ème
NORD,CAMBRAI,0593171B,243,240,0,3,119,124,5 ème
NORD,COUDEKERQUE-BRANCHE,0593120W,105,102,3,0,48,57,5 ème
NORD,CYSOING,0590057S,184,179,0,5,95,89,5 ème
NORD,CYSOING,0592960X,227,227,0,0,121,106,5 ème
NORD,DECHY,0590058T,107,107,0,0,49,58,5 ème
NORD,DOUAI,0594402P,141,125,16,0,71,70,5 ème
NORD,DOUAI,0595190W,62,51,11,0,25,37,5 ème
NORD,DUNKERQUE,0593058D,0,0,0,0,0,0,5 ème
NORD,DUNKERQUE,0593663L,111,95,16,0,55,56,5 ème
NORD,DUNKERQUE,0593664M,82,82,0,0,51,31,5 ème
NORD,DUNKERQUE,0593666P,122,104,16,2,53,69,5 ème
NORD,ESTAIRES,0593103C,54,49,5,0,21,33,5 ème
NORD,FLINES-LEZ-RACHES,0590082U,82,82,0,0,46,36,5 ème
NORD,FOURMIES,0595177G,55,55,0,0,33,22,5 ème
NORD,GRAVELINES,0593123Z,85,85,0,0,41,44,5 ème
NORD,HAZEBROUCK,0595170Z,177,177,0,0,78,99,5 ème
NORD,IWUY,0590107W,76,76,0,0,42,34,5 ème
NORD,JEUMONT,0590109Y,79,75,0,4,38,41,5 ème
NORD,LA BASSEE,0592950L,201,201,0,0,110,91,5 ème
NORD,LAMBERSART,0595163S,95,80,15,0,32,63,5 ème
NORD,LEERS,0595713P,123,123,0,0,55,68,5 ème
NORD,LILLE,0590111A,0,0,0,0,0,0,5 ème
NORD,LILLE,0593006X,0,0,0,0,0,0,5 ème
NORD,LILLE,0596957S,0,0,0,0,0,0,5 ème
NORD,LINSELLES,0596172N,82,79,0,3,46,36,5 ème
NORD,LOOS,0590133Z,0,0,0,0,0,0,5 ème
NORD,LOOS,0593233U,97,97,0,0,44,53,5 ème
NORD,LOOS,0594541R,7,6,0,1,2,5,5 ème
NORD,LOURCHES,0594533G,99,97,0,2,58,41,5 ème
NORD,LOUVROIL,0593686L,68,68,0,0,38,30,5 ème
NORD,MARCQ-EN-BAROEUL,0595398X,424,424,0,0,209,215,5 ème
NORD,MARCQ-EN-BAROEUL,0597115N,50,50,0,0,22,28,5 ème
NORD,MAUBEUGE,0590151U,72,70,0,2,41,31,5 ème
NORD,MAUBEUGE,0593254S,75,67,7,1,48,27,5 ème
NORD,MOUVAUX,0594527A,93,80,10,3,47,46,5 ème
NORD,NIEPPE,0596988A,104,102,0,2,50,54,5 ème
NORD,ONNAING,0590157A,118,118,0,0,59,59,5 ème
NORD,QUIEVRECHAIN,0594303G,108,108,0,0,44,64,5 ème
NORD,RONCHIN,0594865T,81,78,0,3,43,38,5 ème
NORD,ROUBAIX,0592886S,125,125,0,0,76,49,5 ème
NORD,ROUBAIX,0592963A,0,0,0,0,0,0,5 ème
NORD,ROUBAIX,0595167W,95,94,0,1,47,48,5 ème
NORD,ROUBAIX,0595302T,257,253,0,4,132,125,5 ème
NORD,SAINT-AMAND-LES-EAUX,0590192N,0,0,0,0,0,0,5 ème
NORD,SAINT-AMAND-LES-EAUX,0594411Z,193,175,13,5,80,113,5 ème
NORD,SECLIN,0592833J,0,0,0,0,0,0,5 ème
NORD,SECLIN,0593662K,118,103,15,0,55,63,5 ème
NORD,SOMAIN,0592976P,0,0,0,0,0,0,5 ème
NORD,TOURCOING,0590217R,0,0,0,0,0,0,5 ème
NORD,TOURCOING,0592965C,0,0,0,0,0,0,5 ème
NORD,TOURCOING,0592980U,0,0,0,0,0,0,5 ème
NORD,VALENCIENNES,0590224Y,145,145,0,0,75,70,5 ème
NORD,VIEUX-CONDE,0594412A,184,164,14,6,77,107,5 ème
NORD,VILLENEUVE-D'ASCQ,0595328W,150,140,10,0,78,72,5 ème
NORD,VILLENEUVE-D'ASCQ,0595404D,344,344,0,0,175,169,5 ème
NORD,WATTIGNIES,0595597N,116,116,0,0,57,59,5 ème
NORD,WATTRELOS,0593160P,364,364,0,0,185,179,5 ème
NORD,WATTRELOS,0594392D,75,75,0,0,40,35,5 ème
NORD,WATTRELOS,0595169Y,70,70,0,0,27,43,5 ème
NORD,WORMHOUT,0594643B,129,129,0,0,65,64,5 ème
PAS-DE-CALAIS,AIRE-SUR-LA-LYS,0622100W,247,247,0,0,112,135,5 ème
PAS-DE-CALAIS,ARRAS,0620011A,0,0,0,0,0,0,5 ème
PAS-DE-CALAIS,ARRAS,0622789V,82,73,6,3,36,46,5 ème
PAS-DE-CALAIS,ARRAS,0624343J,77,59,13,5,25,52,5 ème
PAS-DE-CALAIS,AUCHEL,0623313P,86,86,0,0,46,40,5 ème
PAS-DE-CALAIS,AUCHY-LES-HESDIN,0622097T,47,47,0,0,16,31,5 ème
PAS-DE-CALAIS,AUXI-LE-CHATEAU,0620025R,45,45,0,0,21,24,5 ème
PAS-DE-CALAIS,AVESNES-LE-COMTE,0620026S,109,92,14,3,53,56,5 ème
PAS-DE-CALAIS,AVION,0622420U,102,85,13,4,38,64,5 ème
PAS-DE-CALAIS,AVION,0622422W,123,123,0,0,49,74,5 ème
PAS-DE-CALAIS,BETHUNE,0622129C,140,140,0,0,77,63,5 ème
PAS-DE-CALAIS,BETHUNE,0622947S,170,155,15,0,78,92,5 ème
PAS-DE-CALAIS,BRUAY-LA-BUISSIERE,0623314R,95,95,0,0,48,47,5 ème
PAS-DE-CALAIS,CALAIS,0622211S,0,0,0,0,0,0,5 ème
PAS-DE-CALAIS,COULOGNE,0620073T,128,123,0,5,67,61,5 ème
PAS-DE-CALAIS,COURCELLES-LES-LENS,0622943M,140,120,16,4,65,75,5 ème
PAS-DE-CALAIS,DESVRES,0622135J,47,47,0,0,26,21,5 ème
PAS-DE-CALAIS,FRUGES,0620085F,70,70,0,0,33,37,5 ème
PAS-DE-CALAIS,HENIN-BEAUMONT,0623328F,0,0,0,0,0,0,5 ème
PAS-DE-CALAIS,HERSIN-COUPIGNY,0620097U,83,83,0,0,40,43,5 ème
PAS-DE-CALAIS,LAVENTIE,0622427B,157,157,0,0,71,86,5 ème
PAS-DE-CALAIS,LENS,0622115M,255,254,0,1,103,152,5 ème
PAS-DE-CALAIS,LE PORTEL,0622095R,132,120,12,0,61,71,5 ème
PAS-DE-CALAIS,LIEVIN,0623377J,0,0,0,0,0,0,5 ème
PAS-DE-CALAIS,MARCK,0622873L,166,166,0,0,88,78,5 ème
PAS-DE-CALAIS,MARLES-LES-MINES,0622272H,118,115,0,3,60,58,5 ème
PAS-DE-CALAIS,NORRENT-FONTES,0620195A,101,101,0,0,51,50,5 ème
PAS-DE-CALAIS,NOYELLES-SOUS-LENS,0623016S,102,98,0,4,52,50,5 ème
PAS-DE-CALAIS,OUTREAU,0620221D,0,0,0,0,0,0,5 ème
PAS-DE-CALAIS,PAS-EN-ARTOIS,0623112W,108,108,0,0,54,54,5 ème
PAS-DE-CALAIS,SAINT-OMER,0620165T,149,148,0,1,77,72,5 ème
PAS-DE-CALAIS,SAINT-OMER,0622119S,36,33,0,3,18,18,5 ème
PAS-DE-CALAIS,SAINT-POL-SUR-TERNOISE,0622790W,147,129,15,3,74,73,5 ème
PAS-DE-CALAIS,THEROUANNE,0620172A,164,161,0,3,79,85,5 ème
PAS-DE-CALAIS,VERMELLES,0623022Y,117,113,0,4,62,55,5 ème
SEINE-ET-MARNE,AVON,0771422C,148,127,16,5,69,79,5 ème
SEINE-ET-MARNE,CESSON,0771662N,111,111,0,0,41,70,5 ème
SEINE-ET-MARNE,CHAMPAGNE-SUR-SEINE,0771342R,175,160,12,3,86,89,5 ème
SEINE-ET-MARNE,CHELLES,0771766B,182,163,15,4,91,91,5 ème
SEINE-ET-MARNE,COULOMMIERS,0770924L,0,0,0,0,0,0,5 ème
SEINE-ET-MARNE,CRECY-LA-CHAPELLE,0771667U,185,182,0,3,86,99,5 ème
SEINE-ET-MARNE,CREGY-LES-MEAUX,0772248A,164,162,0,2,70,94,5 ème
SEINE-ET-MARNE,FONTAINEBLEAU,0771424E,117,117,0,0,65,52,5 ème
SEINE-ET-MARNE,JUILLY,0771917R,128,128,0,0,70,58,5 ème
SEINE-ET-MARNE,LA FERTE-GAUCHER,0771661M,146,129,15,2,64,82,5 ème
SEINE-ET-MARNE,LA FERTE-SOUS-JOUARRE,0771222K,113,113,0,0,54,59,5 ème
SEINE-ET-MARNE,LA FERTE-SOUS-JOUARRE,0771659K,136,120,16,0,63,73,5 ème
SEINE-ET-MARNE,LAGNY-SUR-MARNE,0771768D,138,122,16,0,67,71,5 ème
SEINE-ET-MARNE,LE MEE-SUR-SEINE,0772056S,146,146,0,0,73,73,5 ème
SEINE-ET-MARNE,LIEUSAINT,0772429X,112,108,0,4,56,56,5 ème
SEINE-ET-MARNE,LOGNES,0772125S,102,102,0,0,50,52,5 ème
SEINE-ET-MARNE,LORREZ-LE-BOCAGE-PREAUX,0770030P,142,136,0,6,62,80,5 ème
SEINE-ET-MARNE,MEAUX,0771029A,193,193,0,0,100,93,5 ème
SEINE-ET-MARNE,MEAUX,0771173G,146,146,0,0,61,85,5 ème
SEINE-ET-MARNE,MELUN,0770934X,0,0,0,0,0,0,5 ème
SEINE-ET-MARNE,MITRY-MORY,0771331D,151,137,14,0,83,68,5 ème
SEINE-ET-MARNE,MONTEREAU-FAULT-YONNE,0771174H,130,130,0,0,68,62,5 ème
SEINE-ET-MARNE,NOISIEL,0771940R,0,0,0,0,0,0,5 ème
SEINE-ET-MARNE,PERTHES,0772427V,134,134,0,0,69,65,5 ème
SEINE-ET-MARNE,ROISSY-EN-BRIE,0771563F,147,147,0,0,79,68,5 ème
SEINE-ET-MARNE,SAINT-GERMAIN-SUR-MORIN,0772714G,137,130,0,7,67,70,5 ème
SEINE-ET-MARNE,SAINT-THIBAULT-DES-VIGNES,0772154Y,148,146,0,2,69,79,5 ème
SEINE-ET-MARNE,TRILPORT,0772091E,147,144,0,3,75,72,5 ème
SEINE-ET-MARNE,VILLEPARISIS,0771878Y,140,124,15,1,72,68,5 ème
SEINE-SAINT-DENIS,AUBERVILLIERS,0930903B,117,117,0,0,55,62,5 ème
SEINE-SAINT-DENIS,AUBERVILLIERS,0932122B,0,0,0,0,0,0,5 ème
SEINE-SAINT-DENIS,AULNAY-SOUS-BOIS,0930846P,0,0,0,0,0,0,5 ème
SEINE-SAINT-DENIS,AULNAY-SOUS-BOIS,0931434D,170,163,0,7,89,81,5 ème
SEINE-SAINT-DENIS,AULNAY-SOUS-BOIS,0932652C,64,64,0,0,41,23,5 ème
SEINE-SAINT-DENIS,DRANCY,0930892P,147,147,0,0,73,74,5 ème
SEINE-SAINT-DENIS,DUGNY,0931376R,168,163,0,5,77,91,5 ème
SEINE-SAINT-DENIS,EPINAY-SUR-SEINE,0931145P,202,186,16,0,98,104,5 ème
SEINE-SAINT-DENIS,EPINAY-SUR-SEINE,0931207G,138,136,0,2,63,75,5 ème
SEINE-SAINT-DENIS,LA COURNEUVE,0931188L,167,159,0,8,79,88,5 ème
SEINE-SAINT-DENIS,LA COURNEUVE,0931738J,0,0,0,0,0,0,5 ème
SEINE-SAINT-DENIS,LE RAINCY,0930629D,163,163,0,0,77,86,5 ème
SEINE-SAINT-DENIS,LES PAVILLONS-SOUS-BOIS,0930089S,142,138,0,4,65,77,5 ème
SEINE-SAINT-DENIS,LES PAVILLONS-SOUS-BOIS,0930966V,79,79,0,0,42,37,5 ème
SEINE-SAINT-DENIS,MONTREUIL,0931210K,151,147,0,4,71,80,5 ème
SEINE-SAINT-DENIS,NEUILLY-PLAISANCE,0930623X,202,201,0,1,97,105,5 ème
SEINE-SAINT-DENIS,NEUILLY-SUR-MARNE,0930894S,206,188,16,2,98,108,5 ème
SEINE-SAINT-DENIS,NOISY-LE-GRAND,0931369H,0,0,0,0,0,0,5 ème
SEINE-SAINT-DENIS,NOISY-LE-SEC,0931710D,134,134,0,0,78,56,5 ème
SEINE-SAINT-DENIS,NOISY-LE-SEC,0931883S,94,93,0,1,47,47,5 ème
SEINE-SAINT-DENIS,PANTIN,0931217T,141,137,0,4,62,79,5 ème
SEINE-SAINT-DENIS,PANTIN,0931218U,119,119,0,0,61,58,5 ème
SEINE-SAINT-DENIS,PANTIN,0931764M,14,14,0,0,5,9,5 ème
SEINE-SAINT-DENIS,ROSNY-SOUS-BOIS,0930593P,200,184,16,0,96,104,5 ème
SEINE-SAINT-DENIS,ROSNY-SOUS-BOIS,0931723T,135,132,0,3,62,73,5 ème
SEINE-SAINT-DENIS,SAINT-DENIS,0930138V,0,0,0,0,0,0,5 ème
SEINE-SAINT-DENIS,SAINT-DENIS,0931232J,143,122,14,7,61,82,5 ème
SEINE-SAINT-DENIS,SAINT-DENIS,0932582B,143,137,0,6,74,69,5 ème
SEINE-SAINT-DENIS,SEVRAN,0931190N,167,151,16,0,90,77,5 ème
SEINE-SAINT-DENIS,SEVRAN,0932262D,154,154,0,0,78,76,5 ème
SEINE-SAINT-DENIS,TREMBLAY-EN-FRANCE,0931193S,0,0,0,0,0,0,5 ème
SEINE-SAINT-DENIS,VAUJOURS,0932301W,132,132,0,0,72,60,5 ème
SEINE-SAINT-DENIS,VILLEPINTE,0931192R,153,151,0,2,78,75,5 ème
VAL-DE-MARNE,BONNEUIL-SUR-MARNE,0940171A,10,0,10,0,2,8,5 ème
VAL-DE-MARNE,CHARENTON-LE-PONT,0941353K,158,158,0,0,99,59,5 ème
VAL-DE-MARNE,CHOISY-LE-ROI,0940141T,0,0,0,0,0,0,5 ème
VAL-DE-MARNE,CHOISY-LE-ROI,0941710Y,135,135,0,0,64,71,5 ème
VAL-DE-MARNE,CRETEIL,0940521F,116,116,0,0,57,59,5 ème
VAL-DE-MARNE,CRETEIL,0940884A,120,120,0,0,63,57,5 ème
VAL-DE-MARNE,CRETEIL,0942127B,143,139,0,4,67,76,5 ème
VAL-DE-MARNE,IVRY-SUR-SEINE,0941781A,149,149,0,0,84,65,5 ème
VAL-DE-MARNE,LE KREMLIN-BICETRE,0940809U,95,93,0,2,49,46,5 ème
VAL-DE-MARNE,LE KREMLIN-BICETRE,0941679P,91,91,0,0,45,46,5 ème
VAL-DE-MARNE,LIMEIL-BREVANNES,0941603G,128,110,15,3,58,70,5 ème
VAL-DE-MARNE,MAISONS-ALFORT,0941596Z,166,144,14,8,79,87,5 ème
VAL-DE-MARNE,ORMESSON-SUR-MARNE,0941017V,120,115,0,5,67,53,5 ème
VAL-DE-MARNE,SAINT-MANDE,0940024R,39,39,0,0,20,19,5 ème
VAL-DE-MARNE,SAINT-MAUR-DES-FOSSES,0940879V,117,117,0,0,65,52,5 ème
VAL-DE-MARNE,THIAIS,0940090M,175,175,0,0,87,88,5 ème
VAL-DE-MARNE,VILLEJUIF,0941039U,98,92,0,6,45,53,5 ème
VAL-DE-MARNE,VILLENEUVE-LE-ROI,0941602F,85,80,0,5,46,39,5 ème
VAL-DE-MARNE,VILLENEUVE-SAINT-GEORGES,0940791Z,152,136,16,0,75,77,5 ème
VAL-DE-MARNE,VILLENEUVE-SAINT-GEORGES,0941952L,0,0,0,0,0,0,5 ème
VAL-DE-MARNE,VILLIERS-SUR-MARNE,0941411Y,169,159,10,0,88,81,5 ème
VAL-DE-MARNE,VINCENNES,0940793B,177,177,0,0,75,102,5 ème
VAL-DE-MARNE,VITRY-SUR-SEINE,0940874P,94,94,0,0,56,38,5 ème
VAL-DE-MARNE,VITRY-SUR-SEINE,0941032L,102,102,0,0,50,52,5 ème
VAL-DE-MARNE,VITRY-SUR-SEINE,0941294W,0,0,0,0,0,0,5 ème
PARIS,PARIS,0750362L,103,100,0,3,53,50,5 ème
PARIS,PARIS,0750465Y,99,98,0,1,51,48,5 ème
PARIS,PARIS,0750558Z,0,0,0,0,0,0,5 ème
PARIS,PARIS,0752537A,116,114,0,2,51,65,5 ème
PARIS,PARIS,0752911G,118,113,0,5,54,64,5 ème
PARIS,PARIS,0752934G,265,263,0,2,135,130,5 ème
PARIS,PARIS,0753518S,133,129,0,4,70,63,5 ème
PARIS,PARIS,0753985Z,141,138,0,3,76,65,5 ème
PARIS,PARIS,0754861B,7,0,0,7,4,3,5 ème
PARIS,PARIS,0755000C,128,128,0,0,62,66,5 ème
PARIS,PARIS,0752544H,125,125,0,0,65,60,5 ème
PARIS,PARIS,0755840R,53,53,0,0,22,31,5 ème
PARIS,PARIS,0750436S,0,0,0,0,0,0,5 ème
PARIS,PARIS,0750793E,0,0,0,0,0,0,5 ème
PARIS,PARIS,0752192A,111,107,0,4,55,56,5 ème
PARIS,PARIS,0752317L,110,110,0,0,52,58,5 ème
PARIS,PARIS,0752870M,272,272,0,0,111,161,5 ème
PARIS,PARIS,0752897S,155,155,0,0,88,67,5 ème
PARIS,PARIS,0752918P,153,153,0,0,99,54,5 ème
PARIS,PARIS,0755779Z,113,103,10,0,55,58,5 ème
PARIS,PARIS,0752195D,70,67,0,3,33,37,5 ème
PARIS,PARIS,0750575T,87,86,0,1,45,42,5 ème
PARIS,PARIS,0751707Y,102,86,11,5,48,54,5 ème
PARIS,PARIS,0753938Y,112,112,0,0,58,54,5 ème
PARIS,PARIS,0754004V,129,129,0,0,63,66,5 ème
PARIS,PARIS,0750552T,114,110,0,4,44,70,5 ème
PARIS,PARIS,0752198G,115,98,15,2,53,62,5 ème
PARIS,PARIS,0753939Z,74,74,0,0,32,42,5 ème
PARIS,PARIS,0752525M,115,115,0,0,60,55,5 ème
PARIS,PARIS,0752920S,148,148,0,0,73,75,5 ème
PARIS,PARIS,0752186U,115,115,0,0,48,67,5 ème
PARIS,PARIS,0752531U,93,92,0,1,55,38,5 ème
PARIS,PARIS,0752925X,79,79,0,0,43,36,5 ème
PARIS,PARIS,0754008Z,15,12,0,3,5,10,5 ème
PARIS,PARIS,0754029X,0,0,0,0,0,0,5 ème
PARIS,PARIS,0753854G,19,19,0,0,19,0,5 ème
PARIS,PARIS,0751791P,180,180,0,0,76,104,5 ème
PARIS,PARIS,0752529S,119,116,0,3,60,59,5 ème
PARIS,PARIS,0752532V,140,138,0,2,73,67,5 ème
PARIS,PARIS,0752916M,18,8,0,10,6,12,5 ème
ESSONNE,BONDOUFLE,0911340M,204,201,0,3,99,105,5 ème
ESSONNE,BRETIGNY-SUR-ORGE,0911039K,238,236,0,2,116,122,5 ème
ESSONNE,CROSNE,0910979V,263,261,0,2,132,131,5 ème
ESSONNE,DOURDAN,0911491B,190,175,14,1,91,99,5 ème
ESSONNE,DRAVEIL,0910830H,93,93,0,0,46,47,5 ème
ESSONNE,DRAVEIL,0910973N,143,126,13,4,63,80,5 ème
ESSONNE,EPINAY-SOUS-SENART,0911397Z,180,177,0,3,84,96,5 ème
ESSONNE,ETAMPES,0910717K,139,139,0,0,79,60,5 ème
ESSONNE,ETAMPES,0911150F,153,150,0,3,74,79,5 ème
ESSONNE,ETAMPES,0911401D,0,0,0,0,0,0,5 ème
ESSONNE,GRIGNY,0911253T,141,139,0,2,72,69,5 ème
ESSONNE,IGNY,0911824N,58,58,0,0,21,37,5 ème
ESSONNE,LES ULIS,0911334F,169,150,15,4,88,81,5 ème
ESSONNE,LONGJUMEAU,0910718L,196,196,0,0,98,98,5 ème
ESSONNE,MASSY,0910624J,140,136,0,4,75,65,5 ème
ESSONNE,ORSAY,0910968H,150,147,0,3,68,82,5 ème
ESSONNE,PALAISEAU,0910045E,116,116,0,0,63,53,5 ème
ESSONNE,PALAISEAU,0912321D,0,0,0,0,0,0,5 ème
ESSONNE,PARAY-VIEILLE-POSTE,0911441X,115,115,0,0,70,45,5 ème
ESSONNE,SAINT-CHERON,0911256W,182,178,0,4,99,83,5 ème
ESSONNE,SAINT-MICHEL-SUR-ORGE,0910775Y,191,191,0,0,103,88,5 ème
ESSONNE,SAULX-LES-CHARTREUX,0911029Z,192,176,13,3,101,91,5 ème
ESSONNE,VERRIERES-LE-BUISSON,0910057T,126,126,0,0,62,64,5 ème
ESSONNE,VIGNEUX-SUR-SEINE,0910776Z,182,179,0,3,98,84,5 ème
ESSONNE,VIRY-CHATILLON,0910060W,133,133,0,0,71,62,5 ème
ESSONNE,YERRES,0910756C,0,0,0,0,0,0,5 ème
HAUTS-DE-SEINE,ANTONY,0921170X,146,144,0,2,55,91,5 ème
HAUTS-DE-SEINE,ASNIERES-SUR-SEINE,0921547G,167,166,0,1,96,71,5 ème
HAUTS-DE-SEINE,BAGNEUX,0921168V,128,119,8,1,58,70,5 ème
HAUTS-DE-SEINE,CHATENAY-MALABRY,0921179G,68,67,0,1,35,33,5 ème
HAUTS-DE-SEINE,CHATILLON,0921354X,116,116,0,0,59,57,5 ème
HAUTS-DE-SEINE,COURBEVOIE,0920999L,126,126,0,0,67,59,5 ème
HAUTS-DE-SEINE,FONTENAY-AUX-ROSES,0920963X,0,0,0,0,0,0,5 ème
HAUTS-DE-SEINE,GENNEVILLIERS,0921157H,233,233,0,0,121,112,5 ème
HAUTS-DE-SEINE,LA GARENNE-COLOMBES,0922645A,146,142,0,4,78,68,5 ème
HAUTS-DE-SEINE,LEVALLOIS-PERRET,0921393P,168,167,0,1,81,87,5 ème
HAUTS-DE-SEINE,MALAKOFF,0921165S,112,110,0,2,50,62,5 ème
HAUTS-DE-SEINE,MEUDON,0922450N,225,225,0,0,119,106,5 ème
HAUTS-DE-SEINE,MONTROUGE,0921504K,131,122,0,9,63,68,5 ème
HAUTS-DE-SEINE,NANTERRE,0921394R,114,97,13,4,61,53,5 ème
HAUTS-DE-SEINE,NANTERRE,0922579D,22,22,0,0,14,8,5 ème
HAUTS-DE-SEINE,NEUILLY-SUR-SEINE,0921780K,181,181,0,0,78,103,5 ème
HAUTS-DE-SEINE,NEUILLY-SUR-SEINE,0921913E,204,204,0,0,102,102,5 ème
HAUTS-DE-SEINE,NEUILLY-SUR-SEINE,0921914F,200,195,0,5,106,94,5 ème
HAUTS-DE-SEINE,RUEIL-MALMAISON,0921501G,147,143,0,4,74,73,5 ème
HAUTS-DE-SEINE,SAINT-CLOUD,0921591E,215,215,0,0,107,108,5 ème
HAUTS-DE-SEINE,SEVRES,0920936T,34,34,0,0,17,17,5 ème
HAUTS-DE-SEINE,SURESNES,0920885M,103,96,7,0,57,46,5 ème
HAUTS-DE-SEINE,SURESNES,0921178F,107,107,0,0,58,49,5 ème
HAUTS-DE-SEINE,VAUCRESSON,0921919L,13,13,0,0,6,7,5 ème
HAUTS-DE-SEINE,VILLENEUVE-LA-GARENNE,0921159K,168,165,0,3,90,78,5 ème
VAL-D'OISE,ARGENTEUIL,0950788R,127,125,0,2,68,59,5 ème
VAL-D'OISE,ARGENTEUIL,0950885W,132,129,0,3,74,58,5 ème
VAL-D'OISE,ARGENTEUIL,0950886X,143,126,13,4,60,83,5 ème
VAL-D'OISE,BESSANCOURT,0951400F,151,151,0,0,66,85,5 ème
VAL-D'OISE,CERGY,0951964U,140,131,0,9,63,77,5 ème
VAL-D'OISE,CORMEILLES-EN-PARISIS,0952236P,84,80,0,4,32,52,5 ème
VAL-D'OISE,EAUBONNE,0950892D,151,151,0,0,80,71,5 ème
VAL-D'OISE,ERAGNY,0951194G,162,160,0,2,84,78,5 ème
VAL-D'OISE,GONESSE,0950025L,149,147,0,2,76,73,5 ème
VAL-D'OISE,GONESSE,0951142A,146,135,7,4,83,63,5 ème
VAL-D'OISE,GOUSSAINVILLE,0951921X,178,169,0,9,91,87,5 ème
VAL-D'OISE,JOUY-LE-MOUTIER,0951801S,103,100,0,3,55,48,5 ème
VAL-D'OISE,LOUVRES,0952145R,129,129,0,0,69,60,5 ème
VAL-D'OISE,MAGNY-EN-VEXIN,0951102G,118,117,0,1,73,45,5 ème
VAL-D'OISE,MARLY-LA-VILLE,0951919V,152,152,0,0,66,86,5 ème
VAL-D'OISE,MONTMAGNY,0951141Z,138,134,0,4,65,73,5 ème
VAL-D'OISE,MONTMAGNY,0952010U,21,21,0,0,6,15,5 ème
VAL-D'OISE,MONTMORENCY,0950891C,134,117,14,3,57,77,5 ème
VAL-D'OISE,OSNY,0951403J,129,126,0,3,59,70,5 ème
VAL-D'OISE,PONTOISE,0950896H,145,128,15,2,72,73,5 ème
VAL-D'OISE,SAINT-BRICE-SOUS-FORET,0950931W,150,142,0,8,61,89,5 ème
VAL-D'OISE,SAINT-LEU-LA-FORET,0950748X,142,142,0,0,71,71,5 ème
VAL-D'OISE,SAINT-LEU-LA-FORET,0950763N,189,189,0,0,104,85,5 ème
VAL-D'OISE,TAVERNY,0950945L,139,130,9,0,58,81,5 ème
VAL-D'OISE,VIARMES,0951052C,175,175,0,0,81,94,5 ème
VAL-D'OISE,VILLIERS-LE-BEL,0950939E,183,168,11,4,94,89,5 ème
YVELINES,ACHERES,0783248G,153,136,12,5,64,89,5 ème
YVELINES,BOIS-D'ARCY,0780261K,200,195,0,5,105,95,5 ème
YVELINES,BONNIERES-SUR-SEINE,0783300N,83,83,0,0,34,49,5 ème
YVELINES,CARRIERES-SUR-SEINE,0780033M,180,180,0,0,91,89,5 ème
YVELINES,CONFLANS-SAINTE-HONORINE,0781985J,149,149,0,0,64,85,5 ème
YVELINES,JOUARS-PONTCHARTRAIN,0781632A,157,153,0,4,78,79,5 ème
YVELINES,LA CELLE-SAINT-CLOUD,0780504Z,110,110,0,0,57,53,5 ème
YVELINES,LE MESNIL-SAINT-DENIS,0783342J,110,110,0,0,60,50,5 ème
YVELINES,LE PECQ,0780263M,171,155,16,0,75,96,5 ème
YVELINES,LE PECQ,0783215W,87,79,0,8,40,47,5 ème
YVELINES,LES CLAYES-SOUS-BOIS,0780760C,132,131,0,1,65,67,5 ème
YVELINES,LE VESINET,0781594J,168,167,0,1,75,93,5 ème
YVELINES,MAISONS-LAFFITTE,0783156G,151,147,0,4,79,72,5 ème
YVELINES,MAULE,0780709X,202,202,0,0,80,122,5 ème
YVELINES,MONTESSON,0780578E,151,149,0,2,66,85,5 ème
YVELINES,POISSY,0781591F,177,177,0,0,100,77,5 ème
YVELINES,SAINT-ARNOULT-EN-YVELINES,0780712A,195,195,0,0,98,97,5 ème
YVELINES,SAINT-CYR-L'ECOLE,0782593V,0,0,0,0,0,0,5 ème
YVELINES,SARTROUVILLE,0780258G,213,200,13,0,105,108,5 ème
YVELINES,TRAPPES,0780514K,186,186,0,0,96,90,5 ème
YVELINES,TRAPPES,0780584L,0,0,0,0,0,0,5 ème
YVELINES,VERSAILLES,0780580G,119,119,0,0,42,77,5 ème
YVELINES,VERSAILLES,0780718G,106,104,0,2,61,45,5 ème
YVELINES,VERSAILLES,0781597M,387,385,0,2,165,222,5 ème
YVELINES,VERSAILLES,0783295H,246,246,0,0,126,120,5 ème
YVELINES,VOISINS-LE-BRETONNEUX,0781570H,133,133,0,0,70,63,5 ème
LA REUNION,LA POSSESSION,9741236A,185,182,0,3,91,94,5 ème
LA REUNION,LE PORT,9741313J,127,107,16,4,56,71,5 ème
LA REUNION,LE TAMPON,9740620F,209,203,0,6,94,115,5 ème
LA REUNION,LE TAMPON,9740652R,221,184,31,6,108,113,5 ème
LA REUNION,LE TAMPON,9741088P,89,87,0,2,42,47,5 ème
LA REUNION,LE TAMPON,9741262D,153,149,0,4,77,76,5 ème
LA REUNION,L'ETANG-SALE,9740813R,143,140,0,3,71,72,5 ème
LA REUNION,SAINT-ANDRE,9741261C,176,174,0,2,91,85,5 ème
LA REUNION,SAINT-BENOIT,9741366S,182,176,0,6,91,91,5 ème
LA REUNION,SAINT-BENOIT,9741546M,152,137,15,0,68,84,5 ème
LA REUNION,SAINT-DENIS,9740042C,177,163,11,3,94,83,5 ème
LA REUNION,SAINT-DENIS,9741208V,119,115,0,4,63,56,5 ème
LA REUNION,SAINTE-MARIE,9740022F,129,125,0,4,71,58,5 ème
LA REUNION,SAINTE-SUZANNE,9741237B,222,219,0,3,113,109,5 ème
LA REUNION,SAINT-JOSEPH,9740578K,217,213,0,4,106,111,5 ème
LA REUNION,SAINT-LOUIS,9740012V,180,176,0,4,80,100,5 ème
LA REUNION,SAINT-LOUIS,9740091F,199,195,0,4,104,95,5 ème
LA REUNION,SAINT-PIERRE,9741630D,64,64,0,0,33,31,5 ème
MARTINIQUE,GROS-MORNE,9720012F,88,84,3,1,41,47,5 ème
MARTINIQUE,LA TRINITE,9720025V,74,72,0,2,26,48,5 ème
MARTINIQUE,LA TRINITE,9720351Z,66,50,16,0,34,32,5 ème
MARTINIQUE,LE LORRAIN,9720726G,0,0,0,0,0,0,5 ème
MARTINIQUE,LE MARIN,9720468B,0,0,0,0,0,0,5 ème
MARTINIQUE,LE ROBERT,9720861D,112,94,16,2,55,57,5 ème
MARTINIQUE,LES ANSES-D'ARLET,9720565G,26,18,8,0,11,15,5 ème
MARTINIQUE,RIVIERE-SALEE,9720725F,0,0,0,0,0,0,5 ème
MARTINIQUE,SAINTE-LUCE,9720449F,57,52,0,5,30,27,5 ème
MARTINIQUE,SAINTE-LUCE,9720776L,116,116,0,0,47,69,5 ème
MARTINIQUE,SAINT-ESPRIT,9720020P,95,90,0,5,48,47,5 ème
MAYOTTE,MAMOUDZOU,9760009F,372,368,0,4,201,171,5 ème
MAYOTTE,MAMOUDZOU,9760368W,392,356,33,3,196,196,5 ème
MAYOTTE,OUANGANI,9760371Z,310,275,32,3,153,157,5 ème
MAYOTTE,PAMANDZI,9760183V,378,375,0,3,208,170,5 ème
MAYOTTE,SADA,9760180S,275,274,0,1,143,132,5 ème
CALVADOS,BLAINVILLE-SUR-ORNE,0141940H,88,85,0,3,38,50,5 ème
CALVADOS,CAEN,0140019V,0,0,0,0,0,0,5 ème
CALVADOS,CAEN,0141160K,212,212,0,0,115,97,5 ème
CALVADOS,CAEN,0141212S,122,120,0,2,72,50,5 ème
CALVADOS,CAEN,0141313B,75,70,0,5,34,41,5 ème
CALVADOS,DEAUVILLE,0141192V,0,0,0,0,0,0,5 ème
CALVADOS,DIVES-SUR-MER,0141270E,70,56,13,1,34,36,5 ème
CALVADOS,DOUVRES-LA-DELIVRANDE,0140049C,117,117,0,0,71,46,5 ème
CALVADOS,DOZULE,0140050D,91,88,0,3,43,48,5 ème
CALVADOS,FLEURY-SUR-ORNE,0141553M,91,87,0,4,49,42,5 ème
CALVADOS,HONFLEUR,0141168U,22,22,0,0,8,14,5 ème
CALVADOS,HONFLEUR,0141765T,119,119,0,0,64,55,5 ème
CALVADOS,LISIEUX,0141135H,148,131,17,0,85,63,5 ème
CALVADOS,LISIEUX,0141315D,71,70,0,1,39,32,5 ème
CALVADOS,LISIEUX,0141862Y,139,139,0,0,74,65,5 ème
CALVADOS,SAINT-PIERRE-EN-AUGE,0141226G,108,108,0,0,57,51,5 ème
CALVADOS,SAINT-PIERRE-EN-AUGE,0141272G,99,96,0,3,50,49,5 ème
CALVADOS,TILLY-SUR-SEULLES,0140081M,132,132,0,0,60,72,5 ème
CALVADOS,VIRE NORMANDIE,0141864A,61,61,0,0,27,34,5 ème
CALVADOS,VIRE NORMANDIE,0142145F,57,55,0,2,24,33,5 ème
CALVADOS,VIRE NORMANDIE,0142178S,0,0,0,0,0,0,5 ème
EURE,BEAUMONT-LE-ROGER,0271267F,120,118,0,2,55,65,5 ème
EURE,BERNAY,0271448C,62,62,0,0,33,29,5 ème
EURE,BERNAY,0271581X,0,0,0,0,0,0,5 ème
EURE,BRETEUIL,0270008M,70,70,0,0,33,37,5 ème
EURE,BRIONNE,0270010P,155,138,15,2,69,86,5 ème
EURE,CONCHES-EN-OUCHE,0271094T,162,160,0,2,74,88,5 ème
EURE,ETREPAGNY,0271106F,160,160,0,0,85,75,5 ème
EURE,EVREUX,0270020A,128,126,0,2,65,63,5 ème
EURE,EVREUX,0271070S,0,0,0,0,0,0,5 ème
EURE,GAILLON,0270025F,138,135,0,3,74,64,5 ème
EURE,GISORS,0271047S,77,77,0,0,37,40,5 ème
EURE,LOUVIERS,0271398Y,110,110,0,0,59,51,5 ème
EURE,MESNILS-SUR-ITON,0271060F,145,145,0,0,70,75,5 ème
EURE,NONANCOURT,0270033P,165,165,0,0,80,85,5 ème
EURE,THIBERVILLE,0271099Y,82,82,0,0,42,40,5 ème
EURE,VERNEUIL D'AVRE ET D'ITON,0270043A,156,138,15,3,87,69,5 ème
EURE,VERNON,0271289E,124,111,13,0,68,56,5 ème
EURE,VERNON,0271399Z,75,69,0,6,36,39,5 ème
MANCHE,AGNEAUX,0501701C,136,136,0,0,75,61,5 ème
MANCHE,CARENTAN-LES-MARAIS,0500012S,83,81,0,2,46,37,5 ème
MANCHE,CHERBOURG-EN-COTENTIN,0500034R,106,106,0,0,58,48,5 ème
MANCHE,CHERBOURG-EN-COTENTIN,0500062W,108,105,0,3,47,61,5 ème
MANCHE,CHERBOURG-EN-COTENTIN,0501788X,0,0,0,0,0,0,5 ème
MANCHE,MONTEBOURG,0501201J,34,34,0,0,18,16,5 ème
MANCHE,PORT-BAIL-SUR-MER,0501217B,53,53,0,0,25,28,5 ème
MANCHE,SAINT-CLAIR-SUR-L'ELLE,0500059T,69,64,0,5,30,39,5 ème
MANCHE,SAINT-LO,0500094F,79,75,0,4,45,34,5 ème
MANCHE,SAINT-LO,0500150S,72,69,0,3,31,41,5 ème
MANCHE,SAINT-LO,0501789Y,0,0,0,0,0,0,5 ème
MANCHE,SAINT-PIERRE-EGLISE,0500069D,70,70,0,0,34,36,5 ème
MANCHE,SAINT-SAUVEUR-LE-VICOMTE,0500072G,52,47,0,5,25,27,5 ème
MANCHE,SAINT-SAUVEUR-VILLAGES,0500071F,69,69,0,0,28,41,5 ème
MANCHE,VALOGNES,0500096H,143,139,0,4,74,69,5 ème
ORNE,ALENCON,0610002W,0,0,0,0,0,0,5 ème
ORNE,ATHIS-VAL DE ROUVRE,0610051Z,67,67,0,0,40,27,5 ème
ORNE,GACE,0610958K,58,58,0,0,32,26,5 ème
ORNE,GIEL-COURTEILLES,0610699D,18,18,0,0,4,14,5 ème
ORNE,LA FERRIERE-AUX-ETANGS,0610017M,66,66,0,0,36,30,5 ème
ORNE,L'AIGLE,0610026X,0,0,0,0,0,0,5 ème
ORNE,VAL-AU-PERCHE,0610959L,59,59,0,0,24,35,5 ème
SEINE MARITIME,BOLBEC,0760013B,0,0,0,0,0,0,5 ème
SEINE MARITIME,BUCHY,0761952J,169,166,0,3,81,88,5 ème
SEINE MARITIME,DARNETAL,0760021K,149,149,0,0,77,72,5 ème
SEINE MARITIME,DIEPPE,0761703N,80,68,10,2,42,38,5 ème
SEINE MARITIME,DIEPPE,0761786D,101,91,0,10,46,55,5 ème
SEINE MARITIME,EPOUVILLE,0762598L,126,126,0,0,67,59,5 ème
SEINE MARITIME,GODERVILLE,0761741E,164,152,8,4,84,80,5 ème
SEINE MARITIME,ISNEAUVILLE,0763368Y,159,159,0,0,81,78,5 ème
SEINE MARITIME,LE HAVRE,0762127Z,87,87,0,0,44,43,5 ème
SEINE MARITIME,LE HAVRE,0762173Z,70,59,11,0,37,33,5 ème
SEINE MARITIME,LE PETIT-QUEVILLY,0760087G,0,0,0,0,0,0,5 ème
SEINE MARITIME,LE PETIT-QUEVILLY,0761949F,107,107,0,0,59,48,5 ème
SEINE MARITIME,LE TREPORT,0760114L,0,0,0,0,0,0,5 ème
SEINE MARITIME,MAROMME,0760075U,165,145,16,4,76,89,5 ème
SEINE MARITIME,MONTIVILLIERS,0762227H,185,169,16,0,84,101,5 ème
SEINE MARITIME,ROUEN,0760172Z,175,171,0,4,94,81,5 ème
SEINE MARITIME,ROUEN,0762290B,79,79,0,0,50,29,5 ème
SEINE MARITIME,SAINTE-ADRESSE,0761735Y,0,0,0,0,0,0,5 ème
SEINE MARITIME,SOTTEVILLE-LES-ROUEN,0760173A,107,105,0,2,55,52,5 ème
DORDOGNE,BERGERAC,0241136E,172,172,0,0,104,68,5 ème
DORDOGNE,LANOUAILLE,0240015L,48,48,0,0,22,26,5 ème
DORDOGNE,LE BUGUE,0240011G,71,68,0,3,36,35,5 ème
DORDOGNE,PERIGUEUX,0240052B,96,94,0,2,44,52,5 ème
DORDOGNE,RIBERAC,0240050Z,0,0,0,0,0,0,5 ème
DORDOGNE,SIGOULES-ET-FLAUGEAC,0240924Z,87,75,12,0,39,48,5 ème
DORDOGNE,THIVIERS,0240040N,93,81,10,2,38,55,5 ème
DORDOGNE,TRELISSAC,0240112S,0,0,0,0,0,0,5 ème
GIRONDE,BEGLES,0331882S,0,0,0,0,0,0,5 ème
GIRONDE,BLANQUEFORT,0330018R,0,0,0,0,0,0,5 ème
GIRONDE,BLANQUEFORT,0331548D,0,0,0,0,0,0,5 ème
GIRONDE,BORDEAUX,0330066T,164,162,0,2,79,85,5 ème
GIRONDE,BORDEAUX,0330142A,0,0,0,0,0,0,5 ème
GIRONDE,BORDEAUX,0331513R,82,82,0,0,42,40,5 ème
GIRONDE,BORDEAUX,0332492E,181,181,0,0,81,100,5 ème
GIRONDE,BORDEAUX,0332497K,0,0,0,0,0,0,5 ème
GIRONDE,BRANNE,0330058J,133,130,0,3,59,74,5 ème
GIRONDE,CESTAS,0332342S,221,221,0,0,113,108,5 ème
GIRONDE,EYSINES,0331739L,10,0,10,0,1,9,5 ème
GIRONDE,FLOIRAC,0331419N,156,152,0,4,85,71,5 ème
GIRONDE,GRADIGNAN,0332190B,149,131,15,3,75,74,5 ème
GIRONDE,GUJAN-MESTRAS,0331759H,220,198,17,5,101,119,5 ème
GIRONDE,LANGON,0330084M,205,184,16,5,92,113,5 ème
GIRONDE,LANGON,0331527F,54,54,0,0,24,30,5 ème
GIRONDE,LE PIAN-SUR-GARONNE,0332934K,150,146,0,4,77,73,5 ème
GIRONDE,LESPARRE-MEDOC,0331891B,115,113,0,2,54,61,5 ème
GIRONDE,LIBOURNE,0330091V,168,149,16,3,85,83,5 ème
GIRONDE,LIBOURNE,0331507J,210,210,0,0,108,102,5 ème
GIRONDE,LUSSAC,0330093X,78,76,0,2,37,41,5 ème
GIRONDE,MARCHEPRIME,0333121N,166,166,0,0,93,73,5 ème
GIRONDE,MARSAS,0333484H,180,180,0,0,85,95,5 ème
GIRONDE,PAUILLAC,0330103H,213,194,13,6,100,113,5 ème
GIRONDE,PESSAC,0330106L,114,110,0,4,57,57,5 ème
GIRONDE,SAINTE-FOY-LA-GRANDE,0331531K,47,47,0,0,25,22,5 ème
GIRONDE,SAINT-MEDARD-DE-GUIZIERES,0331532L,90,90,0,0,38,52,5 ème
GIRONDE,SAINT-SELVE,0333528F,150,150,0,0,62,88,5 ème
GIRONDE,SOULAC-SUR-MER,0330125G,74,74,0,0,37,37,5 ème
GIRONDE,TALENCE,0332195G,165,163,0,2,70,95,5 ème
GIRONDE,VILLENAVE-D'ORNON,0330132P,160,156,0,4,78,82,5 ème
LANDES,AIRE-SUR-L'ADOUR,0400047J,0,0,0,0,0,0,5 ème
LANDES,AIRE-SUR-L'ADOUR,0400090F,113,110,0,3,58,55,5 ème
LANDES,AMOU,0400003L,85,85,0,0,40,45,5 ème
LANDES,ANGRESSE,0401091U,141,139,0,2,68,73,5 ème
LANDES,BISCARROSSE,0401048X,83,83,0,0,40,43,5 ème
LANDES,DAX,0400740M,128,120,0,8,64,64,5 ème
LANDES,HAGETMAU,0400727Y,111,93,15,3,51,60,5 ème
LANDES,LABENNE,0401014K,160,158,0,2,77,83,5 ème
LANDES,MONT-DE-MARSAN,0400019D,0,0,0,0,0,0,5 ème
LANDES,MONT-DE-MARSAN,0400774Z,137,132,0,5,67,70,5 ème
LANDES,MONT-DE-MARSAN,0400779E,99,96,0,3,49,50,5 ème
LANDES,MONT-DE-MARSAN,0400858R,120,119,0,1,74,46,5 ème
LANDES,MORCENX-LA-NOUVELLE,0400097N,0,0,0,0,0,0,5 ème
LANDES,MUGRON,0400025K,67,64,0,3,28,39,5 ème
LANDES,POUILLON,0400032T,117,114,0,3,51,66,5 ème
LOT-ET-GARONNE,AGEN,0470061L,145,141,0,4,69,76,5 ème
LOT-ET-GARONNE,FOULAYRONNES,0470782V,0,0,0,0,0,0,5 ème
LOT-ET-GARONNE,LAVARDAC,0470775M,61,44,13,4,28,33,5 ème
LOT-ET-GARONNE,MARMANDE,0470069V,79,79,0,0,36,43,5 ème
LOT-ET-GARONNE,VILLENEUVE-SUR-LOT,0470049Y,146,143,0,3,78,68,5 ème
LOT-ET-GARONNE,VILLENEUVE-SUR-LOT,0470753N,9,0,9,0,2,7,5 ème
PYRENEES-ATLANTIQUES,ANGLET,0640003F,173,169,0,4,62,111,5 ème
PYRENEES-ATLANTIQUES,ARTHEZ-DE-BEARN,0640005H,56,56,0,0,25,31,5 ème
PYRENEES-ATLANTIQUES,BAYONNE,0640013S,0,0,0,0,0,0,5 ème
PYRENEES-ATLANTIQUES,BAYONNE,0640141F,50,50,0,0,25,25,5 ème
PYRENEES-ATLANTIQUES,BEDOUS,0640016V,27,27,0,0,13,14,5 ème
PYRENEES-ATLANTIQUES,BILLERE,0640606L,166,157,0,9,78,88,5 ème
PYRENEES-ATLANTIQUES,CAMBO-LES-BAINS,0641702C,71,66,0,5,40,31,5 ème
PYRENEES-ATLANTIQUES,HASPARREN,0641393S,137,134,0,3,66,71,5 ème
PYRENEES-ATLANTIQUES,HENDAYE,0640228A,149,147,0,2,82,67,5 ème
PYRENEES-ATLANTIQUES,LARCEVEAU-ARROS-CIBITS,0642006H,47,46,0,1,23,24,5 ème
PYRENEES-ATLANTIQUES,MONEIN,0640041X,108,108,0,0,54,54,5 ème
PYRENEES-ATLANTIQUES,OLORON-SAINTE-MARIE,0640211G,89,73,12,4,36,53,5 ème
PYRENEES-ATLANTIQUES,ORTHEZ,0640053K,0,0,0,0,0,0,5 ème
PYRENEES-ATLANTIQUES,ORTHEZ,0640214K,99,81,14,4,48,51,5 ème
PYRENEES-ATLANTIQUES,ORTHEZ,0641560Y,104,104,0,0,53,51,5 ème
PYRENEES-ATLANTIQUES,PAU,0641660G,125,125,0,0,63,62,5 ème
PYRENEES-ATLANTIQUES,PAU,0642010M,19,19,0,0,4,15,5 ème
PYRENEES-ATLANTIQUES,PAU,0642011N,11,11,0,0,3,8,5 ème
PYRENEES-ATLANTIQUES,PONTACQ,0640062V,81,77,0,4,43,38,5 ème
PYRENEES-ATLANTIQUES,SAINT-JEAN-DE-LUZ,0640163E,113,110,0,3,63,50,5 ème
PYRENEES-ATLANTIQUES,SAINT-JEAN-DE-LUZ,0641661H,142,138,0,4,56,86,5 ème
PYRENEES-ATLANTIQUES,SAINT-PALAIS,0640168K,71,71,0,0,30,41,5 ème
PYRENEES-ATLANTIQUES,SAINT-PALAIS,0641232S,65,64,0,1,30,35,5 ème
PYRENEES-ATLANTIQUES,SALIES-DE-BEARN,0640071E,60,58,0,2,29,31,5 ème
PYRENEES-ATLANTIQUES,SAUVETERRE-DE-BEARN,0640073G,42,42,0,0,20,22,5 ème
PYRENEES-ATLANTIQUES,SERRES-CASTET,0641780M,188,182,0,6,86,102,5 ème
CORREZE,ALLASSAC,0190001Y,122,122,0,0,60,62,5 ème
CORREZE,BEAULIEU-SUR-DORDOGNE,0190004B,34,34,0,0,23,11,5 ème
CORREZE,BEYNAT,0190006D,43,43,0,0,18,25,5 ème
CORREZE,BRIVE-LA-GAILLARDE,0190065T,42,41,0,1,12,30,5 ème
CORREZE,BRIVE-LA-GAILLARDE,0190671B,120,116,0,4,65,55,5 ème
CORREZE,BRIVE-LA-GAILLARDE,0190701J,0,0,0,0,0,0,5 ème
CORREZE,BRIVE-LA-GAILLARDE,0190723H,113,113,0,0,49,64,5 ème
CORREZE,BRIVE-LA-GAILLARDE,0190780V,150,144,6,0,64,86,5 ème
CORREZE,MEYSSAC,0190026A,55,55,0,0,24,31,5 ème
CORREZE,SEILHAC,0190030E,76,76,0,0,45,31,5 ème
CREUSE,AHUN,0230001B,46,43,0,3,25,21,5 ème
CREUSE,AUZANCES,0230004E,37,37,0,0,16,21,5 ème
CREUSE,BOUSSAC,0230009K,28,28,0,0,14,14,5 ème
HAUTE-VIENNE,BELLAC,0870004G,0,0,0,0,0,0,5 ème
HAUTE-VIENNE,CHALUS,0870007K,56,56,0,0,29,27,5 ème
HAUTE-VIENNE,LIMOGES,0870117E,166,150,14,2,75,91,5 ème
HAUTE-VIENNE,LIMOGES,0870909R,104,104,0,0,43,61,5 ème
HAUTE-VIENNE,LIMOGES,0875023M,0,0,0,0,0,0,5 ème
HAUTE-VIENNE,PIERRE-BUFFIERE,0870036S,99,99,0,0,50,49,5 ème
HAUTE-VIENNE,SAINT-JUNIEN,0870734A,102,102,0,0,55,47,5 ème
CHARENTE,ANGOULEME,0160047P,0,0,0,0,0,0,5 ème
CHARENTE,ANGOULEME,0160050T,108,108,0,0,55,53,5 ème
CHARENTE,BARBEZIEUX-SAINT-HILAIRE,0161049D,44,44,0,0,27,17,5 ème
CHARENTE,CHALAIS,0160015E,38,38,0,0,15,23,5 ème
CHARENTE,CHASSENEUIL-SUR-BONNIEURE,0160048R,0,0,0,0,0,0,5 ème
CHARENTE,COGNAC,0160117R,95,77,15,3,48,47,5 ème
CHARENTE,GOND-PONTOUVRE,0160106D,130,109,16,5,58,72,5 ème
CHARENTE,JARNAC,0160027T,130,127,0,3,51,79,5 ème
CHARENTE,MONTEMBOEUF,0160031X,33,33,0,0,15,18,5 ème
CHARENTE,MONTMOREAU,0160032Y,40,36,0,4,22,18,5 ème
CHARENTE,ROUILLAC,0160034A,107,104,0,3,57,50,5 ème
CHARENTE,RUELLE-SUR-TOUVRE,0160036C,0,0,0,0,0,0,5 ème
CHARENTE,SEGONZAC,0160042J,89,89,0,0,40,49,5 ème
CHARENTE,SOYAUX,0160100X,80,60,20,0,28,52,5 ème
CHARENTE,SOYAUX,0160862A,0,0,0,0,0,0,5 ème
CHARENTE,VILLEFAGNAN,0160115N,34,34,0,0,19,15,5 ème
CHARENTE-MARITIME,AIGREFEUILLE-D'AUNIS,0170110C,39,33,0,6,16,23,5 ème
CHARENTE-MARITIME,AIGREFEUILLE-D'AUNIS,0171129K,199,195,0,4,94,105,5 ème
CHARENTE-MARITIME,DOMPIERRE-SUR-MER,0171210Y,243,243,0,0,102,141,5 ème
CHARENTE-MARITIME,GEMOZAC,0170009T,123,123,0,0,66,57,5 ème
CHARENTE-MARITIME,LA JARRIE,0170010U,147,147,0,0,72,75,5 ème
CHARENTE-MARITIME,LA ROCHELLE,0170088D,146,144,0,2,76,70,5 ème
CHARENTE-MARITIME,MARANS,0170112E,39,39,0,0,22,17,5 ème
CHARENTE-MARITIME,PONS,0170020E,0,0,0,0,0,0,5 ème
CHARENTE-MARITIME,SAINT-AIGULIN,0170048K,48,48,0,0,26,22,5 ème
CHARENTE-MARITIME,SAINT-JEAN-D'ANGELY,0170051N,0,0,0,0,0,0,5 ème
CHARENTE-MARITIME,SAINT-JEAN-D'ANGELY,0170118L,43,43,0,0,20,23,5 ème
CHARENTE-MARITIME,TONNAY-CHARENTE,0170072L,146,146,0,0,71,75,5 ème
DEUX-SEVRES,AIRVAULT,0790059K,29,29,0,0,13,16,5 ème
DEUX-SEVRES,AIRVAULT,0790704L,51,51,0,0,30,21,5 ème
DEUX-SEVRES,BRESSUIRE,0790080H,0,0,0,0,0,0,5 ème
DEUX-SEVRES,BRESSUIRE,0791014Y,171,171,0,0,83,88,5 ème
DEUX-SEVRES,CERIZAY,0790945Y,85,67,14,4,38,47,5 ème
DEUX-SEVRES,CHEF-BOUTONNE,0790014L,69,69,0,0,37,32,5 ème
DEUX-SEVRES,COULONGES-SUR-L'AUTIZE,0790016N,108,108,0,0,46,62,5 ème
DEUX-SEVRES,LORETZ-D'ARGENTON,0790004A,46,46,0,0,20,26,5 ème
DEUX-SEVRES,MAULEON,0790065S,115,115,0,0,58,57,5 ème
DEUX-SEVRES,MENIGOUTE,0790020T,49,49,0,0,22,27,5 ème
DEUX-SEVRES,NIORT,0790043T,0,0,0,0,0,0,5 ème
DEUX-SEVRES,SAINT-MAIXENT-L'ECOLE,0790978J,150,128,16,6,75,75,5 ème
DEUX-SEVRES,SECONDIGNY,0790034H,64,64,0,0,30,34,5 ème
DEUX-SEVRES,THENEZAY,0790035J,45,45,0,0,23,22,5 ème
DEUX-SEVRES,THOUARS,0790038M,0,0,0,0,0,0,5 ème
DEUX-SEVRES,THOUARS,0790708R,80,75,0,5,43,37,5 ème
VIENNE,CHATELLERAULT,0860006P,0,0,0,0,0,0,5 ème
VIENNE,CHAUVIGNY,0860792U,194,182,12,0,102,92,5 ème
VIENNE,GENCAY,0860016A,130,126,0,4,73,57,5 ème
VIENNE,LATILLE,0860019D,127,127,0,0,63,64,5 ème
VIENNE,L'ISLE-JOURDAIN,0860017B,41,41,0,0,20,21,5 ème
VIENNE,NEUVILLE-DE-POITOU,0860032T,151,149,0,2,86,65,5 ème
VIENNE,POITIERS,0860076R,187,172,15,0,94,93,5 ème
VIENNE,POITIERS,0860823C,0,0,0,0,0,0,5 ème
VIENNE,VALENCE-EN-POITOU,0860762L,40,40,0,0,17,23,5 ème
AUDE,BRAM,0110676A,169,167,0,2,93,76,5 ème
AUDE,CARCASSONNE,0110665N,179,179,0,0,85,94,5 ème
AUDE,CASTELNAUDARY,0110011C,90,90,0,0,38,52,5 ème
AUDE,COUIZA,0110015G,76,76,0,0,37,39,5 ème
AUDE,LIMOUX,0110019L,0,0,0,0,0,0,5 ème
AUDE,LIMOUX,0110052X,44,40,0,4,15,29,5 ème
AUDE,NARBONNE,0110788X,152,128,16,8,84,68,5 ème
GARD,BAGNOLS-SUR-CEZE,0300088H,124,124,0,0,64,60,5 ème
GARD,BESSEGES,0300013B,42,38,0,4,18,24,5 ème
GARD,BOUILLARGUES,0301209B,226,226,0,0,112,114,5 ème
GARD,BRIGNON,0301246S,189,189,0,0,101,88,5 ème
GARD,GALLARGUES-LE-MONTUEUX,0301816L,172,172,0,0,86,86,5 ème
GARD,GENOLHAC,0300016E,25,25,0,0,11,14,5 ème
GARD,LA GRAND-COMBE,0300091L,28,28,0,0,12,16,5 ème
GARD,LEDIGNAN,0301747L,117,117,0,0,51,66,5 ème
GARD,LE MARTINET,0300020J,21,21,0,0,10,11,5 ème
GARD,MARGUERITTES,0301245R,185,165,15,5,96,89,5 ème
GARD,NIMES,0300057Z,0,0,0,0,0,0,5 ème
GARD,NIMES,0300059B,120,117,0,3,57,63,5 ème
GARD,NIMES,0300141R,162,137,20,5,76,86,5 ème
GARD,NIMES,0300996V,16,11,0,5,6,10,5 ème
GARD,NIMES,0301270T,0,0,0,0,0,0,5 ème
GARD,ROCHEFORT-DU-GARD,0301656M,166,163,0,3,84,82,5 ème
GARD,SAINT-AMBROIX,0300099V,45,38,7,0,26,19,5 ème
GARD,VESTRIC-ET-CANDIAC,0301653J,164,164,0,0,88,76,5 ème
HERAULT,AGDE,0341893Y,128,110,16,2,63,65,5 ème
HERAULT,BAILLARGUES,0341577E,176,171,0,5,90,86,5 ème
HERAULT,BEDARIEUX,0340006X,0,0,0,0,0,0,5 ème
HERAULT,BEDARIEUX,0340888F,22,22,0,0,10,12,5 ème
HERAULT,BESSAN,0340008Z,131,129,0,2,65,66,5 ème
HERAULT,BEZIERS,0340011C,0,0,0,0,0,0,5 ème
HERAULT,BEZIERS,0340118U,121,121,0,0,71,50,5 ème
HERAULT,BEZIERS,0340836Z,181,163,17,1,95,86,5 ème
HERAULT,BEZIERS,0341066Z,185,169,16,0,93,92,5 ème
HERAULT,BEZIERS,0342132H,133,116,16,1,72,61,5 ème
HERAULT,CASTELNAU-LE-LEZ,0340086J,198,195,0,3,97,101,5 ème
HERAULT,FABREGUES,0342077Y,150,146,0,4,77,73,5 ème
HERAULT,GANGES,0341424N,150,147,0,3,75,75,5 ème
HERAULT,GIGNAC,0342436N,0,0,0,0,0,0,5 ème
HERAULT,JACOU,0342036D,210,210,0,0,97,113,5 ème
HERAULT,LE CRES,0341363X,240,221,16,3,102,138,5 ème
HERAULT,LUNEL,0340030Y,0,0,0,0,0,0,5 ème
HERAULT,LUNEL,0341825Z,191,171,15,5,93,98,5 ème
HERAULT,LUNEL,0342090M,0,0,0,0,0,0,5 ème
HERAULT,MEZE,0340973Y,126,121,0,5,61,65,5 ème
HERAULT,MONTPELLIER,0340043M,0,0,0,0,0,0,5 ème
HERAULT,MONTPELLIER,0340048T,147,147,0,0,76,71,5 ème
HERAULT,MONTPELLIER,0340051W,130,130,0,0,79,51,5 ème
HERAULT,MONTPELLIER,0340053Y,190,176,13,1,84,106,5 ème
HERAULT,MONTPELLIER,0340111L,106,106,0,0,48,58,5 ème
HERAULT,MONTPELLIER,0340899T,122,122,0,0,60,62,5 ème
HERAULT,MONTPELLIER,0341277D,110,93,13,4,45,65,5 ème
HERAULT,MONTPELLIER,0341421K,253,247,0,6,142,111,5 ème
HERAULT,MONTPELLIER,0341726S,4,0,4,0,1,3,5 ème
HERAULT,MONTPELLIER,0342488V,77,77,0,0,31,46,5 ème
HERAULT,MURVIEL-LES-BEZIERS,0340054Z,148,145,0,3,70,78,5 ème
HERAULT,QUARANTE,0340063J,77,72,0,5,41,36,5 ème
HERAULT,SAINT-ANDRE-DE-SANGONIS,0342186S,191,176,15,0,93,98,5 ème
HERAULT,SAINT-GEORGES-D'ORQUES,0340908C,95,95,0,0,43,52,5 ème
LOZERE,MARVEJOLS,0480005V,70,52,13,5,29,41,5 ème
LOZERE,MENDE,0480025S,0,0,0,0,0,0,5 ème
PYRENEES-ORIENTALES,ESPIRA-DE-L'AGLY,0660065M,108,97,11,0,46,62,5 ème
PYRENEES-ORIENTALES,FONT-ROMEU-ODEILLO-VIA,0660634F,85,85,0,0,36,49,5 ème
PYRENEES-ORIENTALES,PERPIGNAN,0660062J,128,128,0,0,70,58,5 ème
PYRENEES-ORIENTALES,PRADES,0660022R,166,148,13,5,95,71,5 ème
PYRENEES-ORIENTALES,SAINT-ANDRE,0660865G,165,154,0,11,58,107,5 ème
PYRENEES-ORIENTALES,SAINT-LAURENT-DE-LA-SALANQUE,0660028X,234,231,0,3,116,118,5 ème
PYRENEES-ORIENTALES,VILLELONGUE-DELS-MONTS,0660026V,0,0,0,0,0,0,5 ème
ARIEGE,AX-LES-THERMES,0090001C,49,49,0,0,23,26,5 ème
ARIEGE,FOIX,0090478W,198,197,0,1,95,103,5 ème
ARIEGE,LAVELANET,0090007J,69,69,0,0,27,42,5 ème
ARIEGE,MAZERES,0090012P,83,79,0,4,36,47,5 ème
ARIEGE,MIREPOIX,0090573Z,126,103,20,3,71,55,5 ème
ARIEGE,SAINT-GIRONS,0090019X,0,0,0,0,0,0,5 ème
AVEYRON,LAISSAC-SEVERAC L'EGLISE,0120078V,42,42,0,0,23,19,5 ème
AVEYRON,MILLAU,0120014A,0,0,0,0,0,0,5 ème
AVEYRON,MILLAU,0120878P,229,212,15,2,113,116,5 ème
AVEYRON,ONET-LE-CHATEAU,0121273U,112,109,0,3,51,61,5 ème
AVEYRON,PONT-DE-SALARS,0120018E,90,87,0,3,43,47,5 ème
AVEYRON,RIEUPEYROUX,0120020G,35,34,0,1,22,13,5 ème
AVEYRON,RIGNAC,0120021H,83,83,0,0,46,37,5 ème
AVEYRON,VILLEFRANCHE-DE-ROUERGUE,0121255Z,90,86,0,4,42,48,5 ème
GERS,EAUZE,0320052H,41,41,0,0,16,25,5 ème
GERS,FLEURANCE,0320012P,66,60,0,6,35,31,5 ème
GERS,LECTOURE,0320017V,90,78,8,4,43,47,5 ème
GERS,MARCIAC,0320019X,58,58,0,0,31,27,5 ème
GERS,MAUVEZIN,0320021Z,63,63,0,0,31,32,5 ème
GERS,NOGARO,0320027F,101,82,14,5,51,50,5 ème
GERS,SAMATAN,0320030J,0,0,0,0,0,0,5 ème
GERS,SAMATAN,0320031K,105,103,0,2,51,54,5 ème
HAUTE-GARONNE,AUTERIVE,0310084Y,194,178,11,5,90,104,5 ème
HAUTE-GARONNE,AYGUESVIVES,0311573S,204,201,0,3,95,109,5 ème
HAUTE-GARONNE,BOULOGNE-SUR-GESSE,0310007P,48,48,0,0,22,26,5 ème
HAUTE-GARONNE,CASTELGINEST,0311720B,177,172,0,5,96,81,5 ème
HAUTE-GARONNE,ESCALQUENS,0313010D,170,170,0,0,84,86,5 ème
HAUTE-GARONNE,FONTENILLES,0312743N,158,155,0,3,77,81,5 ème
HAUTE-GARONNE,FROUZINS,0311915N,148,146,0,2,71,77,5 ème
HAUTE-GARONNE,GOURDAN-POLIGNAN,0310017A,0,0,0,0,0,0,5 ème
HAUTE-GARONNE,LABARTHE-SUR-LEZE,0312843X,144,140,0,4,79,65,5 ème
HAUTE-GARONNE,LAUNAGUET,0312139G,125,124,0,1,57,68,5 ème
HAUTE-GARONNE,MONTREJEAU,0310023G,84,80,0,4,41,43,5 ème
HAUTE-GARONNE,MURET,0311130K,151,151,0,0,79,72,5 ème
HAUTE-GARONNE,QUINT-FONSEGRIVES,0312762J,171,171,0,0,87,84,5 ème
HAUTE-GARONNE,SAINT-GAUDENS,0311851U,109,107,0,2,55,54,5 ème
HAUTE-GARONNE,SAINT-GAUDENS,0311968W,95,89,0,6,53,42,5 ème
HAUTE-GARONNE,SAINT-LYS,0311772H,151,141,0,10,69,82,5 ème
HAUTE-GARONNE,SAINT-ORENS-DE-GAMEVILLE,0311850T,145,140,0,5,64,81,5 ème
HAUTE-GARONNE,SAINT-PIERRE-DE-LAGES,0312609T,168,165,0,3,76,92,5 ème
HAUTE-GARONNE,TOULOUSE,0310040A,0,0,0,0,0,0,5 ème
HAUTE-GARONNE,TOULOUSE,0310044E,0,0,0,0,0,0,5 ème
HAUTE-GARONNE,TOULOUSE,0310046G,0,0,0,0,0,0,5 ème
HAUTE-GARONNE,TOULOUSE,0310053P,0,0,0,0,0,0,5 ème
HAUTE-GARONNE,TOULOUSE,0310091F,0,0,0,0,0,0,5 ème
HAUTE-GARONNE,TOULOUSE,0311168B,54,54,0,0,28,26,5 ème
HAUTE-GARONNE,TOULOUSE,0311232W,83,83,0,0,44,39,5 ème
HAUTE-GARONNE,TOULOUSE,0311328A,140,133,0,7,61,79,5 ème
HAUTE-GARONNE,TOULOUSE,0311333F,119,102,15,2,61,58,5 ème
HAUTE-GARONNE,TOULOUSE,0312065B,0,0,0,0,0,0,5 ème
HAUTE-GARONNE,TOULOUSE,0313079D,131,125,0,6,64,67,5 ème
HAUTE-GARONNE,TOURNEFEUILLE,0311688S,206,199,0,7,99,107,5 ème
HAUTE-GARONNE,TOURNEFEUILLE,0312307P,176,170,0,6,86,90,5 ème
HAUTES-PYRENEES,ARREAU,0650003A,81,81,0,0,44,37,5 ème
HAUTES-PYRENEES,BAGNERES-DE-BIGORRE,0650005C,0,0,0,0,0,0,5 ème
HAUTES-PYRENEES,BAGNERES-DE-BIGORRE,0650738Z,28,28,0,0,8,20,5 ème
HAUTES-PYRENEES,LANNEMEZAN,0650084N,124,100,17,7,64,60,5 ème
HAUTES-PYRENEES,LOURDES,0650014M,0,0,0,0,0,0,5 ème
HAUTES-PYRENEES,MONLEON-MAGNOAC,0650878B,90,86,0,4,39,51,5 ème
HAUTES-PYRENEES,SAINT-LAURENT-DE-NESTE,0650022W,75,75,0,0,34,41,5 ème
HAUTES-PYRENEES,TARBES,0650033H,58,55,0,3,27,31,5 ème
HAUTES-PYRENEES,TARBES,0650050B,118,116,0,2,52,66,5 ème
HAUTES-PYRENEES,TARBES,0650067V,0,0,0,0,0,0,5 ème
HAUTES-PYRENEES,TARBES,0651004N,153,153,0,0,69,84,5 ème
HAUTES-PYRENEES,VIC-EN-BIGORRE,0650838H,138,123,8,7,69,69,5 ème
LOT,CAHORS,0460050E,0,0,0,0,0,0,5 ème
LOT,CAHORS,0460051F,0,0,0,0,0,0,5 ème
LOT,CAHORS,0460620Z,110,110,0,0,51,59,5 ème
LOT,GOURDON,0460592U,137,120,12,5,67,70,5 ème
LOT,LALBENQUE,0460734Y,44,44,0,0,20,24,5 ème
LOT,SOUILLAC,0460028F,0,0,0,0,0,0,5 ème
TARN,ALBAN,0810002M,56,56,0,0,26,30,5 ème
TARN,ALBI,0811030E,217,188,27,2,105,112,5 ème
TARN,ALBI,0811062P,117,117,0,0,48,69,5 ème
TARN,ALBI,0811197L,195,177,16,2,97,98,5 ème
TARN,BLAYE-LES-MINES,0810788S,179,161,16,2,97,82,5 ème
TARN,BRASSAC,0810008U,68,68,0,0,35,33,5 ème
TARN,CASTRES,0810061B,133,108,23,2,66,67,5 ème
TARN,CASTRES,0810105Z,0,0,0,0,0,0,5 ème
TARN,CASTRES,0810113H,0,0,0,0,0,0,5 ème
TARN,CASTRES,0810959C,0,0,0,0,0,0,5 ème
TARN,CORDES-SUR-CIEL,0810019F,70,70,0,0,32,38,5 ème
TARN,DOURGNE,0810020G,90,90,0,0,38,52,5 ème
TARN,MAZAMET,0811067V,116,116,0,0,61,55,5 ème
TARN,PUYLAURENS,0810036Z,96,96,0,0,41,55,5 ème
TARN,REALMONT,0810038B,110,106,0,4,47,63,5 ème
TARN-ET-GARONNE,CAUSSADE,0820007M,165,137,17,11,78,87,5 ème
TARN-ET-GARONNE,LABASTIDE-SAINT-PIERRE,0820823Z,164,159,0,5,81,83,5 ème
TARN-ET-GARONNE,MONTAUBAN,0820022D,219,214,0,5,116,103,5 ème
TARN-ET-GARONNE,MONTAUBAN,0820052L,111,107,0,4,62,49,5 ème
TARN-ET-GARONNE,MONTAUBAN,0820061W,0,0,0,0,0,0,5 ème
TARN-ET-GARONNE,MONTAUBAN,0820588U,283,261,14,8,136,147,5 ème
TARN-ET-GARONNE,MONTAUBAN,0820896D,157,138,15,4,75,82,5 ème
LOIRE-ATLANTIQUE,AIGREFEUILLE-SUR-MAINE,0442542Z,166,160,0,6,77,89,5 ème
LOIRE-ATLANTIQUE,BOUAYE,0440184L,118,118,0,0,49,69,5 ème
LOIRE-ATLANTIQUE,BOUGUENAIS,0441656L,0,0,0,0,0,0,5 ème
LOIRE-ATLANTIQUE,CLISSON,0440188R,156,156,0,0,73,83,5 ème
LOIRE-ATLANTIQUE,LA BAULE-ESCOUBLAC,0441822S,142,141,0,1,71,71,5 ème
LOIRE-ATLANTIQUE,LA MONTAGNE,0440198B,78,78,0,0,41,37,5 ème
LOIRE-ATLANTIQUE,LE LOROUX-BOTTEREAU,0441686U,137,133,0,4,70,67,5 ème
LOIRE-ATLANTIQUE,LE POULIGUEN,0440061C,37,37,0,0,19,18,5 ème
LOIRE-ATLANTIQUE,MISSILLAC,0441917V,72,69,0,3,34,38,5 ème
LOIRE-ATLANTIQUE,NANTES,0440028S,125,123,0,2,62,63,5 ème
LOIRE-ATLANTIQUE,NANTES,0440030U,0,0,0,0,0,0,5 ème
LOIRE-ATLANTIQUE,NANTES,0440045K,161,154,0,7,85,76,5 ème
LOIRE-ATLANTIQUE,NANTES,0440536U,91,91,0,0,41,50,5 ème
LOIRE-ATLANTIQUE,NANTES,0441934N,168,168,0,0,89,79,5 ème
LOIRE-ATLANTIQUE,NORT-SUR-ERDRE,0440221B,174,174,0,0,81,93,5 ème
LOIRE-ATLANTIQUE,NOZAY,0440292D,136,135,0,1,69,67,5 ème
LOIRE-ATLANTIQUE,REZE,0440231M,66,66,0,0,27,39,5 ème
LOIRE-ATLANTIQUE,SAINTE-LUCE-SUR-LOIRE,0441724K,160,142,16,2,70,90,5 ème
LOIRE-ATLANTIQUE,SAINT-HERBLAIN,0441940V,205,205,0,0,112,93,5 ème
LOIRE-ATLANTIQUE,SAINT-NAZAIRE,0440307V,0,0,0,0,0,0,5 ème
LOIRE-ATLANTIQUE,SAINT-NAZAIRE,0440315D,0,0,0,0,0,0,5 ème
LOIRE-ATLANTIQUE,SAINT-NAZAIRE,0440350S,133,133,0,0,69,64,5 ème
LOIRE-ATLANTIQUE,SAINT-PHILBERT-DE-GRAND-LIEU,0440239W,215,212,0,3,105,110,5 ème
LOIRE-ATLANTIQUE,SAINT-PHILBERT-DE-GRAND-LIEU,0442782K,115,111,0,4,51,64,5 ème
LOIRE-ATLANTIQUE,SAINT-SEBASTIEN-SUR-LOIRE,0440279P,0,0,0,0,0,0,5 ème
LOIRE-ATLANTIQUE,SAINT-SEBASTIEN-SUR-LOIRE,0440537V,0,0,0,0,0,0,5 ème
LOIRE-ATLANTIQUE,VERTOU,0440244B,297,297,0,0,154,143,5 ème
MAINE-ET-LOIRE,ANGERS,0490060Z,71,71,0,0,30,41,5 ème
MAINE-ET-LOIRE,ANGERS,0490845C,60,60,0,0,26,34,5 ème
MAINE-ET-LOIRE,ANGERS,0490953V,71,51,16,4,31,40,5 ème
MAINE-ET-LOIRE,ANGERS,0491764B,105,86,16,3,61,44,5 ème
MAINE-ET-LOIRE,AVRILLE,0490801E,0,0,0,0,0,0,5 ème
MAINE-ET-LOIRE,BEAUPREAU-EN-MAUGES,0490903R,0,0,0,0,0,0,5 ème
MAINE-ET-LOIRE,CHOLET,0491025Y,91,91,0,0,41,50,5 ème
MAINE-ET-LOIRE,CHOLET,0491026Z,89,86,0,3,38,51,5 ème
MAINE-ET-LOIRE,LYS-HAUT-LAYON,0491707P,88,88,0,0,41,47,5 ème
MAINE-ET-LOIRE,MAULEVRIER,0490868C,119,119,0,0,61,58,5 ème
MAINE-ET-LOIRE,MONTREUIL-JUIGNE,0490032U,212,207,0,5,100,112,5 ème
MAINE-ET-LOIRE,MONTREVAULT-SUR-EVRE,0490034W,76,74,0,2,30,46,5 ème
MAINE-ET-LOIRE,SAUMUR,0490042E,48,45,0,3,19,29,5 ème
MAINE-ET-LOIRE,SAUMUR,0490960C,94,90,0,4,39,55,5 ème
MAINE-ET-LOIRE,SAUMUR,0491930G,165,152,13,0,76,89,5 ème
MAINE-ET-LOIRE,SEGRE-EN-ANJOU BLEU,0490962E,125,107,16,2,52,73,5 ème
MAYENNE,ANDOUILLE,0530002P,106,106,0,0,55,51,5 ème
MAYENNE,CHATEAU-GONTIER-SUR-MAYENNE,0530874M,149,142,0,7,71,78,5 ème
MAYENNE,EVRON,0530059B,129,129,0,0,61,68,5 ème
MAYENNE,GORRON,0530793Z,41,41,0,0,24,17,5 ème
MAYENNE,LASSAY-LES-CHATEAUX,0530803K,61,61,0,0,30,31,5 ème
MAYENNE,LAVAL,0530061D,211,196,15,0,106,105,5 ème
MAYENNE,LAVAL,0530875N,246,245,0,1,124,122,5 ème
MAYENNE,MAYENNE,0530826K,104,98,0,6,52,52,5 ème
MAYENNE,MESLAY-DU-MAINE,0530791X,68,68,0,0,32,36,5 ème
MAYENNE,MONTSURS,0530064G,37,37,0,0,16,21,5 ème
MAYENNE,MONTSURS,0530792Y,44,44,0,0,23,21,5 ème
MAYENNE,RENAZE,0530584X,61,59,0,2,33,28,5 ème
MAYENNE,VILLAINES-LA-JUHEL,0530025P,33,29,0,4,18,15,5 ème
SARTHE,ALLONNES,0721224P,82,78,0,4,37,45,5 ème
SARTHE,CERANS-FOULLETOURTE,0721483W,87,87,0,0,45,42,5 ème
SARTHE,CHANGE,0720920J,16,0,16,0,6,10,5 ème
SARTHE,LA CHARTRE-SUR-LE-LOIR,0720011W,51,51,0,0,34,17,5 ème
SARTHE,LA FLECHE,0720021G,0,0,0,0,0,0,5 ème
SARTHE,LA FLECHE,0721405L,89,89,0,0,43,46,5 ème
SARTHE,MONTVAL-SUR-LOIR,0720804H,53,53,0,0,21,32,5 ème
SARTHE,PARIGNE-L'EVEQUE,0720847E,134,111,16,7,60,74,5 ème
SARTHE,PRUILLE-LE-CHETIF,0720811R,94,87,7,0,45,49,5 ème
SARTHE,PRUILLE-LE-CHETIF,0721478R,0,0,0,0,0,0,5 ème
SARTHE,SABLE-SUR-SARTHE,0720048L,0,0,0,0,0,0,5 ème
SARTHE,SAINTE-JAMME-SUR-SARTHE,0721042S,108,108,0,0,53,55,5 ème
SARTHE,SILLE-LE-GUILLAUME,0721365T,41,41,0,0,18,23,5 ème
VENDEE,BENET,0850092N,70,70,0,0,33,37,5 ème
VENDEE,BENET,0851145H,52,52,0,0,32,20,5 ème
VENDEE,CHANTONNAY,0850145W,131,112,16,3,72,59,5 ème
VENDEE,ESSARTS EN BOCAGE,0851647D,142,137,0,5,82,60,5 ème
VENDEE,LA ROCHE-SUR-YON,0850130E,0,0,0,0,0,0,5 ème
VENDEE,LA ROCHE-SUR-YON,0850604V,136,122,12,2,65,71,5 ème
VENDEE,LES ACHARDS,0850106D,145,145,0,0,73,72,5 ème
VENDEE,LES HERBIERS,0851193K,168,147,17,4,87,81,5 ème
VENDEE,MONTAIGU-VENDEE,0850136L,0,0,0,0,0,0,5 ème
VENDEE,MONTAIGU-VENDEE,0850639H,162,146,16,0,77,85,5 ème
VENDEE,MONTAIGU-VENDEE,0851704R,86,86,0,0,42,44,5 ème
VENDEE,NOIRMOUTIER-EN-L'ILE,0851144G,42,42,0,0,21,21,5 ème
VENDEE,SAINT-HILAIRE-DES-LOGES,0851195M,56,56,0,0,15,41,5 ème
VENDEE,SAINT-JEAN-DE-MONTS,0850039F,142,142,0,0,63,79,5 ème
VENDEE,SAINT-LAURENT-SUR-SEVRE,0851293U,172,172,0,0,96,76,5 ème
ALPES-DE-HTE-PROVENCE,MANOSQUE,0040013T,80,76,0,4,37,43,5 ème
ALPES-DE-HTE-PROVENCE,MANOSQUE,0040587S,82,82,0,0,42,40,5 ème
ALPES-DE-HTE-PROVENCE,SAINTE-TULLE,0040524Y,121,121,0,0,59,62,5 ème
ALPES-DE-HTE-PROVENCE,SEYNE,0040021B,31,28,0,3,19,12,5 ème
BOUCHES-DU-RHONE,AIX-EN-PROVENCE,0131711P,148,146,0,2,56,92,5 ème
BOUCHES-DU-RHONE,AIX-EN-PROVENCE,0132917A,251,247,0,4,105,146,5 ème
BOUCHES-DU-RHONE,AIX-EN-PROVENCE,0133397X,109,109,0,0,66,43,5 ème
BOUCHES-DU-RHONE,AIX-EN-PROVENCE,0134094E,162,162,0,0,71,91,5 ème
BOUCHES-DU-RHONE,AIX-EN-PROVENCE,0134342Z,92,92,0,0,54,38,5 ème
BOUCHES-DU-RHONE,ARLES,0131609D,143,139,0,4,63,80,5 ème
BOUCHES-DU-RHONE,ARLES,0131746C,189,167,22,0,93,96,5 ème
BOUCHES-DU-RHONE,AUBAGNE,0131364M,95,95,0,0,44,51,5 ème
BOUCHES-DU-RHONE,AUBAGNE,0132412B,175,153,19,3,95,80,5 ème
BOUCHES-DU-RHONE,CABRIES,0133115R,160,160,0,0,81,79,5 ème
BOUCHES-DU-RHONE,EYGUIERES,0133790Z,145,145,0,0,67,78,5 ème
BOUCHES-DU-RHONE,FOS-SUR-MER,0132634T,220,214,0,6,108,112,5 ème
BOUCHES-DU-RHONE,GREASQUE,0130028K,260,260,0,0,132,128,5 ème
BOUCHES-DU-RHONE,ISTRES,0131888G,147,147,0,0,73,74,5 ème
BOUCHES-DU-RHONE,ISTRES,0132276D,0,0,0,0,0,0,5 ème
BOUCHES-DU-RHONE,LA CIOTAT,0131883B,118,118,0,0,48,70,5 ème
BOUCHES-DU-RHONE,LA CIOTAT,0132786H,190,173,16,1,93,97,5 ème
BOUCHES-DU-RHONE,LAMBESC,0131259Y,139,139,0,0,76,63,5 ème
BOUCHES-DU-RHONE,LANCON-PROVENCE,0134431W,164,164,0,0,77,87,5 ème
BOUCHES-DU-RHONE,LE PUY-SAINTE-REPARADE,0133992U,110,110,0,0,58,52,5 ème
BOUCHES-DU-RHONE,MARIGNANE,0131607B,191,190,0,1,103,88,5 ème
BOUCHES-DU-RHONE,MARIGNANE,0131608C,222,184,33,5,80,142,5 ème
BOUCHES-DU-RHONE,MARSEILLE,0133544G,39,39,0,0,17,22,5 ème
BOUCHES-DU-RHONE,MARSEILLE,0130057S,0,0,0,0,0,0,5 ème
BOUCHES-DU-RHONE,MARSEILLE,0131968U,154,135,15,4,71,83,5 ème
BOUCHES-DU-RHONE,MARSEILLE,0130050J,0,0,0,0,0,0,5 ème
BOUCHES-DU-RHONE,MARSEILLE,0132790M,0,0,0,0,0,0,5 ème
BOUCHES-DU-RHONE,MARSEILLE,0131703F,132,109,23,0,65,67,5 ème
BOUCHES-DU-RHONE,MARSEILLE,0132408X,114,107,0,7,61,53,5 ème
BOUCHES-DU-RHONE,MARSEILLE,0133986M,69,69,0,0,39,30,5 ème
BOUCHES-DU-RHONE,MARSEILLE,0134101M,0,0,0,0,0,0,5 ème
BOUCHES-DU-RHONE,MARSEILLE,0131932E,221,221,0,0,106,115,5 ème
BOUCHES-DU-RHONE,MARSEILLE,0132950L,83,65,18,0,32,51,5 ème
BOUCHES-DU-RHONE,MARSEILLE,0133278T,47,47,0,0,25,22,5 ème
BOUCHES-DU-RHONE,MARSEILLE,0133788X,158,142,14,2,81,77,5 ème
BOUCHES-DU-RHONE,MARSEILLE,0131264D,136,126,0,10,78,58,5 ème
BOUCHES-DU-RHONE,MARSEILLE,0130079R,119,119,0,0,67,52,5 ème
BOUCHES-DU-RHONE,MARSEILLE,0131441W,0,0,0,0,0,0,5 ème
BOUCHES-DU-RHONE,MARSEILLE,0132911U,91,91,0,0,59,32,5 ème
BOUCHES-DU-RHONE,MARSEILLE,0130054N,0,0,0,0,0,0,5 ème
BOUCHES-DU-RHONE,MARSEILLE,0131603X,114,114,0,0,61,53,5 ème
BOUCHES-DU-RHONE,MARSEILLE,0131927Z,176,176,0,0,84,92,5 ème
BOUCHES-DU-RHONE,MARSEILLE,0130084W,107,103,0,4,53,54,5 ème
BOUCHES-DU-RHONE,MARSEILLE,0130139F,86,81,0,5,40,46,5 ème
BOUCHES-DU-RHONE,PEYROLLES-EN-PROVENCE,0131723C,110,110,0,0,53,57,5 ème
BOUCHES-DU-RHONE,ROGNES,0133287C,150,147,0,3,73,77,5 ème
BOUCHES-DU-RHONE,ROQUEVAIRE,0130156Z,174,174,0,0,88,86,5 ème
BOUCHES-DU-RHONE,ROUSSET,0133451F,170,167,0,3,83,87,5 ème
BOUCHES-DU-RHONE,SAINT-CHAMAS,0130158B,115,115,0,0,55,60,5 ème
BOUCHES-DU-RHONE,SAINT-MITRE-LES-REMPARTS,0131367R,94,94,0,0,51,43,5 ème
BOUCHES-DU-RHONE,SALON-DE-PROVENCE,0132789L,146,146,0,0,64,82,5 ème
BOUCHES-DU-RHONE,SALON-DE-PROVENCE,0133492A,174,171,0,3,93,81,5 ème
BOUCHES-DU-RHONE,TARASCON,0131611F,199,176,19,4,102,97,5 ème
BOUCHES-DU-RHONE,VITROLLES,0132214L,114,114,0,0,54,60,5 ème
BOUCHES-DU-RHONE,VITROLLES,0132411A,177,162,15,0,87,90,5 ème
BOUCHES-DU-RHONE,VITROLLES,0133352Y,102,102,0,0,54,48,5 ème
HAUTES-ALPES,LARAGNE-MONTEGLIN,0050452P,72,69,0,3,32,40,5 ème
VAUCLUSE,APT,0840001V,0,0,0,0,0,0,5 ème
VAUCLUSE,APT,0840759U,213,200,8,5,98,115,5 ème
VAUCLUSE,AVIGNON,0840007B,142,142,0,0,68,74,5 ème
VAUCLUSE,AVIGNON,0840042P,0,0,0,0,0,0,5 ème
VAUCLUSE,AVIGNON,0840940R,0,0,0,0,0,0,5 ème
VAUCLUSE,BOLLENE,0840437U,203,179,15,9,95,108,5 ème
VAUCLUSE,CARPENTRAS,0840852V,104,104,0,0,0,104,5 ème
VAUCLUSE,CAVAILLON,0840079E,176,176,0,0,90,86,5 ème
VAUCLUSE,LA TOUR-D'AIGUES,0841027K,194,190,0,4,100,94,5 ème
VAUCLUSE,L'ISLE-SUR-LA-SORGUE,0840021S,0,0,0,0,0,0,5 ème
VAUCLUSE,ORANGE,0840764Z,195,189,0,6,99,96,5 ème
VAUCLUSE,SAINTE-CECILE-LES-VIGNES,0841099N,166,163,0,3,78,88,5 ème
VAUCLUSE,SORGUES,0840033E,103,98,0,5,42,61,5 ème
VAUCLUSE,VALREAS,0840714V,69,69,0,0,29,40,5 ème
VAUCLUSE,VALREAS,0840716X,132,124,8,0,44,88,5 ème
VAUCLUSE,VEDENE,0840039L,0,0,0,0,0,0,5 ème
ALPES-MARITIMES,ANTIBES,0060083H,139,137,0,2,58,81,5 ème
ALPES-MARITIMES,ANTIBES,0061456A,107,107,0,0,53,54,5 ème
ALPES-MARITIMES,CARROS,0061130W,196,175,15,6,94,102,5 ème
ALPES-MARITIMES,GRASSE,0061244V,190,172,16,2,90,100,5 ème
ALPES-MARITIMES,GRASSE,0061668F,117,98,14,5,56,61,5 ème
ALPES-MARITIMES,LA COLLE-SUR-LOUP,0061376N,179,173,0,6,91,88,5 ème
ALPES-MARITIMES,MENTON,0061238N,172,172,0,0,85,87,5 ème
ALPES-MARITIMES,NICE,0060084J,168,160,0,8,78,90,5 ème
ALPES-MARITIMES,NICE,0060086L,148,147,0,1,65,83,5 ème
ALPES-MARITIMES,NICE,0060676C,87,83,0,4,45,42,5 ème
ALPES-MARITIMES,NICE,0061001F,160,142,15,3,81,79,5 ème
ALPES-MARITIMES,NICE,0061003H,127,126,0,1,65,62,5 ème
ALPES-MARITIMES,NICE,0061339Y,237,234,0,3,108,129,5 ème
ALPES-MARITIMES,NICE,0061460E,156,156,0,0,85,71,5 ème
ALPES-MARITIMES,SAINT-JEANNET,0061666D,194,194,0,0,105,89,5 ème
ALPES-MARITIMES,VALBONNE,0062011D,175,175,0,0,95,80,5 ème
ALPES-MARITIMES,VALLAURIS,0061211J,203,181,17,5,89,114,5 ème
VAR,BARJOLS,0830928H,167,147,16,4,72,95,5 ème
VAR,BRIGNOLES,0830833E,174,174,0,0,91,83,5 ème
VAR,FREJUS,0830823U,196,179,17,0,84,112,5 ème
VAR,FREJUS,0830960T,0,0,0,0,0,0,5 ème
VAR,HYERES,0830028E,167,167,0,0,79,88,5 ème
VAR,HYERES,0830832D,109,107,0,2,59,50,5 ème
VAR,HYERES,0831186N,196,193,0,3,113,83,5 ème
VAR,LA CRAU,0830147J,52,52,0,0,17,35,5 ème
VAR,LA GARDE,0830179U,220,220,0,0,106,114,5 ème
VAR,LA SEYNE-SUR-MER,0830830B,119,119,0,0,65,54,5 ème
VAR,LA SEYNE-SUR-MER,0830923C,0,0,0,0,0,0,5 ème
VAR,LE BEAUSSET,0831056X,175,175,0,0,87,88,5 ème
VAR,LES ARCS,0830001A,198,198,0,0,91,107,5 ème
VAR,ROQUEBRUNE-SUR-ARGENS,0831474B,198,198,0,0,101,97,5 ème
VAR,SAINT-CYR-SUR-MER,0830038R,115,115,0,0,48,67,5 ème
VAR,SAINT-MAXIMIN-LA-SAINTE-BAUME,0830959S,164,164,0,0,79,85,5 ème
VAR,SAINT-RAPHAEL,0831116M,197,193,0,4,96,101,5 ème
VAR,TOULON,0830058M,0,0,0,0,0,0,5 ème
VAR,TOULON,0830059N,0,0,0,0,0,0,5 ème
VAR,TOULON,0830110U,166,166,0,0,88,78,5 ème
VAR,TOULON,0830111V,91,89,0,2,41,50,5 ème
VAR,TOULON,0830162A,133,128,0,5,51,82,5 ème
VAR,TOULON,0830926F,173,173,0,0,90,83,5 ème
VAR,TOULON,0831115L,89,85,0,4,50,39,5 ème
VAR,VIDAUBAN,0831379Y,154,154,0,0,78,76,5 ème
ALLIER,BELLENAVES,0030001K,83,80,0,3,40,43,5 ème
ALLIER,BELLERIVE-SUR-ALLIER,0030002L,135,135,0,0,74,61,5 ème
ALLIER,COMMENTRY,0030890B,100,83,17,0,42,58,5 ème
ALLIER,COMMENTRY,0031044U,0,0,0,0,0,0,5 ème
ALLIER,CUSSET,0030979Y,121,121,0,0,55,66,5 ème
ALLIER,DOYET,0030015A,46,46,0,0,20,26,5 ème
ALLIER,MONTLUCON,0030030S,66,64,0,2,36,30,5 ème
ALLIER,MONTLUCON,0030091H,143,140,0,3,75,68,5 ème
ALLIER,MONTMARAULT,0030035X,45,41,0,4,16,29,5 ème
ALLIER,MOULINS,0030039B,123,121,0,2,46,77,5 ème
ALLIER,SAINT-GERMAIN-DES-FOSSES,0030043F,86,81,0,5,41,45,5 ème
ALLIER,SAINT-POURCAIN-SUR-SIOULE,0030104X,45,45,0,0,17,28,5 ème
ALLIER,SAINT-POURCAIN-SUR-SIOULE,0030892D,115,115,0,0,56,59,5 ème
ALLIER,VARENNES-SUR-ALLIER,0030048L,98,80,17,1,48,50,5 ème
ALLIER,VICHY,0030049M,88,88,0,0,43,45,5 ème
CANTAL,ALLANCHE,0150001V,18,18,0,0,9,9,5 ème
CANTAL,CONDAT,0150011F,19,19,0,0,12,7,5 ème
CANTAL,MONTSALVY,0150020R,28,28,0,0,19,9,5 ème
CANTAL,RIOM-ES-MONTAGNES,0150027Y,35,35,0,0,13,22,5 ème
CANTAL,SAINT-FLOUR,0150053B,56,51,0,5,22,34,5 ème
CANTAL,YDES,0150034F,56,56,0,0,20,36,5 ème
HAUTE-LOIRE,BRIOUDE,0430854V,106,96,0,10,57,49,5 ème
HAUTE-LOIRE,BRIOUDE,0430898T,89,86,0,3,44,45,5 ème
HAUTE-LOIRE,LE PUY-EN-VELAY,0430902X,118,118,0,0,53,65,5 ème
HAUTE-LOIRE,MONISTROL-SUR-LOIRE,0430663M,124,119,0,5,55,69,5 ème
HAUTE-LOIRE,RETOURNAC,0430026V,77,77,0,0,40,37,5 ème
HAUTE-LOIRE,SAINT-JULIEN-CHAPTEUIL,0430086K,39,39,0,0,17,22,5 ème
HAUTE-LOIRE,SAUGUES,0430032B,18,18,0,0,6,12,5 ème
HAUTE-LOIRE,YSSINGEAUX,0430909E,92,90,0,2,43,49,5 ème
PUY-DE-DOME,AUBIERE,0631081H,56,51,0,5,24,32,5 ème
PUY-DE-DOME,BESSE-ET-SAINT-ANASTAISE,0630008S,58,58,0,0,32,26,5 ème
PUY-DE-DOME,BILLOM,0630009T,205,205,0,0,96,109,5 ème
PUY-DE-DOME,CLERMONT-FERRAND,0630024J,0,0,0,0,0,0,5 ème
PUY-DE-DOME,CLERMONT-FERRAND,0631085M,197,197,0,0,98,99,5 ème
PUY-DE-DOME,CLERMONT-FERRAND,0631086N,151,151,0,0,65,86,5 ème
PUY-DE-DOME,CLERMONT-FERRAND,0631502R,111,107,0,4,54,57,5 ème
PUY-DE-DOME,CLERMONT-FERRAND,0631731P,146,146,0,0,70,76,5 ème
PUY-DE-DOME,CLERMONT-FERRAND,0631773K,163,161,0,2,79,84,5 ème
PUY-DE-DOME,COURPIERE,0631523N,68,65,0,3,32,36,5 ème
PUY-DE-DOME,COURPIERE,0631733S,43,43,0,0,25,18,5 ème
PUY-DE-DOME,ISSOIRE,0630041C,0,0,0,0,0,0,5 ème
PUY-DE-DOME,RIOM,0631763Z,177,137,32,8,76,101,5 ème
PUY-DE-DOME,SAINT-ELOY-LES-MINES,0630060Y,65,56,0,9,32,33,5 ème
ARDECHE,ANNONAY,0070100W,0,0,0,0,0,0,5 ème
ARDECHE,ANNONAY,0071156U,201,174,17,10,105,96,5 ème
ARDECHE,GUILHERAND-GRANGES,0070011Z,148,146,0,2,67,81,5 ème
ARDECHE,JOYEUSE,0070012A,72,69,0,3,40,32,5 ème
ARDECHE,LAMASTRE,0071168G,27,27,0,0,16,11,5 ème
ARDECHE,LARGENTIERE,0070017F,44,44,0,0,19,25,5 ème
ARDECHE,SAINT-PERAY,0071320X,129,117,10,2,62,67,5 ème
ARDECHE,SATILLIEU,0070086F,55,55,0,0,24,31,5 ème
ARDECHE,TOURNON-SUR-RHONE,0071192H,142,142,0,0,59,83,5 ème
DROME,BOURG-DE-PEAGE,0260001K,216,216,0,0,103,113,5 ème
DROME,CLEON-D'ANDRAN,0260005P,124,124,0,0,55,69,5 ème
DROME,DIEULEFIT,0260009U,79,79,0,0,36,43,5 ème
DROME,MONTELIMAR,0260045H,176,169,0,7,81,95,5 ème
DROME,MONTELIMAR,0261086P,137,134,0,3,63,74,5 ème
DROME,PORTES-LES-VALENCE,0260021G,176,170,0,6,96,80,5 ème
DROME,ROMANS-SUR-ISERE,0261091V,58,52,0,6,26,32,5 ème
DROME,SAINT-DONAT-SUR-L'HERBASSE,0260026M,128,121,0,7,60,68,5 ème
DROME,SAINT-RAMBERT-D'ALBON,0260101U,84,80,0,4,36,48,5 ème
DROME,SUZE-LA-ROUSSE,0260033V,59,59,0,0,24,35,5 ème
DROME,VALENCE,0261100E,0,0,0,0,0,0,5 ème
HAUTE SAVOIE,ANNECY,0740065U,103,99,0,4,55,48,5 ème
HAUTE SAVOIE,ANNECY,0740106N,119,119,0,0,70,49,5 ème
HAUTE SAVOIE,ANNECY,0740930J,174,173,0,1,87,87,5 ème
HAUTE SAVOIE,ANNECY,0741278M,174,171,0,3,92,82,5 ème
HAUTE SAVOIE,ANNEMASSE,0741476C,0,0,0,0,0,0,5 ème
HAUTE SAVOIE,BONNEVILLE,0740157U,177,173,0,4,92,85,5 ème
HAUTE SAVOIE,CHAMONIX-MONT-BLANC,0740110T,58,58,0,0,26,32,5 ème
HAUTE SAVOIE,CLUSES,0740143D,0,0,0,0,0,0,5 ème
HAUTE SAVOIE,COLLONGES-SOUS-SALEVE,0740114X,87,87,0,0,46,41,5 ème
HAUTE SAVOIE,FRANGY,0740024Z,158,158,0,0,86,72,5 ème
HAUTE SAVOIE,GAILLARD,0741097R,145,142,0,3,69,76,5 ème
HAUTE SAVOIE,LA ROCHE-SUR-FORON,0740931K,225,213,12,0,91,134,5 ème
HAUTE SAVOIE,LA ROCHE-SUR-FORON,0741286W,0,0,0,0,0,0,5 ème
HAUTE SAVOIE,MARGENCEL,0741666J,156,137,15,4,79,77,5 ème
HAUTE SAVOIE,MEGEVE,0740026B,67,67,0,0,31,36,5 ème
HAUTE SAVOIE,POISY,0741699V,155,149,0,6,82,73,5 ème
HAUTE SAVOIE,RUMILLY,0740032H,190,156,27,7,97,93,5 ème
HAUTE SAVOIE,SAINT-GERVAIS-LES-BAINS,0740095B,26,26,0,0,10,16,5 ème
HAUTE SAVOIE,SAINT-JEOIRE,0740035L,192,188,0,4,101,91,5 ème
HAUTE SAVOIE,SAINT-JEOIRE,0740152N,0,0,0,0,0,0,5 ème
HAUTE SAVOIE,SAINT-JULIEN-EN-GENEVOIS,0740038P,224,212,12,0,115,109,5 ème
HAUTE SAVOIE,SALLANCHES,0741281R,111,110,0,1,62,49,5 ème
HAUTE SAVOIE,TANINGES,0740043V,92,92,0,0,46,46,5 ème
HAUTE SAVOIE,THONON-LES-BAINS,0740102J,159,159,0,0,80,79,5 ème
HAUTE SAVOIE,THONON-LES-BAINS,0741227G,203,201,0,2,110,93,5 ème
HAUTE SAVOIE,THONON-LES-BAINS,0741341F,240,221,16,3,111,129,5 ème
HAUTE SAVOIE,VILLE-LA-GRAND,0740910M,273,232,31,10,126,147,5 ème
ISERE,BEAUREPAIRE,0381685A,49,49,0,0,24,25,5 ème
ISERE,BOURGOIN-JALLIEU,0381658W,138,138,0,0,80,58,5 ème
ISERE,BOURGOIN-JALLIEU,0382174G,215,186,25,4,106,109,5 ème
ISERE,CHARVIEU-CHAVAGNEUX,0380011F,138,133,0,5,53,85,5 ème
ISERE,ECHIROLLES,0381903M,104,87,13,4,54,50,5 ème
ISERE,FONTAINE,0381810L,113,93,16,4,53,60,5 ème
ISERE,GIERES,0380025W,137,134,0,3,64,73,5 ème
ISERE,GRENOBLE,0380032D,0,0,0,0,0,0,5 ème
ISERE,GRENOBLE,0381758E,0,0,0,0,0,0,5 ème
ISERE,GRENOBLE,0381780D,120,120,0,0,59,61,5 ème
ISERE,GRENOBLE,0382114S,166,160,0,6,79,87,5 ème
ISERE,GRENOBLE,0383437E,33,22,11,0,13,20,5 ème
ISERE,LA COTE-SAINT-ANDRE,0382893N,0,0,0,0,0,0,5 ème
ISERE,LA MURE,0382426F,138,124,8,6,70,68,5 ème
ISERE,LA TRONCHE,0381630R,2,2,0,0,1,1,5 ème
ISERE,LE PONT-DE-BEAUVOISIN,0382427G,121,117,0,4,52,69,5 ème
ISERE,LE PONT-DE-CLAIX,0380013H,103,103,0,0,45,58,5 ème
ISERE,LES AVENIERES VEYRINS-THUELLIN,0380004Y,131,131,0,0,62,69,5 ème
ISERE,MONTALIEU-VERCIEU,0380045T,156,156,0,0,79,77,5 ème
ISERE,SAINT-ETIENNE-DE-SAINT-GEOIRS,0380059H,141,141,0,0,63,78,5 ème
ISERE,SAINT-MARTIN-D'HERES,0380357G,116,95,16,5,64,52,5 ème
ISERE,SAINT-MARTIN-LE-VINOUX,0382036G,117,108,8,1,63,54,5 ème
ISERE,SALAISE-SUR-SANNE,0383253E,168,168,0,0,85,83,5 ème
ISERE,VARCES-ALLIERES-ET-RISSET,0383260M,157,157,0,0,85,72,5 ème
ISERE,VIENNE,0382430K,166,166,0,0,76,90,5 ème
ISERE,VINAY,0380087N,140,137,0,3,65,75,5 ème
ISERE,VOIRON,0381809K,0,0,0,0,0,0,5 ème
SAVOIE,AIME-LA-PLAGNE,0730002F,98,98,0,0,40,58,5 ème
SAVOIE,AIX-LES-BAINS,0730791N,116,116,0,0,59,57,5 ème
SAVOIE,AIX-LES-BAINS,0731204M,141,141,0,0,79,62,5 ème
SAVOIE,ALBERTVILLE,0730760E,0,0,0,0,0,0,5 ème
SAVOIE,BARBERAZ,0730772T,0,0,0,0,0,0,5 ème
SAVOIE,BEAUFORT,0730007L,47,47,0,0,21,26,5 ème
SAVOIE,CHAMBERY,0730811K,16,0,16,0,3,13,5 ème
SAVOIE,MONTMELIAN,0731044N,215,199,16,0,100,115,5 ème
AIN,ARTEMARE,0010794H,65,64,0,1,37,28,5 ème
AIN,BAGE-DOMMARTIN,0010005A,147,141,0,6,73,74,5 ème
AIN,BELLEY,0011150V,96,90,0,6,53,43,5 ème
AIN,DAGNEUX,0011142L,131,131,0,0,72,59,5 ème
AIN,GEX,0010024W,209,189,16,4,90,119,5 ème
AIN,PERONNAS,0010938P,146,111,32,3,70,76,5 ème
AIN,PONCIN,0010036J,121,119,0,2,69,52,5 ème
AIN,TREVOUX,0010097A,185,185,0,0,86,99,5 ème
LOIRE,BOURG-ARGENTAL,0420003A,56,56,0,0,32,24,5 ème
LOIRE,CHAZELLES-SUR-LYON,0420011J,91,91,0,0,32,59,5 ème
LOIRE,LA PACAUDIERE,0421456E,63,63,0,0,30,33,5 ème
LOIRE,LE COTEAU,0421084A,167,145,17,5,71,96,5 ème
LOIRE,MONTBRISON,0421454C,337,304,25,8,173,164,5 ème
LOIRE,NOIRETABLE,0420022W,37,37,0,0,19,18,5 ème
LOIRE,RIVE-DE-GIER,0421172W,181,169,12,0,97,84,5 ème
LOIRE,ROANNE,0420987V,0,0,0,0,0,0,5 ème
LOIRE,SAINT-CHAMOND,0421486M,107,106,0,1,62,45,5 ème
LOIRE,SAINT-ETIENNE,0420049A,0,0,0,0,0,0,5 ème
LOIRE,SAINT-ETIENNE,0421176A,91,76,15,0,41,50,5 ème
LOIRE,SAINT-ETIENNE,0421686E,84,62,16,6,31,53,5 ème
LOIRE,SAINT-ETIENNE,0421804H,199,191,0,8,108,91,5 ème
LOIRE,SAINT-JUST-EN-CHEVALET,0420062P,53,53,0,0,25,28,5 ème
LOIRE,SAINT-JUST-EN-CHEVALET,0421061A,28,28,0,0,11,17,5 ème
RHONE,BRIGNAIS,0692582G,101,97,0,4,46,55,5 ème
RHONE,CALUIRE-ET-CUIRE,0691728D,153,139,12,2,76,77,5 ème
RHONE,CALUIRE-ET-CUIRE,0692968B,0,0,0,0,0,0,5 ème
RHONE,CHAPONNAY,0693243A,172,172,0,0,86,86,5 ème
RHONE,CHATILLON,0693975W,211,207,0,4,107,104,5 ème
RHONE,CIVRIEUX-D'AZERGUES,0690584K,90,87,0,3,40,50,5 ème
RHONE,CONDRIEU,0690587N,84,84,0,0,35,49,5 ème
RHONE,CORBAS,0692898A,143,143,0,0,66,77,5 ème
RHONE,COURS,0690016T,58,58,0,0,28,30,5 ème
RHONE,COURS,0690590S,18,18,0,0,8,10,5 ème
RHONE,DECINES-CHARPIEU,0694185Z,88,88,0,0,53,35,5 ème
RHONE,DEUX-GROSNES,0690070B,47,47,0,0,25,22,5 ème
RHONE,FRANCHEVILLE,0694151M,159,154,0,5,80,79,5 ème
RHONE,GENAS,0691650U,184,184,0,0,92,92,5 ème
RHONE,IRIGNY,0691824H,170,167,0,3,79,91,5 ème
RHONE,L'ARBRESLE,0690578D,135,135,0,0,53,82,5 ème
RHONE,LYON,0692929J,194,194,0,0,95,99,5 ème
RHONE,LYON,0694191F,189,189,0,0,99,90,5 ème
RHONE,LYON,0690641X,0,0,0,0,0,0,5 ème
RHONE,LYON,0690698J,0,0,0,0,0,0,5 ème
RHONE,LYON,0692505Y,175,172,0,3,73,102,5 ème
RHONE,LYON,0691798E,110,109,0,1,55,55,5 ème
RHONE,LYON,0692920Z,159,159,0,0,84,75,5 ème
RHONE,LYON,0692339T,203,189,12,2,86,117,5 ème
RHONE,LYON,0692922B,126,126,0,0,64,62,5 ème
RHONE,LYON,0693479G,165,165,0,0,88,77,5 ème
RHONE,LYON,0692340U,153,138,14,1,84,69,5 ème
RHONE,LYON,0692940W,232,232,0,0,136,96,5 ème
RHONE,LYON,0692698H,202,198,0,4,106,96,5 ème
RHONE,NEUVILLE-SUR-SAONE,0692941X,278,278,0,0,145,133,5 ème
RHONE,OULLINS,0691673U,66,63,0,3,41,25,5 ème
RHONE,RILLIEUX-LA-PAPE,0691498D,147,144,0,3,84,63,5 ème
RHONE,RILLIEUX-LA-PAPE,0692159X,143,130,13,0,65,78,5 ème
RHONE,SAINT-DIDIER-AU-MONT-D'OR,0690546U,158,158,0,0,75,83,5 ème
RHONE,SAINT-LAURENT-DE-MURE,0692865P,196,194,0,2,103,93,5 ème
RHONE,SAINT-PRIEST,0694312M,88,88,0,0,49,39,5 ème
RHONE,TASSIN-LA-DEMI-LUNE,0692163B,184,182,0,2,97,87,5 ème
RHONE,VAL D'OINGT,0690580F,89,89,0,0,54,35,5 ème
RHONE,VAUGNERAY,0690621A,165,161,0,4,80,85,5 ème
RHONE,VAULX-EN-VELIN,0692336P,159,145,9,5,81,78,5 ème
RHONE,VENISSIEUX,0690551Z,173,173,0,0,94,79,5 ème
RHONE,VILLEFRANCHE-SUR-SAONE,0690099H,125,104,14,7,47,78,5 ème
RHONE,VILLEFRANCHE-SUR-SAONE,0693375U,0,0,0,0,0,0,5 ème
RHONE,VILLEURBANNE,0690047B,0,0,0,0,0,0,5 ème
RHONE,VILLEURBANNE,0690107S,0,0,0,0,0,0,5 ème
RHONE,VILLEURBANNE,0690626F,154,139,13,2,85,69,5 ème
RHONE,VILLEURBANNE,0692337R,129,127,0,2,60,69,5 ème
RHONE,VILLEURBANNE,0693093M,106,100,0,6,47,59,5 ème
RHONE,VILLEURBANNE,0694296V,158,155,0,3,76,82,5 ème
DOUBS,AMANCEY,0251048D,19,19,0,0,10,9,5 ème
DOUBS,AUDINCOURT,0250001R,0,0,0,0,0,0,5 ème
DOUBS,BESANCON,0250013D,0,0,0,0,0,0,5 ème
DOUBS,BESANCON,0251079M,0,0,0,0,0,0,5 ème
DOUBS,BESANCON,0251080N,151,129,16,6,80,71,5 ème
DOUBS,BESANCON,0251127P,171,166,0,5,83,88,5 ème
DOUBS,LEVIER,0251069B,76,76,0,0,41,35,5 ème
DOUBS,MOUTHE,0250040H,145,145,0,0,51,94,5 ème
DOUBS,ORNANS,0251129S,122,115,0,7,53,69,5 ème
DOUBS,ROULANS,0250051V,114,114,0,0,52,62,5 ème
DOUBS,SAINT-VIT,0251394E,201,189,12,0,97,104,5 ème
DOUBS,VERCEL-VILLEDIEU-LE-CAMP,0251062U,58,58,0,0,35,23,5 ème
HAUTE-SAONE,DAMPIERRE-SUR-SALON,0700004Z,82,82,0,0,33,49,5 ème
HAUTE-SAONE,FOUGEROLLES-SAINT-VALBERT,0700007C,59,58,0,1,27,32,5 ème
HAUTE-SAONE,GRAY,0700011G,0,0,0,0,0,0,5 ème
HAUTE-SAONE,LURE,0700018P,0,0,0,0,0,0,5 ème
HAUTE-SAONE,LURE,0700076C,0,0,0,0,0,0,5 ème
HAUTE-SAONE,MARNAY,0700026Y,149,149,0,0,72,77,5 ème
HAUTE-SAONE,RIOZ,0700029B,200,199,0,1,88,112,5 ème
HAUTE-SAONE,SAINT-LOUP-SUR-SEMOUSE,0700788B,90,90,0,0,44,46,5 ème
HAUTE-SAONE,VESOUL,0700786Z,135,107,24,4,64,71,5 ème
HAUTE-SAONE,VILLERSEXEL,0700077D,13,0,13,0,4,9,5 ème
JURA,ARBOIS,0390960G,47,47,0,0,26,21,5 ème
JURA,CHAMPAGNOLE,0390961H,117,117,0,0,71,46,5 ème
JURA,DAMPARIS,0390010Z,71,71,0,0,30,41,5 ème
JURA,DOLE,0390797E,136,132,0,4,61,75,5 ème
JURA,DOLE,0391002C,175,157,16,2,77,98,5 ème
JURA,FRAISANS,0390016F,110,110,0,0,55,55,5 ème
JURA,LONS-LE-SAUNIER,0390907Z,134,100,29,5,59,75,5 ème
JURA,ORGELET,0390031X,57,55,0,2,31,26,5 ème
JURA,SAINT-AMOUR,0390914G,0,0,0,0,0,0,5 ème
JURA,SAINT-CLAUDE,0390071R,79,79,0,0,41,38,5 ème
JURA,VOITEUR,0390073T,70,70,0,0,37,33,5 ème
TERRITOIRE DE BELFORT,BAVILLIERS,0900355X,0,0,0,0,0,0,5 ème
TERRITOIRE DE BELFORT,BEAUCOURT,0900275K,114,112,0,2,59,55,5 ème
TERRITOIRE DE BELFORT,DANJOUTIN,0900237U,122,118,0,4,63,59,5 ème
TERRITOIRE DE BELFORT,DELLE,0900007U,120,106,14,0,50,70,5 ème
TERRITOIRE DE BELFORT,DELLE,0900019G,0,0,0,0,0,0,5 ème
COTE D'OR,ARNAY-LE-DUC,0210001M,32,32,0,0,16,16,5 ème
COTE D'OR,BROCHON,0211140A,132,132,0,0,54,78,5 ème
COTE D'OR,CHENOVE,0211225T,82,63,15,4,40,42,5 ème
COTE D'OR,CHEVIGNY-SAINT-SAUVEUR,0211137X,222,222,0,0,120,102,5 ème
COTE D'OR,DIJON,0210019G,0,0,0,0,0,0,5 ème
COTE D'OR,DIJON,0210025N,75,73,0,2,41,34,5 ème
COTE D'OR,DIJON,0211070Z,315,292,14,9,146,169,5 ème
COTE D'OR,MARSANNAY-LA-COTE,0211391Y,96,92,0,4,60,36,5 ème
COTE D'OR,MONTBARD,0210034Y,68,65,0,3,24,44,5 ème
COTE D'OR,NOLAY,0210037B,40,40,0,0,16,24,5 ème
COTE D'OR,PONTAILLER-SUR-SAONE,0210040E,80,80,0,0,39,41,5 ème
COTE D'OR,SEMUR-EN-AUXOIS,0210047M,0,0,0,0,0,0,5 ème
COTE D'OR,TALANT,0211523S,77,76,0,1,38,39,5 ème
NIEVRE,DORNES,0580019F,30,30,0,0,11,19,5 ème
NIEVRE,IMPHY,0580618G,67,65,0,2,33,34,5 ème
NIEVRE,LUZY,0580619H,32,32,0,0,16,16,5 ème
NIEVRE,MOULINS-ENGILBERT,0580030T,44,44,0,0,21,23,5 ème
NIEVRE,VARENNES-VAUZELLES,0580620J,113,96,13,4,54,59,5 ème
SAONE-ET-LOIRE,CHAGNY,0710009Z,158,156,0,2,84,74,5 ème
SAONE-ET-LOIRE,CHALON-SUR-SAONE,0710012C,0,0,0,0,0,0,5 ème
SAONE-ET-LOIRE,CHAUFFAILLES,0710021M,73,73,0,0,44,29,5 ème
SAONE-ET-LOIRE,DIGOIN,0711136Z,109,107,0,2,54,55,5 ème
SAONE-ET-LOIRE,LUGNY,0710044M,143,141,0,2,61,82,5 ème
SAONE-ET-LOIRE,MACON,0711054K,195,179,15,1,102,93,5 ème
SAONE-ET-LOIRE,MATOUR,0710053X,75,75,0,0,38,37,5 ème
SAONE-ET-LOIRE,MONTCEAU-LES-MINES,0711135Y,104,100,0,4,54,50,5 ème
SAONE-ET-LOIRE,PARAY-LE-MONIAL,0711314T,94,94,0,0,37,57,5 ème
SAONE-ET-LOIRE,SAINT-GENGOUX-LE-NATIONAL,0710064J,47,47,0,0,27,20,5 ème
SAONE-ET-LOIRE,TOURNUS,0710535W,97,95,0,2,53,44,5 ème
YONNE,ANCY-LE-FRANC,0890979F,40,40,0,0,19,21,5 ème
YONNE,BRIENON-SUR-ARMANCON,0891057R,46,46,0,0,20,26,5 ème
YONNE,PONT-SUR-YONNE,0890823L,120,105,15,0,51,69,5 ème
YONNE,SENS,0890030Z,115,111,0,4,53,62,5 ème
YONNE,VERMENTON,0890037G,60,60,0,0,29,31,5 ème
COTES D'ARMOR,BROONS,0220136D,52,52,0,0,29,23,5 ème
COTES D'ARMOR,CORLAY,0220009R,15,15,0,0,6,9,5 ème
COTES D'ARMOR,DINAN,0221744B,119,117,0,2,57,62,5 ème
COTES D'ARMOR,GOUAREC,0221745C,14,14,0,0,5,9,5 ème
COTES D'ARMOR,GUERLEDAN,0220150U,40,40,0,0,23,17,5 ème
COTES D'ARMOR,LAMBALLE-ARMOR,0220142K,203,199,0,4,83,120,5 ème
COTES D'ARMOR,LAMBALLE-ARMOR,0220196U,0,0,0,0,0,0,5 ème
COTES D'ARMOR,LE MENE,0220008P,40,40,0,0,23,17,5 ème
COTES D'ARMOR,PLERIN,0220134B,103,103,0,0,43,60,5 ème
COTES D'ARMOR,PLOUER-SUR-RANCE,0220161F,51,51,0,0,19,32,5 ème
COTES D'ARMOR,SAINT-BRIEUC,0220071H,0,0,0,0,0,0,5 ème
COTES D'ARMOR,SAINT-BRIEUC,0220184F,94,84,10,0,56,38,5 ème
COTES D'ARMOR,SAINT-NICOLAS-DU-PELEM,0220061X,19,19,0,0,13,6,5 ème
COTES D'ARMOR,SAINT-QUAY-PORTRIEUX,0220063Z,99,99,0,0,49,50,5 ème
COTES D'ARMOR,SAINT-QUAY-PORTRIEUX,0220176X,64,64,0,0,34,30,5 ème
FINISTERE,BREST,0290012F,0,0,0,0,0,0,5 ème
FINISTERE,BREST,0290236Z,47,47,0,0,24,23,5 ème
FINISTERE,BREST,0291661Y,75,59,16,0,50,25,5 ème
FINISTERE,BREST,0291869Z,184,184,0,0,77,107,5 ème
FINISTERE,CARHAIX-PLOUGUER,0290247L,58,58,0,0,27,31,5 ème
FINISTERE,CONCARNEAU,0290031B,110,105,0,5,59,51,5 ème
FINISTERE,CROZON,0290032C,94,94,0,0,40,54,5 ème
FINISTERE,DOUARNENEZ,0290260A,70,70,0,0,38,32,5 ème
FINISTERE,GUERLESQUIN,0290039K,70,70,0,0,36,34,5 ème
FINISTERE,GUILERS,0291713E,64,64,0,0,32,32,5 ème
FINISTERE,GUIPAVAS,0291655S,140,137,0,3,72,68,5 ème
FINISTERE,HUELGOAT,0290148D,37,37,0,0,18,19,5 ème
FINISTERE,LANDERNEAU,0290045S,222,206,16,0,110,112,5 ème
FINISTERE,LE RELECQ-KERHUON,0292055B,96,96,0,0,51,45,5 ème
FINISTERE,MOELAN-SUR-MER,0291717J,96,96,0,0,53,43,5 ème
FINISTERE,MORLAIX,0291104T,51,50,0,1,26,25,5 ème
FINISTERE,PLABENNEC,0290286D,114,110,0,4,57,57,5 ème
FINISTERE,PLOUDALMEZEAU,0290065N,100,100,0,0,59,41,5 ème
FINISTERE,PLOUGASTEL-DAOULAS,0291928N,106,105,0,1,54,52,5 ème
FINISTERE,PLOUHINEC,0290330B,59,59,0,0,36,23,5 ème
FINISTERE,PLOUNEOUR-MENEZ,0290058F,82,82,0,0,42,40,5 ème
FINISTERE,PLOUZANE,0291753Y,103,103,0,0,37,66,5 ème
FINISTERE,PONT-AVEN,0290301V,16,16,0,0,5,11,5 ème
FINISTERE,PONT-L'ABBE,0290168A,0,0,0,0,0,0,5 ème
FINISTERE,QUIMPER,0290071V,0,0,0,0,0,0,5 ème
FINISTERE,QUIMPER,0290320R,109,109,0,0,57,52,5 ème
FINISTERE,QUIMPERLE,0290107J,90,87,0,3,43,47,5 ème
FINISTERE,SAINT-MARTIN-DES-CHAMPS,0290083H,58,56,0,2,25,33,5 ème
ILLE-ET-VILAINE,BREAL-SOUS-MONTFORT,0352958A,187,187,0,0,89,98,5 ème
ILLE-ET-VILAINE,CANCALE,0350853M,97,97,0,0,45,52,5 ème
ILLE-ET-VILAINE,CESSON-SEVIGNE,0353006C,48,48,0,0,15,33,5 ème
ILLE-ET-VILAINE,CHATEAUBOURG,0352448W,175,175,0,0,89,86,5 ème
ILLE-ET-VILAINE,COMBOURG,0350707D,186,177,0,9,91,95,5 ème
ILLE-ET-VILAINE,CREVIN,0352860U,134,134,0,0,59,75,5 ème
ILLE-ET-VILAINE,DINARD,0351795L,184,184,0,0,96,88,5 ème
ILLE-ET-VILAINE,FOUGERES,0350770X,204,204,0,0,107,97,5 ème
ILLE-ET-VILAINE,FOUGERES,0350967L,113,76,31,6,59,54,5 ème
ILLE-ET-VILAINE,GUICHEN,0351881E,160,156,0,4,86,74,5 ème
ILLE-ET-VILAINE,LA GUERCHE-DE-BRETAGNE,0350863Y,159,159,0,0,93,66,5 ème
ILLE-ET-VILAINE,MARTIGNE-FERCHAUD,0350868D,71,71,0,0,38,33,5 ème
ILLE-ET-VILAINE,MELESSE,0352183H,139,139,0,0,58,81,5 ème
ILLE-ET-VILAINE,MONTFORT-SUR-MEU,0350872H,178,172,0,6,87,91,5 ème
ILLE-ET-VILAINE,MONTFORT-SUR-MEU,0351791G,202,171,31,0,111,91,5 ème
ILLE-ET-VILAINE,PIPRIAC,0350875L,90,86,0,4,42,48,5 ème
ILLE-ET-VILAINE,PLEINE-FOUGERES,0350021H,54,54,0,0,26,28,5 ème
ILLE-ET-VILAINE,PLEINE-FOUGERES,0350877N,47,47,0,0,20,27,5 ème
ILLE-ET-VILAINE,PLELAN-LE-GRAND,0350878P,69,69,0,0,29,40,5 ème
ILLE-ET-VILAINE,REDON,0350102W,0,0,0,0,0,0,5 ème
ILLE-ET-VILAINE,RENNES,0350031U,0,0,0,0,0,0,5 ème
ILLE-ET-VILAINE,RENNES,0350760L,86,85,0,1,39,47,5 ème
ILLE-ET-VILAINE,RENNES,0350776D,0,0,0,0,0,0,5 ème
ILLE-ET-VILAINE,RENNES,0350835T,111,110,0,1,52,59,5 ème
ILLE-ET-VILAINE,RENNES,0351054F,0,0,0,0,0,0,5 ème
ILLE-ET-VILAINE,RENNES,0352071L,32,32,0,0,13,19,5 ème
ILLE-ET-VILAINE,SAINT-MALO,0350785N,104,104,0,0,53,51,5 ème
ILLE-ET-VILAINE,TINTENIAC,0350050P,0,0,0,0,0,0,5 ème
ILLE-ET-VILAINE,VAL D'ANAST,0350017D,81,78,0,3,42,39,5 ème
ILLE-ET-VILAINE,VITRE,0350808N,0,0,0,0,0,0,5 ème
ILLE-ET-VILAINE,VITRE,0352008T,102,102,0,0,50,52,5 ème
MORBIHAN,BAUD,0561386C,106,106,0,0,52,54,5 ème
MORBIHAN,BAUD,0561399S,73,73,0,0,34,39,5 ème
MORBIHAN,ETEL,0560009F,98,98,0,0,50,48,5 ème
MORBIHAN,GOURIN,0561383Z,59,58,0,1,30,29,5 ème
MORBIHAN,GROIX,0561352R,12,12,0,0,5,7,5 ème
MORBIHAN,GUER,0560061M,90,90,0,0,46,44,5 ème
MORBIHAN,LA GACILLY,0561400T,104,104,0,0,55,49,5 ème
MORBIHAN,LE PALAIS,0560034H,31,31,0,0,16,15,5 ème
MORBIHAN,LORIENT,0560149H,110,107,0,3,49,61,5 ème
MORBIHAN,PLESCOP,0561931V,139,137,0,2,60,79,5 ème
MORBIHAN,PLOERMEL,0560108N,242,221,16,5,112,130,5 ème
MORBIHAN,PLUVIGNER,0561356V,165,165,0,0,89,76,5 ème
MORBIHAN,QUESTEMBERT,0561641E,0,0,0,0,0,0,5 ème
MORBIHAN,QUEVEN,0561384A,164,154,8,2,77,87,5 ème
MORBIHAN,VANNES,0560118Z,242,228,14,0,138,104,5 ème
CHER,BOURGES,0180593X,156,137,15,4,72,84,5 ème
CHER,BOURGES,0180766K,69,66,0,3,28,41,5 ème
CHER,BOURGES,0180796T,220,220,0,0,97,123,5 ème
CHER,BOURGES,0180823X,0,0,0,0,0,0,5 ème
CHER,CHATEAUMEILLANT,0180013S,66,58,8,0,29,37,5 ème
CHER,LA GUERCHE-SUR-L'AUBOIS,0180710Z,79,69,8,2,30,49,5 ème
CHER,MEHUN-SUR-YEVRE,0180586P,110,108,0,2,52,58,5 ème
CHER,SAINT-GERMAIN-DU-PUY,0180732Y,109,99,7,3,47,62,5 ème
CHER,SANCOINS,0180033N,45,45,0,0,20,25,5 ème
CHER,VIERZON,0180036S,0,0,0,0,0,0,5 ème
CHER,VIERZON,0180572Z,0,0,0,0,0,0,5 ème
EURE-ET-LOIR,AUTHON-DU-PERCHE,0280002A,49,48,0,1,26,23,5 ème
EURE-ET-LOIR,BU,0281095N,102,98,0,4,57,45,5 ème
EURE-ET-LOIR,CHARTRES,0280691Z,0,0,0,0,0,0,5 ème
EURE-ET-LOIR,CHARTRES,0280993C,157,157,0,0,73,84,5 ème
EURE-ET-LOIR,CHATEAUDUN,0280918W,77,48,29,0,36,41,5 ème
EURE-ET-LOIR,ILLIERS-COMBRAY,0280702L,137,134,0,3,68,69,5 ème
EURE-ET-LOIR,LES VILLAGES VOVEENS,0280040S,131,127,0,4,53,78,5 ème
EURE-ET-LOIR,LUCE,0280657M,109,89,18,2,47,62,5 ème
EURE-ET-LOIR,LUISANT,0281043G,158,157,0,1,73,85,5 ème
EURE-ET-LOIR,NOGENT-LE-ROI,0280035L,180,180,0,0,103,77,5 ème
EURE-ET-LOIR,SAINT-MAURICE-SAINT-GERMAIN,0280684S,0,0,0,0,0,0,5 ème
EURE-ET-LOIR,SAINT-PREST,0281055V,157,155,0,2,69,88,5 ème
EURE-ET-LOIR,SENONCHES,0280887M,72,72,0,0,22,50,5 ème
INDRE,AIGURANDE,0360001F,37,37,0,0,21,16,5 ème
INDRE,ARGENTON-SUR-CREUSE,0360003H,0,0,0,0,0,0,5 ème
INDRE,BUZANCAIS,0360511K,32,32,0,0,21,11,5 ème
INDRE,ISSOUDUN,0360024F,0,0,0,0,0,0,5 ème
INDRE,LE BLANC,0360005K,0,0,0,0,0,0,5 ème
INDRE,LE BLANC,0360719L,96,78,14,4,52,44,5 ème
INDRE,LEVROUX,0360028K,68,68,0,0,34,34,5 ème
INDRE,NEUVY-SAINT-SEPULCHRE,0360030M,45,44,0,1,24,21,5 ème
INDRE,VALENCAY,0360525A,65,61,0,4,28,37,5 ème
INDRE-ET-LOIRE,AMBOISE,0371325P,74,74,0,0,39,35,5 ème
INDRE-ET-LOIRE,FONDETTES,0371397T,133,133,0,0,63,70,5 ème
INDRE-ET-LOIRE,LOCHES,0370016S,0,0,0,0,0,0,5 ème
INDRE-ET-LOIRE,SAINTE-MAURE-DE-TOURAINE,0371101W,114,98,15,1,58,56,5 ème
INDRE-ET-LOIRE,SAINT-PIERRE-DES-CORPS,0371391L,78,78,0,0,35,43,5 ème
INDRE-ET-LOIRE,TOURS,0370040T,0,0,0,0,0,0,5 ème
INDRE-ET-LOIRE,TOURS,0370045Y,127,127,0,0,69,58,5 ème
INDRE-ET-LOIRE,TOURS,0370732V,96,96,0,0,51,45,5 ème
INDRE-ET-LOIRE,TOURS,0370757X,0,0,0,0,0,0,5 ème
INDRE-ET-LOIRE,TOURS,0370884K,171,171,0,0,90,81,5 ème
INDRE-ET-LOIRE,TOURS,0370991B,116,89,22,5,51,65,5 ème
INDRE-ET-LOIRE,TOURS,0371158H,88,88,0,0,42,46,5 ème
LOIRET,AMILLY,0450937Z,189,171,16,2,92,97,5 ème
LOIRET,BEAUNE-LA-ROLANDE,0450006M,127,125,0,2,60,67,5 ème
LOIRET,BELLEGARDE,0450007N,125,110,12,3,54,71,5 ème
LOIRET,COURTENAY,0451173F,145,143,0,2,76,69,5 ème
LOIRET,FERRIERES-EN-GATINAIS,0450022E,157,156,0,1,74,83,5 ème
LOIRET,GIEN,0451245J,104,97,0,7,53,51,5 ème
LOIRET,LA CHAPELLE-SAINT-MESMIN,0451035F,135,128,0,7,73,62,5 ème
LOIRET,LES BORDES,0451608D,133,129,0,4,64,69,5 ème
LOIRET,MONTARGIS,0450041A,111,109,0,2,49,62,5 ème
LOIRET,OLIVET,0450047G,180,180,0,0,95,85,5 ème
LOIRET,ORLEANS,0450786K,0,0,0,0,0,0,5 ème
LOIRET,ORLEANS,0450939B,117,112,0,5,58,59,5 ème
LOIRET,ORLEANS,0451316L,116,111,3,2,53,63,5 ème
LOIRET,ORLEANS,0451590J,0,0,0,0,0,0,5 ème
LOIRET,PATAY,0450061X,149,145,0,4,78,71,5 ème
LOIRET,PITHIVIERS,0450750W,0,0,0,0,0,0,5 ème
LOIRET,PITHIVIERS,0451788Z,168,146,12,10,85,83,5 ème
LOIRET,SAINT-DENIS-EN-VAL,0451660K,134,130,0,4,77,57,5 ème
LOIRET,TIGY,0451449F,100,96,0,4,52,48,5 ème
LOIR-ET-CHER,BLOIS,0410003F,143,124,15,4,68,75,5 ème
LOIR-ET-CHER,BLOIS,0410918A,139,139,0,0,73,66,5 ème
LOIR-ET-CHER,MONTOIRE-SUR-LE-LOIR,0410566T,108,97,7,4,69,39,5 ème
LOIR-ET-CHER,NEUNG-SUR-BEUVRON,0410035R,65,62,0,3,35,30,5 ème
LOIR-ET-CHER,OUCQUES LA NOUVELLE,0410015U,66,66,0,0,39,27,5 ème
LOIR-ET-CHER,SAINT-LAURENT-NOUAN,0410914W,112,96,13,3,54,58,5 ème
LOIR-ET-CHER,SALBRIS,0410686Y,18,18,0,0,8,10,5 ème
LOIR-ET-CHER,SALBRIS,0410717G,83,81,0,2,48,35,5 ème
LOIR-ET-CHER,VENDOME,0410768M,169,139,29,1,77,92,5 ème
CORSE-DU-SUD,AJACCIO,6200011T,190,190,0,0,107,83,5 ème
CORSE-DU-SUD,AJACCIO,6200084X,179,179,0,0,86,93,5 ème
CORSE-DU-SUD,AJACCIO,6200636X,0,0,0,0,0,0,5 ème
CORSE-DU-SUD,PORTO-VECCHIO,6200697N,138,118,16,4,74,64,5 ème
CORSE-DU-SUD,VICO,6200048H,30,30,0,0,21,9,5 ème
HAUTE-CORSE,CERVIONE,7200020J,74,71,3,0,40,34,5 ème
HAUTE-CORSE,L'ILE-ROUSSE,7200025P,124,119,4,1,57,67,5 ème
MEURTHE-ET-MOSELLE,ART-SUR-MEURTHE,0541344T,0,0,0,0,0,0,5 ème
MEURTHE-ET-MOSELLE,BENAMENIL,0540004L,75,69,0,6,36,39,5 ème
MEURTHE-ET-MOSELLE,DOMMARTEMONT,0541706L,69,50,15,4,36,33,5 ème
MEURTHE-ET-MOSELLE,JARNY,0540076P,0,0,0,0,0,0,5 ème
MEURTHE-ET-MOSELLE,JARVILLE-LA-MALGRANGE,0541306B,239,239,0,0,129,110,5 ème
MEURTHE-ET-MOSELLE,JARVILLE-LA-MALGRANGE,0541817G,111,101,8,2,57,54,5 ème
MEURTHE-ET-MOSELLE,LAXOU,0542262R,0,0,0,0,0,0,5 ème
MEURTHE-ET-MOSELLE,LIVERDUN,0541284C,121,121,0,0,61,60,5 ème
MEURTHE-ET-MOSELLE,LONGUYON,0542349K,124,124,0,0,61,63,5 ème
MEURTHE-ET-MOSELLE,LONGWY,0541288G,111,107,0,4,57,54,5 ème
MEURTHE-ET-MOSELLE,LUDRES,0542189L,173,172,0,1,81,92,5 ème
MEURTHE-ET-MOSELLE,NANCY,0540082W,0,0,0,0,0,0,5 ème
MEURTHE-ET-MOSELLE,NANCY,0540106X,145,142,0,3,77,68,5 ème
MEURTHE-ET-MOSELLE,REHON,0541336J,110,110,0,0,60,50,5 ème
MEURTHE-ET-MOSELLE,SAINT-NICOLAS-DE-PORT,0541572R,117,114,0,3,51,66,5 ème
MEURTHE-ET-MOSELLE,TOUL,0541210X,122,119,0,3,59,63,5 ème
MEURTHE-ET-MOSELLE,VAL DE BRIEY,0540115G,111,108,0,3,49,62,5 ème
MEURTHE-ET-MOSELLE,VEZELISE,0540071J,85,85,0,0,34,51,5 ème
MEUSE,BAR-LE-DUC,0550003E,0,0,0,0,0,0,5 ème
MEUSE,BAR-LE-DUC,0550004F,0,0,0,0,0,0,5 ème
MEUSE,STENAY,0550020Y,124,100,15,9,61,63,5 ème
MEUSE,VERDUN,0550026E,0,0,0,0,0,0,5 ème
MEUSE,VERDUN,0550055L,44,44,0,0,15,29,5 ème
MOSELLE,ALGRANGE,0570241C,0,0,0,0,0,0,5 ème
MOSELLE,AUMETZ,0572583Y,83,83,0,0,37,46,5 ème
MOSELLE,BOUZONVILLE,0570012D,109,105,0,4,54,55,5 ème
MOSELLE,DELME,0570020M,77,72,0,5,38,39,5 ème
MOSELLE,FAREBERSVILLER,0572023P,154,142,8,4,74,80,5 ème
MOSELLE,FOLSCHVILLER,0572187T,66,66,0,0,25,41,5 ème
MOSELLE,FORBACH,0572180K,133,113,14,6,73,60,5 ème
MOSELLE,FREYMING-MERLEBACH,0573491K,0,0,0,0,0,0,5 ème
MOSELLE,GROSBLIEDERSTROFF,0572363J,112,109,0,3,54,58,5 ème
MOSELLE,LONGEVILLE-LES-SAINT-AVOLD,0572360F,99,93,0,6,56,43,5 ème
MOSELLE,LORQUIN,0570328X,68,68,0,0,36,32,5 ème
MOSELLE,MARLY,0573211F,0,0,0,0,0,0,5 ème
MOSELLE,METZ,0570283Y,0,0,0,0,0,0,5 ème
MOSELLE,METZ,0572168X,99,90,0,9,43,56,5 ème
MOSELLE,SAINT-AVOLD,0572488V,139,125,9,5,75,64,5 ème
MOSELLE,SARREBOURG,0570213X,74,74,0,0,30,44,5 ème
MOSELLE,THIONVILLE,0572811W,145,145,0,0,76,69,5 ème
MOSELLE,VERNY,0573754W,149,147,0,2,67,82,5 ème
MOSELLE,WOIPPY,0572582X,121,119,0,2,60,61,5 ème
VOSGES,CAPAVENIR VOSGES,0881147U,124,109,12,3,62,62,5 ème
VOSGES,CHARMES,0881145S,94,79,9,6,48,46,5 ème
VOSGES,CHATEL-SUR-MOSELLE,0880418B,90,84,0,6,36,54,5 ème
VOSGES,EPINAL,0880149J,93,91,0,2,40,53,5 ème
VOSGES,LE THILLOT,0880065T,108,98,8,2,52,56,5 ème
VOSGES,RAMBERVILLERS,0880045W,131,121,0,10,76,55,5 ème
VOSGES,RAON-L'ETAPE,0881120P,106,95,9,2,46,60,5 ème
VOSGES,REMIREMONT,0881140L,0,0,0,0,0,0,5 ème
VOSGES,SAINT-DIE-DES-VOSGES,0880151L,171,158,10,3,79,92,5 ème
VOSGES,SAINT-DIE-DES-VOSGES,0881447V,57,52,0,5,20,37,5 ème
VOSGES,SENONES,0881101U,67,65,0,2,35,32,5 ème
VOSGES,VITTEL,0880156S,85,83,0,2,35,50,5 ème
ARDENNES,CARIGNAN,0081099B,104,92,12,0,52,52,5 ème
ARDENNES,CHARLEVILLE-MEZIERES,0080010T,0,0,0,0,0,0,5 ème
ARDENNES,CHARLEVILLE-MEZIERES,0080035V,84,82,0,2,48,36,5 ème
ARDENNES,CHARLEVILLE-MEZIERES,0080068F,38,36,0,2,21,17,5 ème
ARDENNES,JUNIVILLE,0080021E,98,98,0,0,58,40,5 ème
ARDENNES,NOUZONVILLE,0080036W,65,55,10,0,35,30,5 ème
ARDENNES,SEDAN,0080048J,0,0,0,0,0,0,5 ème
ARDENNES,VIREUX-WALLERAND,0080052N,53,53,0,0,25,28,5 ème
ARDENNES,VRIGNE AUX BOIS,0080839U,87,70,14,3,50,37,5 ème
AUBE,BAR-SUR-SEINE,0100005B,147,140,5,2,65,82,5 ème
AUBE,BOUILLY,0100765C,155,146,9,0,68,87,5 ème
AUBE,LUSIGNY-SUR-BARSE,0100033G,137,137,0,0,56,81,5 ème
AUBE,PONT-SAINTE-MARIE,0101031S,138,124,12,2,75,63,5 ème
AUBE,ROMILLY-SUR-SEINE,0100016N,0,0,0,0,0,0,5 ème
AUBE,ROMILLY-SUR-SEINE,0100787B,148,147,0,1,70,78,5 ème
AUBE,ROMILLY-SUR-SEINE,0100905E,145,124,19,2,67,78,5 ème
AUBE,SAINTE-SAVINE,0100664T,174,174,0,0,85,89,5 ème
HAUTE-MARNE,CHATEAUVILLAIN,0520006Z,40,40,0,0,16,24,5 ème
HAUTE-MARNE,CHAUMONT,0520966T,83,83,0,0,43,40,5 ème
HAUTE-MARNE,DOULAINCOURT-SAUCOURT,0520014H,56,56,0,0,26,30,5 ème
HAUTE-MARNE,FRONCLES,0520018M,24,24,0,0,11,13,5 ème
HAUTE-MARNE,LANGRES,0520021R,0,0,0,0,0,0,5 ème
HAUTE-MARNE,LA PORTE DU DER,0520022S,69,69,0,0,34,35,5 ème
HAUTE-MARNE,SAINT-DIZIER,0520692V,0,0,0,0,0,0,5 ème
HAUTE-MARNE,SAINT-DIZIER,0520968V,119,119,0,0,61,58,5 ème
HAUTE-MARNE,WASSY,0520032C,0,0,0,0,0,0,5 ème
MARNE,ANGLURE,0510001Z,78,78,0,0,42,36,5 ème
MARNE,CHALONS-EN-CHAMPAGNE,0511106A,6,0,6,0,1,5,5 ème
MARNE,CHALONS-EN-CHAMPAGNE,0511147V,0,0,0,0,0,0,5 ème
MARNE,FAGNIERES,0511472Y,138,127,9,2,72,66,5 ème
MARNE,GUEUX,0511564Y,156,156,0,0,75,81,5 ème
MARNE,MONTMIRAIL,0511177C,29,29,0,0,8,21,5 ème
MARNE,REIMS,0511801F,187,187,0,0,98,89,5 ème
MARNE,SAINT-MEMMIE,0511216V,189,170,11,8,85,104,5 ème
MARNE,VITRY-LE-FRANCOIS,0511144S,81,81,0,0,39,42,5 ème
MARNE,WITRY-LES-REIMS,0512014M,120,114,0,6,62,58,5 ème
BAS-RHIN,CHATENOIS,0671962U,129,129,0,0,68,61,5 ème
BAS-RHIN,DRULINGEN,0670014B,85,82,0,3,38,47,5 ème
BAS-RHIN,ERSTEIN,0670017E,219,192,19,8,85,134,5 ème
BAS-RHIN,GERSTHEIM,0672135G,78,78,0,0,37,41,5 ème
BAS-RHIN,HOERDT,0672012Y,105,105,0,0,50,55,5 ème
BAS-RHIN,ILLKIRCH-GRAFFENSTADEN,0672194W,168,150,15,3,80,88,5 ème
BAS-RHIN,LAUTERBOURG,0671688W,72,72,0,0,30,42,5 ème
BAS-RHIN,LINGOLSHEIM,0671690Y,153,135,14,4,75,78,5 ème
BAS-RHIN,MARMOUTIER,0671985U,87,81,0,6,43,44,5 ème
BAS-RHIN,MATZENHEIM,0671604E,105,105,0,0,46,59,5 ème
BAS-RHIN,MOLSHEIM,0672606U,155,143,11,1,80,75,5 ème
BAS-RHIN,NIEDERBRONN-LES-BAINS,0671738A,96,88,0,8,50,46,5 ème
BAS-RHIN,REICHSHOFFEN,0671595V,103,90,8,5,53,50,5 ème
BAS-RHIN,SAVERNE,0671987W,109,107,0,2,65,44,5 ème
BAS-RHIN,SCHILTIGHEIM,0670089H,0,0,0,0,0,0,5 ème
BAS-RHIN,SELESTAT,0671830A,163,140,18,5,74,89,5 ème
BAS-RHIN,SOUFFELWEYERSHEIM,0672254L,145,140,0,5,76,69,5 ème
BAS-RHIN,STRASBOURG,0670085D,0,0,0,0,0,0,5 ème
BAS-RHIN,STRASBOURG,0671508A,166,166,0,0,83,83,5 ème
BAS-RHIN,STRASBOURG,0671594U,151,145,0,6,73,78,5 ème
BAS-RHIN,STRASBOURG,0671620X,122,122,0,0,65,57,5 ème
BAS-RHIN,STRASBOURG,0671636P,0,0,0,0,0,0,5 ème
BAS-RHIN,STRASBOURG,0672128Z,110,105,0,5,47,63,5 ème
BAS-RHIN,STRASBOURG,0672304R,63,63,0,0,33,30,5 ème
BAS-RHIN,VAL-DE-MODER,0671598Y,113,111,0,2,52,61,5 ème
BAS-RHIN,VENDENHEIM,0672658A,71,71,0,0,34,37,5 ème
BAS-RHIN,VILLE,0671601B,121,121,0,0,65,56,5 ème
BAS-RHIN,WISSEMBOURG,0671984T,152,134,15,3,72,80,5 ème
HAUT-RHIN,ALTKIRCH,0681373Y,167,127,32,8,81,86,5 ème
HAUT-RHIN,FERRETTE,0680014W,123,123,0,0,63,60,5 ème
HAUT-RHIN,FORTSCHWIHR,0681190Z,202,202,0,0,100,102,5 ème
HAUT-RHIN,HUNINGUE,0680020C,189,175,14,0,89,100,5 ème
HAUT-RHIN,MULHOUSE,0680105V,152,135,14,3,68,84,5 ème
HAUT-RHIN,MULHOUSE,0680135C,208,208,0,0,101,107,5 ème
HAUT-RHIN,MULHOUSE,0681768C,0,0,0,0,0,0,5 ème
HAUT-RHIN,MULHOUSE,0681961M,145,144,0,1,66,79,5 ème
HAUT-RHIN,SAINT-AMARIN,0680064A,96,96,0,0,51,45,5 ème
HAUT-RHIN,SAINT-LOUIS,0680066C,0,0,0,0,0,0,5 ème
HAUT-RHIN,SIERENTZ,0681269K,120,119,0,1,59,61,5 ème
HAUT-RHIN,SOULTZ-HAUT-RHIN,0680128V,120,117,0,3,68,52,5 ème
HAUT-RHIN,VOLGELSHEIM,0681125D,170,144,22,4,83,87,5 ème
HAUT-RHIN,WITTELSHEIM,0681322T,85,83,0,2,43,42,5 ème
HAUT-RHIN,WITTENHEIM,0680161F,15,0,15,0,6,9,5 ème
GUADELOUPE,BASSE-TERRE,9710482X,91,75,12,4,47,44,5 ème
GUADELOUPE,CAPESTERRE-BELLE-EAU,9710406P,126,100,17,9,66,60,5 ème
GUADELOUPE,CAPESTERRE-BELLE-EAU,9710418C,0,0,0,0,0,0,5 ème
GUADELOUPE,LAMENTIN,9710086S,163,149,9,5,85,78,5 ème
GUADELOUPE,LAMENTIN,9710090W,0,0,0,0,0,0,5 ème
GUADELOUPE,LE GOSIER,9710039R,265,249,9,7,127,138,5 ème
GUADELOUPE,LES ABYMES,9710826W,161,156,0,5,71,90,5 ème
GUADELOUPE,LES ABYMES,9710938T,165,165,0,0,89,76,5 ème
GUADELOUPE,MORNE-A-L'EAU,9710403L,160,146,9,5,78,82,5 ème
GUADELOUPE,POINTE-A-PITRE,9710073C,90,86,0,4,41,49,5 ème
GUADELOUPE,SAINTE-ROSE,9710023Y,137,116,17,4,71,66,5 ème
GUADELOUPE,SAINTE-ROSE,9711181G,102,102,0,0,45,57,5 ème
GUADELOUPE,SAINT-LOUIS,9710037N,25,19,3,3,15,10,5 ème
GUADELOUPE,VIEUX-HABITANTS,9710045X,86,83,0,3,38,48,5 ème
GUYANE,CAYENNE,9730020J,245,216,24,5,116,129,5 ème
GUYANE,CAYENNE,9730083C,307,259,44,4,148,159,5 ème
GUYANE,CAYENNE,9730247F,188,184,0,4,97,91,5 ème
GUYANE,CAYENNE,9730479H,30,30,0,0,18,12,5 ème
GUYANE,GRAND-SANTI,9730380A,141,124,17,0,71,70,5 ème
GUYANE,KOUROU,9730483M,114,102,0,12,57,57,5 ème
GUYANE,MACOURIA,9730206L,158,151,0,7,75,83,5 ème
GUYANE,MANA,9730373T,180,163,14,3,90,90,5 ème
GUYANE,MATOURY,9730307W,294,245,48,1,151,143,5 ème
GUYANE,PAPAICHTON,9730381B,53,39,11,3,28,25,5 ème
GUYANE,REMIRE-MONTJOLY,9730179G,242,216,21,5,124,118,5 ème
GUYANE,SAINT-GEORGES,9730173A,171,145,23,3,75,96,5 ème
GUYANE,SAINT-LAURENT-DU-MARONI,9730110G,225,195,28,2,128,97,5 ème
GUYANE,SAINT-LAURENT-DU-MARONI,9730348R,226,217,0,9,111,115,5 ème
AISNE,CHARMES,0020467X,23,23,0,0,14,9,5 ème
AISNE,CHATEAU-THIERRY,0021939X,0,0,0,0,0,0,5 ème
AISNE,CORBENY,0020017H,102,102,0,0,59,43,5 ème
AISNE,FLAVY-LE-MARTEL,0021593W,128,128,0,0,56,72,5 ème
AISNE,HARLY,0021534G,100,98,0,2,42,58,5 ème
AISNE,HIRSON,0020075W,133,115,13,5,70,63,5 ème
AISNE,HIRSON,0020089L,0,0,0,0,0,0,5 ème
AISNE,RIBEMONT,0021689A,83,82,0,1,38,45,5 ème
AISNE,SAINT-QUENTIN,0020056A,106,87,16,3,53,53,5 ème
AISNE,SAINT-QUENTIN,0020473D,207,207,0,0,92,115,5 ème
AISNE,SAINT-QUENTIN,0022042J,0,0,0,0,0,0,5 ème
AISNE,SOISSONS,0020492Z,0,0,0,0,0,0,5 ème
AISNE,SOISSONS,0022044L,0,0,0,0,0,0,5 ème
AISNE,TERGNIER,0020063H,191,170,15,6,115,76,5 ème
AISNE,VERVINS,0020067M,114,92,16,6,50,64,5 ème
AISNE,VILLENEUVE-SUR-AISNE,0020029W,96,96,0,0,41,55,5 ème
AISNE,VILLERS-COTTERETS,0021989B,67,67,0,0,38,29,5 ème
OISE,BEAUVAIS,0600002B,0,0,0,0,0,0,5 ème
OISE,BEAUVAIS,0601189S,140,136,0,4,60,80,5 ème
OISE,BRENOUILLE,0601786R,146,143,0,3,77,69,5 ème
OISE,BRESLES,0601424X,126,123,0,3,70,56,5 ème
OISE,BRETEUIL,0601153C,14,12,1,1,5,9,5 ème
OISE,CHAMBLY,0600060P,159,159,0,0,84,75,5 ème
OISE,COMPIEGNE,0601295G,94,94,0,0,48,46,5 ème
OISE,COMPIEGNE,0601366J,152,148,0,4,76,76,5 ème
OISE,CREPY-EN-VALOIS,0601294F,157,150,0,7,77,80,5 ème
OISE,CREVECOEUR-LE-GRAND,0600027D,130,109,17,4,69,61,5 ème
OISE,LAMORLAYE,0601872J,135,135,0,0,63,72,5 ème
OISE,MOUY,0601293E,146,143,0,3,84,62,5 ème
OISE,PONT-SAINTE-MAXENCE,0601147W,166,166,0,0,83,83,5 ème
OISE,RIBECOURT-DRESLINCOURT,0601822E,0,0,0,0,0,0,5 ème
OISE,SAINT-AUBIN-EN-BRAY,0601292D,147,145,0,2,75,72,5 ème
OISE,SAINT-JUST-EN-CHAUSSEE,0601445V,195,178,11,6,96,99,5 ème
OISE,SAINT-LEU-D'ESSERENT,0601409F,177,175,0,2,82,95,5 ème
SOMME,ALBERT,0801218P,83,79,0,4,38,45,5 ème
SOMME,AMIENS,0800019L,113,94,15,4,51,62,5 ème
SOMME,AMIENS,0800020M,106,105,0,1,50,56,5 ème
SOMME,AMIENS,0801194N,0,0,0,0,0,0,5 ème
SOMME,AMIENS,0801219R,179,179,0,0,104,75,5 ème
SOMME,AMIENS,0801946F,0,0,0,0,0,0,5 ème
SOMME,BRAY-SUR-SOMME,0800023R,41,41,0,0,22,19,5 ème
SOMME,CHAULNES,0801536K,73,73,0,0,35,38,5 ème
SOMME,CONTY,0800025T,113,109,0,4,60,53,5 ème
SOMME,CORBIE,0801478X,90,90,0,0,56,34,5 ème
SOMME,CRECY-EN-PONTHIEU,0800027V,73,70,0,3,30,43,5 ème
SOMME,FLIXECOURT,0801487G,72,67,0,5,34,38,5 ème
SOMME,HAM,0800036E,107,87,15,5,59,48,5 ème
SOMME,LONGPRE-LES-CORPS-SAINTS,0800037F,85,83,0,2,48,37,5 ème
SOMME,MONTDIDIER,0801225X,105,100,0,5,58,47,5 ème
NORD,ARMENTIERES,0590257J,0,0,0,0,0,0,5 ème
NORD,ARMENTIERES,0594397J,121,118,0,3,49,72,5 ème
NORD,AVESNELLES,0595176F,124,117,6,1,62,62,5 ème
NORD,BAILLEUL,0593063J,0,0,0,0,0,0,5 ème
NORD,BAILLEUL,0594636U,239,223,12,4,126,113,5 ème
NORD,BAVAY,0592924H,21,21,0,0,14,7,5 ème
NORD,BERGUES,0593479L,56,56,0,0,28,28,5 ème
NORD,BERLAIMONT,0594415D,80,80,0,0,37,43,5 ème
NORD,BEUVRAGES,0594301E,116,104,8,4,53,63,5 ème
NORD,CAMBRAI,0593487V,123,117,0,6,59,64,5 ème
NORD,CAMBRAI,0593488W,135,115,16,4,67,68,5 ème
NORD,CAMBRAI,0595175E,127,123,0,4,67,60,5 ème
NORD,CAPPELLE-EN-PEVELE,0596873A,185,185,0,0,95,90,5 ème
NORD,CAUDRY,0590044C,0,0,0,0,0,0,5 ème
NORD,COUDEKERQUE-BRANCHE,0590263R,0,0,0,0,0,0,5 ème
NORD,COUDEKERQUE-BRANCHE,0594295Y,49,43,0,6,19,30,5 ème
NORD,CROIX,0593239A,137,134,0,3,73,64,5 ème
NORD,DENAIN,0592962Z,72,70,0,2,34,38,5 ème
NORD,DOUAI,0590068D,168,162,0,6,79,89,5 ème
NORD,DOUAI,0592941B,147,139,0,8,80,67,5 ème
NORD,DOUAI,0595387K,211,208,0,3,100,111,5 ème
NORD,DUNKERQUE,0590164H,55,52,0,3,23,32,5 ème
NORD,DUNKERQUE,0593101A,95,95,0,0,44,51,5 ème
NORD,FACHES-THUMESNIL,0593476H,103,103,0,0,65,38,5 ème
NORD,FOURMIES,0590083V,0,0,0,0,0,0,5 ème
NORD,FOURMIES,0593252P,96,80,14,2,45,51,5 ème
NORD,GRANDE-SYNTHE,0595782P,79,75,0,4,38,41,5 ème
NORD,HALLUIN,0590091D,146,134,7,5,73,73,5 ème
NORD,HAUBOURDIN,0593127D,59,56,0,3,27,32,5 ème
NORD,HAUTMONT,0590098L,0,0,0,0,0,0,5 ème
NORD,HAZEBROUCK,0593077Z,0,0,0,0,0,0,5 ème
NORD,HEM,0595630Z,134,134,0,0,72,62,5 ème
NORD,JEUMONT,0592712C,0,0,0,0,0,0,5 ème
NORD,LA MADELEINE,0593658F,117,104,11,2,60,57,5 ème
NORD,LESQUIN,0592889V,194,194,0,0,98,96,5 ème
NORD,LILLE,0590115E,116,112,0,4,61,55,5 ème
NORD,LILLE,0590131X,126,124,0,2,61,65,5 ème
NORD,LILLE,0590266U,0,0,0,0,0,0,5 ème
NORD,LILLE,0593027V,0,0,0,0,0,0,5 ème
NORD,LILLE,0594288R,103,103,0,0,45,58,5 ème
NORD,LILLE,0594523W,95,93,0,2,41,54,5 ème
NORD,LILLE,0596177U,79,79,0,0,44,35,5 ème
NORD,LILLE,0597004T,117,117,0,0,63,54,5 ème
NORD,LINSELLES,0592895B,148,148,0,0,87,61,5 ème
NORD,LOOS,0593660H,73,73,0,0,39,34,5 ème
NORD,MARCQ-EN-BAROEUL,0593227M,171,171,0,0,85,86,5 ème
NORD,MASNIERES,0593683H,109,109,0,0,53,56,5 ème
NORD,MASNY,0593483R,108,103,0,5,50,58,5 ème
NORD,MAUBEUGE,0594362W,135,124,5,6,65,70,5 ème
NORD,MAUBEUGE,0595399Y,167,167,0,0,70,97,5 ème
NORD,MONS-EN-BAROEUL,0593178J,117,107,10,0,49,68,5 ème
NORD,MONS-EN-BAROEUL,0593218C,121,121,0,0,53,68,5 ème
NORD,PERENCHIES,0594628K,93,91,0,2,46,47,5 ème
NORD,RAISMES,0594408W,112,98,10,4,54,58,5 ème
NORD,RONCQ,0593668S,73,73,0,0,28,45,5 ème
NORD,ROOST-WARENDIN,0593251N,154,142,7,5,66,88,5 ème
NORD,ROUBAIX,0590189K,0,0,0,0,0,0,5 ème
NORD,ROUBAIX,0592905M,112,95,17,0,50,62,5 ème
NORD,ROUBAIX,0593667R,130,111,16,3,69,61,5 ème
NORD,ROUBAIX,0594634S,95,81,8,6,43,52,5 ème
NORD,SAINT-AMAND-LES-EAUX,0595400Z,220,220,0,0,111,109,5 ème
NORD,SAINT-ANDRE-LEZ-LILLE,0592911U,88,88,0,0,36,52,5 ème
NORD,SIN-LE-NOBLE,0593185S,169,150,15,4,81,88,5 ème
NORD,SOMAIN,0597055Y,231,231,0,0,122,109,5 ème
NORD,THUMERIES,0590211J,168,168,0,0,84,84,5 ème
NORD,TOURCOING,0592714E,83,80,2,1,39,44,5 ème
NORD,TOURCOING,0592966D,0,0,0,0,0,0,5 ème
NORD,TOURCOING,0593149C,128,126,0,2,57,71,5 ème
NORD,TOURCOING,0593150D,106,106,0,0,45,61,5 ème
NORD,TOURCOING,0593152F,44,44,0,0,21,23,5 ème
NORD,VALENCIENNES,0592967E,0,0,0,0,0,0,5 ème
NORD,VALENCIENNES,0592969G,0,0,0,0,0,0,5 ème
NORD,VALENCIENNES,0593155J,230,220,5,5,104,126,5 ème
NORD,VALENCIENNES,0595173C,92,92,0,0,40,52,5 ème
NORD,VILLENEUVE-D'ASCQ,0595656C,85,81,0,4,44,41,5 ème
NORD,WATTEN,0593159N,61,57,0,4,35,26,5 ème
NORD,WATTRELOS,0593242D,153,137,14,2,77,76,5 ème
NORD,WORMHOUT,0595856V,0,0,0,0,0,0,5 ème
PAS-DE-CALAIS,AIRE-SUR-LA-LYS,0622094P,173,159,11,3,68,105,5 ème
PAS-DE-CALAIS,ARDRES,0620004T,155,155,0,0,88,67,5 ème
PAS-DE-CALAIS,ARDRES,0622123W,129,125,0,4,72,57,5 ème
PAS-DE-CALAIS,AUBIGNY-EN-ARTOIS,0620016F,161,161,0,0,85,76,5 ème
PAS-DE-CALAIS,BERCK,0620229M,11,11,0,0,5,6,5 ème
PAS-DE-CALAIS,BETHUNE,0622089J,0,0,0,0,0,0,5 ème
PAS-DE-CALAIS,BOULOGNE-SUR-MER,0620199E,109,106,0,3,56,53,5 ème
PAS-DE-CALAIS,BOULOGNE-SUR-MER,0622131E,66,66,0,0,38,28,5 ème
PAS-DE-CALAIS,BOULOGNE-SUR-MER,0623571V,101,101,0,0,57,44,5 ème
PAS-DE-CALAIS,BOUVIGNY-BOYEFFLES,0622108E,150,150,0,0,79,71,5 ème
PAS-DE-CALAIS,BRUAY-LA-BUISSIERE,0620198D,91,91,0,0,56,35,5 ème
PAS-DE-CALAIS,CALAIS,0620188T,0,0,0,0,0,0,5 ème
PAS-DE-CALAIS,CALAIS,0622099V,13,0,13,0,5,8,5 ème
PAS-DE-CALAIS,DIVION,0620079Z,89,85,0,4,43,46,5 ème
PAS-DE-CALAIS,ETAPLES,0620187S,0,0,0,0,0,0,5 ème
PAS-DE-CALAIS,ETAPLES,0622192W,0,0,0,0,0,0,5 ème
PAS-DE-CALAIS,FREVENT,0622261W,95,83,12,0,45,50,5 ème
PAS-DE-CALAIS,GUINES,0622150A,0,0,0,0,0,0,5 ème
PAS-DE-CALAIS,HARNES,0622791X,181,163,15,3,87,94,5 ème
PAS-DE-CALAIS,HESDIN,0620099W,100,88,12,0,50,50,5 ème
PAS-DE-CALAIS,ISBERGUES,0620136L,109,109,0,0,63,46,5 ème
PAS-DE-CALAIS,LENS,0622418S,201,185,16,0,99,102,5 ème
PAS-DE-CALAIS,LENS,0623864N,0,0,0,0,0,0,5 ème
PAS-DE-CALAIS,LIEVIN,0620190V,0,0,0,0,0,0,5 ème
PAS-DE-CALAIS,LIEVIN,0620219B,109,89,16,4,57,52,5 ème
PAS-DE-CALAIS,LIEVIN,0622086F,132,129,0,3,61,71,5 ème
PAS-DE-CALAIS,MARQUISE,0620131F,0,0,0,0,0,0,5 ème
PAS-DE-CALAIS,MARQUISE,0622143T,84,84,0,0,42,42,5 ème
PAS-DE-CALAIS,MAZINGARBE,0622087G,109,106,0,3,62,47,5 ème
PAS-DE-CALAIS,MERICOURT,0622262X,132,115,16,1,67,65,5 ème
PAS-DE-CALAIS,MONTIGNY-EN-GOHELLE,0622423X,87,87,0,0,47,40,5 ème
PAS-DE-CALAIS,NOEUX-LES-MINES,0624440P,0,0,0,0,0,0,5 ème
PAS-DE-CALAIS,OUTREAU,0620154F,135,135,0,0,67,68,5 ème
PAS-DE-CALAIS,ROUVROY,0620158K,133,133,0,0,75,58,5 ème
PAS-DE-CALAIS,SAINT-MARTIN-BOULOGNE,0622198C,0,0,0,0,0,0,5 ème
PAS-DE-CALAIS,SAINT-NICOLAS,0623014P,197,176,17,4,91,106,5 ème
PAS-DE-CALAIS,SAINT-OMER,0622907Y,96,76,15,5,44,52,5 ème
PAS-DE-CALAIS,SAINT-POL-SUR-TERNOISE,0622121U,35,35,0,0,13,22,5 ème
PAS-DE-CALAIS,VITRY-EN-ARTOIS,0622084D,166,148,13,5,82,84,5 ème
PAS-DE-CALAIS,WIMILLE,0622299M,107,93,14,0,51,56,5 ème
PAS-DE-CALAIS,WINGLES,0620180J,178,154,21,3,83,95,5 ème
SEINE-ET-MARNE,BRIE-COMTE-ROBERT,0771363N,198,178,16,4,89,109,5 ème
SEINE-ET-MARNE,BRIE-COMTE-ROBERT,0771993Y,111,111,0,0,52,59,5 ème
SEINE-ET-MARNE,BUSSY-SAINT-GEORGES,0772413E,154,154,0,0,75,79,5 ème
SEINE-ET-MARNE,BUSSY-SAINT-GEORGES,0772588V,139,136,0,3,65,74,5 ème
SEINE-ET-MARNE,CHAMPS-SUR-MARNE,0772330P,130,130,0,0,67,63,5 ème
SEINE-ET-MARNE,CHATEAU-LANDON,0770010T,76,76,0,0,34,42,5 ème
SEINE-ET-MARNE,CHELLES,0770013W,138,138,0,0,70,68,5 ème
SEINE-ET-MARNE,COMBS-LA-VILLE,0771475K,185,168,15,2,92,93,5 ème
SEINE-ET-MARNE,COULOMMIERS,0771513B,155,141,14,0,82,73,5 ème
SEINE-ET-MARNE,COURTRY,0772396L,137,134,0,3,70,67,5 ème
SEINE-ET-MARNE,DAMMARIE-LES-LYS,0770019C,174,140,26,8,95,79,5 ème
SEINE-ET-MARNE,FONTAINEBLEAU,0771925Z,195,195,0,0,88,107,5 ème
SEINE-ET-MARNE,GRETZ-ARMAINVILLIERS,0772189L,136,134,0,2,71,65,5 ème
SEINE-ET-MARNE,LA CHAPELLE-LA-REINE,0770009S,136,135,0,1,68,68,5 ème
SEINE-ET-MARNE,LA FERTE-SOUS-JOUARRE,0770024H,199,194,0,5,107,92,5 ème
SEINE-ET-MARNE,LE MEE-SUR-SEINE,0771337K,164,164,0,0,75,89,5 ème
SEINE-ET-MARNE,LIEUSAINT,0772128V,116,113,0,3,58,58,5 ème
SEINE-ET-MARNE,MELUN,0771238C,0,0,0,0,0,0,5 ème
SEINE-ET-MARNE,MELUN,0771762X,171,168,0,3,83,88,5 ème
SEINE-ET-MARNE,MONTEREAU-FAULT-YONNE,0770938B,0,0,0,0,0,0,5 ème
SEINE-ET-MARNE,MONTEREAU-FAULT-YONNE,0771567K,178,158,19,1,84,94,5 ème
SEINE-ET-MARNE,MOUROUX,0772247Z,101,99,0,2,48,53,5 ème
SEINE-ET-MARNE,NANTEUIL-LES-MEAUX,0772499Y,177,175,0,2,100,77,5 ème
SEINE-ET-MARNE,NEMOURS,0771621U,74,74,0,0,35,39,5 ème
SEINE-ET-MARNE,PONTAULT-COMBAULT,0771419Z,190,190,0,0,101,89,5 ème
SEINE-ET-MARNE,PROVINS,0771336J,0,0,0,0,0,0,5 ème
SEINE-ET-MARNE,PROVINS,0771515D,149,146,0,3,62,87,5 ème
SEINE-ET-MARNE,SAINT-PIERRE-LES-NEMOURS,0772574E,113,106,0,7,53,60,5 ème
SEINE-ET-MARNE,SAVIGNY-LE-TEMPLE,0771960M,154,138,14,2,77,77,5 ème
SEINE-ET-MARNE,SOURDUN,0772737G,53,53,0,0,26,27,5 ème
SEINE-ET-MARNE,THORIGNY-SUR-MARNE,0770944H,0,0,0,0,0,0,5 ème
SEINE-ET-MARNE,THORIGNY-SUR-MARNE,0771472G,178,178,0,0,82,96,5 ème
SEINE-ET-MARNE,TORCY,0772482E,97,97,0,0,44,53,5 ème
SEINE-ET-MARNE,VARENNES-SUR-SEINE,0770053P,146,143,0,3,67,79,5 ème
SEINE-ET-MARNE,VILLIERS-SAINT-GEORGES,0770059W,75,74,0,1,31,44,5 ème
SEINE-SAINT-DENIS,AUBERVILLIERS,0931184G,149,133,16,0,66,83,5 ème
SEINE-SAINT-DENIS,AUBERVILLIERS,0931186J,139,139,0,0,73,66,5 ème
SEINE-SAINT-DENIS,AUBERVILLIERS,0932272P,107,87,15,5,54,53,5 ème
SEINE-SAINT-DENIS,BAGNOLET,0930936M,0,0,0,0,0,0,5 ème
SEINE-SAINT-DENIS,BOBIGNY,0931198X,0,0,0,0,0,0,5 ème
SEINE-SAINT-DENIS,BONDY,0931005M,110,109,0,1,52,58,5 ème
SEINE-SAINT-DENIS,BONDY,0931612X,167,150,17,0,83,84,5 ème
SEINE-SAINT-DENIS,BONDY,0932282A,0,0,0,0,0,0,5 ème
SEINE-SAINT-DENIS,DRANCY,0931201A,189,186,0,3,100,89,5 ème
SEINE-SAINT-DENIS,DRANCY,0932229T,0,0,0,0,0,0,5 ème
SEINE-SAINT-DENIS,DUGNY,0932126F,0,0,0,0,0,0,5 ème
SEINE-SAINT-DENIS,EPINAY-SUR-SEINE,0931428X,152,152,0,0,69,83,5 ème
SEINE-SAINT-DENIS,GAGNY,0930898W,153,150,0,3,85,68,5 ème
SEINE-SAINT-DENIS,GOURNAY-SUR-MARNE,0931382X,106,106,0,0,53,53,5 ème
SEINE-SAINT-DENIS,LE PRE-SAINT-GERVAIS,0931219V,145,145,0,0,73,72,5 ème
SEINE-SAINT-DENIS,LE RAINCY,0930969Y,163,163,0,0,77,86,5 ème
SEINE-SAINT-DENIS,LE RAINCY,0932302X,26,26,0,0,26,0,5 ème
SEINE-SAINT-DENIS,LIVRY-GARGAN,0930619T,217,210,0,7,114,103,5 ème
SEINE-SAINT-DENIS,LIVRY-GARGAN,0932454M,159,159,0,0,79,80,5 ème
SEINE-SAINT-DENIS,MONTREUIL,0931213N,116,110,0,6,56,60,5 ème
SEINE-SAINT-DENIS,MONTREUIL,0932579Y,130,128,0,2,62,68,5 ème
SEINE-SAINT-DENIS,NOISY-LE-GRAND,0931705Y,175,175,0,0,87,88,5 ème
SEINE-SAINT-DENIS,NOISY-LE-GRAND,0932333F,134,132,0,2,66,68,5 ème
SEINE-SAINT-DENIS,NOISY-LE-GRAND,0932581A,105,99,0,6,58,47,5 ème
SEINE-SAINT-DENIS,PIERREFITTE-SUR-SEINE,0931224A,163,163,0,0,81,82,5 ème
SEINE-SAINT-DENIS,ROMAINVILLE,0931222Y,122,120,0,2,67,55,5 ème
SEINE-SAINT-DENIS,ROSNY-SOUS-BOIS,0931739K,0,0,0,0,0,0,5 ème
SEINE-SAINT-DENIS,SAINT-DENIS,0930865K,133,131,0,2,65,68,5 ème
SEINE-SAINT-DENIS,SAINT-DENIS,0931229F,150,141,9,0,65,85,5 ème
SEINE-SAINT-DENIS,SAINT-DENIS,0931230G,128,128,0,0,59,69,5 ème
SEINE-SAINT-DENIS,SAINT-OUEN,0932261C,137,134,0,3,72,65,5 ème
SEINE-SAINT-DENIS,TREMBLAY-EN-FRANCE,0931149U,214,210,0,4,98,116,5 ème
SEINE-SAINT-DENIS,VAUJOURS,0930921W,203,203,0,0,102,101,5 ème
SEINE-SAINT-DENIS,VILLEMOMBLE,0931227D,155,153,0,2,78,77,5 ème
SEINE-SAINT-DENIS,VILLEPINTE,0932038K,100,100,0,0,55,45,5 ème
VAL-DE-MARNE,ALFORTVILLE,0941022A,182,170,12,0,89,93,5 ème
VAL-DE-MARNE,ARCUEIL,0941971G,206,189,17,0,91,115,5 ème
VAL-DE-MARNE,BOISSY-SAINT-LEGER,0940612E,87,84,0,3,36,51,5 ème
VAL-DE-MARNE,CHAMPIGNY-SUR-MARNE,0941015T,139,123,16,0,70,69,5 ème
VAL-DE-MARNE,CHENNEVIERES-SUR-MARNE,0941348E,152,136,11,5,67,85,5 ème
VAL-DE-MARNE,CRETEIL,0940006W,170,154,15,1,81,89,5 ème
VAL-DE-MARNE,CRETEIL,0940031Y,123,123,0,0,59,64,5 ème
VAL-DE-MARNE,CRETEIL,0940100Y,104,96,0,8,63,41,5 ème
VAL-DE-MARNE,CRETEIL,0941102M,104,99,0,5,43,61,5 ème
VAL-DE-MARNE,CRETEIL,0941614U,56,56,0,0,56,0,5 ème
VAL-DE-MARNE,GENTILLY,0940134K,0,0,0,0,0,0,5 ème
VAL-DE-MARNE,IVRY-SUR-SEINE,0941025D,147,131,16,0,68,79,5 ème
VAL-DE-MARNE,IVRY-SUR-SEINE,0941601E,164,161,0,3,67,97,5 ème
VAL-DE-MARNE,JOINVILLE-LE-PONT,0940012C,128,128,0,0,57,71,5 ème
VAL-DE-MARNE,LE PERREUX-SUR-MARNE,0940788W,168,163,0,5,75,93,5 ème
VAL-DE-MARNE,LE PLESSIS-TREVISE,0941221S,203,203,0,0,98,105,5 ème
VAL-DE-MARNE,L'HAY-LES-ROSES,0940583Y,152,137,11,4,67,85,5 ème
VAL-DE-MARNE,MAISONS-ALFORT,0941024C,71,71,0,0,36,35,5 ème
VAL-DE-MARNE,MAISONS-ALFORT,0941355M,0,0,0,0,0,0,5 ème
VAL-DE-MARNE,NOGENT-SUR-MARNE,0941714C,239,239,0,0,112,127,5 ème
VAL-DE-MARNE,RUNGIS,0940072T,80,80,0,0,43,37,5 ème
VAL-DE-MARNE,SAINT-MAUR-DES-FOSSES,0940140S,0,0,0,0,0,0,5 ème
VAL-DE-MARNE,SAINT-MAUR-DES-FOSSES,0940552P,211,211,0,0,114,97,5 ème
VAL-DE-MARNE,SAINT-MAUR-DES-FOSSES,0940569H,180,180,0,0,87,93,5 ème
VAL-DE-MARNE,SAINT-MAUR-DES-FOSSES,0941600D,141,141,0,0,73,68,5 ème
VAL-DE-MARNE,VALENTON,0941052H,114,114,0,0,49,65,5 ème
VAL-DE-MARNE,VILLEJUIF,0941038T,137,137,0,0,77,60,5 ème
VAL-DE-MARNE,VILLENEUVE-SAINT-GEORGES,0940749D,132,129,0,3,66,66,5 ème
VAL-DE-MARNE,VILLENEUVE-SAINT-GEORGES,0940792A,125,121,0,4,63,62,5 ème
VAL-DE-MARNE,VITRY-SUR-SEINE,0941033M,130,122,8,0,62,68,5 ème
VAL-DE-MARNE,VITRY-SUR-SEINE,0941224V,113,100,13,0,48,65,5 ème
PARIS,PARIS,0750776L,0,0,0,0,0,0,5 ème
PARIS,PARIS,0752829T,80,79,0,1,35,45,5 ème
PARIS,PARIS,0755778Y,70,64,0,6,36,34,5 ème
PARIS,PARIS,0750607C,155,153,0,2,79,76,5 ème
PARIS,PARIS,0750778N,0,0,0,0,0,0,5 ème
PARIS,PARIS,0752536Z,108,108,0,0,57,51,5 ème
PARIS,PARIS,0753896C,256,245,0,11,137,119,5 ème
PARIS,PARIS,0754853T,94,94,0,0,41,53,5 ème
PARIS,PARIS,0752316K,104,102,0,2,54,50,5 ème
PARIS,PARIS,0753982W,130,130,0,0,64,66,5 ème
PARIS,PARIS,0754924V,0,0,0,0,0,0,5 ème
PARIS,PARIS,0750445B,141,127,14,0,63,78,5 ème
PARIS,PARIS,0750463W,0,0,0,0,0,0,5 ème
PARIS,PARIS,0752543G,90,90,0,0,43,47,5 ème
PARIS,PARIS,0752846L,0,0,0,0,0,0,5 ème
PARIS,PARIS,0751708Z,0,0,0,0,0,0,5 ème
PARIS,PARIS,0752318M,137,137,0,0,67,70,5 ème
PARIS,PARIS,0752545J,169,169,0,0,90,79,5 ème
PARIS,PARIS,0752546K,163,163,0,0,77,86,5 ème
PARIS,PARIS,0753992G,59,59,0,0,21,38,5 ème
PARIS,PARIS,0754475G,0,0,0,0,0,0,5 ème
PARIS,PARIS,0752919R,57,57,0,0,33,24,5 ème
PARIS,PARIS,0752936J,133,133,0,0,69,64,5 ème
PARIS,PARIS,0752554U,194,190,0,4,100,94,5 ème
PARIS,PARIS,0753350J,0,0,0,0,0,0,5 ème
PARIS,PARIS,0750429J,88,86,0,2,43,45,5 ème
PARIS,PARIS,0752196E,69,62,7,0,33,36,5 ème
PARIS,PARIS,0750650Z,0,0,0,0,0,0,5 ème
PARIS,PARIS,0751706X,106,103,0,3,52,54,5 ème
PARIS,PARIS,0755052J,52,52,0,0,22,30,5 ème
PARIS,PARIS,0753046D,120,120,0,0,68,52,5 ème
PARIS,PARIS,0754005W,135,135,0,0,72,63,5 ème
PARIS,PARIS,0755029J,25,25,0,0,0,25,5 ème
PARIS,PARIS,0752693V,105,99,0,6,51,54,5 ème
PARIS,PARIS,0753965C,63,63,0,0,25,38,5 ème
PARIS,PARIS,0750407K,53,52,0,1,35,18,5 ème
PARIS,PARIS,0753967E,115,115,0,0,58,57,5 ème
PARIS,PARIS,0752527P,154,153,0,1,66,88,5 ème
PARIS,PARIS,0752528R,124,122,0,2,73,51,5 ème
PARIS,PARIS,0752882A,110,110,0,0,60,50,5 ème
PARIS,PARIS,0752912H,96,96,0,0,51,45,5 ème
PARIS,PARIS,0752961L,0,0,0,0,0,0,5 ème
PARIS,PARIS,0752533W,106,103,0,3,50,56,5 ème
ESSONNE,ATHIS-MONS,0911027X,199,185,10,4,93,106,5 ème
ESSONNE,BALLANCOURT-SUR-ESSONNE,0910773W,183,183,0,0,84,99,5 ème
ESSONNE,CORBEIL-ESSONNES,0911570M,125,108,17,0,62,63,5 ème
ESSONNE,DOURDAN,0911940P,102,100,0,2,47,55,5 ème
ESSONNE,ETAMPES,0911402E,180,165,12,3,79,101,5 ème
ESSONNE,EVRY-COURCOURONNES,0910021D,186,171,15,0,85,101,5 ème
ESSONNE,EVRY-COURCOURONNES,0911748F,236,236,0,0,121,115,5 ème
ESSONNE,GRIGNY,0911036G,152,132,16,4,72,80,5 ème
ESSONNE,LA FERTE-ALAIS,0910977T,153,151,0,2,66,87,5 ème
ESSONNE,LE MEREVILLOIS,0911403F,191,188,0,3,94,97,5 ème
ESSONNE,MASSY,0910859P,177,160,15,2,87,90,5 ème
ESSONNE,MASSY,0911031B,183,183,0,0,80,103,5 ème
ESSONNE,MONTGERON,0910677S,150,146,0,4,67,83,5 ème
ESSONNE,MONTLHERY,0910980W,41,41,0,0,15,26,5 ème
ESSONNE,MORSANG-SUR-ORGE,0910042B,195,178,16,1,94,101,5 ème
ESSONNE,SAINTE-GENEVIEVE-DES-BOIS,0910860R,232,229,0,3,117,115,5 ème
ESSONNE,SAINT-GERMAIN-LES-CORBEIL,0911341N,217,216,0,1,111,106,5 ème
ESSONNE,SAINT-PIERRE-DU-PERRAY,0911948Y,165,162,0,3,77,88,5 ème
ESSONNE,SAVIGNY-SUR-ORGE,0910836P,58,58,0,0,34,24,5 ème
ESSONNE,VERRIERES-LE-BUISSON,0911601W,18,18,0,0,7,11,5 ème
HAUTS-DE-SEINE,ANTONY,0921786S,174,174,0,0,97,77,5 ème
HAUTS-DE-SEINE,ASNIERES-SUR-SEINE,0920890T,156,156,0,0,83,73,5 ème
HAUTS-DE-SEINE,ASNIERES-SUR-SEINE,0922256C,60,60,0,0,34,26,5 ème
HAUTS-DE-SEINE,ASNIERES-SUR-SEINE,0922565N,208,203,0,5,114,94,5 ème
HAUTS-DE-SEINE,BAGNEUX,0921631Y,115,115,0,0,57,58,5 ème
HAUTS-DE-SEINE,BOULOGNE-BILLANCOURT,0920902F,190,190,0,0,85,105,5 ème
HAUTS-DE-SEINE,BOULOGNE-BILLANCOURT,0921238W,134,134,0,0,71,63,5 ème
HAUTS-DE-SEINE,BOULOGNE-BILLANCOURT,0921904V,109,109,0,0,58,51,5 ème
HAUTS-DE-SEINE,BOURG-LA-REINE,0921242A,191,177,13,1,93,98,5 ème
HAUTS-DE-SEINE,BOURG-LA-REINE,0921905W,230,230,0,0,115,115,5 ème
HAUTS-DE-SEINE,CHATENAY-MALABRY,0921180H,79,79,0,0,41,38,5 ème
HAUTS-DE-SEINE,CHAVILLE,0920689Z,174,174,0,0,73,101,5 ème
HAUTS-DE-SEINE,CHAVILLE,0921907Y,160,157,0,3,75,85,5 ème
HAUTS-DE-SEINE,CLAMART,0920653K,182,179,0,3,90,92,5 ème
HAUTS-DE-SEINE,COLOMBES,0920626F,139,139,0,0,75,64,5 ème
HAUTS-DE-SEINE,COLOMBES,0921160L,152,152,0,0,84,68,5 ème
HAUTS-DE-SEINE,COURBEVOIE,0922578C,161,161,0,0,78,83,5 ème
HAUTS-DE-SEINE,LE PLESSIS-ROBINSON,0920624D,154,148,6,0,73,81,5 ème
HAUTS-DE-SEINE,LEVALLOIS-PERRET,0921391M,85,83,0,2,38,47,5 ème
HAUTS-DE-SEINE,MALAKOFF,0921012A,112,110,0,2,60,52,5 ème
HAUTS-DE-SEINE,NEUILLY-SUR-SEINE,0920985W,0,0,0,0,0,0,5 ème
HAUTS-DE-SEINE,PUTEAUX,0921219A,144,137,0,7,63,81,5 ème
HAUTS-DE-SEINE,PUTEAUX,0922731U,121,121,0,0,64,57,5 ème
HAUTS-DE-SEINE,RUEIL-MALMAISON,0921018G,152,152,0,0,108,44,5 ème
HAUTS-DE-SEINE,RUEIL-MALMAISON,0921590D,165,155,10,0,86,79,5 ème
HAUTS-DE-SEINE,RUEIL-MALMAISON,0921916H,179,179,0,0,179,0,5 ème
VAL-D'OISE,BEAUMONT-SUR-OISE,0950751A,65,65,0,0,31,34,5 ème
VAL-D'OISE,BEAUMONT-SUR-OISE,0951748J,0,0,0,0,0,0,5 ème
VAL-D'OISE,BRAY-ET-LU,0952079U,77,77,0,0,41,36,5 ème
VAL-D'OISE,CERGY,0950937C,184,165,16,3,92,92,5 ème
VAL-D'OISE,CERGY,0951697D,185,169,14,2,87,98,5 ème
VAL-D'OISE,CHARS,0951282C,0,0,0,0,0,0,5 ème
VAL-D'OISE,CORMEILLES-EN-PARISIS,0950656X,0,0,0,0,0,0,5 ème
VAL-D'OISE,CORMEILLES-EN-PARISIS,0950790T,93,93,0,0,46,47,5 ème
VAL-D'OISE,CORMEILLES-EN-PARISIS,0951099D,148,144,0,4,68,80,5 ème
VAL-D'OISE,CORMEILLES-EN-PARISIS,0952045G,135,131,0,4,60,75,5 ème
VAL-D'OISE,DOMONT,0951220K,14,14,0,0,0,14,5 ème
VAL-D'OISE,EAUBONNE,0950893E,146,141,0,5,63,83,5 ème
VAL-D'OISE,ECOUEN,0950941G,117,114,2,1,71,46,5 ème
VAL-D'OISE,ERAGNY,0951672B,89,87,0,2,39,50,5 ème
VAL-D'OISE,ERMONT,0950019E,162,160,0,2,84,78,5 ème
VAL-D'OISE,FOSSES,0950926R,210,203,7,0,104,106,5 ème
VAL-D'OISE,L'ISLE-ADAM,0950898K,211,192,15,4,121,90,5 ème
VAL-D'OISE,MENUCOURT,0951233Z,131,131,0,0,66,65,5 ème
VAL-D'OISE,MONTSOULT,0951051B,121,121,0,0,67,54,5 ème
VAL-D'OISE,OSNY,0950760K,149,149,0,0,81,68,5 ème
VAL-D'OISE,PONTOISE,0951943W,76,76,0,0,40,36,5 ème
VAL-D'OISE,SAINT-GRATIEN,0951190C,159,142,10,7,79,80,5 ème
VAL-D'OISE,SAINT-OUEN-L'AUMONE,0950039B,106,106,0,0,54,52,5 ème
VAL-D'OISE,SANNOIS,0950805J,0,0,0,0,0,0,5 ème
VAL-D'OISE,SANNOIS,0951754R,115,110,0,5,50,65,5 ème
VAL-D'OISE,SARCELLES,0950723V,186,181,0,5,86,100,5 ème
VAL-D'OISE,SARCELLES,0951509Z,196,196,0,0,102,94,5 ème
VAL-D'OISE,SOISY-SOUS-MONTMORENCY,0951352D,144,132,11,1,60,84,5 ème
VAL-D'OISE,VAUREAL,0951705M,146,145,0,1,70,76,5 ème
VAL-D'OISE,VIGNY,0952080V,146,146,0,0,73,73,5 ème
YVELINES,ANDRESY,0780002D,211,211,0,0,107,104,5 ème
YVELINES,BOUGIVAL,0783301P,95,95,0,0,44,51,5 ème
YVELINES,CHANTELOUP-LES-VIGNES,0781986K,64,64,0,0,33,31,5 ème
YVELINES,CHATOU,0780507C,155,141,12,2,66,89,5 ème
YVELINES,COIGNIERES,0781511U,123,120,0,3,63,60,5 ème
YVELINES,CONFLANS-SAINTE-HONORINE,0780050F,198,194,0,4,97,101,5 ème
YVELINES,CONFLANS-SAINTE-HONORINE,0783447Y,0,0,0,0,0,0,5 ème
YVELINES,EPONE,0780656P,162,160,0,2,78,84,5 ème
YVELINES,FEUCHEROLLES,0781863B,129,129,0,0,62,67,5 ème
YVELINES,GUYANCOURT,0781695U,96,80,16,0,38,58,5 ème
YVELINES,ISSOU,0781885A,156,156,0,0,78,78,5 ème
YVELINES,LES CLAYES-SOUS-BOIS,0783251K,120,120,0,0,57,63,5 ème
YVELINES,MAGNY-LES-HAMEAUX,0781171Z,113,113,0,0,45,68,5 ème
YVELINES,MANTES-LA-VILLE,0780116C,179,174,0,5,92,87,5 ème
YVELINES,MONTESSON,0783339F,147,147,0,0,85,62,5 ème
YVELINES,MONTIGNY-LE-BRETONNEUX,0781818C,110,110,0,0,61,49,5 ème
YVELINES,NOISY-LE-ROI,0780179W,146,124,12,10,64,82,5 ème
YVELINES,PLAISIR,0780761D,172,169,0,3,93,79,5 ème
YVELINES,POISSY,0780264N,143,124,16,3,62,81,5 ème
YVELINES,SAINT-CYR-L'ECOLE,0780186D,140,136,0,4,68,72,5 ème
YVELINES,SAINT-GERMAIN-EN-LAYE,0781589D,191,191,0,0,90,101,5 ème
YVELINES,SAINT-GERMAIN-EN-LAYE,0783307W,129,129,0,0,59,70,5 ème
YVELINES,SAINT-GERMAIN-EN-LAYE,0783547G,157,157,0,0,94,63,5 ème
YVELINES,TRAPPES,0780273Y,0,0,0,0,0,0,5 ème
YVELINES,TRIEL-SUR-SEINE,0780573Z,193,191,0,2,94,99,5 ème
YVELINES,VERNOUILLET,0780845V,97,97,0,0,50,47,5 ème
YVELINES,VERSAILLES,0781107E,214,214,0,0,114,100,5 ème
YVELINES,VIROFLAY,0780184B,172,172,0,0,95,77,5 ème
LA REUNION,BRAS-PANON,9740046G,204,200,0,4,112,92,5 ème
LA REUNION,LE TAMPON,9740036W,178,147,27,4,90,88,5 ème
LA REUNION,SAINT-ANDRE,9740599H,147,145,0,2,68,79,5 ème
LA REUNION,SAINT-ANDRE,9741386N,158,157,0,1,74,84,5 ème
LA REUNION,SAINT-DENIS,9740081V,202,202,0,0,108,94,5 ème
LA REUNION,SAINT-DENIS,9740572D,243,208,32,3,107,136,5 ème
LA REUNION,SAINT-DENIS,9740618D,145,128,16,1,75,70,5 ème
LA REUNION,SAINT-DENIS,9740734E,97,80,13,4,42,55,5 ème
LA REUNION,SAINT-DENIS,9741654E,26,26,0,0,15,11,5 ème
LA REUNION,SAINTE-ROSE,9740044E,88,88,0,0,41,47,5 ème
LA REUNION,SAINT-JOSEPH,9741047V,171,166,0,5,87,84,5 ème
LA REUNION,SAINT-LEU,9741048W,177,149,25,3,91,86,5 ème
LA REUNION,SAINT-LOUIS,9740011U,211,195,16,0,97,114,5 ème
LA REUNION,SAINT-PAUL,9740093H,241,204,32,5,122,119,5 ème
LA REUNION,SAINT-PAUL,9741190A,135,132,0,3,69,66,5 ème
LA REUNION,SAINT-PHILIPPE,9740468R,84,82,0,2,44,40,5 ème
MARTINIQUE,DUCOS,9720469C,190,173,13,4,91,99,5 ème
MARTINIQUE,FORT-DE-FRANCE,9720052Z,74,65,0,9,35,39,5 ème
MARTINIQUE,FORT-DE-FRANCE,9720084J,62,48,11,3,29,33,5 ème
MARTINIQUE,FORT-DE-FRANCE,9720429J,0,0,0,0,0,0,5 ème
MARTINIQUE,FORT-DE-FRANCE,9720501M,0,0,0,0,0,0,5 ème
MARTINIQUE,LE CARBET,9720008B,79,79,0,0,38,41,5 ème
MARTINIQUE,LE FRANCOIS,9720771F,0,0,0,0,0,0,5 ème
MARTINIQUE,RIVIERE-PILOTE,9720017L,120,102,15,3,61,59,5 ème
MARTINIQUE,RIVIERE-SALEE,9720448E,107,93,9,5,52,55,5 ème
MARTINIQUE,SAINTE-MARIE,9720842H,45,45,0,0,19,26,5 ème
MARTINIQUE,SAINT-JOSEPH,9720021R,149,132,11,6,74,75,5 ème
MARTINIQUE,SAINT-PIERRE,9720446C,65,50,12,3,43,22,5 ème
MAYOTTE,BOUENI,9760379H,203,174,27,2,96,107,5 ème
MAYOTTE,CHICONI,9760119A,204,203,0,1,93,111,5 ème
MAYOTTE,DEMBENI,9760245M,468,466,0,2,252,216,5 ème
MAYOTTE,KOUNGOU,9760369X,441,417,23,1,238,203,5 ème
MAYOTTE,MAMOUDZOU,9760308F,441,435,0,6,218,223,5 ème
CALVADOS,ARGENCES,0140072C,144,144,0,0,74,70,4 ème
CALVADOS,BAYEUX,0141860W,151,151,0,0,78,73,4 ème
CALVADOS,CABOURG,0141812U,48,48,0,0,24,24,4 ème
CALVADOS,CAEN,0140015R,113,108,0,5,65,48,4 ème
CALVADOS,CAEN,0140024A,118,113,0,5,59,59,4 ème
CALVADOS,CAEN,0141596J,132,129,0,3,58,74,4 ème
CALVADOS,CAEN,0141816Y,141,115,24,2,66,75,4 ème
CALVADOS,COURSEULLES-SUR-MER,0140041U,97,95,0,2,44,53,4 ème
CALVADOS,CREULLY SUR SEULLES,0140042V,99,95,0,4,44,55,4 ème
CALVADOS,DOUVRES-LA-DELIVRANDE,0141216W,182,175,7,0,76,106,4 ème
CALVADOS,EVRECY,0140051E,156,152,0,4,79,77,4 ème
CALVADOS,HEROUVILLE-SAINT-CLAIR,0141166S,56,56,0,0,29,27,4 ème
CALVADOS,LISIEUX,0141766U,182,173,0,9,78,104,4 ème
CALVADOS,ORBEC,0140073D,64,64,0,0,31,33,4 ème
CALVADOS,PONT-L'EVEQUE,0140075F,109,108,0,1,46,63,4 ème
CALVADOS,SAINT-MARTIN-DE-FONTENAY,0140068Y,165,165,0,0,83,82,4 ème
CALVADOS,VERSON,0140087U,161,158,0,3,78,83,4 ème
EURE,BERNAY,0271096V,116,113,0,3,59,57,4 ème
EURE,BERNAY,0271316J,87,73,14,0,41,46,4 ème
EURE,BROGLIE,0271122Y,37,37,0,0,15,22,4 ème
EURE,BUEIL,0271744Z,131,131,0,0,69,62,4 ème
EURE,EVREUX,0271449D,82,82,0,0,37,45,4 ème
EURE,GASNY,0271442W,156,151,0,5,92,64,4 ème
EURE,GISORS,0270026G,0,0,0,0,0,0,4 ème
EURE,LES ANDELYS,0270001E,121,118,0,3,62,59,4 ème
EURE,LE VAL D'HAZEY,0271482P,135,118,17,0,79,56,4 ème
EURE,LOUVIERS,0270029K,0,0,0,0,0,0,4 ème
EURE,LOUVIERS,0271336F,152,131,17,4,63,89,4 ème
EURE,LOUVIERS,0271634E,0,0,0,0,0,0,4 ème
EURE,MESNILS-SUR-ITON,0270014U,86,84,0,2,43,43,4 ème
EURE,PONT-AUDEMER,0271081D,0,0,0,0,0,0,4 ème
EURE,PONT-AUDEMER,0271450E,93,90,0,3,47,46,4 ème
EURE,ROMILLY-SUR-ANDELLE,0271533V,129,129,0,0,67,62,4 ème
EURE,VERNEUIL D'AVRE ET D'ITON,0271676A,17,17,0,0,9,8,4 ème
EURE,VERNON,0270052K,0,0,0,0,0,0,4 ème
EURE,VERNON,0271068P,87,87,0,0,49,38,4 ème
MANCHE,AGON-COUTAINVILLE,0500001E,62,62,0,0,27,35,4 ème
MANCHE,AVRANCHES,0500003G,66,65,0,1,35,31,4 ème
MANCHE,BRICQUEBEC-EN-COTENTIN,0500010P,137,114,18,5,67,70,4 ème
MANCHE,CARENTAN-LES-MARAIS,0500139E,120,118,0,2,65,55,4 ème
MANCHE,CERISY-LA-SALLE,0500014U,53,53,0,0,24,29,4 ème
MANCHE,CHERBOURG-EN-COTENTIN,0501205N,84,69,15,0,39,45,4 ème
MANCHE,CHERBOURG-EN-COTENTIN,0501216A,110,105,0,5,53,57,4 ème
MANCHE,CHERBOURG-EN-COTENTIN,0501482P,108,92,15,1,56,52,4 ème
MANCHE,CHERBOURG-EN-COTENTIN,0502008L,108,104,0,4,51,57,4 ème
MANCHE,GAVRAY-SUR-SIENNE,0500035S,45,40,0,5,27,18,4 ème
MANCHE,ISIGNY-LE-BUAT,0501830T,28,28,0,0,13,15,4 ème
MANCHE,LA HAYE,0501218C,59,57,0,2,27,32,4 ème
MANCHE,SAINT-HILAIRE-DU-HARCOUET,0500148P,40,40,0,0,16,24,4 ème
MANCHE,SAINT-JEAN-DE-DAYE,0501301T,52,52,0,0,31,21,4 ème
MANCHE,SAINT-LO,0501219D,0,0,0,0,0,0,4 ème
MANCHE,SAINT-PIERRE-EGLISE,0500122L,48,48,0,0,18,30,4 ème
MANCHE,SAINT-VAAST-LA-HOUGUE,0501300S,41,41,0,0,21,20,4 ème
MANCHE,TORIGNY-LES-VILLES,0500079P,121,119,0,2,56,65,4 ème
ORNE,ALENCON,0610056E,80,78,0,2,36,44,4 ème
ORNE,ARGENTAN,0611022E,90,69,14,7,48,42,4 ème
ORNE,ARGENTAN,0611023F,114,109,0,5,57,57,4 ème
ORNE,ARGENTAN,0611099N,71,71,0,0,33,38,4 ème
ORNE,DOMFRONT EN POIRAIE,0610696A,35,35,0,0,15,20,4 ème
ORNE,DOMFRONT EN POIRAIE,0610970Y,79,64,12,3,40,39,4 ème
ORNE,ECOUCHE-LES-VALLEES,0610016L,49,49,0,0,29,20,4 ème
ORNE,FLERS,0610698C,0,0,0,0,0,0,4 ème
ORNE,GIEL-COURTEILLES,0610724F,0,0,0,0,0,0,4 ème
ORNE,LA FERTE MACE,0610709P,73,73,0,0,35,38,4 ème
ORNE,L'AIGLE,0610691V,84,84,0,0,44,40,4 ème
ORNE,LE MELE-SUR-SARTHE,0610031C,69,69,0,0,36,33,4 ème
ORNE,LONGNY LES VILLAGES,0610739X,30,30,0,0,17,13,4 ème
ORNE,PUTANGES-LE-LAC,0610037J,49,49,0,0,25,24,4 ème
ORNE,SEES,0611095J,43,43,0,0,20,23,4 ème
SEINE MARITIME,AUMALE,0762107C,67,67,0,0,34,33,4 ème
SEINE MARITIME,BACQUEVILLE-EN-CAUX,0760004S,67,64,0,3,34,33,4 ème
SEINE MARITIME,BARENTIN,0760007V,0,0,0,0,0,0,4 ème
SEINE MARITIME,BARENTIN,0762286X,126,126,0,0,61,65,4 ème
SEINE MARITIME,BARENTIN,0762764S,160,139,17,4,80,80,4 ème
SEINE MARITIME,BOLBEC,0761701L,200,177,16,7,93,107,4 ème
SEINE MARITIME,BOLBEC,0761725M,114,114,0,0,51,63,4 ème
SEINE MARITIME,DIEPPE,0760024N,0,0,0,0,0,0,4 ème
SEINE MARITIME,DIEPPE,0762225F,160,158,0,2,84,76,4 ème
SEINE MARITIME,EU,0762170W,147,133,14,0,71,76,4 ème
SEINE MARITIME,FORGES-LES-EAUX,0762600N,0,0,0,0,0,0,4 ème
SEINE MARITIME,GRAND-COURONNE,0762836V,0,0,0,0,0,0,4 ème
SEINE MARITIME,LA FEUILLIE,0762177D,64,64,0,0,27,37,4 ème
SEINE MARITIME,LE GRAND-QUEVILLY,0760049R,99,91,0,8,50,49,4 ème
SEINE MARITIME,LE GRAND-QUEVILLY,0762093M,126,108,16,2,67,59,4 ème
SEINE MARITIME,LE HAVRE,0760062E,0,0,0,0,0,0,4 ème
SEINE MARITIME,LE HAVRE,0761328F,99,99,0,0,62,37,4 ème
SEINE MARITIME,LE HAVRE,0761699J,131,127,0,4,61,70,4 ème
SEINE MARITIME,LE HAVRE,0761781Y,98,84,9,5,53,45,4 ème
SEINE MARITIME,LE HAVRE,0762564Z,280,280,0,0,116,164,4 ème
SEINE MARITIME,LE HAVRE,0763500S,0,0,0,0,0,0,4 ème
SEINE MARITIME,LE HOULME,0761746K,114,114,0,0,60,54,4 ème
SEINE MARITIME,LE MESNIL-ESNARD,0762565A,152,152,0,0,84,68,4 ème
SEINE MARITIME,LILLEBONNE,0762289A,149,128,15,6,78,71,4 ème
SEINE MARITIME,RIVES-EN-SEINE,0762084C,173,165,0,8,78,95,4 ème
SEINE MARITIME,ROUEN,0761717D,64,64,0,0,23,41,4 ème
SEINE MARITIME,ROUEN,0762178E,143,143,0,0,74,69,4 ème
SEINE MARITIME,SAINT-ETIENNE-DU-ROUVRAY,0761647C,106,91,15,0,55,51,4 ème
SEINE MARITIME,SAINT-ETIENNE-DU-ROUVRAY,0762132E,60,60,0,0,22,38,4 ème
SEINE MARITIME,SOTTEVILLE-LES-ROUEN,0761691A,185,168,15,2,88,97,4 ème
SEINE MARITIME,TERRES-DE-CAUX,0760034Z,103,99,0,4,49,54,4 ème
SEINE MARITIME,YVETOT,0762880T,0,0,0,0,0,0,4 ème
DORDOGNE,ANNESSE-ET-BEAULIEU,0240997D,74,74,0,0,37,37,4 ème
DORDOGNE,BEAUMONTOIS EN PERIGORD,0240001W,69,69,0,0,31,38,4 ème
DORDOGNE,BERGERAC,0240094X,0,0,0,0,0,0,4 ème
DORDOGNE,BERGERAC,0240996C,136,133,0,3,63,73,4 ème
DORDOGNE,COULAURES,0240012H,0,0,0,0,0,0,4 ème
DORDOGNE,LA FORCE,0240053C,152,134,16,2,73,79,4 ème
DORDOGNE,LALINDE,0240158S,85,85,0,0,43,42,4 ème
DORDOGNE,MONTIGNAC,0240927C,92,92,0,0,45,47,4 ème
DORDOGNE,MUSSIDAN,0240961P,88,85,0,3,44,44,4 ème
DORDOGNE,NEUVIC,0240044T,70,67,0,3,26,44,4 ème
DORDOGNE,PERIGUEUX,0241043D,112,112,0,0,65,47,4 ème
DORDOGNE,SAINT-CYPRIEN,0240065R,59,59,0,0,23,36,4 ème
DORDOGNE,SARLAT-LA-CANEDA,0240121B,212,204,8,0,109,103,4 ème
DORDOGNE,TERRASSON-LAVILLEDIEU,0240037K,150,143,5,2,83,67,4 ème
DORDOGNE,THENON,0240066S,72,72,0,0,34,38,4 ème
GIRONDE,ARCACHON,0330167C,87,87,0,0,29,58,4 ème
GIRONDE,BEGLES,0331752A,148,147,0,1,78,70,4 ème
GIRONDE,BIGANOS,0330017P,126,123,0,3,61,65,4 ème
GIRONDE,BLAYE,0331511N,62,60,0,2,34,28,4 ème
GIRONDE,BLAYE,0332347X,169,143,22,4,83,86,4 ème
GIRONDE,BORDEAUX,0331462K,96,96,0,0,47,49,4 ème
GIRONDE,BORDEAUX,0331662C,213,210,0,3,86,127,4 ème
GIRONDE,BORDEAUX,0331663D,135,119,13,3,74,61,4 ème
GIRONDE,BORDEAUX,0332082J,141,141,0,0,76,65,4 ème
GIRONDE,BORDEAUX,0332491D,50,50,0,0,19,31,4 ème
GIRONDE,BORDEAUX,0332496J,0,0,0,0,0,0,4 ème
GIRONDE,BORDEAUX,0333531J,55,55,0,0,31,24,4 ème
GIRONDE,BOURG,0332341R,148,142,0,6,75,73,4 ème
GIRONDE,CARBON-BLANC,0333132A,142,139,0,3,67,75,4 ème
GIRONDE,CASTILLON-LA-BATAILLE,0330064R,108,105,0,3,54,54,4 ème
GIRONDE,CUDOS,0332327A,50,50,0,0,24,26,4 ème
GIRONDE,HOURTIN,0330081J,92,92,0,0,53,39,4 ème
GIRONDE,LANGON,0330082K,0,0,0,0,0,0,4 ème
GIRONDE,LANGON,0330083L,181,174,0,7,91,90,4 ème
GIRONDE,LIBOURNE,0330162X,100,97,0,3,52,48,4 ème
GIRONDE,MERIGNAC,0330145D,158,148,0,10,82,76,4 ème
GIRONDE,MERIGNAC,0331668J,0,0,0,0,0,0,4 ème
GIRONDE,MONSEGUR,0330100E,59,59,0,0,24,35,4 ème
GIRONDE,PAREMPUYRE,0332569N,173,173,0,0,69,104,4 ème
GIRONDE,PAUILLAC,0331644H,75,75,0,0,43,32,4 ème
GIRONDE,PESSAC,0331758G,179,174,0,5,92,87,4 ème
GIRONDE,PODENSAC,0330108N,179,170,9,0,85,94,4 ème
GIRONDE,SAINT-ANDRE-DE-CUBZAC,0331530J,160,158,0,2,81,79,4 ème
GIRONDE,SAINT-LOUBES,0332340P,237,237,0,0,117,120,4 ème
GIRONDE,SAINT-MEDARD-EN-JALLES,0330119A,0,0,0,0,0,0,4 ème
GIRONDE,TALENCE,0330128K,129,129,0,0,65,64,4 ème
LANDES,CAPBRETON,0400005N,124,109,15,0,68,56,4 ème
LANDES,DAX,0400729A,172,167,0,5,88,84,4 ème
LANDES,DAX,0401022U,150,148,0,2,65,85,4 ème
LANDES,GEAUNE,0400011V,77,77,0,0,33,44,4 ème
LANDES,MONT-DE-MARSAN,0400020E,0,0,0,0,0,0,4 ème
LANDES,MONT-DE-MARSAN,0400648M,139,136,0,3,68,71,4 ème
LANDES,MONTFORT-EN-CHALOSSE,0400023H,130,125,0,5,70,60,4 ème
LANDES,PARENTIS-EN-BORN,0400026L,195,179,16,0,99,96,4 ème
LANDES,RION-DES-LANDES,0400033U,50,50,0,0,23,27,4 ème
LANDES,SAINT-PAUL-LES-DAX,0401066S,116,113,0,3,52,64,4 ème
LANDES,SAINT-VINCENT-DE-TYROSSE,0400039A,125,125,0,0,60,65,4 ème
LANDES,SOUSTONS,0400728Z,136,133,0,3,69,67,4 ème
LANDES,TARNOS,0400091G,125,125,0,0,58,67,4 ème
LOT-ET-GARONNE,AGEN,0470777P,178,175,0,3,78,100,4 ème
LOT-ET-GARONNE,CASSENEUIL,0470011G,59,59,0,0,29,30,4 ème
LOT-ET-GARONNE,CLAIRAC,0470015L,0,0,0,0,0,0,4 ème
LOT-ET-GARONNE,LE MAS-D'AGENAIS,0470043S,93,93,0,0,52,41,4 ème
LOT-ET-GARONNE,LE PASSAGE,0470105J,216,193,17,6,109,107,4 ème
LOT-ET-GARONNE,MARMANDE,0470733S,178,175,0,3,90,88,4 ème
LOT-ET-GARONNE,NERAC,0470776N,112,112,0,0,55,57,4 ème
LOT-ET-GARONNE,NERAC,0471038Y,29,29,0,0,14,15,4 ème
LOT-ET-GARONNE,VILLENEUVE-SUR-LOT,0470038L,0,0,0,0,0,0,4 ème
PYRENEES-ATLANTIQUES,ANGLET,0640110X,111,111,0,0,51,60,4 ème
PYRENEES-ATLANTIQUES,BAYONNE,0640212H,223,200,13,10,99,124,4 ème
PYRENEES-ATLANTIQUES,BIARRITZ,0641414P,127,113,9,5,52,75,4 ème
PYRENEES-ATLANTIQUES,BIZANOS,0641413N,160,159,0,1,81,79,4 ème
PYRENEES-ATLANTIQUES,CAMBO-LES-BAINS,0641392R,106,94,8,4,45,61,4 ème
PYRENEES-ATLANTIQUES,GELOS,0640026F,0,0,0,0,0,0,4 ème
PYRENEES-ATLANTIQUES,LASSEUBE,0640036S,55,54,0,1,28,27,4 ème
PYRENEES-ATLANTIQUES,LESCAR,0640121J,66,60,0,6,25,41,4 ème
PYRENEES-ATLANTIQUES,LESTELLE-BETHARRAM,0641655B,63,50,13,0,32,31,4 ème
PYRENEES-ATLANTIQUES,MAULEON-LICHARRE,0641656C,33,33,0,0,14,19,4 ème
PYRENEES-ATLANTIQUES,MOURENX,0641561Z,93,73,16,4,50,43,4 ème
PYRENEES-ATLANTIQUES,ORTHEZ,0641659F,56,56,0,0,31,25,4 ème
PYRENEES-ATLANTIQUES,PAU,0640058R,0,0,0,0,0,0,4 ème
PYRENEES-ATLANTIQUES,PAU,0640189H,0,0,0,0,0,0,4 ème
PYRENEES-ATLANTIQUES,PAU,0640227Z,196,175,16,5,101,95,4 ème
PYRENEES-ATLANTIQUES,PAU,0640607M,206,201,0,5,101,105,4 ème
PYRENEES-ATLANTIQUES,PAU,0640608N,180,142,31,7,69,111,4 ème
PYRENEES-ATLANTIQUES,SAINT-JEAN-DE-LUZ,0640066Z,0,0,0,0,0,0,4 ème
PYRENEES-ATLANTIQUES,SAINT-JEAN-DE-LUZ,0640229B,118,98,15,5,48,70,4 ème
CORREZE,BRIVE-LA-GAILLARDE,0190059L,127,127,0,0,65,62,4 ème
CORREZE,BRIVE-LA-GAILLARDE,0190635M,105,87,16,2,46,59,4 ème
CORREZE,EGLETONS,0190019T,77,74,0,3,36,41,4 ème
CORREZE,MERLINES,0190023X,22,22,0,0,8,14,4 ème
CORREZE,MEYMAC,0190025Z,51,51,0,0,23,28,4 ème
CORREZE,OBJAT,0190717B,155,152,0,3,76,79,4 ème
CORREZE,TREIGNAC,0190632J,49,49,0,0,31,18,4 ème
CORREZE,TULLE,0190614P,146,143,0,3,77,69,4 ème
CORREZE,USSEL,0190782X,25,25,0,0,10,15,4 ème
CREUSE,AUBUSSON,0230506A,75,62,10,3,36,39,4 ème
CREUSE,BENEVENT-L'ABBAYE,0230005F,46,46,0,0,28,18,4 ème
CREUSE,BONNAT,0230006G,32,32,0,0,15,17,4 ème
CREUSE,FELLETIN,0230017U,57,57,0,0,27,30,4 ème
CREUSE,SAINT-VAURY,0230028F,65,65,0,0,37,28,4 ème
HAUTE-VIENNE,AMBAZAC,0870684W,148,148,0,0,75,73,4 ème
HAUTE-VIENNE,EYMOUTIERS,0870014T,45,45,0,0,22,23,4 ème
HAUTE-VIENNE,LIMOGES,0870022B,123,106,16,1,52,71,4 ème
HAUTE-VIENNE,LIMOGES,0870771R,192,172,16,4,89,103,4 ème
HAUTE-VIENNE,LIMOGES,0870816P,176,176,0,0,90,86,4 ème
HAUTE-VIENNE,LIMOGES,0870817R,120,118,0,2,62,58,4 ème
HAUTE-VIENNE,LIMOGES,0870865T,160,157,0,3,76,84,4 ème
HAUTE-VIENNE,NEXON,0870032M,78,78,0,0,37,41,4 ème
HAUTE-VIENNE,ROCHECHOUART,0870037T,87,87,0,0,32,55,4 ème
HAUTE-VIENNE,SAINT-MATHIEU,0870047D,43,43,0,0,22,21,4 ème
CHARENTE,AIGRE,0160001P,39,39,0,0,19,20,4 ème
CHARENTE,ANGOULEME,0160061E,152,152,0,0,58,94,4 ème
CHARENTE,ANGOULEME,0160113L,58,58,0,0,29,29,4 ème
CHARENTE,CHAMPAGNE-MOUTON,0160016F,25,25,0,0,12,13,4 ème
CHARENTE,JARNAC,0160075V,29,29,0,0,19,10,4 ème
CHARENTE,RUFFEC,0160077X,41,41,0,0,22,19,4 ème
CHARENTE,RUFFEC,0161003D,0,0,0,0,0,0,4 ème
CHARENTE-MARITIME,AYTRE,0171339N,102,99,0,3,52,50,4 ème
CHARENTE-MARITIME,COURCON,0170007R,183,177,0,6,86,97,4 ème
CHARENTE-MARITIME,LAGORD,0170970M,228,228,0,0,106,122,4 ème
CHARENTE-MARITIME,LA ROCHELLE,0171184V,210,209,0,1,123,87,4 ème
CHARENTE-MARITIME,LA ROCHELLE,0171238D,0,0,0,0,0,0,4 ème
CHARENTE-MARITIME,LA TREMBLADE,0170388E,124,124,0,0,53,71,4 ème
CHARENTE-MARITIME,LE CHATEAU-D'OLERON,0170005N,67,67,0,0,32,35,4 ème
CHARENTE-MARITIME,MONTLIEU-LA-GARDE,0170076R,66,66,0,0,35,31,4 ème
CHARENTE-MARITIME,ROCHEFORT,0170081W,102,87,15,0,47,55,4 ème
CHARENTE-MARITIME,ROYAN,0170384A,65,59,0,6,26,39,4 ème
DEUX-SEVRES,BRESSUIRE,0790091V,183,178,0,5,95,88,4 ème
DEUX-SEVRES,BRESSUIRE,0791029P,0,0,0,0,0,0,4 ème
DEUX-SEVRES,CELLES-SUR-BELLE,0790011H,127,127,0,0,69,58,4 ème
DEUX-SEVRES,CERIZAY,0790063P,73,73,0,0,38,35,4 ème
DEUX-SEVRES,MAUZE-SUR-LE-MIGNON,0790929F,94,94,0,0,38,56,4 ème
DEUX-SEVRES,MELLE,0790943W,114,93,17,4,56,58,4 ème
DEUX-SEVRES,MONCOUTANT-SUR-SEVRE,0790067U,87,87,0,0,34,53,4 ème
DEUX-SEVRES,NIORT,0791016A,142,139,0,3,70,72,4 ème
DEUX-SEVRES,PARTHENAY,0790030D,98,95,0,3,51,47,4 ème
DEUX-SEVRES,PARTHENAY,0791042D,101,99,0,2,45,56,4 ème
DEUX-SEVRES,SAINT-MAIXENT-L'ECOLE,0790031E,0,0,0,0,0,0,4 ème
VIENNE,CHATELLERAULT,0860752A,0,0,0,0,0,0,4 ème
VIENNE,CIVRAY,0860761K,49,49,0,0,23,26,4 ème
VIENNE,DANGE-SAINT-ROMAIN,0860763M,50,50,0,0,27,23,4 ème
VIENNE,JAUNAY-MARIGNY,0861038L,168,165,0,3,92,76,4 ème
VIENNE,LOUDUN,0860022G,0,0,0,0,0,0,4 ème
VIENNE,LUSIGNAN,0861053C,117,117,0,0,55,62,4 ème
VIENNE,MIGNALOUX-BEAUVOIR,0860793V,19,0,19,0,7,12,4 ème
VIENNE,POITIERS,0860037Y,0,0,0,0,0,0,4 ème
VIENNE,POITIERS,0860040B,145,145,0,0,73,72,4 ème
VIENNE,POITIERS,0860759H,118,118,0,0,63,55,4 ème
VIENNE,POITIERS,0861092V,110,106,0,4,60,50,4 ème
VIENNE,SAINT-BENOIT,0861073Z,213,193,17,3,106,107,4 ème
VIENNE,SAINT-JEAN-DE-SAUVES,0860045G,58,58,0,0,29,29,4 ème
VIENNE,VALENCE-EN-POITOU,0860014Y,58,58,0,0,24,34,4 ème
VIENNE,VIVONNE,0860047J,133,132,0,1,61,72,4 ème
AUDE,CARCASSONNE,0110007Y,0,0,0,0,0,0,4 ème
AUDE,CASTELNAUDARY,0110012D,0,0,0,0,0,0,4 ème
AUDE,CASTELNAUDARY,0110896P,30,30,0,0,15,15,4 ème
AUDE,LEZIGNAN-CORBIERES,0111034P,59,59,0,0,23,36,4 ème
AUDE,LEZIGNAN-CORBIERES,0111051H,119,104,15,0,64,55,4 ème
AUDE,NARBONNE,0110021N,180,163,14,3,88,92,4 ème
AUDE,NARBONNE,0110023R,0,0,0,0,0,0,4 ème
AUDE,NARBONNE,0110026U,158,144,14,0,74,84,4 ème
AUDE,RIEUX-MINERVOIS,0110667R,109,109,0,0,58,51,4 ème
AUDE,TREBES,0110674Y,85,80,0,5,41,44,4 ème
GARD,ARAMON,0301325C,138,135,0,3,65,73,4 ème
GARD,BAGNOLS-SUR-CEZE,0300055X,195,193,0,2,87,108,4 ème
GARD,BAGNOLS-SUR-CEZE,0300106C,0,0,0,0,0,0,4 ème
GARD,BAGNOLS-SUR-CEZE,0301327E,163,154,0,9,90,73,4 ème
GARD,BEAUCAIRE,0300089J,55,51,0,4,24,31,4 ème
GARD,BEAUCAIRE,0301208A,169,157,0,12,77,92,4 ème
GARD,NIMES,0300946R,109,104,0,5,53,56,4 ème
GARD,NIMES,0301010K,135,115,15,5,60,75,4 ème
GARD,NIMES,0301098F,127,109,15,3,59,68,4 ème
GARD,NIMES,0301210C,0,0,0,0,0,0,4 ème
GARD,QUISSAC,0300032X,121,121,0,0,50,71,4 ème
GARD,SAINT-AMBROIX,0300036B,92,88,0,4,55,37,4 ème
GARD,SAINT-GENIES-DE-MALGOIRES,0301670C,163,147,16,0,84,79,4 ème
GARD,SOMMIERES,0301232B,233,229,0,4,113,120,4 ème
GARD,UZES,0300047N,0,0,0,0,0,0,4 ème
GARD,VERGEZE,0300050S,195,176,16,3,91,104,4 ème
HERAULT,AGDE,0342080B,94,94,0,0,58,36,4 ème
HERAULT,BEDARIEUX,0340119V,180,171,5,4,92,88,4 ème
HERAULT,CAZOULS-LES-BEZIERS,0340021N,165,146,15,4,80,85,4 ème
HERAULT,CLERMONT-L'HERAULT,0340893L,122,122,0,0,61,61,4 ème
HERAULT,GIGNAC,0341386X,178,178,0,0,89,89,4 ème
HERAULT,MONTAGNAC,0340037F,62,59,0,3,34,28,4 ème
HERAULT,MONTPELLIER,0340042L,0,0,0,0,0,0,4 ème
HERAULT,MONTPELLIER,0340109J,165,158,0,7,80,85,4 ème
HERAULT,MONTPELLIER,0340833W,15,0,15,0,7,8,4 ème
HERAULT,MONTPELLIER,0340880X,134,134,0,0,53,81,4 ème
HERAULT,MONTPELLIER,0341278E,210,192,14,4,106,104,4 ème
HERAULT,MONTPELLIER,0342266D,46,46,0,0,20,26,4 ème
HERAULT,PEZENAS,0340837A,168,149,16,3,76,92,4 ème
HERAULT,SAINT-JEAN-DE-VEDAS,0341276C,173,166,0,7,80,93,4 ème
HERAULT,SAINT-PONS-DE-THOMIERES,0340069R,0,0,0,0,0,0,4 ème
HERAULT,SAINT-PONS-DE-THOMIERES,0340070S,56,52,4,0,31,25,4 ème
HERAULT,SERIGNAN,0341388Z,225,196,16,13,120,105,4 ème
HERAULT,SETE,0340115R,112,112,0,0,60,52,4 ème
LOZERE,FLORAC TROIS RIVIERES,0480003T,62,58,0,4,33,29,4 ème
LOZERE,LA CANOURGUE,0480006W,53,53,0,0,32,21,4 ème
LOZERE,LE COLLET-DE-DEZE,0480002S,28,28,0,0,10,18,4 ème
LOZERE,MENDE,0480607Z,189,166,9,14,90,99,4 ème
LOZERE,MEYRUEIS,0480011B,25,25,0,0,12,13,4 ème
LOZERE,MEYRUEIS,0480034B,24,24,0,0,9,15,4 ème
LOZERE,MONT LOZERE ET GOULET,0480001R,19,19,0,0,9,10,4 ème
PYRENEES-ORIENTALES,BOURG-MADAME,0660600U,100,90,9,1,56,44,4 ème
PYRENEES-ORIENTALES,CABESTANY,0660521H,211,189,18,4,101,110,4 ème
PYRENEES-ORIENTALES,CANET-EN-ROUSSILLON,0660648W,209,205,0,4,92,117,4 ème
PYRENEES-ORIENTALES,CERET,0660601V,203,185,16,2,89,114,4 ème
PYRENEES-ORIENTALES,LE SOLER,0660872P,51,51,0,0,23,28,4 ème
PYRENEES-ORIENTALES,PRADES,0660021P,0,0,0,0,0,0,4 ème
PYRENEES-ORIENTALES,RIVESALTES,0660037G,193,172,15,6,79,114,4 ème
PYRENEES-ORIENTALES,SAINT-CYPRIEN,0660846L,96,96,0,0,52,44,4 ème
ARIEGE,LAVELANET,0090006H,0,0,0,0,0,0,4 ème
ARIEGE,LAVELANET,0090490J,59,55,0,4,35,24,4 ème
ARIEGE,PAMIERS,0090037S,112,109,0,3,40,72,4 ème
ARIEGE,PAMIERS,0090481Z,23,0,23,0,7,16,4 ème
AVEYRON,AUBIN,0120096P,0,0,0,0,0,0,4 ème
AVEYRON,DECAZEVILLE,0120006S,0,0,0,0,0,0,4 ème
AVEYRON,RIGNAC,0120070L,34,34,0,0,14,20,4 ème
AVEYRON,RODEZ,0121133S,116,91,15,10,46,70,4 ème
AVEYRON,VILLEFRANCHE-DE-ROUERGUE,0121213D,149,146,0,3,76,73,4 ème
AVEYRON,VILLEFRANCHE-DE-ROUERGUE,0121260E,0,0,0,0,0,0,4 ème
GERS,AUCH,0320562M,138,127,11,0,66,72,4 ème
GERS,FLEURANCE,0320686X,23,23,0,0,9,14,4 ème
GERS,MASSEUBE,0320608M,65,65,0,0,29,36,4 ème
GERS,MIRANDE,0320035P,65,64,0,1,38,27,4 ème
GERS,NOGARO,0320025D,0,0,0,0,0,0,4 ème
GERS,RISCLE,0320029H,59,59,0,0,31,28,4 ème
GERS,VIC-FEZENSAC,0320033M,49,48,0,1,25,24,4 ème
HAUTE-GARONNE,AUCAMVILLE,0311632F,205,198,0,7,86,119,4 ème
HAUTE-GARONNE,AURIGNAC,0310003K,44,41,0,3,27,17,4 ème
HAUTE-GARONNE,BALMA,0311330C,204,182,16,6,101,103,4 ème
HAUTE-GARONNE,BEAUZELLE,0313078C,171,168,0,3,83,88,4 ème
HAUTE-GARONNE,CARAMAN,0311690U,103,89,14,0,47,56,4 ème
HAUTE-GARONNE,CASTANET-TOLOSAN,0311266H,197,197,0,0,96,101,4 ème
HAUTE-GARONNE,CAZERES,0310012V,152,148,0,4,69,83,4 ème
HAUTE-GARONNE,COLOMIERS,0311238C,136,134,0,2,68,68,4 ème
HAUTE-GARONNE,COLOMIERS,0311687R,169,166,0,3,68,101,4 ème
HAUTE-GARONNE,FONSORBES,0312338Y,141,136,0,5,72,69,4 ème
HAUTE-GARONNE,LEGUEVIN,0312337X,176,172,0,4,81,95,4 ème
HAUTE-GARONNE,MURET,0311240E,16,0,16,0,10,6,4 ème
HAUTE-GARONNE,NAILLOUX,0312699R,157,153,0,4,71,86,4 ème
HAUTE-GARONNE,NOE,0312868Z,158,155,0,3,76,82,4 ème
HAUTE-GARONNE,SAINT-GAUDENS,0310083X,138,110,22,6,59,79,4 ème
HAUTE-GARONNE,TOULOUSE,0310057U,0,0,0,0,0,0,4 ème
HAUTE-GARONNE,TOULOUSE,0310092G,188,183,0,5,90,98,4 ème
HAUTE-GARONNE,TOULOUSE,0311231V,108,103,0,5,50,58,4 ème
HAUTE-GARONNE,TOULOUSE,0311236A,226,226,0,0,111,115,4 ème
HAUTE-GARONNE,TOULOUSE,0311264F,96,93,0,3,48,48,4 ème
HAUTE-GARONNE,TOULOUSE,0311570N,41,41,0,0,17,24,4 ème
HAUTE-GARONNE,TOULOUSE,0311631E,189,178,0,11,110,79,4 ème
HAUTE-GARONNE,TOULOUSE,0311962P,241,241,0,0,112,129,4 ème
HAUTE-GARONNE,TOULOUSE,0312284P,23,23,0,0,10,13,4 ème
HAUTE-GARONNE,VERFEIL,0311335H,121,121,0,0,65,56,4 ème
HAUTES-PYRENEES,ARGELES-GAZOST,0650836F,105,105,0,0,58,47,4 ème
HAUTES-PYRENEES,AUREILHAN,0650028C,0,0,0,0,0,0,4 ème
HAUTES-PYRENEES,LOURDES,0650015N,114,97,14,3,48,66,4 ème
HAUTES-PYRENEES,LOURDES,0650877A,154,150,0,4,82,72,4 ème
HAUTES-PYRENEES,LOURES-BAROUSSE,0650017R,51,51,0,0,29,22,4 ème
HAUTES-PYRENEES,MAUBOURGUET,0650019T,55,53,0,2,25,30,4 ème
HAUTES-PYRENEES,TARBES,0650031F,122,119,0,3,62,60,4 ème
HAUTES-PYRENEES,TARBES,0650034J,140,121,19,0,68,72,4 ème
HAUTES-PYRENEES,TARBES,0650886K,0,0,0,0,0,0,4 ème
HAUTES-PYRENEES,TOURNAY,0650036L,69,68,0,1,37,32,4 ème
HAUTES-PYRENEES,VIC-EN-BIGORRE,0650035K,0,0,0,0,0,0,4 ème
LOT,BRETENOUX,0460573Y,81,81,0,0,43,38,4 ème
LOT,FIGEAC,0460032K,0,0,0,0,0,0,4 ème
LOT,FIGEAC,0460054J,150,136,12,2,60,90,4 ème
LOT,GRAMAT,0460046A,22,17,0,5,11,11,4 ème
LOT,LATRONQUIERE,0460018V,21,21,0,0,12,9,4 ème
LOT,SOUILLAC,0460594W,65,62,0,3,26,39,4 ème
TARN,ALBI,0811061N,114,110,0,4,71,43,4 ème
TARN,CASTRES,0810016C,0,0,0,0,0,0,4 ème
TARN,CASTRES,0810088F,37,37,0,0,17,20,4 ème
TARN,GRAULHET,0810125W,204,185,17,2,98,106,4 ème
TARN,LABRUGUIERE,0810089G,71,71,0,0,29,42,4 ème
TARN,LAUTREC,0810028R,57,57,0,0,28,29,4 ème
TARN,LAVAUR,0811032G,236,221,13,2,115,121,4 ème
TARN,MAZAMET,0810126X,111,92,14,5,49,62,4 ème
TARN,SAINT-SULPICE-LA-POINTE,0810041E,196,196,0,0,98,98,4 ème
TARN-ET-GARONNE,DIEUPENTALE,0820678S,43,37,0,6,18,25,4 ème
TARN-ET-GARONNE,MOISSAC,0820017Y,194,180,10,4,93,101,4 ème
TARN-ET-GARONNE,MONTAUBAN,0820754Z,174,167,7,0,88,86,4 ème
TARN-ET-GARONNE,MONTEILS,0820883P,0,0,0,0,0,0,4 ème
LOIRE-ATLANTIQUE,BASSE-GOULAINE,0442277L,158,158,0,0,85,73,4 ème
LOIRE-ATLANTIQUE,BOUGUENAIS,0440316E,180,159,16,5,80,100,4 ème
LOIRE-ATLANTIQUE,GORGES,0440107C,51,51,0,0,9,42,4 ème
LOIRE-ATLANTIQUE,GUERANDE,0442368K,89,83,0,6,62,27,4 ème
LOIRE-ATLANTIQUE,HERBIGNAC,0440015C,129,129,0,0,68,61,4 ème
LOIRE-ATLANTIQUE,HERBIGNAC,0440195Y,99,99,0,0,43,56,4 ème
LOIRE-ATLANTIQUE,LE LOROUX-BOTTEREAU,0440200D,187,184,0,3,99,88,4 ème
LOIRE-ATLANTIQUE,LE PELLERIN,0441658N,121,121,0,0,61,60,4 ème
LOIRE-ATLANTIQUE,LIGNE,0440199C,89,89,0,0,41,48,4 ème
LOIRE-ATLANTIQUE,MONTOIR-DE-BRETAGNE,0440539X,102,100,0,2,53,49,4 ème
LOIRE-ATLANTIQUE,NANTES,0440033X,0,0,0,0,0,0,4 ème
LOIRE-ATLANTIQUE,NANTES,0440049P,112,109,0,3,54,58,4 ème
LOIRE-ATLANTIQUE,NANTES,0440210P,69,69,0,0,34,35,4 ème
LOIRE-ATLANTIQUE,NANTES,0440219Z,47,47,0,0,20,27,4 ème
LOIRE-ATLANTIQUE,NANTES,0440246D,0,0,0,0,0,0,4 ème
LOIRE-ATLANTIQUE,NANTES,0440309X,73,73,0,0,47,26,4 ème
LOIRE-ATLANTIQUE,NANTES,0441545R,131,112,15,4,69,62,4 ème
LOIRE-ATLANTIQUE,NANTES,0441608J,87,64,16,7,46,41,4 ème
LOIRE-ATLANTIQUE,NANTES,0441938T,178,178,0,0,84,94,4 ème
LOIRE-ATLANTIQUE,NANTES,0442725Y,0,0,0,0,0,0,4 ème
LOIRE-ATLANTIQUE,NOZAY,0440223D,133,133,0,0,79,54,4 ème
LOIRE-ATLANTIQUE,ORVAULT,0440055W,167,167,0,0,86,81,4 ème
LOIRE-ATLANTIQUE,PAIMBOEUF,0441862K,113,97,16,0,52,61,4 ème
LOIRE-ATLANTIQUE,REZE,0440064F,140,140,0,0,76,64,4 ème
LOIRE-ATLANTIQUE,REZE,0440065G,187,187,0,0,85,102,4 ème
LOIRE-ATLANTIQUE,SAINT-BREVIN-LES-PINS,0440233P,105,102,0,3,50,55,4 ème
LOIRE-ATLANTIQUE,SAINT-PERE-EN-RETZ,0440238V,117,117,0,0,65,52,4 ème
LOIRE-ATLANTIQUE,THOUARE-SUR-LOIRE,0442417N,172,168,0,4,93,79,4 ème
LOIRE-ATLANTIQUE,TREILLIERES,0440209N,140,140,0,0,72,68,4 ème
LOIRE-ATLANTIQUE,TREILLIERES,0442418P,152,152,0,0,75,77,4 ème
LOIRE-ATLANTIQUE,VERTOU,0440080Y,112,110,0,2,63,49,4 ème
MAINE-ET-LOIRE,ANGERS,0490784L,0,0,0,0,0,0,4 ème
MAINE-ET-LOIRE,ANGERS,0490921K,132,132,0,0,50,82,4 ème
MAINE-ET-LOIRE,ANGERS,0491028B,103,103,0,0,51,52,4 ème
MAINE-ET-LOIRE,ANGERS,0491083L,178,178,0,0,89,89,4 ème
MAINE-ET-LOIRE,ANGERS,0491641T,86,86,0,0,32,54,4 ème
MAINE-ET-LOIRE,ANGERS,0492004M,238,215,16,7,112,126,4 ème
MAINE-ET-LOIRE,ANGERS,0492081W,171,169,0,2,80,91,4 ème
MAINE-ET-LOIRE,BEAUPREAU-EN-MAUGES,0490851J,205,199,0,6,89,116,4 ème
MAINE-ET-LOIRE,BELLEVIGNE-EN-LAYON,0490879P,98,98,0,0,51,47,4 ème
MAINE-ET-LOIRE,CHALONNES-SUR-LOIRE,0490955X,114,111,0,3,59,55,4 ème
MAINE-ET-LOIRE,CHEMILLE-EN-ANJOU,0490858S,172,171,0,1,83,89,4 ème
MAINE-ET-LOIRE,CHOLET,0491675E,99,83,16,0,51,48,4 ème
MAINE-ET-LOIRE,DOUE-EN-ANJOU,0490863X,102,102,0,0,60,42,4 ème
MAINE-ET-LOIRE,GENNES-VAL-DE-LOIRE,0491261E,148,148,0,0,79,69,4 ème
MAINE-ET-LOIRE,INGRANDES-LE FRESNE SUR LOIRE,0490026M,57,57,0,0,31,26,4 ème
MAINE-ET-LOIRE,LE LION-D'ANGERS,0490866A,92,89,0,3,54,38,4 ème
MAINE-ET-LOIRE,LES HAUTS-D'ANJOU,0490857R,95,95,0,0,46,49,4 ème
MAINE-ET-LOIRE,LES PONTS-DE-CE,0491923Z,115,115,0,0,57,58,4 ème
MAINE-ET-LOIRE,LYS-HAUT-LAYON,0490881S,81,81,0,0,44,37,4 ème
MAINE-ET-LOIRE,MAUGES-SUR-LOIRE,0490873H,91,91,0,0,41,50,4 ème
MAINE-ET-LOIRE,NOYANT-VILLAGES,0491766D,46,46,0,0,27,19,4 ème
MAINE-ET-LOIRE,OMBREE D'ANJOU,0490037Z,66,66,0,0,29,37,4 ème
MAINE-ET-LOIRE,OMBREE D'ANJOU,0490871F,44,44,0,0,19,25,4 ème
MAINE-ET-LOIRE,SAUMUR,0490055U,0,0,0,0,0,0,4 ème
MAINE-ET-LOIRE,SAUMUR,0490836T,98,96,0,2,45,53,4 ème
MAINE-ET-LOIRE,SAUMUR,0490839W,81,81,0,0,37,44,4 ème
MAINE-ET-LOIRE,SEVREMOINE,0490874J,76,76,0,0,33,43,4 ème
MAINE-ET-LOIRE,TRELAZE,0490048L,157,142,15,0,75,82,4 ème
MAINE-ET-LOIRE,VAL D'ERDRE-AUXENCE,0490029R,87,87,0,0,43,44,4 ème
MAINE-ET-LOIRE,VERRIERES-EN-ANJOU,0492140K,148,148,0,0,73,75,4 ème
MAYENNE,AMBRIERES-LES-VALLEES,0530001N,61,61,0,0,34,27,4 ème
MAYENNE,CHATEAU-GONTIER-SUR-MAYENNE,0530040F,0,0,0,0,0,0,4 ème
MAYENNE,ERNEE,0530770Z,144,142,0,2,75,69,4 ème
MAYENNE,GORRON,0530060C,26,26,0,0,13,13,4 ème
MAYENNE,LAVAL,0530484N,115,93,16,6,60,55,4 ème
SARTHE,ALLONNES,0720001K,106,86,16,4,50,56,4 ème
SARTHE,CHANGE,0721477P,101,96,0,5,41,60,4 ème
SARTHE,CONLIE,0720014Z,107,88,16,3,59,48,4 ème
SARTHE,CONNERRE,0720015A,167,167,0,0,80,87,4 ème
SARTHE,ECOMMOY,0721043T,115,115,0,0,63,52,4 ème
SARTHE,LA FLECHE,0720023J,129,97,32,0,71,58,4 ème
SARTHE,LE MANS,0720033V,0,0,0,0,0,0,4 ème
SARTHE,LE MANS,0720034W,0,0,0,0,0,0,4 ème
SARTHE,LE MANS,0720038A,73,73,0,0,33,40,4 ème
SARTHE,LE MANS,0720812S,184,184,0,0,97,87,4 ème
SARTHE,LE MANS,0720902P,103,82,16,5,53,50,4 ème
SARTHE,LE MANS,0720986F,147,126,16,5,70,77,4 ème
SARTHE,LE MANS,0721608G,4,4,0,0,2,2,4 ème
SARTHE,MAROLLES-LES-BRAULTS,0720043F,42,42,0,0,17,25,4 ème
SARTHE,SILLE-LE-GUILLAUME,0720817X,66,66,0,0,30,36,4 ème
SARTHE,TELOCHE,0721261E,169,166,0,3,76,93,4 ème
SARTHE,YVRE-L'EVEQUE,0721225R,71,66,0,5,25,46,4 ème
VENDEE,CHALLANS,0850142T,0,0,0,0,0,0,4 ème
VENDEE,CHALLANS,0850147Y,232,205,24,3,100,132,4 ème
VENDEE,CHALLANS,0851158X,322,305,15,2,162,160,4 ème
VENDEE,CHALLANS,0851698J,42,42,0,0,19,23,4 ème
VENDEE,FONTENAY-LE-COMTE,0850066K,114,114,0,0,58,56,4 ème
VENDEE,LA CHATAIGNERAIE,0850097U,96,96,0,0,46,50,4 ème
VENDEE,LA ROCHE-SUR-YON,0850027T,0,0,0,0,0,0,4 ème
VENDEE,LA ROCHE-SUR-YON,0851274Y,177,177,0,0,92,85,4 ème
VENDEE,LES ACHARDS,0851655M,129,129,0,0,58,71,4 ème
VENDEE,LES HERBIERS,0851400K,0,0,0,0,0,0,4 ème
VENDEE,LES SABLES-D'OLONNE,0850033Z,0,0,0,0,0,0,4 ème
VENDEE,LES SABLES-D'OLONNE,0850117R,184,168,12,4,91,93,4 ème
VENDEE,LUCON,0851290R,179,178,0,1,89,90,4 ème
VENDEE,MONTAIGU-VENDEE,0850104B,288,270,14,4,129,159,4 ème
VENDEE,MOUTIERS-LES-MAUXFAITS,0850107E,171,171,0,0,87,84,4 ème
VENDEE,MOUTIERS-LES-MAUXFAITS,0850641K,128,128,0,0,59,69,4 ème
VENDEE,NOIRMOUTIER-EN-L'ILE,0850109G,23,23,0,0,8,15,4 ème
VENDEE,PALLUAU,0850108F,92,92,0,0,42,50,4 ème
VENDEE,SAINT-JEAN-DE-MONTS,0850123X,86,86,0,0,38,48,4 ème
VENDEE,SAINT-MICHEL-EN-L'HERM,0851132U,66,66,0,0,25,41,4 ème
ALPES-DE-HTE-PROVENCE,ANNOT,0040001E,32,32,0,0,20,12,4 ème
ALPES-DE-HTE-PROVENCE,BANON,0040002F,39,39,0,0,22,17,4 ème
ALPES-DE-HTE-PROVENCE,CHATEAU-ARNOUX-SAINT-AUBAN,0040052K,161,156,0,5,74,87,4 ème
ALPES-DE-HTE-PROVENCE,DIGNE-LES-BAINS,0040007L,0,0,0,0,0,0,4 ème
ALPES-DE-HTE-PROVENCE,FORCALQUIER,0040382U,109,109,0,0,56,53,4 ème
ALPES-DE-HTE-PROVENCE,MANOSQUE,0040011R,0,0,0,0,0,0,4 ème
ALPES-DE-HTE-PROVENCE,MANOSQUE,0040462F,116,110,0,6,57,59,4 ème
ALPES-DE-HTE-PROVENCE,RIEZ,0040017X,64,64,0,0,38,26,4 ème
ALPES-DE-HTE-PROVENCE,SAINT-ANDRE-LES-ALPES,0040019Z,48,48,0,0,19,29,4 ème
BOUCHES-DU-RHONE,AIX-EN-PROVENCE,0132325G,117,113,0,4,57,60,4 ème
BOUCHES-DU-RHONE,AIX-EN-PROVENCE,0133395V,0,0,0,0,0,0,4 ème
BOUCHES-DU-RHONE,ARLES,0131322S,145,145,0,0,79,66,4 ème
BOUCHES-DU-RHONE,ARLES,0131610E,176,174,0,2,88,88,4 ème
BOUCHES-DU-RHONE,ARLES,0132572A,162,162,0,0,75,87,4 ème
BOUCHES-DU-RHONE,FUVEAU,0133243E,206,206,0,0,86,120,4 ème
BOUCHES-DU-RHONE,MARIGNANE,0130033R,0,0,0,0,0,0,4 ème
BOUCHES-DU-RHONE,MARSEILLE,0132204A,129,123,0,6,59,70,4 ème
BOUCHES-DU-RHONE,MARSEILLE,0130068D,0,0,0,0,0,0,4 ème
BOUCHES-DU-RHONE,MARSEILLE,0131379D,93,91,0,2,42,51,4 ème
BOUCHES-DU-RHONE,MARSEILLE,0131385K,92,92,0,0,44,48,4 ème
BOUCHES-DU-RHONE,MARSEILLE,0132401P,125,110,15,0,59,66,4 ème
BOUCHES-DU-RHONE,MARSEILLE,0132402R,205,205,0,0,88,117,4 ème
BOUCHES-DU-RHONE,MARSEILLE,0131756N,184,155,24,5,92,92,4 ème
BOUCHES-DU-RHONE,MARSEILLE,0133494C,27,27,0,0,15,12,4 ème
BOUCHES-DU-RHONE,MARSEILLE,0132312T,221,218,0,3,112,109,4 ème
BOUCHES-DU-RHONE,MARSEILLE,0133827P,10,10,0,0,3,7,4 ème
BOUCHES-DU-RHONE,MARSEILLE,0131604Y,140,135,0,5,76,64,4 ème
BOUCHES-DU-RHONE,MARSEILLE,0132114C,85,85,0,0,41,44,4 ème
BOUCHES-DU-RHONE,MARSEILLE,0132491M,161,129,32,0,73,88,4 ème
BOUCHES-DU-RHONE,MARSEILLE,0132956T,86,86,0,0,33,53,4 ème
BOUCHES-DU-RHONE,MARSEILLE,0133775H,71,68,0,3,36,35,4 ème
BOUCHES-DU-RHONE,MARSEILLE,0131372W,75,75,0,0,37,38,4 ème
BOUCHES-DU-RHONE,MARSEILLE,0131885D,156,154,0,2,80,76,4 ème
BOUCHES-DU-RHONE,MARSEILLE,0132785G,119,117,0,2,61,58,4 ème
BOUCHES-DU-RHONE,MARSEILLE,0131605Z,157,136,16,5,79,78,4 ème
BOUCHES-DU-RHONE,MARSEILLE,0131370U,44,44,0,0,25,19,4 ème
BOUCHES-DU-RHONE,MARSEILLE,0130055P,0,0,0,0,0,0,4 ème
BOUCHES-DU-RHONE,MARSEILLE,0132949K,123,123,0,0,63,60,4 ème
BOUCHES-DU-RHONE,MARSEILLE,0133445Z,19,19,0,0,9,10,4 ème
BOUCHES-DU-RHONE,MARSEILLE,0131943S,167,163,0,4,70,97,4 ème
BOUCHES-DU-RHONE,MARSEILLE,0132193N,0,0,0,0,0,0,4 ème
BOUCHES-DU-RHONE,MARSEILLE,0130062X,0,0,0,0,0,0,4 ème
BOUCHES-DU-RHONE,MARSEILLE,0132913W,195,195,0,0,91,104,4 ème
BOUCHES-DU-RHONE,MARSEILLE,0132914X,195,192,0,3,91,104,4 ème
BOUCHES-DU-RHONE,MARSEILLE,0132311S,114,109,0,5,58,56,4 ème
BOUCHES-DU-RHONE,MARTIGUES,0131707K,116,111,0,5,64,52,4 ème
BOUCHES-DU-RHONE,PLAN-DE-CUQUES,0133665N,146,146,0,0,73,73,4 ème
BOUCHES-DU-RHONE,PORT-DE-BOUC,0132322D,121,121,0,0,61,60,4 ème
BOUCHES-DU-RHONE,SAINT-ANDIOL,0133621R,183,177,0,6,103,80,4 ème
BOUCHES-DU-RHONE,SAINT-REMY-DE-PROVENCE,0132573B,160,144,16,0,80,80,4 ème
BOUCHES-DU-RHONE,SALON-DE-PROVENCE,0130163G,261,235,23,3,129,132,4 ème
BOUCHES-DU-RHONE,SALON-DE-PROVENCE,0131349W,159,156,0,3,82,77,4 ème
BOUCHES-DU-RHONE,VELAUX,0133353Z,168,168,0,0,87,81,4 ème
BOUCHES-DU-RHONE,VITROLLES,0133196D,165,153,0,12,82,83,4 ème
HAUTES-ALPES,GAP,0050008G,0,0,0,0,0,0,4 ème
HAUTES-ALPES,GAP,0050480V,185,166,15,4,98,87,4 ème
HAUTES-ALPES,L'ARGENTIERE-LA-BESSEE,0050409T,69,68,0,1,38,31,4 ème
HAUTES-ALPES,SERRES,0050520N,34,34,0,0,17,17,4 ème
HAUTES-ALPES,TALLARD,0050638S,84,84,0,0,45,39,4 ème
HAUTES-ALPES,VEYNES,0050022X,76,76,0,0,38,38,4 ème
VAUCLUSE,CARPENTRAS,0840761W,131,130,0,1,78,53,4 ème
VAUCLUSE,CARPENTRAS,0840851U,127,127,0,0,127,0,4 ème
VAUCLUSE,CAVAILLON,0840018N,118,89,25,4,57,61,4 ème
VAUCLUSE,CAVAILLON,0841086Z,89,86,0,3,33,56,4 ème
VAUCLUSE,LE PONTET,0840664R,178,161,15,2,96,82,4 ème
VAUCLUSE,L'ISLE-SUR-LA-SORGUE,0840585E,121,118,0,3,59,62,4 ème
VAUCLUSE,L'ISLE-SUR-LA-SORGUE,0841118J,126,126,0,0,58,68,4 ème
VAUCLUSE,MAZAN,0841043C,159,159,0,0,73,86,4 ème
VAUCLUSE,MONTEUX,0840698C,196,192,0,4,95,101,4 ème
VAUCLUSE,PERTUIS,0840069U,85,85,0,0,46,39,4 ème
VAUCLUSE,PERTUIS,0840926A,113,109,0,4,53,60,4 ème
VAUCLUSE,SORGUES,0840583C,159,143,16,0,76,83,4 ème
VAUCLUSE,SORGUES,0841078R,0,0,0,0,0,0,4 ème
VAUCLUSE,VEDENE,0840803S,192,192,0,0,95,97,4 ème
ALPES-MARITIMES,ANTIBES,0060795G,90,90,0,0,37,53,4 ème
ALPES-MARITIMES,BEAUSOLEIL,0061278G,105,105,0,0,62,43,4 ème
ALPES-MARITIMES,CANNES,0061174U,137,137,0,0,50,87,4 ème
ALPES-MARITIMES,CANNES,0061394H,0,0,0,0,0,0,4 ème
ALPES-MARITIMES,CANNES,0061457B,257,257,0,0,135,122,4 ème
ALPES-MARITIMES,CANNES,0061561P,0,0,0,0,0,0,4 ème
ALPES-MARITIMES,LA TRINITE,0060910G,143,136,0,7,68,75,4 ème
ALPES-MARITIMES,MANDELIEU-LA-NAPOULE,0061175V,165,165,0,0,68,97,4 ème
ALPES-MARITIMES,MANDELIEU-LA-NAPOULE,0061924J,120,119,0,1,54,66,4 ème
ALPES-MARITIMES,NICE,0060043P,0,0,0,0,0,0,4 ème
ALPES-MARITIMES,NICE,0060085K,154,148,0,6,78,76,4 ème
ALPES-MARITIMES,NICE,0060679F,121,121,0,0,58,63,4 ème
ALPES-MARITIMES,NICE,0060681H,70,70,0,0,32,38,4 ème
ALPES-MARITIMES,NICE,0060745C,81,79,0,2,40,41,4 ème
ALPES-MARITIMES,NICE,0060840F,185,167,14,4,79,106,4 ème
ALPES-MARITIMES,NICE,0061462G,26,26,0,0,7,19,4 ème
ALPES-MARITIMES,PEGOMAS,0062181N,147,147,0,0,61,86,4 ème
ALPES-MARITIMES,ROQUEBILLIERE,0061237M,65,62,3,0,36,29,4 ème
ALPES-MARITIMES,ROQUEFORT-LES-PINS,0062056C,181,181,0,0,93,88,4 ème
VAR,AUPS,0830002B,152,148,0,4,76,76,4 ème
VAR,BANDOL,0830003C,95,83,12,0,41,54,4 ème
VAR,BESSE-SUR-ISSOLE,0831630W,191,191,0,0,102,89,4 ème
VAR,BRIGNOLES,0830103L,192,192,0,0,106,86,4 ème
VAR,BRIGNOLES,0830734X,174,148,22,4,74,100,4 ème
VAR,CUERS,0831482K,60,60,0,0,36,24,4 ème
VAR,DRAGUIGNAN,0830929J,180,175,0,5,92,88,4 ème
VAR,DRAGUIGNAN,0830956N,201,178,16,7,102,99,4 ème
VAR,DRAGUIGNAN,0831306U,86,86,0,0,38,48,4 ème
VAR,GAREOULT,0831391L,176,176,0,0,98,78,4 ème
VAR,HYERES,0830145G,157,132,23,2,64,93,4 ème
VAR,LA SEYNE-SUR-MER,0831052T,128,128,0,0,55,73,4 ème
VAR,LA SEYNE-SUR-MER,0831196Z,160,149,11,0,80,80,4 ème
VAR,LORGUES,0830076G,152,150,0,2,69,83,4 ème
VAR,OLLIOULES,0831188R,196,192,0,4,87,109,4 ème
VAR,ROCBARON,0831645M,137,137,0,0,65,72,4 ème
VAR,SAINT-MANDRIER-SUR-MER,0830071B,47,47,0,0,29,18,4 ème
VAR,SAINT-ZACHARIE,0831657A,141,141,0,0,74,67,4 ème
VAR,SANARY-SUR-MER,0830178T,107,107,0,0,53,54,4 ème
VAR,TOULON,0830953K,162,160,0,2,73,89,4 ème
VAR,TOULON,0831197A,125,124,0,1,63,62,4 ème
VAR,TOULON,0831198B,124,124,0,0,64,60,4 ème
VAR,VINON-SUR-VERDON,0831552L,162,162,0,0,83,79,4 ème
ALLIER,BOURBON-L'ARCHAMBAULT,0030004N,72,71,0,1,29,43,4 ème
ALLIER,CERILLY,0030005P,25,25,0,0,13,12,4 ème
ALLIER,CUSSET,0030061A,0,0,0,0,0,0,4 ème
ALLIER,GANNAT,0030017C,121,116,0,5,61,60,4 ème
ALLIER,MONTLUCON,0030981A,77,77,0,0,25,52,4 ème
ALLIER,MOULINS,0030081X,73,70,0,3,32,41,4 ème
ALLIER,YZEURE,0030837U,166,160,0,6,89,77,4 ème
CANTAL,AURILLAC,0150008C,0,0,0,0,0,0,4 ème
CANTAL,AURILLAC,0150639N,99,94,0,5,46,53,4 ème
CANTAL,MAURIAC,0150061K,23,23,0,0,11,12,4 ème
CANTAL,PIERREFORT,0150024V,11,11,0,0,5,6,4 ème
CANTAL,RIOM-ES-MONTAGNES,0150062L,13,13,0,0,3,10,4 ème
CANTAL,VIC-SUR-CERE,0150033E,47,47,0,0,25,22,4 ème
HAUTE-LOIRE,BRIVES-CHARENSAC,0430917N,58,39,16,3,26,32,4 ème
HAUTE-LOIRE,ESPALY-SAINT-MARCEL,0430023S,0,0,0,0,0,0,4 ème
HAUTE-LOIRE,LANGEAC,0430013F,45,42,0,3,22,23,4 ème
HAUTE-LOIRE,LANGEAC,0430072V,40,40,0,0,28,12,4 ème
HAUTE-LOIRE,LE PUY-EN-VELAY,0430903Y,56,55,0,1,27,29,4 ème
HAUTE-LOIRE,MONISTROL-SUR-LOIRE,0430906B,186,169,17,0,90,96,4 ème
HAUTE-LOIRE,SAINTE-FLORINE,0430029Y,76,73,0,3,39,37,4 ème
HAUTE-LOIRE,SAINTE-FLORINE,0430085J,13,13,0,0,7,6,4 ème
HAUTE-LOIRE,YSSINGEAUX,0430953C,0,0,0,0,0,0,4 ème
PUY-DE-DOME,BEAUMONT,0630007R,133,132,0,1,64,69,4 ème
PUY-DE-DOME,CEYRAT,0630063B,131,122,0,9,61,70,4 ème
PUY-DE-DOME,CHATEL-GUYON,0630017B,123,123,0,0,72,51,4 ème
PUY-DE-DOME,CLERMONT-FERRAND,0631073Z,126,126,0,0,62,64,4 ème
PUY-DE-DOME,CLERMONT-FERRAND,0631120A,103,87,8,8,51,52,4 ème
PUY-DE-DOME,CLERMONT-FERRAND,0631126G,122,103,15,4,63,59,4 ème
PUY-DE-DOME,CLERMONT-FERRAND,0631522M,137,119,13,5,60,77,4 ème
PUY-DE-DOME,CLERMONT-FERRAND,0632091F,0,0,0,0,0,0,4 ème
PUY-DE-DOME,COURNON-D'AUVERGNE,0631688T,155,140,13,2,81,74,4 ème
PUY-DE-DOME,CUNLHAT,0630031S,17,17,0,0,8,9,4 ème
PUY-DE-DOME,GERZAT,0631161V,173,152,13,8,93,80,4 ème
PUY-DE-DOME,ISSOIRE,0631734T,125,125,0,0,57,68,4 ème
PUY-DE-DOME,LA TOUR-D'AUVERGNE,0630036X,33,33,0,0,16,17,4 ème
PUY-DE-DOME,LEMPDES,0631412T,168,151,15,2,80,88,4 ème
PUY-DE-DOME,LEZOUX,0631481T,171,169,0,2,91,80,4 ème
PUY-DE-DOME,MANZAT,0630038Z,52,52,0,0,24,28,4 ème
PUY-DE-DOME,OLLIERGUES,0630045G,19,19,0,0,8,11,4 ème
PUY-DE-DOME,ORCINES,0631100D,21,21,0,0,6,15,4 ème
PUY-DE-DOME,PONT-DU-CHATEAU,0630916D,158,158,0,0,77,81,4 ème
PUY-DE-DOME,PONT-DU-CHATEAU,0631480S,0,0,0,0,0,0,4 ème
PUY-DE-DOME,PUY-GUILLAUME,0630050M,68,68,0,0,34,34,4 ème
PUY-DE-DOME,RIOM,0631580A,143,138,0,5,78,65,4 ème
PUY-DE-DOME,ROMAGNAT,0630665F,1,0,1,0,0,1,4 ème
PUY-DE-DOME,SAINT-ELOY-LES-MINES,0630061Z,0,0,0,0,0,0,4 ème
PUY-DE-DOME,SAINT-ELOY-LES-MINES,0631109N,19,19,0,0,11,8,4 ème
PUY-DE-DOME,SAINT-SATURNIN,0631111R,58,54,0,4,27,31,4 ème
ARDECHE,BOURG-SAINT-ANDEOL,0070006U,114,100,14,0,54,60,4 ème
ARDECHE,LE POUZIN,0070019H,78,75,0,3,39,39,4 ème
ARDECHE,LE TEIL,0070864B,42,42,0,0,23,19,4 ème
ARDECHE,TOURNON-SUR-RHONE,0070848J,250,228,16,6,119,131,4 ème
DROME,BOURG-DE-PEAGE,0260090G,183,183,0,0,85,98,4 ème
DROME,CREST,0261092W,102,99,0,3,35,67,4 ème
DROME,DIE,0261093X,106,105,0,1,49,57,4 ème
DROME,MONTELIMAR,0260789S,195,159,32,4,98,97,4 ème
DROME,MONTELIMAR,0261088S,133,133,0,0,64,69,4 ème
DROME,ROMANS-SUR-ISERE,0260115J,147,122,15,10,74,73,4 ème
DROME,SAINT-VALLIER,0260032U,176,153,16,7,91,85,4 ème
DROME,SAINT-VALLIER,0261397C,0,0,0,0,0,0,4 ème
DROME,VALENCE,0260049M,121,112,0,9,66,55,4 ème
DROME,VALENCE,0260070K,128,128,0,0,62,66,4 ème
DROME,VALENCE,0260082Y,0,0,0,0,0,0,4 ème
DROME,VALENCE,0260978X,167,151,16,0,87,80,4 ème
HAUTE SAVOIE,ANNECY,0740062R,0,0,0,0,0,0,4 ème
HAUTE SAVOIE,ANNECY,0741096P,166,160,0,6,86,80,4 ème
HAUTE SAVOIE,BONS-EN-CHABLAIS,0740015P,180,179,0,1,85,95,4 ème
HAUTE SAVOIE,CLUSES,0740017S,0,0,0,0,0,0,4 ème
HAUTE SAVOIE,COLLONGES-SOUS-SALEVE,0741596H,25,25,0,0,15,10,4 ème
HAUTE SAVOIE,CRANVES-SALES,0741514U,210,208,0,2,95,115,4 ème
HAUTE SAVOIE,EVIAN-LES-BAINS,0740117A,78,78,0,0,41,37,4 ème
HAUTE SAVOIE,GROISY,0740025A,197,196,0,1,97,100,4 ème
HAUTE SAVOIE,LA ROCHE-SUR-FORON,0741279N,192,192,0,0,109,83,4 ème
HAUTE SAVOIE,MEGEVE,0740119C,58,58,0,0,19,39,4 ème
HAUTE SAVOIE,REIGNIER-ESERY,0740029E,236,235,0,1,98,138,4 ème
HAUTE SAVOIE,SAINT-JULIEN-EN-GENEVOIS,0741282S,154,151,0,3,74,80,4 ème
HAUTE SAVOIE,SAINT-JULIEN-EN-GENEVOIS,0741419R,148,137,0,11,75,73,4 ème
HAUTE SAVOIE,SAINT-PIERRE-EN-FAUCIGNY,0741665H,174,156,15,3,68,106,4 ème
HAUTE SAVOIE,SALLANCHES,0740039R,133,131,0,2,69,64,4 ème
HAUTE SAVOIE,SCIONZIER,0741139L,214,190,19,5,104,110,4 ème
ISERE,ALLEVARD,0380002W,126,126,0,0,62,64,4 ème
ISERE,ALLEVARD,0381741L,0,0,0,0,0,0,4 ème
ISERE,BOURGOIN-JALLIEU,0381687C,116,116,0,0,60,56,4 ème
ISERE,CHATTE,0383345E,121,121,0,0,60,61,4 ème
ISERE,CLAIX,0382107J,16,0,16,0,4,12,4 ème
ISERE,CLAIX,0382865H,117,115,0,2,50,67,4 ème
ISERE,CREMIEU,0382103E,196,193,0,3,106,90,4 ème
ISERE,ECHIROLLES,0382044R,93,90,0,3,51,42,4 ème
ISERE,GRENOBLE,0380036H,0,0,0,0,0,0,4 ème
ISERE,GRENOBLE,0381667F,145,145,0,0,78,67,4 ème
ISERE,GRENOBLE,0381776Z,165,165,0,0,72,93,4 ème
ISERE,GRENOBLE,0383243U,155,155,0,0,92,63,4 ème
ISERE,HEYRIEUX,0380038K,127,127,0,0,70,57,4 ème
ISERE,LA COTE-SAINT-ANDRE,0380014J,0,0,0,0,0,0,4 ème
ISERE,LA MOTTE-D'AVEILLANS,0380047V,44,44,0,0,21,23,4 ème
ISERE,LA TOUR-DU-PIN,0380073Y,0,0,0,0,0,0,4 ème
ISERE,LA VERPILLIERE,0382176J,171,171,0,0,85,86,4 ème
ISERE,LE GRAND-LEMPS,0380026X,148,148,0,0,79,69,4 ème
ISERE,LE PEAGE-DE-ROUSSILLON,0381733C,0,0,0,0,0,0,4 ème
ISERE,LE PEAGE-DE-ROUSSILLON,0382582A,134,134,0,0,75,59,4 ème
ISERE,LES ABRETS EN DAUPHINE,0380001V,156,151,0,5,75,81,4 ème
ISERE,L'ISLE-D'ABEAU,0383056R,113,108,0,5,47,66,4 ème
ISERE,MEYLAN,0382492C,83,83,0,0,37,46,4 ème
ISERE,PONTCHARRA,0381905P,154,144,10,0,82,72,4 ème
ISERE,PONT-EVEQUE,0382504R,125,121,0,4,61,64,4 ème
ISERE,ROUSSILLON,0381599G,0,0,0,0,0,0,4 ème
ISERE,SAINT-EGREVE,0380058G,176,176,0,0,77,99,4 ème
ISERE,SAINT-ISMIER,0382100B,164,164,0,0,77,87,4 ème
ISERE,SASSENAGE,0382098Z,182,178,0,4,87,95,4 ème
ISERE,SEYSSINET-PARISET,0380072X,136,134,0,2,65,71,4 ème
ISERE,SEYSSUEL,0382115T,211,190,15,6,103,108,4 ème
ISERE,VIENNE,0382583B,256,250,0,6,145,111,4 ème
ISERE,VILLARD-DE-LANS,0382429J,210,208,0,2,98,112,4 ème
ISERE,VOIRON,0382042N,137,134,0,3,61,76,4 ème
SAVOIE,AIX-LES-BAINS,0730853F,158,126,26,6,65,93,4 ème
SAVOIE,ALBERTVILLE,0731272L,78,75,0,3,36,42,4 ème
SAVOIE,CHAMBERY,0730776X,0,0,0,0,0,0,4 ème
SAVOIE,CHAMBERY,0730902J,141,140,0,1,77,64,4 ème
SAVOIE,LES ECHELLES,0730022C,89,87,0,2,34,55,4 ème
SAVOIE,MOUTIERS,0730796U,43,43,0,0,21,22,4 ème
SAVOIE,SAINT-ALBAN-LEYSSE,0730810J,151,131,15,5,70,81,4 ème
SAVOIE,UGINE,0730044B,89,89,0,0,43,46,4 ème
SAVOIE,VALGELON-LA ROCHETTE,0731114P,129,128,0,1,64,65,4 ème
SAVOIE,YENNE,0730045C,80,80,0,0,31,49,4 ème
AIN,BELLEY,0011010T,0,0,0,0,0,0,4 ème
AIN,BOURG-EN-BRESSE,0010018P,117,115,0,2,59,58,4 ème
AIN,BOURG-EN-BRESSE,0010080G,88,88,0,0,47,41,4 ème
AIN,BOURG-EN-BRESSE,0010974D,148,114,32,2,74,74,4 ème
AIN,BOURG-EN-BRESSE,0011118K,0,0,0,0,0,0,4 ème
AIN,BOURG-EN-BRESSE,0011275F,143,142,0,1,74,69,4 ème
AIN,CHATILLON-SUR-CHALARONNE,0010821M,142,140,0,2,72,70,4 ème
AIN,FEILLENS,0010086N,108,108,0,0,56,52,4 ème
AIN,LAGNIEU,0010026Y,190,185,0,5,90,100,4 ème
AIN,LEYMENT,0011300H,161,158,0,3,80,81,4 ème
AIN,MEXIMIEUX,0010041P,254,226,24,4,110,144,4 ème
AIN,MONTLUEL,0010796K,181,179,0,2,82,99,4 ème
AIN,PLATEAU D'HAUTEVILLE,0010025X,82,80,0,2,41,41,4 ème
AIN,REYRIEUX,0011338Z,163,163,0,0,81,82,4 ème
AIN,SAINT-ANDRE-DE-CORCY,0011257L,115,112,0,3,57,58,4 ème
AIN,TREVOUX,0010066S,198,196,0,2,97,101,4 ème
AIN,VALSERHONE,0010006B,0,0,0,0,0,0,4 ème
AIN,VONNAS,0010046V,110,107,0,3,57,53,4 ème
LOIRE,ANDREZIEUX-BOUTHEON,0421691K,0,0,0,0,0,0,4 ème
LOIRE,CHAZELLES-SUR-LYON,0420998G,0,0,0,0,0,0,4 ème
LOIRE,FEURS,0420012K,203,199,0,4,100,103,4 ème
LOIRE,FIRMINY,0421570D,91,73,16,2,41,50,4 ème
LOIRE,FIRMINY,0421659A,76,71,0,5,34,42,4 ème
LOIRE,FIRMINY,0421681Z,68,65,0,3,35,33,4 ème
LOIRE,LE CHAMBON-FEUGEROLLES,0421044G,47,47,0,0,29,18,4 ème
LOIRE,LE CHAMBON-FEUGEROLLES,0421919H,111,94,17,0,51,60,4 ème
LOIRE,PELUSSIN,0420024Y,122,122,0,0,52,70,4 ème
LOIRE,SAINT-CHAMOND,0421688G,104,102,0,2,52,52,4 ème
LOIRE,SAINT-ETIENNE,0421038A,80,80,0,0,40,40,4 ème
LOIRE,SAINT-ETIENNE,0421569C,129,124,0,5,68,61,4 ème
LOIRE,SAINT-ETIENNE,0421741P,124,121,0,3,42,82,4 ème
LOIRE,SAINT-ETIENNE,0421742R,0,0,0,0,0,0,4 ème
LOIRE,SURY-LE-COMTAL,0420985T,0,0,0,0,0,0,4 ème
RHONE,BELLEVILLE-EN-BEAUJOLAIS,0693734J,0,0,0,0,0,0,4 ème
RHONE,BELLEVILLE-EN-BEAUJOLAIS,0694279B,107,107,0,0,55,52,4 ème
RHONE,BRON,0691479H,113,109,0,4,57,56,4 ème
RHONE,CHAPONOST,0693365H,162,162,0,0,83,79,4 ème
RHONE,CHAZAY-D'AZERGUES,0692448L,130,130,0,0,67,63,4 ème
RHONE,CRAPONNE,0692422H,169,166,0,3,86,83,4 ème
RHONE,LAMURE-SUR-AZERGUES,0690022Z,99,94,0,5,43,56,4 ème
RHONE,LYON,0692334M,118,117,0,1,59,59,4 ème
RHONE,LYON,0694007F,206,203,0,3,105,101,4 ème
RHONE,LYON,0692937T,188,188,0,0,95,93,4 ème
RHONE,LYON,0691663H,183,183,0,0,86,97,4 ème
RHONE,LYON,0693137K,144,144,0,0,79,65,4 ème
RHONE,LYON,0694453R,121,119,0,2,66,55,4 ème
RHONE,LYON,0690060R,78,76,0,2,37,41,4 ème
RHONE,LYON,0691669P,166,162,0,4,82,84,4 ème
RHONE,LYON,0693406C,0,0,0,0,0,0,4 ème
RHONE,LYON,0694295U,125,125,0,0,62,63,4 ème
RHONE,LYON,0692703N,97,93,0,4,42,55,4 ème
RHONE,OULLINS,0690541N,147,147,0,0,76,71,4 ème
RHONE,OULLINS,0692924D,353,353,0,0,187,166,4 ème
RHONE,SAINTE-FOY-LES-LYON,0691484N,97,85,12,0,44,53,4 ème
RHONE,SAINT-MARTIN-EN-HAUT,0694092Y,82,82,0,0,43,39,4 ème
RHONE,SAINT-PRIEST,0692417C,161,160,0,1,78,83,4 ème
RHONE,SAINT-PRIEST,0694406P,127,111,15,1,62,65,4 ème
RHONE,TASSIN-LA-DEMI-LUNE,0692943Z,212,211,0,1,93,119,4 ème
RHONE,THIZY-LES-BOURGS,0690581G,52,52,0,0,23,29,4 ème
RHONE,VAL D'OINGT,0691674V,122,119,0,3,64,58,4 ème
RHONE,VAULX-EN-VELIN,0691666L,134,112,16,6,49,85,4 ème
RHONE,VENISSIEUX,0690093B,0,0,0,0,0,0,4 ème
RHONE,VENISSIEUX,0691799F,164,146,16,2,76,88,4 ème
RHONE,VENISSIEUX,0692418D,0,0,0,0,0,0,4 ème
RHONE,VILLEFRANCHE-SUR-SAONE,0690097F,0,0,0,0,0,0,4 ème
RHONE,VILLEFRANCHE-SUR-SAONE,0691645N,110,109,0,1,57,53,4 ème
RHONE,VILLEFRANCHE-SUR-SAONE,0692944A,279,276,0,3,146,133,4 ème
RHONE,VILLEURBANNE,0690599B,72,72,0,0,30,42,4 ème
RHONE,VILLEURBANNE,0692945B,205,205,0,0,113,92,4 ème
RHONE,VOURLES,0690624D,165,165,0,0,79,86,4 ème
DOUBS,BAUME-LES-DAMES,0250063H,0,0,0,0,0,0,4 ème
DOUBS,BESANCON,0250009Z,114,108,0,6,63,51,4 ème
DOUBS,BESANCON,0251371E,16,0,16,0,3,13,4 ème
DOUBS,BESANCON,0251587P,102,102,0,0,51,51,4 ème
DOUBS,BLAMONT,0250015F,56,56,0,0,34,22,4 ème
DOUBS,ETUPES,0251211F,128,125,0,3,59,69,4 ème
DOUBS,L'ISLE-SUR-LE-DOUBS,0250024R,101,95,0,6,49,52,4 ème
DOUBS,ORCHAMPS-VENNES,0251054K,68,68,0,0,37,31,4 ème
DOUBS,ORNANS,0251055L,61,61,0,0,29,32,4 ème
DOUBS,PIERREFONTAINE-LES-VARANS,0251315U,56,56,0,0,30,26,4 ème
DOUBS,PONT-DE-ROIDE-VERMONDANS,0250047R,114,110,0,4,59,55,4 ème
DOUBS,QUINGEY,0250049T,103,103,0,0,42,61,4 ème
DOUBS,SELONCOURT,0251397H,81,81,0,0,41,40,4 ème
HAUTE-SAONE,CHAMPAGNEY,0700895T,113,113,0,0,54,59,4 ème
HAUTE-SAONE,FAUCOGNEY-ET-LA-MER,0700005A,46,46,0,0,24,22,4 ème
HAUTE-SAONE,GRAY,0700060K,43,43,0,0,22,21,4 ème
HAUTE-SAONE,GRAY,0700904C,96,77,17,2,56,40,4 ème
HAUTE-SAONE,GY,0700061L,43,43,0,0,22,21,4 ème
HAUTE-SAONE,JUSSEY,0700016M,65,65,0,0,26,39,4 ème
HAUTE-SAONE,LURE,0700045U,201,181,15,5,99,102,4 ème
HAUTE-SAONE,LUXEUIL-LES-BAINS,0700056F,56,56,0,0,23,33,4 ème
HAUTE-SAONE,VAUVILLERS,0700035H,38,34,0,4,17,21,4 ème
JURA,ARBOIS,0390074U,15,15,0,0,6,9,4 ème
JURA,ARINTHOD,0390783P,47,47,0,0,22,25,4 ème
JURA,CHAUSSIN,0390922R,92,92,0,0,37,55,4 ème
JURA,LONS-LE-SAUNIER,0390022M,112,109,0,3,58,54,4 ème
JURA,NOZEROY,0390784R,42,42,0,0,24,18,4 ème
JURA,SAINT-AMOUR,0390785S,59,59,0,0,31,28,4 ème
JURA,SAINT-CLAUDE,0390924T,105,81,18,6,63,42,4 ème
TERRITOIRE DE BELFORT,BELFORT,0900017E,90,88,0,2,39,51,4 ème
TERRITOIRE DE BELFORT,CHEVREMONT,0900032W,33,33,0,0,16,17,4 ème
TERRITOIRE DE BELFORT,VALDOIE,0900014B,107,104,0,3,51,56,4 ème
COTE D'OR,AUXONNE,0210003P,0,0,0,0,0,0,4 ème
COTE D'OR,BEAUNE,0211229X,170,166,0,4,94,76,4 ème
COTE D'OR,BEAUNE,0211428N,23,0,23,0,8,15,4 ème
COTE D'OR,BLIGNY-SUR-OUCHE,0210011Y,13,13,0,0,5,8,4 ème
COTE D'OR,CHATILLON-SUR-SEINE,0210013A,0,0,0,0,0,0,4 ème
COTE D'OR,CHATILLON-SUR-SEINE,0211079J,37,37,0,0,15,22,4 ème
COTE D'OR,DIJON,0210018F,0,0,0,0,0,0,4 ème
COTE D'OR,DIJON,0211034K,168,164,0,4,98,70,4 ème
COTE D'OR,DIJON,0211071A,103,103,0,0,51,52,4 ème
COTE D'OR,DIJON,0211081L,168,168,0,0,83,85,4 ème
COTE D'OR,DIJON,0211136W,106,87,16,3,55,51,4 ème
COTE D'OR,DIJON,0211150L,132,116,16,0,66,66,4 ème
COTE D'OR,DIJON,0211162Z,72,52,15,5,37,35,4 ème
COTE D'OR,GENLIS,0211164B,129,129,0,0,71,58,4 ème
COTE D'OR,SAULIEU,0210046L,46,44,0,2,21,25,4 ème
COTE D'OR,SOMBERNON,0210051S,94,94,0,0,42,52,4 ème
COTE D'OR,VITTEAUX,0210053U,27,27,0,0,12,15,4 ème
NIEVRE,CORBIGNY,0580012Y,32,32,0,0,18,14,4 ème
NIEVRE,COSNE-COURS-SUR-LOIRE,0580669M,91,76,11,4,49,42,4 ème
NIEVRE,COSNE-COURS-SUR-LOIRE,0580746W,106,106,0,0,48,58,4 ème
NIEVRE,NEVERS,0580050P,0,0,0,0,0,0,4 ème
NIEVRE,NEVERS,0580599L,100,95,0,5,54,46,4 ème
NIEVRE,VARZY,0580042F,0,0,0,0,0,0,4 ème
SAONE-ET-LOIRE,AUTUN,0710115P,82,82,0,0,37,45,4 ème
SAONE-ET-LOIRE,CHALON-SUR-SAONE,0711348E,169,165,0,4,87,82,4 ème
SAONE-ET-LOIRE,CLUNY,0710024R,125,123,0,2,78,47,4 ème
SAONE-ET-LOIRE,CUISEAUX,0710033A,54,54,0,0,20,34,4 ème
SAONE-ET-LOIRE,EPINAC,0710037E,42,42,0,0,21,21,4 ème
SAONE-ET-LOIRE,LA CHAPELLE-DE-GUINCHAY,0711321A,129,129,0,0,56,73,4 ème
SAONE-ET-LOIRE,LE CREUSOT,0711069B,134,126,8,0,51,83,4 ème
SAONE-ET-LOIRE,MACON,0710080B,0,0,0,0,0,0,4 ème
SAONE-ET-LOIRE,MACON,0710534V,136,124,12,0,69,67,4 ème
SAONE-ET-LOIRE,MARCIGNY,0711071D,70,70,0,0,33,37,4 ème
SAONE-ET-LOIRE,MONTCEAU-LES-MINES,0710056A,90,71,16,3,48,42,4 ème
SAONE-ET-LOIRE,MONTCEAU-LES-MINES,0711777W,114,114,0,0,64,50,4 ème
SAONE-ET-LOIRE,MONTCENIS,0711323C,68,67,0,1,29,39,4 ème
SAONE-ET-LOIRE,PARAY-LE-MONIAL,0711755X,0,0,0,0,0,0,4 ème
SAONE-ET-LOIRE,SAINT-GERMAIN-DU-BOIS,0711146K,81,81,0,0,39,42,4 ème
SAONE-ET-LOIRE,SAINT-MARCEL,0711490J,127,111,16,0,58,69,4 ème
YONNE,AUXERRE,0890789Z,198,177,17,4,104,94,4 ème
YONNE,AUXERRE,0890819G,0,0,0,0,0,0,4 ème
YONNE,AVALLON,0890008A,0,0,0,0,0,0,4 ème
YONNE,COURSON-LES-CARRIERES,0890015H,75,75,0,0,33,42,4 ème
YONNE,JOIGNY,0890065M,112,112,0,0,46,66,4 ème
YONNE,JOIGNY,0890937K,125,123,0,2,61,64,4 ème
YONNE,JOIGNY,0891199V,0,0,0,0,0,0,4 ème
YONNE,MONTHOLON,0890788Y,113,113,0,0,60,53,4 ème
YONNE,SAINT-VALERIEN,0890028X,182,175,0,7,84,98,4 ème
YONNE,SENS,0891055N,157,157,0,0,79,78,4 ème
YONNE,SENS,0891093E,109,109,0,0,58,51,4 ème
YONNE,VILLENEUVE-LA-GUYARD,0891186F,125,125,0,0,63,62,4 ème
YONNE,VILLENEUVE-L'ARCHEVEQUE,0890038H,86,86,0,0,44,42,4 ème
COTES D'ARMOR,CREHEN,0221619R,101,101,0,0,43,58,4 ème
COTES D'ARMOR,EVRAN,0220140H,36,36,0,0,14,22,4 ème
COTES D'ARMOR,GUINGAMP,0220197V,109,102,0,7,57,52,4 ème
COTES D'ARMOR,GUINGAMP,0221698B,100,80,20,0,52,48,4 ème
COTES D'ARMOR,HILLION,0222030M,192,189,0,3,97,95,4 ème
COTES D'ARMOR,LAMBALLE-ARMOR,0221537B,172,140,29,3,91,81,4 ème
COTES D'ARMOR,MONCONTOUR,0221594N,72,72,0,0,33,39,4 ème
COTES D'ARMOR,PAIMPOL,0221991V,133,117,16,0,75,58,4 ème
COTES D'ARMOR,PERROS-GUIREC,0220167M,38,38,0,0,18,20,4 ème
COTES D'ARMOR,PERROS-GUIREC,0221029Z,119,119,0,0,57,62,4 ème
COTES D'ARMOR,PLEMET,0220153X,15,15,0,0,9,6,4 ème
COTES D'ARMOR,PLESIDY,0221877W,61,61,0,0,34,27,4 ème
COTES D'ARMOR,PLOUFRAGAN,0221621T,186,147,32,7,91,95,4 ème
COTES D'ARMOR,PLOUGUENAST-LANGAST,0220162G,44,44,0,0,20,24,4 ème
COTES D'ARMOR,SAINT-BRIEUC,0220054P,135,132,0,3,68,67,4 ème
COTES D'ARMOR,SAINT-BRIEUC,0220058U,0,0,0,0,0,0,4 ème
COTES D'ARMOR,SAINT-BRIEUC,0221513A,149,129,16,4,76,73,4 ème
COTES D'ARMOR,SAINT-BRIEUC,0221751J,140,140,0,0,79,61,4 ème
COTES D'ARMOR,TREGUIER,0220072J,0,0,0,0,0,0,4 ème
COTES D'ARMOR,TREGUIER,0220177Y,39,39,0,0,18,21,4 ème
FINISTERE,BREST,0290335G,0,0,0,0,0,0,4 ème
FINISTERE,BREST,0291824A,102,97,0,5,47,55,4 ème
FINISTERE,BREST,0291867X,195,179,14,2,107,88,4 ème
FINISTERE,CARANTEC,0290021R,72,72,0,0,28,44,4 ème
FINISTERE,CARHAIX-PLOUGUER,0291102R,123,101,15,7,58,65,4 ème
FINISTERE,CLEDER,0290253T,23,23,0,0,14,9,4 ème
FINISTERE,CONCARNEAU,0290030A,0,0,0,0,0,0,4 ème
FINISTERE,CONCARNEAU,0290132L,71,55,16,0,30,41,4 ème
FINISTERE,CONCARNEAU,0291873D,151,151,0,0,79,72,4 ème
FINISTERE,DAOULAS,0290033D,138,133,0,5,65,73,4 ème
FINISTERE,DOUARNENEZ,0291591X,136,121,11,4,77,59,4 ème
FINISTERE,FOUESNANT,0290262C,74,74,0,0,28,46,4 ème
FINISTERE,LANDERNEAU,0290184T,0,0,0,0,0,0,4 ème
FINISTERE,LANMEUR,0290047U,91,91,0,0,34,57,4 ème
FINISTERE,LANNILIS,0291639Z,85,85,0,0,42,43,4 ème
FINISTERE,LE RELECQ-KERHUON,0290308C,67,67,0,0,34,33,4 ème
FINISTERE,MORLAIX,0291085X,114,99,15,0,56,58,4 ème
FINISTERE,QUIMPER,0290068S,139,136,0,3,69,70,4 ème
FINISTERE,QUIMPER,0291087Z,101,82,16,3,52,49,4 ème
FINISTERE,QUIMPER,0291592Y,170,170,0,0,87,83,4 ème
FINISTERE,QUIMPER,0292204N,42,42,0,0,26,16,4 ème
FINISTERE,SAINT-POL-DE-LEON,0290207T,0,0,0,0,0,0,4 ème
FINISTERE,SAINT-RENAN,0290086L,116,116,0,0,54,62,4 ème
ILLE-ET-VILAINE,CESSON-SEVIGNE,0351906G,171,168,0,3,97,74,4 ème
ILLE-ET-VILAINE,CHATEAUBOURG,0350854N,113,109,0,4,52,61,4 ème
ILLE-ET-VILAINE,CHATEAUGIRON,0352248D,120,120,0,0,57,63,4 ème
ILLE-ET-VILAINE,DOL-DE-BRETAGNE,0350708E,174,140,30,4,79,95,4 ème
ILLE-ET-VILAINE,FOUGERES,0351997F,96,96,0,0,50,46,4 ème
ILLE-ET-VILAINE,LA GUERCHE-DE-BRETAGNE,0351799R,52,47,0,5,31,21,4 ème
ILLE-ET-VILAINE,MAEN ROCH,0350883V,109,104,0,5,52,57,4 ème
ILLE-ET-VILAINE,MONTAUBAN-DE-BRETAGNE,0350870F,82,82,0,0,38,44,4 ème
ILLE-ET-VILAINE,PACE,0352319F,257,257,0,0,120,137,4 ème
ILLE-ET-VILAINE,REDON,0351969A,135,132,0,3,68,67,4 ème
ILLE-ET-VILAINE,RENNES,0350759K,111,110,0,1,57,54,4 ème
ILLE-ET-VILAINE,RENNES,0350781J,113,111,0,2,63,50,4 ème
ILLE-ET-VILAINE,RENNES,0351878B,0,0,0,0,0,0,4 ème
ILLE-ET-VILAINE,RETIERS,0351882F,110,110,0,0,46,64,4 ème
ILLE-ET-VILAINE,VERN-SUR-SEICHE,0352541X,158,155,0,3,75,83,4 ème
ILLE-ET-VILAINE,VITRE,0350709F,0,0,0,0,0,0,4 ème
MORBIHAN,ALLAIRE,0561376S,109,109,0,0,59,50,4 ème
MORBIHAN,GOURIN,0561546B,52,38,14,0,25,27,4 ème
MORBIHAN,GUER,0560135T,66,66,0,0,42,24,4 ème
MORBIHAN,HENNEBONT,0560070X,0,0,0,0,0,0,4 ème
MORBIHAN,JOSSELIN,0560020T,62,52,10,0,30,32,4 ème
MORBIHAN,LANESTER,0560142A,98,98,0,0,51,47,4 ème
MORBIHAN,LE PALAIS,0560154N,17,17,0,0,7,10,4 ème
MORBIHAN,LORIENT,0560029C,176,176,0,0,82,94,4 ème
MORBIHAN,LORIENT,0560102G,185,168,17,0,93,92,4 ème
MORBIHAN,LORIENT,0562028A,119,110,0,9,54,65,4 ème
MORBIHAN,MAURON,0560032F,32,32,0,0,16,16,4 ème
MORBIHAN,PLOEMEUR,0560802T,115,112,0,3,60,55,4 ème
MORBIHAN,PONTIVY,0561332U,138,103,30,5,67,71,4 ème
MORBIHAN,PONTIVY,0561474Y,110,110,0,0,61,49,4 ème
MORBIHAN,PORT-LOUIS,0560042S,0,0,0,0,0,0,4 ème
MORBIHAN,QUESTEMBERT,0560044U,104,77,23,4,52,52,4 ème
MORBIHAN,RIANTEC,0561409C,138,133,0,5,65,73,4 ème
MORBIHAN,SAINT-AVE,0561840W,93,93,0,0,50,43,4 ème
MORBIHAN,SAINTE-ANNE-D'AURAY,0560119A,0,0,0,0,0,0,4 ème
MORBIHAN,SAINTE-ANNE-D'AURAY,0561545A,116,112,0,4,59,57,4 ème
MORBIHAN,SARZEAU,0560173J,43,43,0,0,18,25,4 ème
MORBIHAN,SENE,0561622J,109,104,0,5,49,60,4 ème
MORBIHAN,VANNES,0560050A,161,161,0,0,69,92,4 ème
CHER,BOURGES,0180008L,0,0,0,0,0,0,4 ème
CHER,BOURGES,0180009M,0,0,0,0,0,0,4 ème
CHER,BOURGES,0180673J,145,134,9,2,77,68,4 ème
CHER,NERONDES,0180023C,48,48,0,0,19,29,4 ème
CHER,NERONDES,0180567U,26,26,0,0,21,5,4 ème
CHER,SAINT-FLORENT-SUR-CHER,0180028H,165,157,8,0,83,82,4 ème
CHER,VIERZON,0180570X,64,54,10,0,28,36,4 ème
CHER,VIERZON,0180592W,165,147,14,4,87,78,4 ème
EURE-ET-LOIR,AUNEAU-BLEURY-SAINT-SYMPHORIEN,0280671C,77,77,0,0,34,43,4 ème
EURE-ET-LOIR,BROU,0280006E,72,70,0,2,40,32,4 ème
EURE-ET-LOIR,BROU,0280674F,40,40,0,0,20,20,4 ème
EURE-ET-LOIR,CHARTRES,0280663U,177,177,0,0,83,94,4 ème
EURE-ET-LOIR,CHARTRES,0280755U,227,222,0,5,123,104,4 ème
EURE-ET-LOIR,DREUX,0280687V,0,0,0,0,0,0,4 ème
EURE-ET-LOIR,DREUX,0280716B,141,127,14,0,62,79,4 ème
EURE-ET-LOIR,DREUX,0280994D,176,173,3,0,95,81,4 ème
EURE-ET-LOIR,DREUX,0281060A,148,145,0,3,81,67,4 ème
EURE-ET-LOIR,VERNOUILLET,0280753S,147,143,0,4,68,79,4 ème
INDRE,ARGENTON-SUR-CREUSE,0360718K,129,115,13,1,61,68,4 ème
INDRE,CHABRIS,0360044C,48,48,0,0,23,25,4 ème
INDRE,CHATEAUROUX,0360011S,0,0,0,0,0,0,4 ème
INDRE,CHATEAUROUX,0360048G,121,118,0,3,47,74,4 ème
INDRE,CHATEAUROUX,0360496U,103,102,0,1,50,53,4 ème
INDRE,CHATEAUROUX,0360541T,99,81,18,0,47,52,4 ème
INDRE,CHATILLON-SUR-INDRE,0360018Z,48,48,0,0,21,27,4 ème
INDRE,DEOLS,0360658V,121,108,11,2,51,70,4 ème
INDRE,ECUEILLE,0360022D,16,16,0,0,6,10,4 ème
INDRE,ISSOUDUN,0360721N,109,93,13,3,51,58,4 ème
INDRE,LA CHATRE,0360019A,0,0,0,0,0,0,4 ème
INDRE,LE BLANC,0360510J,33,33,0,0,14,19,4 ème
INDRE-ET-LOIRE,AMBOISE,0371122U,201,179,17,5,107,94,4 ème
INDRE-ET-LOIRE,AZAY-LE-RIDEAU,0371210P,155,143,12,0,80,75,4 ème
INDRE-ET-LOIRE,CHATEAU-RENAULT,0371211R,0,0,0,0,0,0,4 ème
INDRE-ET-LOIRE,CHINON,0371208M,16,16,0,0,7,9,4 ème
INDRE-ET-LOIRE,JOUE-LES-TOURS,0370071B,94,78,16,0,38,56,4 ème
INDRE-ET-LOIRE,LANGEAIS,0370885L,185,181,0,4,95,90,4 ème
INDRE-ET-LOIRE,NEUVY-LE-ROI,0370023Z,83,83,0,0,42,41,4 ème
INDRE-ET-LOIRE,RICHELIEU,0371191U,51,51,0,0,22,29,4 ème
INDRE-ET-LOIRE,SAINT-CYR-SUR-LOIRE,0371126Y,85,81,0,4,28,57,4 ème
INDRE-ET-LOIRE,SAINT-PIERRE-DES-CORPS,0370766G,71,71,0,0,41,30,4 ème
INDRE-ET-LOIRE,TOURS,0370044X,142,139,0,3,65,77,4 ème
INDRE-ET-LOIRE,TOURS,0370730T,61,61,0,0,36,25,4 ème
INDRE-ET-LOIRE,TOURS,0370764E,99,99,0,0,45,54,4 ème
INDRE-ET-LOIRE,TOURS,0370765F,102,99,0,3,37,65,4 ème
INDRE-ET-LOIRE,TOURS,0371209N,141,136,0,5,66,75,4 ème
INDRE-ET-LOIRE,TOURS,0371330V,115,115,0,0,60,55,4 ème
INDRE-ET-LOIRE,VOUVRAY,0370746K,34,34,0,0,12,22,4 ème
LOIRET,AMILLY,0451104F,17,0,17,0,9,8,4 ème
LOIRET,ARTENAY,0450003J,117,117,0,0,62,55,4 ème
LOIRET,BAZOCHES-LES-GALLERANDES,0450004K,124,122,0,2,56,68,4 ème
LOIRET,BEAUGENCY,0450479B,37,37,0,0,16,21,4 ème
LOIRET,CHATEAUNEUF-SUR-LOIRE,0450783G,161,152,0,9,78,83,4 ème
LOIRET,CHATILLON-SUR-LOIRE,0450017Z,85,81,0,4,43,42,4 ème
LOIRET,DADONVILLE,0451787Y,130,123,6,1,68,62,4 ème
LOIRET,GIEN,0451450G,80,79,0,1,36,44,4 ème
LOIRET,LA FERTE-SAINT-AUBIN,0450023F,164,161,0,3,75,89,4 ème
LOIRET,LE MALESHERBOIS,0450787L,132,129,0,3,67,65,4 ème
LOIRET,LORRIS,0450034T,112,110,0,2,63,49,4 ème
LOIRET,MONTARGIS,0451330B,34,34,0,0,12,22,4 ème
LOIRET,NEUVILLE-AUX-BOIS,0450045E,149,135,14,0,62,87,4 ème
LOIRET,OLIVET,0451304Y,0,0,0,0,0,0,4 ème
LOIRET,ORLEANS,0450049J,0,0,0,0,0,0,4 ème
LOIRET,ORLEANS,0450053N,139,137,0,2,75,64,4 ème
LOIRET,ORLEANS,0450055R,144,124,17,3,78,66,4 ème
LOIRET,ORLEANS,0450782F,0,0,0,0,0,0,4 ème
LOIRET,ORLEANS,0450785J,172,169,0,3,85,87,4 ème
LOIRET,ORLEANS,0451329A,138,138,0,0,64,74,4 ème
LOIRET,SAINT-AY,0451719Z,118,117,0,1,59,59,4 ème
LOIRET,SAINT-BENOIT-SUR-LOIRE,0450123P,54,54,0,0,23,31,4 ème
LOIRET,SAINT-JEAN-DE-BRAYE,0450839T,127,123,0,4,49,78,4 ème
LOIRET,TRAINOU,0451443Z,151,147,0,4,83,68,4 ème
LOIRET,VILLEMANDEUR,0451665R,136,133,0,3,55,81,4 ème
LOIR-ET-CHER,BLOIS,0410621C,37,37,0,0,22,15,4 ème
LOIR-ET-CHER,BLOIS,0410678P,57,49,8,0,24,33,4 ème
LOIR-ET-CHER,LAMOTTE-BEUVRON,0410008L,100,87,12,1,47,53,4 ème
LOIR-ET-CHER,MONTOIRE-SUR-LE-LOIR,0410682U,21,21,0,0,11,10,4 ème
LOIR-ET-CHER,SAINT-AIGNAN,0410714D,131,103,24,4,56,75,4 ème
LOIR-ET-CHER,VENDOME,0410792N,123,118,0,5,62,61,4 ème
CORSE-DU-SUD,AJACCIO,6200006M,211,181,27,3,102,109,4 ème
CORSE-DU-SUD,GROSSETO-PRUGNA,6200080T,91,91,0,0,53,38,4 ème
CORSE-DU-SUD,LEVIE,6200026J,18,18,0,0,10,8,4 ème
HAUTE-CORSE,BASTIA,7200012A,74,69,0,5,35,39,4 ème
HAUTE-CORSE,BASTIA,7200612C,158,141,15,2,68,90,4 ème
HAUTE-CORSE,CALVI,7200017F,116,115,0,1,61,55,4 ème
MEURTHE-ET-MOSELLE,COLOMBEY-LES-BELLES,0540012V,125,120,0,5,68,57,4 ème
MEURTHE-ET-MOSELLE,CUSTINES,0540078S,92,92,0,0,49,43,4 ème
MEURTHE-ET-MOSELLE,GERBEVILLER,0540022F,56,56,0,0,25,31,4 ème
MEURTHE-ET-MOSELLE,LANDRES,0540086A,0,0,0,0,0,0,4 ème
MEURTHE-ET-MOSELLE,LEXY,0541579Y,164,145,16,3,71,93,4 ème
MEURTHE-ET-MOSELLE,LUNEVILLE,0541328A,144,140,0,4,75,69,4 ème
MEURTHE-ET-MOSELLE,LUNEVILLE,0541990V,69,69,0,0,42,27,4 ème
MEURTHE-ET-MOSELLE,MONT-SAINT-MARTIN,0541357G,0,0,0,0,0,0,4 ème
MEURTHE-ET-MOSELLE,NANCY,0541340N,21,21,0,0,13,8,4 ème
MEURTHE-ET-MOSELLE,NANCY,0541370W,0,0,0,0,0,0,4 ème
MEURTHE-ET-MOSELLE,NANCY,0541998D,0,0,0,0,0,0,4 ème
MEURTHE-ET-MOSELLE,NEUVES-MAISONS,0540052N,117,117,0,0,59,58,4 ème
MEURTHE-ET-MOSELLE,PONT-A-MOUSSON,0541270M,0,0,0,0,0,0,4 ème
MEURTHE-ET-MOSELLE,TOUL,0541377D,0,0,0,0,0,0,4 ème
MEURTHE-ET-MOSELLE,TOUL,0541999E,112,111,0,1,60,52,4 ème
MEURTHE-ET-MOSELLE,VANDOEUVRE-LES-NANCY,0540111C,117,112,0,5,51,66,4 ème
MEURTHE-ET-MOSELLE,VANDOEUVRE-LES-NANCY,0541515D,134,118,16,0,68,66,4 ème
MEUSE,BAR-LE-DUC,0550703R,75,70,0,5,36,39,4 ème
MEUSE,CLERMONT-EN-ARGONNE,0550007J,56,56,0,0,29,27,4 ème
MEUSE,COMMERCY,0550008K,0,0,0,0,0,0,4 ème
MEUSE,COMMERCY,0550840P,175,159,13,3,95,80,4 ème
MEUSE,COMMERCY,0550920B,27,27,0,0,16,11,4 ème
MEUSE,MONTMEDY,0550016U,51,51,0,0,18,33,4 ème
MEUSE,SAINT-MIHIEL,0550804A,102,99,0,3,48,54,4 ème
MEUSE,STENAY,0550072E,0,0,0,0,0,0,4 ème
MEUSE,THIERVILLE-SUR-MEUSE,0550759B,100,99,0,1,46,54,4 ème
MEUSE,VERDUN,0550050F,90,90,0,0,53,37,4 ème
MOSELLE,AUDUN-LE-TICHE,0572170Z,88,88,0,0,42,46,4 ème
MOSELLE,BITCHE,0573326F,0,0,0,0,0,0,4 ème
MOSELLE,DIEUZE,0570021N,0,0,0,0,0,0,4 ème
MOSELLE,FAMECK,0572075W,0,0,0,0,0,0,4 ème
MOSELLE,FAULQUEMONT,0572176F,100,90,8,2,42,58,4 ème
MOSELLE,FORBACH,0570030Y,0,0,0,0,0,0,4 ème
MOSELLE,FORBACH,0572922S,225,225,0,0,118,107,4 ème
MOSELLE,FREYMING-MERLEBACH,0570326V,137,118,14,5,63,74,4 ème
MOSELLE,GUENANGE,0573244S,176,157,9,10,91,85,4 ème
MOSELLE,HAGONDANGE,0572172B,136,136,0,0,68,68,4 ème
MOSELLE,METZ,0570069R,104,95,0,9,43,61,4 ème
MOSELLE,METZ,0572088K,126,105,14,7,59,67,4 ème
MOSELLE,METZ,0572166V,154,136,15,3,80,74,4 ème
MOSELLE,METZ,0572352X,102,102,0,0,46,56,4 ème
MOSELLE,MOULINS-LES-METZ,0572186S,76,74,0,2,41,35,4 ème
MOSELLE,OTTANGE,0572101Z,0,0,0,0,0,0,4 ème
MOSELLE,ROMBAS,0572585A,94,94,0,0,53,41,4 ème
MOSELLE,SARREGUEMINES,0572184P,128,123,0,5,55,73,4 ème
MOSELLE,SARREGUEMINES,0572587C,112,94,15,3,55,57,4 ème
MOSELLE,THIONVILLE,0570108H,0,0,0,0,0,0,4 ème
MOSELLE,THIONVILLE,0572951Y,0,0,0,0,0,0,4 ème
MOSELLE,VITRY-SUR-ORNE,0572019K,135,135,0,0,73,62,4 ème
VOSGES,CAPAVENIR VOSGES,0880064S,0,0,0,0,0,0,4 ème
VOSGES,CONTREXEVILLE,0881102V,91,80,6,5,48,43,4 ème
VOSGES,DOMPAIRE,0880017R,107,107,0,0,51,56,4 ème
VOSGES,GERARDMER,0880031F,0,0,0,0,0,0,4 ème
VOSGES,LA VOGE-LES-BAINS,0880002Z,25,25,0,0,15,10,4 ème
VOSGES,LE VAL-D'AJOL,0880068W,55,55,0,0,26,29,4 ème
VOSGES,REMIREMONT,0880154P,128,110,14,4,61,67,4 ème
VOSGES,SAINT-DIE-DES-VOSGES,0880152M,0,0,0,0,0,0,4 ème
ARDENNES,ASFELD,0081102E,116,116,0,0,61,55,4 ème
ARDENNES,BOGNY-SUR-MEUSE,0080105W,44,41,0,3,16,28,4 ème
ARDENNES,CHARLEVILLE-MEZIERES,0080084Y,169,168,0,1,80,89,4 ème
ARDENNES,GRANDPRE,0081096Y,35,35,0,0,18,17,4 ème
ARDENNES,RIMOGNE,0080042C,81,73,8,0,36,45,4 ème
ARDENNES,SAULT-LES-RETHEL,0080909V,89,73,13,3,40,49,4 ème
ARDENNES,SEDAN,0080910W,85,85,0,0,36,49,4 ème
AUBE,AIX-VILLEMAUR-PALIS,0100806X,99,99,0,0,56,43,4 ème
AUBE,BAR-SUR-SEINE,0100004A,0,0,0,0,0,0,4 ème
AUBE,BAR-SUR-SEINE,0100745F,41,41,0,0,20,21,4 ème
AUBE,LA CHAPELLE-SAINT-LUC,0100009F,158,158,0,0,78,80,4 ème
AUBE,MARIGNY-LE-CHATEL,0100011H,77,77,0,0,31,46,4 ème
AUBE,MERY-SUR-SEINE,0100785Z,121,121,0,0,55,66,4 ème
AUBE,SAINT-ANDRE-LES-VERGERS,0100019S,132,120,9,3,53,79,4 ème
AUBE,TROYES,0100031E,139,138,0,1,68,71,4 ème
AUBE,TROYES,0100057H,74,74,0,0,27,47,4 ème
AUBE,TROYES,0100058J,53,51,0,2,19,34,4 ème
AUBE,TROYES,0100947A,110,110,0,0,51,59,4 ème
AUBE,TROYES,0101015Z,11,11,0,0,4,7,4 ème
HAUTE-MARNE,CHAUMONT,0520008B,0,0,0,0,0,0,4 ème
HAUTE-MARNE,CHAUMONT,0520039K,101,77,24,0,49,52,4 ème
HAUTE-MARNE,CHEVILLON,0520842H,71,71,0,0,37,34,4 ème
HAUTE-MARNE,JOINVILLE,0520822L,76,72,0,4,41,35,4 ème
HAUTE-MARNE,SAINT-DIZIER,0520050X,102,102,0,0,46,56,4 ème
HAUTE-MARNE,SAINT-DIZIER,0520051Y,101,98,0,3,45,56,4 ème
MARNE,BAZANCOURT,0511326P,138,129,9,0,61,77,4 ème
MARNE,CHALONS-EN-CHAMPAGNE,0510011K,149,145,0,4,83,66,4 ème
MARNE,CHALONS-EN-CHAMPAGNE,0511083A,100,98,0,2,45,55,4 ème
MARNE,CHALONS-EN-CHAMPAGNE,0511951U,0,0,0,0,0,0,4 ème
MARNE,DORMANS,0511258R,116,99,12,5,55,61,4 ème
MARNE,ESTERNAY,0511567B,49,49,0,0,27,22,4 ème
MARNE,MONTMIRAIL,0510026B,68,66,0,2,32,36,4 ème
MARNE,MONTMORT-LUCY,0510027C,40,40,0,0,21,19,4 ème
MARNE,REIMS,0510036M,0,0,0,0,0,0,4 ème
MARNE,REIMS,0511084B,175,170,0,5,91,84,4 ème
MARNE,REIMS,0511153B,0,0,0,0,0,0,4 ème
MARNE,REIMS,0511251H,124,111,13,0,64,60,4 ème
MARNE,REIMS,0511254L,167,164,0,3,50,117,4 ème
MARNE,RILLY-LA-MONTAGNE,0510048A,70,70,0,0,27,43,4 ème
MARNE,VITRY-LE-FRANCOIS,0510062R,0,0,0,0,0,0,4 ème
BAS-RHIN,BISCHHEIM,0670004R,157,135,12,10,75,82,4 ème
BAS-RHIN,BISCHWILLER,0670006T,0,0,0,0,0,0,4 ème
BAS-RHIN,ESCHAU,0671687V,184,182,0,2,86,98,4 ème
BAS-RHIN,GEISPOLSHEIM,0671824U,132,131,0,1,53,79,4 ème
BAS-RHIN,HAGUENAU,0671603D,149,149,0,0,77,72,4 ème
BAS-RHIN,HAGUENAU,0671734W,164,143,15,6,83,81,4 ème
BAS-RHIN,HOCHFELDEN,0671961T,181,174,0,7,77,104,4 ème
BAS-RHIN,ILLKIRCH-GRAFFENSTADEN,0671455T,16,0,16,0,8,8,4 ème
BAS-RHIN,ILLKIRCH-GRAFFENSTADEN,0671956M,109,104,0,5,49,60,4 ème
BAS-RHIN,ILLKIRCH-GRAFFENSTADEN,0672198A,0,0,0,0,0,0,4 ème
BAS-RHIN,LA BROQUE,0671697F,105,89,15,1,52,53,4 ème
BAS-RHIN,MARLENHEIM,0671989Y,146,146,0,0,67,79,4 ème
BAS-RHIN,MOLSHEIM,0670043H,0,0,0,0,0,0,4 ème
BAS-RHIN,MOLSHEIM,0672615D,0,0,0,0,0,0,4 ème
BAS-RHIN,RHINAU,0671963V,57,57,0,0,29,28,4 ème
BAS-RHIN,SOUFFLENHEIM,0670076U,156,153,0,3,63,93,4 ème
BAS-RHIN,SOULTZ-SOUS-FORETS,0671827X,172,171,0,1,86,86,4 ème
BAS-RHIN,STRASBOURG,0670133F,210,207,0,3,122,88,4 ème
BAS-RHIN,STRASBOURG,0671593T,181,178,0,3,91,90,4 ème
BAS-RHIN,STRASBOURG,0671607H,160,156,0,4,62,98,4 ème
BAS-RHIN,STRASBOURG,0671742E,174,151,19,4,75,99,4 ème
BAS-RHIN,STRASBOURG,0672899M,96,96,0,0,50,46,4 ème
BAS-RHIN,WALBOURG,0672302N,109,109,0,0,41,68,4 ème
BAS-RHIN,WASSELONNE,0671740C,127,125,0,2,68,59,4 ème
BAS-RHIN,WINGEN-SUR-MODER,0671739B,60,60,0,0,32,28,4 ème
HAUT-RHIN,BLOTZHEIM,0680131Y,119,119,0,0,61,58,4 ème
HAUT-RHIN,BRUNSTATT-DIDENHEIM,0681957H,143,138,0,5,69,74,4 ème
HAUT-RHIN,COLMAR,0680133A,150,150,0,0,80,70,4 ème
HAUT-RHIN,HIRSINGUE,0680019B,146,143,0,3,62,84,4 ème
HAUT-RHIN,ILLZACH,0680021D,116,116,0,0,44,72,4 ème
HAUT-RHIN,ISSENHEIM,0680144M,231,231,0,0,117,114,4 ème
HAUT-RHIN,LUTTERBACH,0681370V,153,133,18,2,73,80,4 ème
HAUT-RHIN,MULHOUSE,0680110A,149,119,24,6,77,72,4 ème
HAUT-RHIN,MULHOUSE,0681395X,191,163,28,0,99,92,4 ème
HAUT-RHIN,ORBEY,0681448E,75,75,0,0,33,42,4 ème
HAUT-RHIN,SAINT-LOUIS,0681747E,162,160,0,2,75,87,4 ème
HAUT-RHIN,SEPPOIS-LE-BAS,0680071H,73,73,0,0,42,31,4 ème
HAUT-RHIN,THANN,0680074L,0,0,0,0,0,0,4 ème
HAUT-RHIN,THANN,0681541F,77,74,0,3,33,44,4 ème
HAUT-RHIN,WITTELSHEIM,0680079S,108,103,0,5,53,55,4 ème
HAUT-RHIN,WITTENHEIM,0681126E,120,100,18,2,61,59,4 ème
HAUT-RHIN,WITTENHEIM,0681930D,137,137,0,0,70,67,4 ème
GUADELOUPE,GOURBEYRE,9710034K,53,52,0,1,31,22,4 ème
GUADELOUPE,GOURBEYRE,9710067W,0,0,0,0,0,0,4 ème
GUADELOUPE,GRAND-BOURG,9710926E,73,73,0,0,35,38,4 ème
GUADELOUPE,LE GOSIER,9711066G,0,0,0,0,0,0,4 ème
GUADELOUPE,LE MOULE,9710052E,0,0,0,0,0,0,4 ème
GUADELOUPE,LES ABYMES,9711205H,34,34,0,0,8,26,4 ème
GUADELOUPE,POINTE-A-PITRE,9710072B,47,45,0,2,25,22,4 ème
GUADELOUPE,SAINTE-ANNE,9710021W,212,193,16,3,99,113,4 ème
GUADELOUPE,SAINT-FRANCOIS,9710030F,155,155,0,0,71,84,4 ème
GUADELOUPE,SAINT-MARTIN,9710981P,0,0,0,0,0,0,4 ème
GUADELOUPE,SAINT-MARTIN,9711023K,140,136,0,4,64,76,4 ème
GUYANE,KOUROU,9730125Y,200,159,36,5,98,102,4 ème
GUYANE,KOUROU,9730237V,130,130,0,0,74,56,4 ème
GUYANE,MANA,9730192W,187,163,20,4,74,113,4 ème
GUYANE,REMIRE-MONTJOLY,9730334A,102,102,0,0,46,56,4 ème
GUYANE,SAINT-LAURENT-DU-MARONI,9730394R,243,235,0,8,112,131,4 ème
AISNE,BEAUREVOIR,0020004U,74,74,0,0,33,41,4 ème
AISNE,BRAINE,0020009Z,129,119,0,10,67,62,4 ème
AISNE,CHATEAU-THIERRY,0020468Y,68,62,0,6,31,37,4 ème
AISNE,CHATEAU-THIERRY,0021826Z,209,188,16,5,107,102,4 ème
AISNE,CHAUNY,0021493M,133,107,24,2,63,70,4 ème
AISNE,CUFFIES,0021491K,99,94,0,5,47,52,4 ème
AISNE,FERE-EN-TARDENOIS,0020024R,142,132,8,2,68,74,4 ème
AISNE,GUISE,0020483P,28,28,0,0,14,14,4 ème
AISNE,LA CAPELLE,0020479K,19,19,0,0,8,11,4 ème
AISNE,LAON,0020078Z,0,0,0,0,0,0,4 ème
AISNE,MOY-DE-L'AISNE,0020037E,98,98,0,0,44,54,4 ème
AISNE,NEUILLY-SAINT-FRONT,0020038F,98,98,0,0,49,49,4 ème
AISNE,SAINT-QUENTIN,0020080B,123,119,0,4,56,67,4 ème
AISNE,SAINT-QUENTIN,0021478W,12,0,12,0,10,2,4 ème
AISNE,VILLENEUVE-SAINT-GERMAIN,0021490J,102,80,22,0,45,57,4 ème
OISE,BEAUVAIS,0601140N,202,202,0,0,100,102,4 ème
OISE,BEAUVAIS,0601188R,178,159,16,3,80,98,4 ème
OISE,BEAUVAIS,0601487R,137,118,16,3,67,70,4 ème
OISE,BETZ,0601447X,128,128,0,0,59,69,4 ème
OISE,CHANTILLY,0601606V,173,171,0,2,89,84,4 ème
OISE,CLERMONT,0601471Y,192,187,0,5,95,97,4 ème
OISE,CREIL,0601449Z,175,160,13,2,84,91,4 ème
OISE,CREPY-EN-VALOIS,0601363F,0,0,0,0,0,0,4 ème
OISE,CREVECOEUR-LE-GRAND,0600070A,14,0,14,0,5,9,4 ème
OISE,CUISE-LA-MOTTE,0601146V,17,16,0,1,11,6,4 ème
OISE,GOUVIEUX,0601192V,125,108,14,3,60,65,4 ème
OISE,MERU,0601191U,128,110,13,5,65,63,4 ème
OISE,MONTATAIRE,0601178E,190,173,8,9,95,95,4 ème
OISE,MORTEFONTAINE,0601145U,228,228,0,0,109,119,4 ème
OISE,NANTEUIL-LE-HAUDOUIN,0601408E,205,201,0,4,103,102,4 ème
OISE,NOGENT-SUR-OISE,0600062S,0,0,0,0,0,0,4 ème
OISE,NOYON,0601297J,153,123,26,4,65,88,4 ème
OISE,RIBECOURT-DRESLINCOURT,0600046Z,93,90,0,3,47,46,4 ème
OISE,SAINT-MAXIMIN,0600048B,0,0,0,0,0,0,4 ème
OISE,VILLERS-SAINT-PAUL,0601821D,137,135,0,2,63,74,4 ème
SOMME,ABBEVILLE,0800002T,168,145,16,7,90,78,4 ème
SOMME,AILLY-SUR-NOYE,0800004V,84,83,0,1,37,47,4 ème
SOMME,AMIENS,0801212H,129,129,0,0,60,69,4 ème
SOMME,AMIENS,0801220S,112,112,0,0,45,67,4 ème
SOMME,AMIENS,0802214X,14,14,0,0,7,7,4 ème
SOMME,CORBIE,0801511H,88,84,0,4,51,37,4 ème
SOMME,DOULLENS,0800029X,164,148,15,1,75,89,4 ème
SOMME,DOULLENS,0801900F,0,0,0,0,0,0,4 ème
SOMME,FRIVILLE-ESCARBOTIN,0800033B,129,126,0,3,62,67,4 ème
SOMME,GAMACHES,0800034C,122,104,11,7,52,70,4 ème
SOMME,HAM,0801224W,81,81,0,0,49,32,4 ème
SOMME,MERS-LES-BAINS,0800039H,35,35,0,0,17,18,4 ème
SOMME,NESLE,0801369D,63,63,0,0,34,29,4 ème
SOMME,NOUVION,0801488H,90,90,0,0,46,44,4 ème
SOMME,POIX-DE-PICARDIE,0801326G,88,88,0,0,48,40,4 ème
SOMME,ROISEL,0800050V,68,68,0,0,28,40,4 ème
SOMME,ROYE,0801341Y,124,103,17,4,61,63,4 ème
NORD,ANNOEULLIN,0593234V,152,152,0,0,70,82,4 ème
NORD,ARMENTIERES,0593060F,0,0,0,0,0,0,4 ème
NORD,ARMENTIERES,0595382E,167,167,0,0,96,71,4 ème
NORD,AULNOYE-AYMERIES,0590015W,0,0,0,0,0,0,4 ème
NORD,BONDUES,0595385H,227,227,0,0,108,119,4 ème
NORD,BOURBOURG,0592955S,151,151,0,0,82,69,4 ème
NORD,CONDE-SUR-L'ESCAUT,0590050J,129,108,18,3,61,68,4 ème
NORD,CONDE-SUR-L'ESCAUT,0596854E,0,0,0,0,0,0,4 ème
NORD,COUDEKERQUE-BRANCHE,0593182N,48,48,0,0,23,25,4 ème
NORD,COUDEKERQUE-BRANCHE,0593494C,117,96,16,5,57,60,4 ème
NORD,DENAIN,0590264S,0,0,0,0,0,0,4 ème
NORD,DOUAI,0595171A,171,168,0,3,90,81,4 ème
NORD,DOUAI,0595894L,0,0,0,0,0,0,4 ème
NORD,DUNKERQUE,0590200X,83,83,0,0,38,45,4 ème
NORD,DUNKERQUE,0593143W,99,82,0,17,49,50,4 ème
NORD,DUNKERQUE,0596716E,95,90,0,5,40,55,4 ème
NORD,ESTAIRES,0595757M,119,119,0,0,53,66,4 ème
NORD,FOURMIES,0594879H,75,75,0,0,35,40,4 ème
NORD,FOURMIES,0595390N,51,50,0,1,27,24,4 ème
NORD,GRANDE-SYNTHE,0594398K,95,83,9,3,54,41,4 ème
NORD,GRANDE-SYNTHE,0595388L,61,61,0,0,33,28,4 ème
NORD,GRAND-FORT-PHILIPPE,0595712N,43,43,0,0,20,23,4 ème
NORD,HAUTMONT,0592634T,143,143,0,0,55,88,4 ème
NORD,HAUTMONT,0594309N,105,92,13,0,54,51,4 ème
NORD,HAZEBROUCK,0595391P,121,119,0,2,63,58,4 ème
NORD,LA MADELEINE,0592896C,148,148,0,0,76,72,4 ème
NORD,LAMBRES-LEZ-DOUAI,0594298B,129,126,0,3,59,70,4 ème
NORD,LANDRECIES,0595178H,126,120,6,0,62,64,4 ème
NORD,LE CATEAU-CAMBRESIS,0595337F,177,164,11,2,89,88,4 ème
NORD,LE QUESNOY,0595172B,244,235,9,0,93,151,4 ème
NORD,LESQUIN,0593991T,113,113,0,0,53,60,4 ème
NORD,LILLE,0593131H,109,109,0,0,54,55,4 ème
NORD,LILLE,0593179K,123,121,0,2,52,71,4 ème
NORD,LILLE,0593235W,119,104,15,0,61,58,4 ème
NORD,LOON-PLAGE,0595596M,72,69,0,3,40,32,4 ème
NORD,MERVILLE,0592899F,143,140,0,3,56,87,4 ème
NORD,MONS-EN-BAROEUL,0590155Y,106,102,0,4,55,51,4 ème
NORD,ORCHIES,0592900G,141,138,0,3,63,78,4 ème
NORD,ORCHIES,0593040J,0,0,0,0,0,0,4 ème
NORD,PECQUENCOURT,0596529B,111,108,0,3,46,65,4 ème
NORD,PONT-A-MARCQ,0594866U,114,114,0,0,59,55,4 ème
NORD,ROUBAIX,0590190L,134,134,0,0,78,56,4 ème
NORD,ROUBAIX,0592917A,164,164,0,0,78,86,4 ème
NORD,SAINT-ANDRE-LEZ-LILLE,0592832H,0,0,0,0,0,0,4 ème
NORD,SAINT-ANDRE-LEZ-LILLE,0593228N,116,108,0,8,54,62,4 ème
NORD,SAINT-SAULVE,0594644C,87,85,0,2,41,46,4 ème
NORD,SAINT-SAULVE,0595402B,209,205,0,4,120,89,4 ème
NORD,SEBOURG,0593144X,104,104,0,0,55,49,4 ème
NORD,SOLRE-LE-CHATEAU,0590206D,77,77,0,0,42,35,4 ème
NORD,THIANT,0594645D,120,114,6,0,63,57,4 ème
NORD,TOURCOING,0593217B,331,321,10,0,174,157,4 ème
NORD,VALENCIENNES,0593154H,96,96,0,0,52,44,4 ème
NORD,VALENCIENNES,0593680E,75,66,9,0,36,39,4 ème
NORD,VILLENEUVE-D'ASCQ,0593196D,163,153,9,1,94,69,4 ème
NORD,VILLENEUVE-D'ASCQ,0593198F,106,106,0,0,33,73,4 ème
NORD,VILLENEUVE-D'ASCQ,0594291U,148,148,0,0,65,83,4 ème
NORD,VILLENEUVE-D'ASCQ,0594525Y,79,78,0,1,42,37,4 ème
NORD,WAZIERS,0590238N,86,86,0,0,43,43,4 ème
NORD,WAZIERS,0593495D,0,0,0,0,0,0,4 ème
PAS-DE-CALAIS,ANGRES,0622579S,127,127,0,0,69,58,4 ème
PAS-DE-CALAIS,ANZIN-SAINT-AUBIN,0622125Y,293,291,0,2,144,149,4 ème
PAS-DE-CALAIS,ARRAS,0622196A,0,0,0,0,0,0,4 ème
PAS-DE-CALAIS,BERTINCOURT,0620039F,72,72,0,0,34,38,4 ème
PAS-DE-CALAIS,CALAIS,0620189U,0,0,0,0,0,0,4 ème
PAS-DE-CALAIS,CALAIS,0622109F,106,106,0,0,41,65,4 ème
PAS-DE-CALAIS,CALAIS,0622431F,75,72,0,3,35,40,4 ème
PAS-DE-CALAIS,CALAIS,0622432G,119,119,0,0,64,55,4 ème
PAS-DE-CALAIS,CALAIS,0622576N,105,84,17,4,52,53,4 ème
PAS-DE-CALAIS,CALAIS,0623315S,150,146,0,4,74,76,4 ème
PAS-DE-CALAIS,CARVIN,0623919Y,116,113,0,3,49,67,4 ème
PAS-DE-CALAIS,DESVRES,0623023Z,159,133,21,5,78,81,4 ème
PAS-DE-CALAIS,DOUVRIN,0622867E,170,169,0,1,80,90,4 ème
PAS-DE-CALAIS,FOUQUIERES-LES-LENS,0622098U,86,86,0,0,49,37,4 ème
PAS-DE-CALAIS,FRUGES,0622112J,51,49,0,2,25,26,4 ème
PAS-DE-CALAIS,FRUGES,0622195Z,0,0,0,0,0,0,4 ème
PAS-DE-CALAIS,HENIN-BEAUMONT,0620096T,97,79,18,0,40,57,4 ème
PAS-DE-CALAIS,HESDIN,0622139N,26,26,0,0,15,11,4 ème
PAS-DE-CALAIS,HUCQUELIERS,0620104B,118,115,0,3,66,52,4 ème
PAS-DE-CALAIS,LAVENTIE,0622140P,67,67,0,0,31,36,4 ème
PAS-DE-CALAIS,LENS,0622868F,109,93,13,3,52,57,4 ème
PAS-DE-CALAIS,LE TOUQUET-PARIS-PLAGE,0622806N,96,94,0,2,39,57,4 ème
PAS-DE-CALAIS,LIBERCOURT,0622239X,77,77,0,0,33,44,4 ème
PAS-DE-CALAIS,LICQUES,0620194Z,111,111,0,0,63,48,4 ème
PAS-DE-CALAIS,LIEVIN,0622302R,13,0,13,0,4,9,4 ème
PAS-DE-CALAIS,LILLERS,0620121V,0,0,0,0,0,0,4 ème
PAS-DE-CALAIS,LILLERS,0623312N,104,101,0,3,47,57,4 ème
PAS-DE-CALAIS,LONGUENESSE,0623572W,92,92,0,0,51,41,4 ème
PAS-DE-CALAIS,LOOS-EN-GOHELLE,0620123X,72,72,0,0,41,31,4 ème
PAS-DE-CALAIS,LUMBRES,0620124Y,0,0,0,0,0,0,4 ème
PAS-DE-CALAIS,LUMBRES,0622142S,69,69,0,0,32,37,4 ème
PAS-DE-CALAIS,MARQUISE,0622096S,262,249,13,0,118,144,4 ème
PAS-DE-CALAIS,MONTREUIL,0622117P,96,96,0,0,49,47,4 ème
PAS-DE-CALAIS,MONTREUIL,0622951W,164,147,13,4,62,102,4 ème
PAS-DE-CALAIS,PERNES,0620156H,87,87,0,0,51,36,4 ème
PAS-DE-CALAIS,SANGATTE,0623865P,139,139,0,0,82,57,4 ème
PAS-DE-CALAIS,WINGLES,0620258U,0,0,0,0,0,0,4 ème
PAS-DE-CALAIS,WIZERNES,0622874M,92,81,9,2,34,58,4 ème
SEINE-ET-MARNE,BOIS-LE-ROI,0770002J,153,153,0,0,75,78,4 ème
SEINE-ET-MARNE,CHAMPS-SUR-MARNE,0771511Z,134,134,0,0,71,63,4 ème
SEINE-ET-MARNE,CHELLES,0771171E,0,0,0,0,0,0,4 ème
SEINE-ET-MARNE,CHELLES,0771926A,164,164,0,0,95,69,4 ème
SEINE-ET-MARNE,CHESSY,0772651N,122,116,0,6,60,62,4 ème
SEINE-ET-MARNE,ESBLY,0771361L,199,180,16,3,92,107,4 ème
SEINE-ET-MARNE,LAGNY-SUR-MARNE,0771918S,304,304,0,0,150,154,4 ème
SEINE-ET-MARNE,LE CHATELET-EN-BRIE,0771068T,118,116,0,2,59,59,4 ème
SEINE-ET-MARNE,MAGNY-LE-HONGRE,0772713F,167,167,0,0,85,82,4 ème
SEINE-ET-MARNE,MEAUX,0771420A,153,133,16,4,85,68,4 ème
SEINE-ET-MARNE,MELUN,0771070V,64,63,0,1,42,22,4 ème
SEINE-ET-MARNE,MELUN,0771220H,92,92,0,0,55,37,4 ème
SEINE-ET-MARNE,MELUN,0771923X,194,191,0,3,96,98,4 ème
SEINE-ET-MARNE,MOISSY-CRAMAYEL,0772191N,137,137,0,0,68,69,4 ème
SEINE-ET-MARNE,MORET-LOING-ET-ORVANNE,0770038Y,167,166,0,1,78,89,4 ème
SEINE-ET-MARNE,NANGIS,0770040A,183,182,0,1,92,91,4 ème
SEINE-ET-MARNE,OTHIS,0771562E,178,178,0,0,93,85,4 ème
SEINE-ET-MARNE,OZOIR-LA-FERRIERE,0771334G,167,167,0,0,101,66,4 ème
SEINE-ET-MARNE,OZOIR-LA-FERRIERE,0772293Z,127,125,0,2,68,59,4 ème
SEINE-ET-MARNE,PROVINS,0771176K,115,100,15,0,59,56,4 ème
SEINE-ET-MARNE,SAINT-FARGEAU-PONTHIERRY,0771517F,198,198,0,0,92,106,4 ème
SEINE-ET-MARNE,SAINT-SOUPPLETS,0772483F,85,83,0,2,42,43,4 ème
SEINE-ET-MARNE,SAVIGNY-LE-TEMPLE,0772274D,148,146,0,2,67,81,4 ème
SEINE-ET-MARNE,SERRIS,0772589W,170,168,0,2,74,96,4 ème
SEINE-ET-MARNE,VAIRES-SUR-MARNE,0771177L,185,181,0,4,100,85,4 ème
SEINE-ET-MARNE,VAUX-LE-PENIL,0771178M,170,167,0,3,77,93,4 ème
SEINE-ET-MARNE,VERNEUIL-L'ETANG,0771619S,138,132,0,6,75,63,4 ème
SEINE-ET-MARNE,VOISENON,0771930E,217,217,0,0,112,105,4 ème
SEINE-ET-MARNE,VULAINES-SUR-SEINE,0772867Y,132,132,0,0,67,65,4 ème
SEINE-SAINT-DENIS,AUBERVILLIERS,0930902A,118,118,0,0,64,54,4 ème
SEINE-SAINT-DENIS,AULNAY-SOUS-BOIS,0931379U,174,159,15,0,86,88,4 ème
SEINE-SAINT-DENIS,AULNAY-SOUS-BOIS,0932310F,162,162,0,0,72,90,4 ème
SEINE-SAINT-DENIS,BAGNOLET,0931022F,141,141,0,0,71,70,4 ème
SEINE-SAINT-DENIS,BOBIGNY,0930900Y,163,160,0,3,75,88,4 ème
SEINE-SAINT-DENIS,BOBIGNY,0931194T,224,205,15,4,111,113,4 ème
SEINE-SAINT-DENIS,BONDY,0931711E,148,148,0,0,80,68,4 ème
SEINE-SAINT-DENIS,BONDY,0931860S,138,131,0,7,70,68,4 ème
SEINE-SAINT-DENIS,CLICHY-SOUS-BOIS,0930616P,158,155,0,3,80,78,4 ème
SEINE-SAINT-DENIS,CLICHY-SOUS-BOIS,0932366S,155,155,0,0,81,74,4 ème
SEINE-SAINT-DENIS,DRANCY,0931199Y,169,165,0,4,83,86,4 ème
SEINE-SAINT-DENIS,GAGNY,0931233K,0,0,0,0,0,0,4 ème
SEINE-SAINT-DENIS,GAGNY,0931855L,44,44,0,0,0,44,4 ème
SEINE-SAINT-DENIS,GAGNY,0932311G,170,151,15,4,97,73,4 ème
SEINE-SAINT-DENIS,LA COURNEUVE,0930128J,0,0,0,0,0,0,4 ème
SEINE-SAINT-DENIS,LE BLANC-MESNIL,0932580Z,140,135,0,5,54,86,4 ème
SEINE-SAINT-DENIS,LE PRE-SAINT-GERVAIS,0930917S,89,89,0,0,38,51,4 ème
SEINE-SAINT-DENIS,LE RAINCY,0930970Z,20,20,0,0,7,13,4 ème
SEINE-SAINT-DENIS,LE RAINCY,0932772H,38,38,0,0,14,24,4 ème
SEINE-SAINT-DENIS,LES LILAS,0931439J,181,181,0,0,97,84,4 ème
SEINE-SAINT-DENIS,MONTFERMEIL,0931546A,167,163,0,4,79,88,4 ème
SEINE-SAINT-DENIS,MONTREUIL,0931211L,129,129,0,0,56,73,4 ème
SEINE-SAINT-DENIS,MONTREUIL,0931212M,102,90,12,0,53,49,4 ème
SEINE-SAINT-DENIS,MONTREUIL,0931845A,120,120,0,0,59,61,4 ème
SEINE-SAINT-DENIS,NEUILLY-SUR-MARNE,0931228E,135,133,0,2,52,83,4 ème
SEINE-SAINT-DENIS,NOISY-LE-GRAND,0930883E,189,184,0,5,93,96,4 ème
SEINE-SAINT-DENIS,NOISY-LE-GRAND,0931614Z,175,158,17,0,86,89,4 ème
SEINE-SAINT-DENIS,NOISY-LE-SEC,0931610V,173,151,13,9,86,87,4 ème
SEINE-SAINT-DENIS,PANTIN,0931713G,172,157,15,0,90,82,4 ème
SEINE-SAINT-DENIS,PIERREFITTE-SUR-SEINE,0931223Z,195,178,12,5,99,96,4 ème
SEINE-SAINT-DENIS,SAINT-DENIS,0930959M,244,243,0,1,126,118,4 ème
SEINE-SAINT-DENIS,SAINT-DENIS,0931231H,134,134,0,0,67,67,4 ème
SEINE-SAINT-DENIS,SAINT-DENIS,0932273R,126,124,0,2,61,65,4 ème
SEINE-SAINT-DENIS,SAINT-DENIS,0932586F,64,64,0,0,25,39,4 ème
SEINE-SAINT-DENIS,SAINT-DENIS,0932773J,29,29,0,0,17,12,4 ème
SEINE-SAINT-DENIS,SEVRAN,0931979W,146,143,0,3,70,76,4 ème
SEINE-SAINT-DENIS,STAINS,0931225B,136,134,0,2,60,76,4 ème
SEINE-SAINT-DENIS,VILLEPINTE,0931607S,164,143,17,4,77,87,4 ème
VAL-DE-MARNE,ALFORTVILLE,0940126B,0,0,0,0,0,0,4 ème
VAL-DE-MARNE,BOISSY-SAINT-LEGER,0940892J,75,75,0,0,37,38,4 ème
VAL-DE-MARNE,BONNEUIL-SUR-MARNE,0941095E,142,123,16,3,64,78,4 ème
VAL-DE-MARNE,CHAMPIGNY-SUR-MARNE,0941092B,96,96,0,0,45,51,4 ème
VAL-DE-MARNE,CHAMPIGNY-SUR-MARNE,0941299B,200,188,12,0,92,108,4 ème
VAL-DE-MARNE,CHAMPIGNY-SUR-MARNE,0941431V,138,138,0,0,74,64,4 ème
VAL-DE-MARNE,CHARENTON-LE-PONT,0940808T,186,186,0,0,92,94,4 ème
VAL-DE-MARNE,CHENNEVIERES-SUR-MARNE,0940787V,73,69,0,4,33,40,4 ème
VAL-DE-MARNE,CHOISY-LE-ROI,0941229A,184,170,14,0,94,90,4 ème
VAL-DE-MARNE,CRETEIL,0940003T,73,73,0,0,38,35,4 ème
VAL-DE-MARNE,CRETEIL,0941018W,0,0,0,0,0,0,4 ème
VAL-DE-MARNE,CRETEIL,0941351H,152,139,0,13,84,68,4 ème
VAL-DE-MARNE,FONTENAY-SOUS-BOIS,0940516A,213,213,0,0,77,136,4 ème
VAL-DE-MARNE,FONTENAY-SOUS-BOIS,0941296Y,161,148,13,0,84,77,4 ème
VAL-DE-MARNE,GENTILLY,0941099J,119,119,0,0,53,66,4 ème
VAL-DE-MARNE,LE KREMLIN-BICETRE,0940022N,77,77,0,0,37,40,4 ème
VAL-DE-MARNE,LE PERREUX-SUR-MARNE,0940789X,156,156,0,0,75,81,4 ème
VAL-DE-MARNE,MAISONS-ALFORT,0941046B,170,170,0,0,84,86,4 ème
VAL-DE-MARNE,ORLY,0941044Z,132,132,0,0,68,64,4 ème
VAL-DE-MARNE,SAINT-MANDE,0940790Y,137,134,0,3,69,68,4 ème
VAL-DE-MARNE,SAINT-MANDE,0941715D,135,131,0,4,62,73,4 ème
VAL-DE-MARNE,SAINT-MAUR-DES-FOSSES,0940585A,0,0,0,0,0,0,4 ème
VAL-DE-MARNE,SAINT-MAUR-DES-FOSSES,0940811W,86,86,0,0,42,44,4 ème
VAL-DE-MARNE,SAINT-MAURICE,0941597A,79,79,0,0,44,35,4 ème
VAL-DE-MARNE,SUCY-EN-BRIE,0940748C,185,181,0,4,87,98,4 ème
VAL-DE-MARNE,VILLECRESNES,0941412Z,170,170,0,0,80,90,4 ème
VAL-DE-MARNE,VILLEJUIF,0941035P,117,101,16,0,53,64,4 ème
VAL-DE-MARNE,VILLENEUVE-LE-ROI,0941103N,120,120,0,0,61,59,4 ème
VAL-DE-MARNE,VILLENEUVE-LE-ROI,0941234F,90,90,0,0,39,51,4 ème
VAL-DE-MARNE,VILLIERS-SUR-MARNE,0940625U,108,106,0,2,49,59,4 ème
VAL-DE-MARNE,VINCENNES,0942188T,141,137,0,4,63,78,4 ème
VAL-DE-MARNE,VITRY-SUR-SEINE,0941034N,118,118,0,0,63,55,4 ème
VAL-DE-MARNE,VITRY-SUR-SEINE,0942434K,102,100,0,2,41,61,4 ème
PARIS,PARIS,0752251P,109,105,0,4,67,42,4 ème
PARIS,PARIS,0753047E,100,96,0,4,59,41,4 ème
PARIS,PARIS,0754506R,144,144,0,0,68,76,4 ème
PARIS,PARIS,0750676C,0,0,0,0,0,0,4 ème
PARIS,PARIS,0752895P,115,115,0,0,115,0,4 ème
PARIS,PARIS,0752954D,1,1,0,0,0,1,4 ème
PARIS,PARIS,0753978S,61,61,0,0,33,28,4 ème
PARIS,PARIS,0754528P,126,108,15,3,58,68,4 ème
PARIS,PARIS,0750444A,143,142,0,1,73,70,4 ème
PARIS,PARIS,0750610F,105,102,0,3,49,56,4 ème
PARIS,PARIS,0750783U,0,0,0,0,0,0,4 ème
PARIS,PARIS,0752538B,114,114,0,0,41,73,4 ème
PARIS,PARIS,0752540D,107,107,0,0,53,54,4 ème
PARIS,PARIS,0752896R,88,88,0,0,48,40,4 ème
PARIS,PARIS,0752957G,136,133,0,3,62,74,4 ème
PARIS,PARIS,0753937X,97,94,0,3,44,53,4 ème
PARIS,PARIS,0750611G,140,138,0,2,64,76,4 ème
PARIS,PARIS,0751705W,139,134,0,5,68,71,4 ème
PARIS,PARIS,0753908R,146,146,0,0,79,67,4 ème
PARIS,PARIS,0754253R,81,81,0,0,39,42,4 ème
PARIS,PARIS,0752843H,177,177,0,0,89,88,4 ème
PARIS,PARIS,0754305X,161,160,0,1,74,87,4 ème
PARIS,PARIS,0752548M,365,360,0,5,177,188,4 ème
PARIS,PARIS,0752549N,185,185,0,0,91,94,4 ème
PARIS,PARIS,0753996L,78,78,0,0,47,31,4 ème
PARIS,PARIS,0752107H,178,175,0,3,86,92,4 ème
PARIS,PARIS,0752387M,126,126,0,0,53,73,4 ème
PARIS,PARIS,0752552S,154,151,0,3,70,84,4 ème
PARIS,PARIS,0752821J,155,155,0,0,89,66,4 ème
PARIS,PARIS,0752898T,133,132,0,1,54,79,4 ème
PARIS,PARIS,0752958H,140,138,0,2,69,71,4 ème
PARIS,PARIS,0750182R,108,105,0,3,54,54,4 ème
PARIS,PARIS,0750800M,0,0,0,0,0,0,4 ème
PARIS,PARIS,0751793S,90,88,0,2,53,37,4 ème
PARIS,PARIS,0752108J,118,115,0,3,63,55,4 ème
PARIS,PARIS,0754706H,101,97,0,4,63,38,4 ème
PARIS,PARIS,0750360J,107,107,0,0,46,61,4 ème
PARIS,PARIS,0752555V,84,82,0,2,32,52,4 ème
PARIS,PARIS,0752606A,94,93,0,1,51,43,4 ème
PARIS,PARIS,0752556W,109,103,0,6,52,57,4 ème
PARIS,PARIS,0754006X,91,91,0,0,49,42,4 ème
PARIS,PARIS,0755241P,91,89,0,2,42,49,4 ème
PARIS,PARIS,0752248L,80,80,0,0,47,33,4 ème
PARIS,PARIS,0750387N,88,88,0,0,36,52,4 ème
PARIS,PARIS,0750651A,0,0,0,0,0,0,4 ème
PARIS,PARIS,0752902X,261,255,0,6,141,120,4 ème
PARIS,PARIS,0752526N,151,151,0,0,63,88,4 ème
PARIS,PARIS,0752900V,317,305,9,3,137,180,4 ème
PARIS,PARIS,0752924W,80,80,0,0,28,52,4 ème
PARIS,PARIS,0752249M,178,176,0,2,84,94,4 ème
PARIS,PARIS,0752530T,175,175,0,0,83,92,4 ème
ESSONNE,ATHIS-MONS,0911745C,299,289,9,1,150,149,4 ème
ESSONNE,BRUNOY,0910714G,125,125,0,0,69,56,4 ème
ESSONNE,CERNY,0910630R,0,0,0,0,0,0,4 ème
ESSONNE,CHAMPCUEIL,0912233H,180,177,0,3,92,88,4 ème
ESSONNE,CORBEIL-ESSONNES,0911443Z,177,164,13,0,81,96,4 ème
ESSONNE,ETAMPES,0911747E,132,132,0,0,78,54,4 ème
ESSONNE,EVRY-COURCOURONNES,0911254U,0,0,0,0,0,0,4 ème
ESSONNE,EVRY-COURCOURONNES,0912173T,127,123,0,4,55,72,4 ème
ESSONNE,LA NORVILLE,0911255V,179,158,16,5,76,103,4 ème
ESSONNE,LES ULIS,0911127F,165,149,16,0,85,80,4 ème
ESSONNE,LISSES,0911754M,120,116,0,4,51,69,4 ème
ESSONNE,MENNECY,0911185U,214,199,12,3,97,117,4 ème
ESSONNE,MONTGERON,0911353B,24,24,0,0,8,16,4 ème
ESSONNE,NOZAY,0912174U,130,126,0,4,65,65,4 ème
ESSONNE,OLLAINVILLE,0912175V,155,153,0,2,77,78,4 ème
ESSONNE,PALAISEAU,0910046F,108,104,0,4,52,56,4 ème
ESSONNE,PALAISEAU,0910820X,136,136,0,0,69,67,4 ème
ESSONNE,SAINTE-GENEVIEVE-DES-BOIS,0910678T,140,140,0,0,69,71,4 ème
ESSONNE,SAINT-MICHEL-SUR-ORGE,0911257X,194,176,16,2,95,99,4 ème
ESSONNE,SAINT-MICHEL-SUR-ORGE,0911946W,0,0,0,0,0,0,4 ème
ESSONNE,SAVIGNY-SUR-ORGE,0911038J,115,115,0,0,51,64,4 ème
ESSONNE,VILLEBON-SUR-YVETTE,0911335G,177,161,16,0,89,88,4 ème
ESSONNE,VILLEMOISSON-SUR-ORGE,0911145A,172,170,0,2,75,97,4 ème
ESSONNE,VIRY-CHATILLON,0910971L,170,151,15,4,78,92,4 ème
ESSONNE,VIRY-CHATILLON,0911752K,221,221,0,0,106,115,4 ème
ESSONNE,YERRES,0910062Y,182,182,0,0,94,88,4 ème
ESSONNE,YERRES,0912000E,41,40,0,1,41,0,4 ème
HAUTS-DE-SEINE,ANTONY,0921507N,150,150,0,0,70,80,4 ème
HAUTS-DE-SEINE,ASNIERES-SUR-SEINE,0921545E,149,131,13,5,60,89,4 ème
HAUTS-DE-SEINE,ASNIERES-SUR-SEINE,0921902T,201,201,0,0,101,100,4 ème
HAUTS-DE-SEINE,BAGNEUX,0920680P,0,0,0,0,0,0,4 ème
HAUTS-DE-SEINE,BOIS-COLOMBES,0921779J,152,147,0,5,78,74,4 ème
HAUTS-DE-SEINE,BOULOGNE-BILLANCOURT,0921237V,107,105,0,2,39,68,4 ème
HAUTS-DE-SEINE,CHATENAY-MALABRY,0921906X,210,210,0,0,95,115,4 ème
HAUTS-DE-SEINE,CLAMART,0920998K,93,93,0,0,46,47,4 ème
HAUTS-DE-SEINE,CLICHY,0921623P,138,136,0,2,65,73,4 ème
HAUTS-DE-SEINE,COLOMBES,0921229L,0,0,0,0,0,0,4 ème
HAUTS-DE-SEINE,COURBEVOIE,0921550K,118,115,0,3,48,70,4 ème
HAUTS-DE-SEINE,COURBEVOIE,0922020W,117,112,0,5,65,52,4 ème
HAUTS-DE-SEINE,COURBEVOIE,0922867S,17,17,0,0,12,5,4 ème
HAUTS-DE-SEINE,FONTENAY-AUX-ROSES,0920081N,182,177,0,5,88,94,4 ème
HAUTS-DE-SEINE,ISSY-LES-MOULINEAUX,0921003R,48,48,0,0,16,32,4 ème
HAUTS-DE-SEINE,ISSY-LES-MOULINEAUX,0922247T,142,142,0,0,62,80,4 ème
HAUTS-DE-SEINE,ISSY-LES-MOULINEAUX,0922653J,0,0,0,0,0,0,4 ème
HAUTS-DE-SEINE,LE PLESSIS-ROBINSON,0920883K,98,98,0,0,45,53,4 ème
HAUTS-DE-SEINE,MALAKOFF,0921241Z,148,147,0,1,75,73,4 ème
HAUTS-DE-SEINE,MEUDON,0921782M,167,165,0,2,67,100,4 ème
HAUTS-DE-SEINE,MONTROUGE,0921911C,99,99,0,0,51,48,4 ème
HAUTS-DE-SEINE,NANTERRE,0920594W,100,97,0,3,50,50,4 ème
HAUTS-DE-SEINE,NANTERRE,0921940J,88,86,0,2,39,49,4 ème
HAUTS-DE-SEINE,NANTERRE,0922464D,0,0,0,0,0,0,4 ème
HAUTS-DE-SEINE,NEUILLY-SUR-SEINE,0921498D,120,118,0,2,52,68,4 ème
HAUTS-DE-SEINE,PUTEAUX,0921233R,172,172,0,0,83,89,4 ème
HAUTS-DE-SEINE,RUEIL-MALMAISON,0920852B,65,63,0,2,31,34,4 ème
HAUTS-DE-SEINE,RUEIL-MALMAISON,0921235T,132,132,0,0,60,72,4 ème
HAUTS-DE-SEINE,SCEAUX,0921784P,146,145,0,1,65,81,4 ème
HAUTS-DE-SEINE,VILLE-D'AVRAY,0920886N,141,139,0,2,61,80,4 ème
HAUTS-DE-SEINE,VILLENEUVE-LA-GARENNE,0921543C,147,137,8,2,75,72,4 ème
VAL-D'OISE,ARGENTEUIL,0950789S,133,133,0,0,71,62,4 ème
VAL-D'OISE,CERGY,0951401G,137,119,13,5,62,75,4 ème
VAL-D'OISE,DOMONT,0950014Z,208,204,0,4,99,109,4 ème
VAL-D'OISE,ENGHIEN-LES-BAINS,0950930V,107,105,0,2,41,66,4 ème
VAL-D'OISE,FRANCONVILLE,0950793W,130,130,0,0,80,50,4 ème
VAL-D'OISE,GARGES-LES-GONESSE,0952036X,147,140,0,7,69,78,4 ème
VAL-D'OISE,JOUY-LE-MOUTIER,0951527U,195,175,16,4,87,108,4 ème
VAL-D'OISE,LE PLESSIS-BOUCHARD,0951232Y,116,115,0,1,64,52,4 ème
VAL-D'OISE,L'ISLE-ADAM,0950758H,86,86,0,0,37,49,4 ème
VAL-D'OISE,LOUVRES,0951354F,117,112,0,5,62,55,4 ème
VAL-D'OISE,MAGNY-EN-VEXIN,0950823D,59,59,0,0,25,34,4 ème
VAL-D'OISE,MARINES,0950936B,158,143,15,0,73,85,4 ème
VAL-D'OISE,PARMAIN,0951279Z,162,162,0,0,70,92,4 ème
VAL-D'OISE,PIERRELAYE,0951726K,113,111,0,2,57,56,4 ème
VAL-D'OISE,PONTOISE,0950895G,134,131,0,3,57,77,4 ème
VAL-D'OISE,PONTOISE,0951506W,190,187,0,3,89,101,4 ème
VAL-D'OISE,SAINT-GRATIEN,0950037Z,117,117,0,0,58,59,4 ème
VAL-D'OISE,SAINT-OUEN-L'AUMONE,0950658Z,0,0,0,0,0,0,4 ème
VAL-D'OISE,SAINT-PRIX,0951992Z,116,116,0,0,57,59,4 ème
VAL-D'OISE,SARCELLES,0951939S,19,19,0,0,0,19,4 ème
VAL-D'OISE,VILLIERS-LE-BEL,0950796Z,178,176,0,2,91,87,4 ème
VAL-D'OISE,VILLIERS-LE-BEL,0951090U,0,0,0,0,0,0,4 ème
VAL-D'OISE,VILLIERS-LE-BEL,0951993A,155,152,0,3,75,80,4 ème
YVELINES,BONNIERES-SUR-SEINE,0780707V,194,194,0,0,87,107,4 ème
YVELINES,BREVAL,0781862A,121,121,0,0,61,60,4 ème
YVELINES,CHATOU,0781601S,25,25,0,0,14,11,4 ème
YVELINES,CHEVREUSE,0780418F,200,194,0,6,107,93,4 ème
YVELINES,CONFLANS-SAINTE-HONORINE,0780183A,218,202,14,2,93,125,4 ème
YVELINES,ELANCOURT,0780856G,145,141,0,4,57,88,4 ème
YVELINES,GAILLON-SUR-MONTCIENT,0783464S,117,117,0,0,52,65,4 ème
YVELINES,GARGENVILLE,0780758A,173,167,0,6,74,99,4 ème
YVELINES,HOUDAN,0780254C,185,183,0,2,92,93,4 ème
YVELINES,HOUILLES,0783287Z,155,155,0,0,91,64,4 ème
YVELINES,LE CHESNAY-ROCQUENCOURT,0782602E,0,0,0,0,0,0,4 ème
YVELINES,LE CHESNAY-ROCQUENCOURT,0783252L,177,177,0,0,89,88,4 ème
YVELINES,LIMAY,0780255D,160,160,0,0,69,91,4 ème
YVELINES,MAGNANVILLE,0781098V,185,167,16,2,98,87,4 ème
YVELINES,MAISONS-LAFFITTE,0781587B,96,96,0,0,52,44,4 ème
YVELINES,MANTES-LA-JOLIE,0780708W,139,139,0,0,80,59,4 ème
YVELINES,MANTES-LA-JOLIE,0781590E,190,190,0,0,95,95,4 ème
YVELINES,MANTES-LA-JOLIE,0781955B,120,118,0,2,61,59,4 ème
YVELINES,MANTES-LA-JOLIE,0781977A,90,87,0,3,37,53,4 ème
YVELINES,MANTES-LA-VILLE,0780569V,166,149,16,1,74,92,4 ème
YVELINES,MEULAN-EN-YVELINES,0783340G,135,135,0,0,80,55,4 ème
YVELINES,MONTFORT-L'AMAURY,0780262L,210,192,16,2,103,107,4 ème
YVELINES,MONTIGNY-LE-BRETONNEUX,0781954A,104,101,0,3,49,55,4 ème
YVELINES,PLAISIR,0780420H,166,151,15,0,91,75,4 ème
YVELINES,POISSY,0781101Y,134,134,0,0,52,82,4 ème
YVELINES,SAINT-GERMAIN-EN-LAYE,0783816Z,0,0,0,0,0,0,4 ème
YVELINES,VERNEUIL-SUR-SEINE,0780267S,183,167,16,0,75,108,4 ème
YVELINES,VERSAILLES,0783325R,0,0,0,0,0,0,4 ème
LA REUNION,CILAOS,9740096L,77,75,0,2,40,37,4 ème
LA REUNION,LA PLAINE-DES-PALMISTES,9740037X,97,94,0,3,42,55,4 ème
LA REUNION,LE PORT,9740548C,161,161,0,0,81,80,4 ème
LA REUNION,LE PORT,9740812P,163,128,32,3,83,80,4 ème
LA REUNION,LE PORT,9741045T,138,134,0,4,71,67,4 ème
LA REUNION,LES AVIRONS,9740005M,142,142,0,0,78,64,4 ème
LA REUNION,LE TAMPON,9740070H,196,193,0,3,101,95,4 ème
LA REUNION,LE TAMPON,9741581A,194,191,0,3,105,89,4 ème
LA REUNION,SAINT-ANDRE,9740076P,146,146,0,0,84,62,4 ème
LA REUNION,SAINT-BENOIT,9740083X,119,116,0,3,48,71,4 ème
LA REUNION,SAINT-BENOIT,9740702V,186,149,28,9,78,108,4 ème
LA REUNION,SAINT-DENIS,9740080U,200,199,0,1,110,90,4 ème
LA REUNION,SAINT-DENIS,9741044S,170,166,0,4,74,96,4 ème
LA REUNION,SAINT-DENIS,9741188Y,223,218,0,5,126,97,4 ème
LA REUNION,SAINT-DENIS,9741260B,112,109,0,3,64,48,4 ème
LA REUNION,SAINT-LEU,9740018B,124,122,0,2,64,60,4 ème
LA REUNION,SAINT-LOUIS,9741189Z,165,157,0,8,91,74,4 ème
LA REUNION,SAINT-PAUL,9740035V,170,137,32,1,73,97,4 ème
LA REUNION,SAINT-PAUL,9740039Z,190,181,0,9,91,99,4 ème
LA REUNION,SAINT-PAUL,9740784J,216,212,0,4,100,116,4 ème
LA REUNION,SAINT-PAUL,9740932V,250,233,15,2,120,130,4 ème
LA REUNION,SAINT-PIERRE,9740574F,184,147,31,6,87,97,4 ème
LA REUNION,SAINT-PIERRE,9740576H,107,104,0,3,49,58,4 ème
LA REUNION,SAINT-PIERRE,9740811N,160,139,14,7,77,83,4 ème
LA REUNION,SAINT-PIERRE,9741235Z,148,145,0,3,77,71,4 ème
MARTINIQUE,FORT-DE-FRANCE,9720010D,136,117,16,3,54,82,4 ème
MARTINIQUE,FORT-DE-FRANCE,9720064M,194,194,0,0,62,132,4 ème
MARTINIQUE,FORT-DE-FRANCE,9720349X,115,115,0,0,53,62,4 ème
MARTINIQUE,FORT-DE-FRANCE,9720412R,113,79,34,0,46,67,4 ème
MARTINIQUE,FORT-DE-FRANCE,9720855X,18,18,0,0,7,11,4 ème
MARTINIQUE,LE FRANCOIS,9720495F,68,68,0,0,38,30,4 ème
MARTINIQUE,LE MARIN,9720447D,101,87,14,0,43,58,4 ème
MARTINIQUE,LE MORNE-ROUGE,9720066P,45,45,0,0,29,16,4 ème
MARTINIQUE,LE ROBERT,9720019N,73,73,0,0,34,39,4 ème
MARTINIQUE,SAINTE-ANNE,9720514B,47,47,0,0,29,18,4 ème
MARTINIQUE,SAINTE-MARIE,9720513A,73,50,19,4,35,38,4 ème
MAYOTTE,BANDRELE,9760179R,254,247,0,7,136,118,4 ème
MAYOTTE,CHIRONGUI,9760042S,237,237,0,0,123,114,4 ème
MAYOTTE,MAMOUDZOU,9760162X,332,329,0,3,187,145,4 ème
ALLIER,DOMPIERRE-SUR-BESBRE,0030013Y,93,90,0,3,51,42,4 ème
ALLIER,HURIEL,0030018D,81,81,0,0,41,40,4 ème
ALLIER,JALIGNY-SUR-BESBRE,0030019E,29,26,0,3,13,16,4 ème
ALLIER,LAPALISSE,0030092J,91,88,0,3,46,45,4 ème
ALLIER,LE MAYET-DE-MONTAGNE,0030023J,42,42,0,0,24,18,4 ème
ALLIER,MARCILLAT-EN-COMBRAILLE,0030022H,25,25,0,0,11,14,4 ème
ALLIER,MONTLUCON,0030758H,111,110,0,1,57,54,4 ème
ALLIER,MOULINS,0030838V,129,94,31,4,58,71,4 ème
ALLIER,SAINT-YORRE,0031010G,79,72,0,7,42,37,4 ème
ALLIER,VARENNES-SUR-ALLIER,0030924N,0,0,0,0,0,0,4 ème
ALLIER,VICHY,0030050N,129,109,16,4,63,66,4 ème
ALLIER,VICHY,0030070K,84,84,0,0,45,39,4 ème
CANTAL,AURILLAC,0150647X,146,143,0,3,80,66,4 ème
CANTAL,MASSIAC,0150014J,33,33,0,0,17,16,4 ème
CANTAL,MAURIAC,0150016L,59,48,10,1,31,28,4 ème
CANTAL,SAINT-FLOUR,0150029A,107,89,13,5,53,54,4 ème
HAUTE-LOIRE,BRIOUDE,0430109K,7,0,7,0,0,7,4 ème
HAUTE-LOIRE,BRIVES-CHARENSAC,0430101B,0,0,0,0,0,0,4 ème
HAUTE-LOIRE,CRAPONNE-SUR-ARZON,0430010C,39,39,0,0,17,22,4 ème
HAUTE-LOIRE,CRAPONNE-SUR-ARZON,0430068R,26,26,0,0,11,15,4 ème
HAUTE-LOIRE,LA CHAISE-DIEU,0430006Y,19,16,0,3,9,10,4 ème
HAUTE-LOIRE,LE CHAMBON-SUR-LIGNON,0430820H,32,25,7,0,18,14,4 ème
HAUTE-LOIRE,LE MONASTIER-SUR-GAZEILLE,0430017K,57,57,0,0,23,34,4 ème
HAUTE-LOIRE,LE MONASTIER-SUR-GAZEILLE,0430074X,30,30,0,0,14,16,4 ème
HAUTE-LOIRE,LE PUY-EN-VELAY,0430025U,90,87,0,3,38,52,4 ème
HAUTE-LOIRE,LE PUY-EN-VELAY,0430098Y,0,0,0,0,0,0,4 ème
HAUTE-LOIRE,MONISTROL-SUR-LOIRE,0430103D,0,0,0,0,0,0,4 ème
HAUTE-LOIRE,SAINT-DIDIER-EN-VELAY,0430027W,145,145,0,0,74,71,4 ème
HAUTE-LOIRE,SAINTE-SIGOLENE,0430090P,42,38,0,4,13,29,4 ème
HAUTE-LOIRE,YSSINGEAUX,0430135N,136,114,17,5,70,66,4 ème
PUY-DE-DOME,AMBERT,0630001J,0,0,0,0,0,0,4 ème
PUY-DE-DOME,ARLANC,0630006P,22,22,0,0,14,8,4 ème
PUY-DE-DOME,CLERMONT-FERRAND,0631050Z,0,0,0,0,0,0,4 ème
PUY-DE-DOME,CLERMONT-FERRAND,0631410R,191,191,0,0,102,89,4 ème
PUY-DE-DOME,CLERMONT-FERRAND,0631736V,0,0,0,0,0,0,4 ème
PUY-DE-DOME,COURNON-D'AUVERGNE,0630028N,161,159,0,2,81,80,4 ème
PUY-DE-DOME,ISSOIRE,0631604B,180,149,30,1,84,96,4 ème
PUY-DE-DOME,LES MARTRES-DE-VEYRE,0631479R,174,169,0,5,73,101,4 ème
PUY-DE-DOME,MARINGUES,0630039A,114,114,0,0,56,58,4 ème
PUY-DE-DOME,PONTAUMUR,0630047J,40,40,0,0,21,19,4 ème
PUY-DE-DOME,PONTGIBAUD,0630049L,74,74,0,0,39,35,4 ème
PUY-DE-DOME,RIOM,0631121B,145,145,0,0,68,77,4 ème
PUY-DE-DOME,SAINT-ANTHEME,0630058W,23,23,0,0,14,9,4 ème
PUY-DE-DOME,SAINT-DIER-D'AUVERGNE,0630059X,43,43,0,0,17,26,4 ème
PUY-DE-DOME,THIERS,0631238D,165,144,15,6,87,78,4 ème
PUY-DE-DOME,VOLVIC,0630074N,126,124,0,2,57,69,4 ème
PUY-DE-DOME,VOLVIC,0631115V,32,32,0,0,13,19,4 ème
ARDECHE,AUBENAS,0070062E,209,209,0,0,86,123,4 ème
ARDECHE,AUBENAS,0070115M,0,0,0,0,0,0,4 ème
ARDECHE,AUBENAS,0071169H,158,130,24,4,79,79,4 ème
ARDECHE,LES VANS,0070037C,66,66,0,0,30,36,4 ème
ARDECHE,LE TEIL,0070112J,0,0,0,0,0,0,4 ème
ARDECHE,RUOMS,0070863A,43,43,0,0,20,23,4 ème
ARDECHE,VALLON-PONT-D'ARC,0070035A,92,92,0,0,44,48,4 ème
ARDECHE,VILLENEUVE-DE-BERG,0070040F,107,107,0,0,49,58,4 ème
DROME,BEAUMONT-LES-VALENCE,0261528V,144,141,0,3,80,64,4 ème
DROME,CHABEUIL,0260092J,70,70,0,0,32,38,4 ème
DROME,CREST,0260072M,0,0,0,0,0,0,4 ème
DROME,MONTELIMAR,0261034H,23,0,16,7,6,17,4 ème
DROME,PIERRELATTE,0260019E,0,0,0,0,0,0,4 ème
DROME,ROMANS-SUR-ISERE,0260044G,0,0,0,0,0,0,4 ème
DROME,ROMANS-SUR-ISERE,0260078U,0,0,0,0,0,0,4 ème
DROME,SAINT-RAMBERT-D'ALBON,0260029R,109,109,0,0,54,55,4 ème
DROME,VALENCE,0260116K,0,0,0,0,0,0,4 ème
DROME,VALENCE,0261094Y,93,87,0,6,43,50,4 ème
DROME,VALENCE,0261136U,228,224,0,4,111,117,4 ème
HAUTE SAVOIE,ABONDANCE,0741442R,30,30,0,0,16,14,4 ème
HAUTE SAVOIE,ANNECY,0740124H,220,205,15,0,106,114,4 ème
HAUTE SAVOIE,ANNECY,0740929H,179,175,0,4,92,87,4 ème
HAUTE SAVOIE,ANNECY,0741117M,219,201,16,2,108,111,4 ème
HAUTE SAVOIE,BELLEVAUX,0740109S,67,67,0,0,41,26,4 ème
HAUTE SAVOIE,BOEGE,0740048A,103,103,0,0,47,56,4 ème
HAUTE SAVOIE,CHAMONIX-MONT-BLANC,0741116L,141,141,0,0,69,72,4 ème
HAUTE SAVOIE,CRUSEILLES,0740018T,180,180,0,0,88,92,4 ème
HAUTE SAVOIE,DOUVAINE,0740116Z,91,91,0,0,49,42,4 ème
HAUTE SAVOIE,PASSY,0740263J,179,162,14,3,91,88,4 ème
HAUTE SAVOIE,RUMILLY,0741469V,0,0,0,0,0,0,4 ème
HAUTE SAVOIE,SAINT-JORIOZ,0740036M,141,141,0,0,74,67,4 ème
HAUTE SAVOIE,SILLINGY,0741488R,154,152,0,2,71,83,4 ème
HAUTE SAVOIE,THONES,0741283T,128,128,0,0,70,58,4 ème
HAUTE SAVOIE,THONON-LES-BAINS,0740156T,0,0,0,0,0,0,4 ème
HAUTE SAVOIE,THONON-LES-BAINS,0741163M,159,155,0,4,76,83,4 ème
ISERE,BOURGOIN-JALLIEU,0380111P,220,220,0,0,98,122,4 ème
ISERE,CHAMPIER,0383542U,169,169,0,0,83,86,4 ème
ISERE,CHIRENS,0383454Y,173,173,0,0,84,89,4 ème
ISERE,DOMENE,0382268J,156,139,16,1,79,77,4 ème
ISERE,ECHIROLLES,0380021S,145,140,0,5,63,82,4 ème
ISERE,ENTRE-DEUX-GUIERS,0381692H,80,74,0,6,33,47,4 ème
ISERE,GRENOBLE,0381604M,83,83,0,0,51,32,4 ème
ISERE,GRENOBLE,0381664C,288,285,0,3,139,149,4 ème
ISERE,GRENOBLE,0382032C,106,100,0,6,58,48,4 ème
ISERE,GRENOBLE,0382581Z,150,147,0,3,73,77,4 ème
ISERE,LE PONT-DE-BEAUVOISIN,0380053B,0,0,0,0,0,0,4 ème
ISERE,MONESTIER-DE-CLERMONT,0380044S,91,91,0,0,35,56,4 ème
ISERE,MORESTEL,0380046U,149,146,0,3,77,72,4 ème
ISERE,PONT-DE-CHERUY,0382110M,194,174,16,4,85,109,4 ème
ISERE,PONT-EN-ROYANS,0380055D,78,78,0,0,35,43,4 ème
ISERE,RIVES,0382266G,214,193,16,5,106,108,4 ème
ISERE,ROUSSILLON,0380050Y,146,145,0,1,74,72,4 ème
ISERE,SAINT-JEAN-DE-BOURNAY,0382265F,198,193,0,5,104,94,4 ème
ISERE,SAINT-LAURENT-DU-PONT,0380062L,74,74,0,0,32,42,4 ème
ISERE,SAINT-MARCELLIN,0382428H,141,119,16,6,69,72,4 ème
ISERE,SAINT-MAURICE-L'EXIL,0382043P,172,145,22,5,79,93,4 ème
ISERE,SASSENAGE,0382099A,0,0,0,0,0,0,4 ème
ISERE,SEYSSINS,0382431L,145,142,0,3,65,80,4 ème
ISERE,VIENNE,0381678T,0,0,0,0,0,0,4 ème
ISERE,VIENNE,0382195E,203,203,0,0,103,100,4 ème
ISERE,VIF,0382039K,175,171,0,4,77,98,4 ème
ISERE,VILLARD-BONNOT,0381778B,200,200,0,0,97,103,4 ème
ISERE,VIZILLE,0380089R,0,0,0,0,0,0,4 ème
SAVOIE,ALBERTVILLE,0730006K,0,0,0,0,0,0,4 ème
SAVOIE,ALBERTVILLE,0731069R,86,83,0,3,42,44,4 ème
SAVOIE,BARBY,0731306Y,161,156,0,5,83,78,4 ème
SAVOIE,COGNIN,0731113N,112,112,0,0,51,61,4 ème
SAVOIE,FRONTENEX,0730023D,113,111,0,2,57,56,4 ème
SAVOIE,GRESY-SUR-AIX,0731521G,162,159,0,3,92,70,4 ème
SAVOIE,LA MOTTE-SERVOLEX,0730774V,0,0,0,0,0,0,4 ème
SAVOIE,LE CHATELARD,0730020A,54,51,0,3,24,30,4 ème
SAVOIE,MOUTIERS,0730008M,180,162,16,2,88,92,4 ème
SAVOIE,SAINT-ETIENNE-DE-CUINES,0730017X,84,84,0,0,38,46,4 ème
SAVOIE,SAINT-GENIX-LES-VILLAGES,0730036T,115,110,0,5,61,54,4 ème
SAVOIE,SAINT-PAUL-SUR-ISERE,0730769P,39,39,0,0,13,26,4 ème
SAVOIE,UGINE,0730043A,0,0,0,0,0,0,4 ème
AIN,AMBERIEU-EN-BUGEY,0010001W,0,0,0,0,0,0,4 ème
AIN,ARBENT,0010987T,167,163,0,4,93,74,4 ème
AIN,COLIGNY,0011071J,99,99,0,0,48,51,4 ème
AIN,CULOZ,0010022U,109,109,0,0,58,51,4 ème
AIN,FERNEY-VOLTAIRE,0010896U,248,243,0,5,127,121,4 ème
AIN,JASSANS-RIOTTIER,0011193S,119,102,16,1,69,50,4 ème
AIN,MIRIBEL,0011151W,79,79,0,0,33,46,4 ème
AIN,NANTUA,0011068F,92,91,0,1,48,44,4 ème
AIN,PONT-DE-VAUX,0011070H,99,94,0,5,50,49,4 ème
AIN,SAINT-DENIS-LES-BOURG,0011333U,144,140,0,4,59,85,4 ème
AIN,SAINT-RAMBERT-EN-BUGEY,0010039M,73,71,0,2,39,34,4 ème
LOIRE,BALBIGNY,0421455D,105,102,0,3,47,58,4 ème
LOIRE,CHAZELLES-SUR-LYON,0421658Z,91,91,0,0,37,54,4 ème
LOIRE,MONTBRISON,0421002L,0,0,0,0,0,0,4 ème
LOIRE,PANISSIERES,0420023X,75,75,0,0,35,40,4 ème
LOIRE,RIORGES,0421457F,121,119,0,2,57,64,4 ème
LOIRE,SAINT-BONNET-LE-CHATEAU,0421082Y,41,41,0,0,18,23,4 ème
LOIRE,SAINT-CHAMOND,0420968Z,188,155,30,3,79,109,4 ème
LOIRE,SAINT-ETIENNE,0420984S,0,0,0,0,0,0,4 ème
LOIRE,SAINT-ETIENNE,0421041D,122,122,0,0,63,59,4 ème
LOIRE,SAINT-ETIENNE,0421451Z,76,60,16,0,34,42,4 ème
LOIRE,SAINT-ETIENNE,0421801E,175,175,0,0,108,67,4 ème
LOIRE,SAINT-ETIENNE,0421803G,54,52,0,2,23,31,4 ème
LOIRE,SAINT-ETIENNE,0422158T,0,0,0,0,0,0,4 ème
LOIRE,SAINT-GALMIER,0421058X,145,142,0,3,82,63,4 ème
LOIRE,SAINT-GALMIER,0421607U,154,133,17,4,74,80,4 ème
LOIRE,SAINT-GENEST-LERPT,0422160V,0,0,0,0,0,0,4 ème
LOIRE,SAINT-JUST-SAINT-RAMBERT,0421063C,79,79,0,0,40,39,4 ème
LOIRE,SAINT-JUST-SAINT-RAMBERT,0421734G,197,194,0,3,101,96,4 ème
RHONE,ANSE,0690002C,208,206,0,2,107,101,4 ème
RHONE,BEAUJEU,0690005F,74,69,0,5,27,47,4 ème
RHONE,BELLEVILLE-EN-BEAUJOLAIS,0690007H,188,171,13,4,88,100,4 ème
RHONE,CALUIRE-ET-CUIRE,0692165D,13,13,0,0,6,7,4 ème
RHONE,CALUIRE-ET-CUIRE,0692410V,164,161,0,3,83,81,4 ème
RHONE,CHAMPAGNE-AU-MONT-D'OR,0692414Z,155,138,14,3,62,93,4 ème
RHONE,COMMUNAY,0693092L,157,151,0,6,72,85,4 ème
RHONE,ECULLY,0691481K,112,107,0,5,57,55,4 ème
RHONE,ECULLY,0693095P,0,0,0,0,0,0,4 ème
RHONE,GENAS,0693331W,209,209,0,0,97,112,4 ème
RHONE,GIVORS,0690018V,0,0,0,0,0,0,4 ème
RHONE,GIVORS,0691483M,122,121,0,1,58,64,4 ème
RHONE,L'ARBRESLE,0690003D,0,0,0,0,0,0,4 ème
RHONE,LYON,0690043X,0,0,0,0,0,0,4 ème
RHONE,LYON,0690660T,0,0,0,0,0,0,4 ème
RHONE,LYON,0693370N,0,0,0,0,0,0,4 ème
RHONE,LYON,0692693C,138,135,0,3,68,70,4 ème
RHONE,LYON,0692695E,101,101,0,0,48,53,4 ème
RHONE,LYON,0690125L,0,0,0,0,0,0,4 ème
RHONE,LYON,0690601D,53,53,0,0,20,33,4 ème
RHONE,LYON,0691662G,199,199,0,0,117,82,4 ème
RHONE,LYON,0691670R,77,60,16,1,36,41,4 ème
RHONE,LYON,0692696F,208,205,0,3,115,93,4 ème
RHONE,LYON,0692931L,119,119,0,0,60,59,4 ème
RHONE,LYON,0690604G,90,86,0,4,40,50,4 ème
RHONE,LYON,0692938U,56,56,0,0,30,26,4 ème
RHONE,LYON,0690045Z,0,0,0,0,0,0,4 ème
RHONE,MEYZIEU,0691668N,135,132,0,3,65,70,4 ème
RHONE,MEYZIEU,0692335N,166,150,16,0,76,90,4 ème
RHONE,NEUVILLE-SUR-SAONE,0692423J,212,193,16,3,106,106,4 ème
RHONE,OULLINS,0690075G,117,102,15,0,64,53,4 ème
RHONE,OULLINS,0690129R,0,0,0,0,0,0,4 ème
RHONE,RILLIEUX-LA-PAPE,0691680B,0,0,0,0,0,0,4 ème
RHONE,RILLIEUX-LA-PAPE,0692517L,0,0,0,0,0,0,4 ème
RHONE,SAINT-PIERRE-DE-CHANDIEU,0694227V,139,137,0,2,55,84,4 ème
RHONE,SAINT-PRIEST,0691497C,175,170,0,5,79,96,4 ème
RHONE,THIZY-LES-BOURGS,0692164C,38,36,0,2,15,23,4 ème
RHONE,THIZY-LES-BOURGS,0693566B,0,0,0,0,0,0,4 ème
RHONE,VAULX-EN-VELIN,0690249W,167,165,0,2,82,85,4 ème
RHONE,VAULX-EN-VELIN,0690652J,0,0,0,0,0,0,4 ème
RHONE,VENISSIEUX,0692717D,0,0,0,0,0,0,4 ème
RHONE,VILLEFRANCHE-SUR-SAONE,0691644M,0,0,0,0,0,0,4 ème
RHONE,VILLEFRANCHE-SUR-SAONE,0692699J,194,192,0,2,89,105,4 ème
RHONE,VILLEURBANNE,0691478G,158,151,0,7,76,82,4 ème
RHONE,VILLEURBANNE,0691664J,193,174,16,3,101,92,4 ème
RHONE,VILLEURBANNE,0691675W,157,134,16,7,79,78,4 ème
DOUBS,AUDINCOURT,0250003T,161,144,17,0,79,82,4 ème
DOUBS,BART,0251556F,127,124,0,3,61,66,4 ème
DOUBS,BESANCON,0251116C,129,122,0,7,74,55,4 ème
DOUBS,BESANCON,0251348E,129,126,0,3,63,66,4 ème
DOUBS,BESANCON,0251586N,14,13,0,1,5,9,4 ème
DOUBS,BESANCON,0251589S,189,176,13,0,101,88,4 ème
DOUBS,BESANCON,0251592V,0,0,0,0,0,0,4 ème
DOUBS,DOUBS,0251949H,167,146,16,5,83,84,4 ème
DOUBS,LABERGEMENT-SAINTE-MARIE,0251065X,29,29,0,0,19,10,4 ème
DOUBS,LE RUSSEY,0250052W,49,49,0,0,30,19,4 ème
DOUBS,MAICHE,0251373G,123,112,8,3,69,54,4 ème
DOUBS,MANDEURE,0251324D,87,86,0,1,40,47,4 ème
DOUBS,MONTBELIARD,0250067M,0,0,0,0,0,0,4 ème
DOUBS,MONTBELIARD,0251994G,0,0,0,0,0,0,4 ème
DOUBS,PONTARLIER,0251349F,0,0,0,0,0,0,4 ème
DOUBS,PONTARLIER,0251524W,139,136,0,3,75,64,4 ème
DOUBS,PONTARLIER,0251590T,135,135,0,0,74,61,4 ème
DOUBS,PONTARLIER,0251677M,125,123,0,2,47,78,4 ème
DOUBS,ROUGEMONT,0250050U,75,75,0,0,33,42,4 ème
DOUBS,SANCEY,0251061T,33,33,0,0,14,19,4 ème
DOUBS,SAONE,0251376K,158,158,0,0,80,78,4 ème
DOUBS,SOCHAUX,0250056A,178,158,16,4,77,101,4 ème
DOUBS,VALDAHON,0251372F,163,159,0,4,84,79,4 ème
DOUBS,VALENTIGNEY,0251599C,118,116,0,2,52,66,4 ème
HAUTE-SAONE,GRAY,0700010F,68,66,0,2,42,26,4 ème
HAUTE-SAONE,GRAY,0701001H,0,0,0,0,0,0,4 ème
HAUTE-SAONE,GY,0700013J,76,76,0,0,41,35,4 ème
HAUTE-SAONE,LUXEUIL-LES-BAINS,0701078S,0,0,0,0,0,0,4 ème
HAUTE-SAONE,MELISEY,0700925A,79,74,0,5,32,47,4 ème
HAUTE-SAONE,NOIDANS-LES-VESOUL,0701036W,109,108,0,1,49,60,4 ème
HAUTE-SAONE,VESOUL,0701002J,106,106,0,0,53,53,4 ème
HAUTE-SAONE,VILLERSEXEL,0700896U,87,87,0,0,39,48,4 ème
JURA,BLETTERANS,0390004T,91,89,0,2,31,60,4 ème
JURA,CHAMPAGNOLE,0391001B,0,0,0,0,0,0,4 ème
JURA,DOLE,0390015E,0,0,0,0,0,0,4 ème
JURA,LES ROUSSES,0390923S,103,103,0,0,50,53,4 ème
JURA,LONS-LE-SAUNIER,0390906Y,138,136,0,2,78,60,4 ème
JURA,MONT-SOUS-VAUDREY,0390997X,57,57,0,0,30,27,4 ème
JURA,SAINT-AUBIN,0390083D,49,49,0,0,25,24,4 ème
JURA,SALINS-LES-BAINS,0390085F,20,20,0,0,9,11,4 ème
TERRITOIRE DE BELFORT,BELFORT,0900018F,123,121,0,2,51,72,4 ème
TERRITOIRE DE BELFORT,BELFORT,0900235S,56,56,0,0,30,26,4 ème
TERRITOIRE DE BELFORT,BELFORT,0900295G,179,160,16,3,107,72,4 ème
TERRITOIRE DE BELFORT,BELFORT,0900335A,222,222,0,0,105,117,4 ème
TERRITOIRE DE BELFORT,MONTREUX-CHATEAU,0900011Y,84,84,0,0,37,47,4 ème
TERRITOIRE DE BELFORT,MORVILLARS,0900277M,98,94,0,4,46,52,4 ème
COTE D'OR,DIJON,0211227V,82,82,0,0,39,43,4 ème
COTE D'OR,LONGVIC,0210057Y,152,152,0,0,79,73,4 ème
COTE D'OR,SEMUR-EN-AUXOIS,0211088U,55,55,0,0,28,27,4 ème
NIEVRE,CHATEAU-CHINON (VILLE),0580552K,0,0,0,0,0,0,4 ème
NIEVRE,CLAMECY,0580651T,85,85,0,0,41,44,4 ème
NIEVRE,CORBIGNY,0580065F,30,30,0,0,14,16,4 ème
NIEVRE,DECIZE,0580068J,19,19,0,0,9,10,4 ème
NIEVRE,GUERIGNY,0580023K,52,48,0,4,19,33,4 ème
NIEVRE,LA MACHINE,0580028R,26,26,0,0,12,14,4 ème
NIEVRE,NEVERS,0580071M,0,0,0,0,0,0,4 ème
NIEVRE,SAINT-PIERRE-LE-MOUTIER,0580039C,77,77,0,0,34,43,4 ème
SAONE-ET-LOIRE,AUTUN,0710001R,0,0,0,0,0,0,4 ème
SAONE-ET-LOIRE,AUTUN,0711294W,128,120,7,1,58,70,4 ème
SAONE-ET-LOIRE,BUXY,0710007X,84,84,0,0,47,37,4 ème
SAONE-ET-LOIRE,CHALON-SUR-SAONE,0711322B,0,0,0,0,0,0,4 ème
SAONE-ET-LOIRE,CHALON-SUR-SAONE,0711896A,0,0,0,0,0,0,4 ème
SAONE-ET-LOIRE,CHAROLLES,0710155H,95,76,16,3,42,53,4 ème
SAONE-ET-LOIRE,COUCHES,0710025S,77,77,0,0,40,37,4 ème
SAONE-ET-LOIRE,GIVRY,0710125A,29,29,0,0,17,12,4 ème
SAONE-ET-LOIRE,GIVRY,0710154G,105,105,0,0,54,51,4 ème
SAONE-ET-LOIRE,GUEUGNON,0711252A,129,110,16,3,60,69,4 ème
SAONE-ET-LOIRE,LOUHANS,0710042K,0,0,0,0,0,0,4 ème
SAONE-ET-LOIRE,LOUHANS,0711449P,180,160,17,3,74,106,4 ème
SAONE-ET-LOIRE,LUGNY,0710128D,24,24,0,0,12,12,4 ème
SAONE-ET-LOIRE,PARAY-LE-MONIAL,0710061F,104,102,0,2,51,53,4 ème
SAONE-ET-LOIRE,VERDUN-SUR-LE-DOUBS,0710073U,93,93,0,0,44,49,4 ème
YONNE,AUXERRE,0890006Y,174,156,16,2,97,77,4 ème
YONNE,AUXERRE,0890090P,160,159,0,1,84,76,4 ème
YONNE,AVALLON,0890822K,95,77,14,4,54,41,4 ème
YONNE,JOIGNY,0891016W,24,0,24,0,7,17,4 ème
YONNE,MIGENNES,0890017K,95,89,0,6,45,50,4 ème
YONNE,TONNERRE,0890980G,120,98,21,1,65,55,4 ème
YONNE,VILLENEUVE-SUR-YONNE,0890540D,157,155,0,2,65,92,4 ème
COTES D'ARMOR,DINAN,0220081U,141,111,28,2,75,66,4 ème
COTES D'ARMOR,DINAN,0221623V,170,170,0,0,91,79,4 ème
COTES D'ARMOR,LOUDEAC,0220027K,0,0,0,0,0,0,4 ème
COTES D'ARMOR,MERDRIGNAC,0221538C,69,69,0,0,42,27,4 ème
COTES D'ARMOR,PLANCOET,0220038X,119,116,0,3,50,69,4 ème
COTES D'ARMOR,PLENEE-JUGON,0220040Z,84,84,0,0,44,40,4 ème
COTES D'ARMOR,PLENEUF-VAL-ANDRE,0220158C,75,75,0,0,38,37,4 ème
COTES D'ARMOR,PLERIN,0221039K,180,176,0,4,101,79,4 ème
COTES D'ARMOR,PLOUHA,0221512Z,112,112,0,0,60,52,4 ème
COTES D'ARMOR,ROSTRENEN,0221749G,49,44,0,5,19,30,4 ème
COTES D'ARMOR,SAINT-BRIEUC,0220059V,0,0,0,0,0,0,4 ème
COTES D'ARMOR,SAINT-BRIEUC,0220172T,74,71,0,3,31,43,4 ème
COTES D'ARMOR,SAINT-BRIEUC,0221750H,162,162,0,0,79,83,4 ème
COTES D'ARMOR,TREGUIER,0220073K,137,137,0,0,73,64,4 ème
FINISTERE,BANNALEC,0291086Y,88,88,0,0,44,44,4 ème
FINISTERE,BREST,0290100B,118,113,0,5,58,60,4 ème
FINISTERE,BREST,0290108K,0,0,0,0,0,0,4 ème
FINISTERE,BREST,0290149E,86,65,16,5,52,34,4 ème
FINISTERE,BREST,0291594A,120,117,0,3,44,76,4 ème
FINISTERE,BREST,0291868Y,190,190,0,0,106,84,4 ème
FINISTERE,BREST,0292139T,0,0,0,0,0,0,4 ème
FINISTERE,BRIEC,0290244H,94,94,0,0,40,54,4 ème
FINISTERE,CHATEAUNEUF-DU-FAOU,0290252S,27,27,0,0,16,11,4 ème
FINISTERE,LANDERNEAU,0291874E,201,197,0,4,109,92,4 ème
FINISTERE,LANDIVISIAU,0290153J,117,115,0,2,55,62,4 ème
FINISTERE,LANDIVISIAU,0291640A,198,195,0,3,117,81,4 ème
FINISTERE,LANNILIS,0290048V,115,115,0,0,55,60,4 ème
FINISTERE,LESNEVEN,0290049W,159,156,0,3,92,67,4 ème
FINISTERE,LESNEVEN,0291875F,231,219,12,0,126,105,4 ème
FINISTERE,MORLAIX,0291227B,83,83,0,0,44,39,4 ème
FINISTERE,PLABENNEC,0292290G,130,126,0,4,54,76,4 ème
FINISTERE,PLEYBEN,0290053A,67,64,0,3,28,39,4 ème
FINISTERE,PLEYBEN,0290130J,0,0,0,0,0,0,4 ème
FINISTERE,PLOUESCAT,0290056D,44,44,0,0,23,21,4 ème
FINISTERE,PLOUGASNOU,0290057E,28,28,0,0,12,16,4 ème
FINISTERE,PLOZEVET,0290331C,43,43,0,0,18,25,4 ème
FINISTERE,PONT-AVEN,0290060H,55,55,0,0,28,27,4 ème
FINISTERE,PONT-CROIX,0290302W,34,34,0,0,13,21,4 ème
FINISTERE,QUIMPER,0291879K,65,65,0,0,22,43,4 ème
FINISTERE,QUIMPER,0292144Y,0,0,0,0,0,0,4 ème
FINISTERE,ROSPORDEN,0291634U,119,117,0,2,55,64,4 ème
FINISTERE,SAINT-POL-DE-LEON,0290333E,104,89,15,0,50,54,4 ème
FINISTERE,SAINT-POL-DE-LEON,0291883P,159,159,0,0,80,79,4 ème
FINISTERE,SCAER,0290088N,73,73,0,0,36,37,4 ème
FINISTERE,SIZUN,0290089P,74,74,0,0,38,36,4 ème
ILLE-ET-VILAINE,BETTON,0352260S,124,124,0,0,66,58,4 ème
ILLE-ET-VILAINE,CESSON-SEVIGNE,0352972R,16,16,0,0,3,13,4 ème
ILLE-ET-VILAINE,CHARTRES-DE-BRETAGNE,0351852Y,163,163,0,0,99,64,4 ème
ILLE-ET-VILAINE,DOL-DE-BRETAGNE,0350009V,0,0,0,0,0,0,4 ème
ILLE-ET-VILAINE,DOL-DE-BRETAGNE,0350767U,172,170,0,2,80,92,4 ème
ILLE-ET-VILAINE,GUIGNEN,0350864Z,100,100,0,0,48,52,4 ème
ILLE-ET-VILAINE,JANZE,0351053E,159,127,32,0,92,67,4 ème
ILLE-ET-VILAINE,LAILLE,0352959B,118,118,0,0,51,67,4 ème
ILLE-ET-VILAINE,LA MEZIERE,0352760K,157,157,0,0,85,72,4 ème
ILLE-ET-VILAINE,LE RHEU,0351847T,191,189,0,2,107,84,4 ème
ILLE-ET-VILAINE,LIFFRE,0350867C,157,157,0,0,87,70,4 ème
ILLE-ET-VILAINE,ORGERES,0352691K,128,128,0,0,62,66,4 ème
ILLE-ET-VILAINE,REDON,0350775C,212,197,13,2,123,89,4 ème
ILLE-ET-VILAINE,REDON,0350790U,0,0,0,0,0,0,4 ème
ILLE-ET-VILAINE,RENNES,0350027P,131,127,0,4,68,63,4 ème
ILLE-ET-VILAINE,RENNES,0350734H,114,114,0,0,58,56,4 ème
ILLE-ET-VILAINE,RENNES,0350836U,111,111,0,0,60,51,4 ème
ILLE-ET-VILAINE,RENNES,0350963G,160,144,16,0,80,80,4 ème
ILLE-ET-VILAINE,RENNES,0351638R,217,212,0,5,95,122,4 ème
ILLE-ET-VILAINE,RENNES,0352069J,187,159,28,0,91,96,4 ème
ILLE-ET-VILAINE,ROMILLE,0350057X,123,123,0,0,66,57,4 ème
ILLE-ET-VILAINE,SAINT-AUBIN-D'AUBIGNE,0350881T,134,134,0,0,68,66,4 ème
ILLE-ET-VILAINE,SAINT-AUBIN-D'AUBIGNE,0351849V,156,136,17,3,83,73,4 ème
ILLE-ET-VILAINE,SAINT-AUBIN-DU-CORMIER,0350039C,129,129,0,0,67,62,4 ème
ILLE-ET-VILAINE,SAINT-GEORGES-DE-REINTEMBAULT,0350885X,31,31,0,0,12,19,4 ème
ILLE-ET-VILAINE,SAINT-JACQUES-DE-LA-LANDE,0352589Z,96,89,0,7,54,42,4 ème
ILLE-ET-VILAINE,SAINT-MALO,0350044H,78,76,0,2,38,40,4 ème
ILLE-ET-VILAINE,SAINT-MALO,0350916F,168,133,31,4,86,82,4 ème
ILLE-ET-VILAINE,VAL-COUESNON,0350848G,48,48,0,0,23,25,4 ème
ILLE-ET-VILAINE,VITRE,0351909K,184,149,31,4,83,101,4 ème
MORBIHAN,ARRADON,0561598H,171,168,0,3,90,81,4 ème
MORBIHAN,AURAY,0560002Y,118,103,12,3,63,55,4 ème
MORBIHAN,CARNAC,0560006C,108,108,0,0,58,50,4 ème
MORBIHAN,CARNAC,0560127J,65,65,0,0,39,26,4 ème
MORBIHAN,ELVEN,0560129L,119,119,0,0,56,63,4 ème
MORBIHAN,GUEMENE-SUR-SCORFF,0560133R,35,35,0,0,18,17,4 ème
MORBIHAN,JOSSELIN,0560019S,0,0,0,0,0,0,4 ème
MORBIHAN,LANESTER,0560022V,97,97,0,0,35,62,4 ème
MORBIHAN,LA TRINITE-PORHOET,0560174K,20,20,0,0,9,11,4 ème
MORBIHAN,LE FAOUET,0560010G,49,44,0,5,25,24,4 ème
MORBIHAN,LOCMINE,0560024X,70,70,0,0,32,38,4 ème
MORBIHAN,LORIENT,0561330S,94,77,14,3,44,50,4 ème
MORBIHAN,PLOUAY,0561403W,67,67,0,0,31,36,4 ème
MORBIHAN,PLUNERET,0561616C,119,119,0,0,61,58,4 ème
MORBIHAN,QUIBERON,0560168D,10,10,0,0,5,5,4 ème
MORBIHAN,SARZEAU,0560048Y,92,92,0,0,39,53,4 ème
MORBIHAN,VANNES,0560053D,0,0,0,0,0,0,4 ème
MORBIHAN,VANNES,0560115W,109,104,0,5,44,65,4 ème
MORBIHAN,VANNES,0561792U,45,45,0,0,24,21,4 ème
CHER,BOURGES,0180777X,147,128,16,3,71,76,4 ème
CHER,DUN-SUR-AURON,0180736C,105,93,8,4,45,60,4 ème
CHER,SAINT-AMAND-MONTROND,0180025E,0,0,0,0,0,0,4 ème
CHER,SAINT-AMAND-MONTROND,0180026F,0,0,0,0,0,0,4 ème
CHER,SANCERGUES,0180745M,70,70,0,0,48,22,4 ème
EURE-ET-LOIR,CHARTRES,0280756V,87,84,0,3,50,37,4 ème
EURE-ET-LOIR,CHATEAUDUN,0280700J,0,0,0,0,0,0,4 ème
EURE-ET-LOIR,CLOYES-LES-TROIS-RIVIERES,0280867R,91,90,0,1,55,36,4 ème
EURE-ET-LOIR,COURVILLE-SUR-EURE,0280018T,173,170,0,3,91,82,4 ème
EURE-ET-LOIR,DREUX,0280658N,115,111,0,4,53,62,4 ème
EURE-ET-LOIR,DREUX,0280925D,0,0,0,0,0,0,4 ème
EURE-ET-LOIR,GALLARDON,0280701K,108,102,0,6,47,61,4 ème
EURE-ET-LOIR,LUCE,0280009H,0,0,0,0,0,0,4 ème
EURE-ET-LOIR,MAINVILLIERS,0280659P,16,0,16,0,4,12,4 ème
EURE-ET-LOIR,MIGNIERES,0280664V,71,68,0,3,31,40,4 ème
EURE-ET-LOIR,NOGENT-LE-ROTROU,0280669A,49,47,0,2,23,26,4 ème
EURE-ET-LOIR,TOURY,0280884J,126,121,0,5,57,69,4 ème
INDRE,BUZANCAIS,0360498W,112,96,11,5,44,68,4 ème
INDRE,CHATEAUROUX,0360543V,85,85,0,0,49,36,4 ème
INDRE,LA CHATRE,0360720M,106,89,14,3,57,49,4 ème
INDRE,VATAN,0360040Y,68,68,0,0,32,36,4 ème
INDRE-ET-LOIRE,AMBOISE,0371123V,0,0,0,0,0,0,4 ème
INDRE-ET-LOIRE,BLERE,0371124W,142,142,0,0,70,72,4 ème
INDRE-ET-LOIRE,CHATEAU-RENAULT,0370007G,177,160,13,4,96,81,4 ème
INDRE-ET-LOIRE,CHINON,0371159J,147,126,16,5,80,67,4 ème
INDRE-ET-LOIRE,CORMERY,0370010K,104,104,0,0,56,48,4 ème
INDRE-ET-LOIRE,ESVRES,0371204H,116,116,0,0,67,49,4 ème
INDRE-ET-LOIRE,JOUE-LES-TOURS,0371098T,113,111,0,2,60,53,4 ème
INDRE-ET-LOIRE,JOUE-LES-TOURS,0371316E,82,80,0,2,46,36,4 ème
INDRE-ET-LOIRE,LOCHES,0370768J,207,186,14,7,102,105,4 ème
INDRE-ET-LOIRE,LUYNES,0371378X,90,90,0,0,35,55,4 ème
INDRE-ET-LOIRE,MONTRESOR,0370051E,43,43,0,0,19,24,4 ème
INDRE-ET-LOIRE,PREUILLY-SUR-CLAISE,0370738B,14,14,0,0,8,6,4 ème
INDRE-ET-LOIRE,TOURS,0370041U,104,103,0,1,51,53,4 ème
INDRE-ET-LOIRE,TOURS,0370053G,0,0,0,0,0,0,4 ème
INDRE-ET-LOIRE,TOURS,0370743G,75,75,0,0,38,37,4 ème
INDRE-ET-LOIRE,VOUVRAY,0371189S,154,153,0,1,79,75,4 ème
LOIRET,CHATEAU-RENARD,0451107J,96,93,0,3,49,47,4 ème
LOIRET,CHECY,0451365P,191,186,0,5,103,88,4 ème
LOIRET,CLERY-SAINT-ANDRE,0451434P,123,122,0,1,58,65,4 ème
LOIRET,FLEURY-LES-AUBRAIS,0450784H,207,184,16,7,101,106,4 ème
LOIRET,GIEN,0451037H,0,0,0,0,0,0,4 ème
LOIRET,ORLEANS,0450109Z,111,107,0,4,53,58,4 ème
LOIRET,PITHIVIERS,0451332D,65,65,0,0,39,26,4 ème
LOIR-ET-CHER,BLOIS,0410693F,20,20,0,0,11,9,4 ème
LOIR-ET-CHER,BLOIS,0410790L,178,158,16,4,87,91,4 ème
LOIR-ET-CHER,BLOIS,0410860M,178,172,0,6,81,97,4 ème
LOIR-ET-CHER,BLOIS,0410952M,90,87,0,3,47,43,4 ème
LOIR-ET-CHER,BRACIEUX,0410005H,111,107,0,4,44,67,4 ème
LOIR-ET-CHER,LE CONTROIS-EN-SOLOGNE,0410595Z,165,163,0,2,73,92,4 ème
LOIR-ET-CHER,MONDOUBLEAU,0410596A,78,73,0,5,32,46,4 ème
LOIR-ET-CHER,ROMORANTIN-LANTHENAY,0410036S,0,0,0,0,0,0,4 ème
LOIR-ET-CHER,ROMORANTIN-LANTHENAY,0410793P,90,90,0,0,51,39,4 ème
LOIR-ET-CHER,SAMBIN,0410677N,105,105,0,0,56,49,4 ème
LOIR-ET-CHER,SELLES-SUR-CHER,0410651K,111,107,0,4,47,64,4 ème
LOIR-ET-CHER,VENDOME,0410031L,0,0,0,0,0,0,4 ème
LOIR-ET-CHER,VINEUIL,0410773T,43,43,0,0,21,22,4 ème
CORSE-DU-SUD,AJACCIO,6200010S,151,151,0,0,70,81,4 ème
CORSE-DU-SUD,BONIFACIO,6200015X,67,67,0,0,31,36,4 ème
CORSE-DU-SUD,SARROLA-CARCOPINO,6200191N,142,142,0,0,67,75,4 ème
HAUTE-CORSE,BASTIA,7200139N,104,104,0,0,48,56,4 ème
HAUTE-CORSE,BIGUGLIA,7200727C,178,166,12,0,90,88,4 ème
MEURTHE-ET-MOSELLE,BACCARAT,0540001H,107,105,0,2,56,51,4 ème
MEURTHE-ET-MOSELLE,BLENOD-LES-PONT-A-MOUSSON,0541576V,193,167,22,4,94,99,4 ème
MEURTHE-ET-MOSELLE,CHAMPIGNEULLES,0541466A,124,105,16,3,77,47,4 ème
MEURTHE-ET-MOSELLE,CIREY-SUR-VEZOUZE,0540011U,78,69,9,0,40,38,4 ème
MEURTHE-ET-MOSELLE,DIEULOUARD,0540013W,103,98,0,5,48,55,4 ème
MEURTHE-ET-MOSELLE,DOMBASLE-SUR-MEURTHE,0540014X,81,77,0,4,34,47,4 ème
MEURTHE-ET-MOSELLE,DOMBASLE-SUR-MEURTHE,0540015Y,0,0,0,0,0,0,4 ème
MEURTHE-ET-MOSELLE,EINVILLE-AU-JARD,0540017A,60,60,0,0,30,30,4 ème
MEURTHE-ET-MOSELLE,FOUG,0540019C,39,39,0,0,21,18,4 ème
MEURTHE-ET-MOSELLE,HEILLECOURT,0542468P,132,127,0,5,64,68,4 ème
MEURTHE-ET-MOSELLE,JARNY,0540025J,166,147,16,3,82,84,4 ème
MEURTHE-ET-MOSELLE,LONGLAVILLE,0541578X,118,118,0,0,53,65,4 ème
MEURTHE-ET-MOSELLE,LONGUYON,0541452K,23,23,0,0,13,10,4 ème
MEURTHE-ET-MOSELLE,LONGWY,0541989U,124,124,0,0,61,63,4 ème
MEURTHE-ET-MOSELLE,LUNEVILLE,0540037X,0,0,0,0,0,0,4 ème
MEURTHE-ET-MOSELLE,MALZEVILLE,0541474J,158,157,0,1,84,74,4 ème
MEURTHE-ET-MOSELLE,NANCY,0541364P,0,0,0,0,0,0,4 ème
MEURTHE-ET-MOSELLE,NANCY,0541819J,105,105,0,0,61,44,4 ème
MEURTHE-ET-MOSELLE,NEUVES-MAISONS,0541573S,146,125,17,4,74,72,4 ème
MEURTHE-ET-MOSELLE,PONT-A-MOUSSON,0541440X,69,69,0,0,41,28,4 ème
MEURTHE-ET-MOSELLE,TOUL,0541330C,113,104,0,9,48,65,4 ème
MEURTHE-ET-MOSELLE,TOUL,0541565H,175,144,28,3,78,97,4 ème
MEURTHE-ET-MOSELLE,VAL DE BRIEY,0541338L,18,0,18,0,6,12,4 ème
MEURTHE-ET-MOSELLE,VILLERS-LES-NANCY,0541776M,85,81,0,4,44,41,4 ème
MEUSE,ANCEMONT,0550859K,76,76,0,0,33,43,4 ème
MEUSE,ANCERVILLE,0550848Y,66,66,0,0,35,31,4 ème
MEUSE,BAR-LE-DUC,0550046B,85,85,0,0,40,45,4 ème
MEUSE,LIGNY-EN-BARROIS,0550052H,20,20,0,0,11,9,4 ème
MEUSE,LIGNY-EN-BARROIS,0550700M,0,0,0,0,0,0,4 ème
MEUSE,VAUCOULEURS,0550023B,91,87,0,4,43,48,4 ème
MOSELLE,AMNEVILLE,0572689N,130,128,0,2,59,71,4 ème
MOSELLE,BOULAY-MOSELLE,0570225K,0,0,0,0,0,0,4 ème
MOSELLE,CHATEAU-SALINS,0570327W,63,60,0,3,32,31,4 ème
MOSELLE,CREUTZWALD,0572022N,0,0,0,0,0,0,4 ème
MOSELLE,FALCK,0572358D,81,81,0,0,39,42,4 ème
MOSELLE,HAM-SOUS-VARSBERG,0572359E,97,97,0,0,50,47,4 ème
MOSELLE,HARTZVILLER,0570038G,67,67,0,0,27,40,4 ème
MOSELLE,HAYANGE,0570077Z,0,0,0,0,0,0,4 ème
MOSELLE,HAYANGE,0572171A,108,101,0,7,53,55,4 ème
MOSELLE,HAYANGE,0572480L,165,162,0,3,80,85,4 ème
MOSELLE,KEDANGE-SUR-CANNER,0570315H,161,161,0,0,80,81,4 ème
MOSELLE,MARLY,0572082D,105,97,0,8,56,49,4 ème
MOSELLE,MARLY,0572754J,79,79,0,0,37,42,4 ème
MOSELLE,METZ,0570127D,135,124,0,11,66,69,4 ème
MOSELLE,METZ,0572809U,165,165,0,0,73,92,4 ème
MOSELLE,METZ,0572925V,240,240,0,0,135,105,4 ème
MOSELLE,METZ,0573688Z,5,5,0,0,2,3,4 ème
MOSELLE,MONTIGNY-LES-METZ,0570144X,0,0,0,0,0,0,4 ème
MOSELLE,MOULINS-LES-METZ,0572477H,79,67,10,2,37,42,4 ème
MOSELLE,PELTRE,0572928Y,48,48,0,0,18,30,4 ème
MOSELLE,PUTTELANGE-AUX-LACS,0572183N,77,76,0,1,37,40,4 ème
MOSELLE,REMILLY,0572013D,138,134,0,4,65,73,4 ème
MOSELLE,SAINT-AVOLD,0570087K,0,0,0,0,0,0,4 ème
MOSELLE,SAINT-AVOLD,0570268G,0,0,0,0,0,0,4 ème
MOSELLE,SARRALBE,0570093S,106,106,0,0,55,51,4 ème
MOSELLE,SARREBOURG,0572816B,160,156,0,4,71,89,4 ème
MOSELLE,SARREGUEMINES,0572021M,64,64,0,0,32,32,4 ème
MOSELLE,TALANGE,0572174D,115,103,9,3,53,62,4 ème
MOSELLE,THIONVILLE,0572812X,113,112,0,1,53,60,4 ème
MOSELLE,THIONVILLE,0572931B,326,326,0,0,169,157,4 ème
MOSELLE,UCKANGE,0570318L,110,107,0,3,51,59,4 ème
VOSGES,BRUYERES,0880106M,51,51,0,0,31,20,4 ème
VOSGES,ELOYES,0881371M,95,91,0,4,34,61,4 ème
VOSGES,EPINAL,0881119N,13,0,13,0,6,7,4 ème
VOSGES,EPINAL,0881146T,184,164,16,4,77,107,4 ème
VOSGES,GOLBEY,0881097P,174,172,0,2,88,86,4 ème
VOSGES,LAMARCHE,0880034J,39,39,0,0,22,17,4 ème
VOSGES,LIFFOL-LE-GRAND,0881103W,50,50,0,0,33,17,4 ème
VOSGES,MONTHUREUX-SUR-SAONE,0881386D,59,59,0,0,33,26,4 ème
VOSGES,NEUFCHATEAU,0880040R,0,0,0,0,0,0,4 ème
VOSGES,PROVENCHERES-ET-COLROY,0880044V,63,63,0,0,26,37,4 ème
VOSGES,RAMBERVILLERS,0880114W,46,44,0,2,19,27,4 ème
VOSGES,RAON-L'ETAPE,0881370L,0,0,0,0,0,0,4 ème
VOSGES,REMIREMONT,0881498A,0,0,0,0,0,0,4 ème
VOSGES,VAGNEY,0881372N,85,80,0,5,39,46,4 ème
ARDENNES,CHARLEVILLE-MEZIERES,0080011U,78,75,0,3,42,36,4 ème
ARDENNES,CHARLEVILLE-MEZIERES,0080082W,0,0,0,0,0,0,4 ème
ARDENNES,CHARLEVILLE-MEZIERES,0080829H,76,76,0,0,42,34,4 ème
ARDENNES,CHARLEVILLE-MEZIERES,0080994M,93,93,0,0,49,44,4 ème
ARDENNES,FUMAY,0080017A,75,67,6,2,36,39,4 ème
ARDENNES,RAUCOURT-ET-FLABA,0081103F,65,65,0,0,25,40,4 ème
ARDENNES,RETHEL,0080897G,110,107,0,3,61,49,4 ème
ARDENNES,SEDAN,0080826E,86,68,17,1,42,44,4 ème
ARDENNES,SEDAN,0080995N,129,129,0,0,58,71,4 ème
ARDENNES,SIGNY-L'ABBAYE,0081104G,85,85,0,0,46,39,4 ème
AUBE,BRIENNE-LE-CHATEAU,0100007D,106,101,5,0,45,61,4 ème
AUBE,MESNIL-SAINT-LOUP,0100051B,26,26,0,0,9,17,4 ème
AUBE,NOGENT-SUR-SEINE,0100786A,141,140,0,1,73,68,4 ème
AUBE,PINEY,0100013K,74,74,0,0,44,30,4 ème
AUBE,TROYES,0100038M,124,122,0,2,51,73,4 ème
AUBE,TROYES,0100056G,60,60,0,0,40,20,4 ème
HAUTE-MARNE,BOURBONNE-LES-BAINS,0520706K,52,48,0,4,30,22,4 ème
HAUTE-MARNE,CHALINDREY,0520794F,34,34,0,0,15,19,4 ème
HAUTE-MARNE,CHAUMONT,0520733P,106,103,0,3,59,47,4 ème
HAUTE-MARNE,CHAUMONT,0520737U,96,92,0,4,46,50,4 ème
HAUTE-MARNE,COLOMBEY LES DEUX EGLISES,0520814C,27,27,0,0,17,10,4 ème
HAUTE-MARNE,LANGRES,0520052Z,76,72,0,4,38,38,4 ème
HAUTE-MARNE,LANGRES,0520967U,36,36,0,0,20,16,4 ème
HAUTE-MARNE,SAINT-DIZIER,0521123N,8,8,0,0,3,5,4 ème
HAUTE-MARNE,VAL-DE-MEUSE,0520023T,43,43,0,0,19,24,4 ème
HAUTE-MARNE,WASSY,0520708M,80,77,0,3,40,40,4 ème
MARNE,BLANCS-COTEAUX,0510059M,94,94,0,0,38,56,4 ème
MARNE,CHALONS-EN-CHAMPAGNE,0511711H,47,43,0,4,24,23,4 ème
MARNE,EPERNAY,0510068X,0,0,0,0,0,0,4 ème
MARNE,FERE-CHAMPENOISE,0510022X,61,59,0,2,27,34,4 ème
MARNE,FISMES,0511176B,58,56,0,2,29,29,4 ème
MARNE,PONTFAVERGER-MORONVILLIERS,0510030F,100,100,0,0,48,52,4 ème
MARNE,REIMS,0511138K,205,202,0,3,122,83,4 ème
MARNE,REIMS,0511146U,0,0,0,0,0,0,4 ème
MARNE,REIMS,0511799D,124,123,0,1,69,55,4 ème
MARNE,REIMS,0511802G,85,76,0,9,50,35,4 ème
MARNE,SERMAIZE-LES-BAINS,0510052E,108,104,4,0,50,58,4 ème
MARNE,SEZANNE,0510053F,0,0,0,0,0,0,4 ème
MARNE,SEZANNE,0510054G,138,116,16,6,67,71,4 ème
MARNE,TINQUEUX,0511187N,197,170,21,6,105,92,4 ème
MARNE,VITRY-LE-FRANCOIS,0511256N,105,82,18,5,50,55,4 ème
BAS-RHIN,BARR,0673006D,99,78,15,6,45,54,4 ème
BAS-RHIN,BISCHHEIM,0671822S,134,126,0,8,72,62,4 ème
BAS-RHIN,BISCHWILLER,0672130B,252,215,28,9,128,124,4 ème
BAS-RHIN,BOUXWILLER,0672076T,164,140,21,3,87,77,4 ème
BAS-RHIN,DIEMERINGEN,0671741D,67,66,0,1,32,35,4 ème
BAS-RHIN,HAGUENAU,0670024M,0,0,0,0,0,0,4 ème
BAS-RHIN,HAGUENAU,0671509B,0,0,0,0,0,0,4 ème
BAS-RHIN,INGWILLER,0670035Z,68,66,0,2,38,30,4 ème
BAS-RHIN,LA WANTZENAU,0671689X,127,127,0,0,65,62,4 ème
BAS-RHIN,OBERNAI,0670050R,0,0,0,0,0,0,4 ème
BAS-RHIN,PFULGRIESHEIM,0672193V,152,149,0,3,87,65,4 ème
BAS-RHIN,SCHILTIGHEIM,0670062D,0,0,0,0,0,0,4 ème
BAS-RHIN,SCHILTIGHEIM,0672602P,0,0,0,0,0,0,4 ème
BAS-RHIN,SELESTAT,0671832C,0,0,0,0,0,0,4 ème
BAS-RHIN,STRASBOURG,0670129B,0,0,0,0,0,0,4 ème
BAS-RHIN,STRASBOURG,0671692A,90,72,14,4,38,52,4 ème
BAS-RHIN,STRASBOURG,0671907J,193,173,16,4,95,98,4 ème
BAS-RHIN,STRASBOURG,0671958P,125,122,0,3,58,67,4 ème
BAS-RHIN,STRASBOURG,0672129A,119,118,0,1,71,48,4 ème
BAS-RHIN,STRASBOURG,0672306T,192,192,0,0,104,88,4 ème
BAS-RHIN,STRASBOURG,0672806L,0,0,0,0,0,0,4 ème
HAUT-RHIN,BUHL,0682018Z,99,99,0,0,50,49,4 ème
HAUT-RHIN,BURNHAUPT-LE-HAUT,0682017Y,154,150,0,4,75,79,4 ème
HAUT-RHIN,CARSPACH,0680154Y,0,0,0,0,0,0,4 ème
HAUT-RHIN,COLMAR,0680009R,138,134,0,4,61,77,4 ème
HAUT-RHIN,COLMAR,0680084X,137,105,26,6,74,63,4 ème
HAUT-RHIN,COLMAR,0681656F,0,0,0,0,0,0,4 ème
HAUT-RHIN,GUEBWILLER,0681318N,174,141,30,3,69,105,4 ème
HAUT-RHIN,HABSHEIM,0681713T,74,74,0,0,31,43,4 ème
HAUT-RHIN,ILLZACH,0681757R,79,79,0,0,44,35,4 ème
HAUT-RHIN,INGERSHEIM,0681654D,112,110,0,2,55,57,4 ème
HAUT-RHIN,KAYSERSBERG VIGNOBLE,0680022E,34,34,0,0,15,19,4 ème
HAUT-RHIN,KINGERSHEIM,0681369U,146,143,0,3,69,77,4 ème
HAUT-RHIN,MASEVAUX-NIEDERBRUCK,0681265F,120,120,0,0,55,65,4 ème
HAUT-RHIN,MULHOUSE,0680037W,0,0,0,0,0,0,4 ème
HAUT-RHIN,MULHOUSE,0681284B,111,111,0,0,53,58,4 ème
HAUT-RHIN,MUNSTER,0681539D,142,142,0,0,76,66,4 ème
HAUT-RHIN,PULVERSHEIM,0681801N,0,0,0,0,0,0,4 ème
HAUT-RHIN,RIEDISHEIM,0680112C,134,130,0,4,59,75,4 ème
HAUT-RHIN,RIXHEIM,0680129W,161,141,16,4,73,88,4 ème
HAUT-RHIN,ROUFFACH,0680139G,88,88,0,0,46,42,4 ème
HAUT-RHIN,SAINTE-MARIE-AUX-MINES,0680068E,0,0,0,0,0,0,4 ème
HAUT-RHIN,SAINTE-MARIE-AUX-MINES,0681394W,89,72,15,2,43,46,4 ème
HAUT-RHIN,WINTZENHEIM,0681365P,132,111,15,6,60,72,4 ème
GUADELOUPE,BAIE-MAHAULT,9710040S,248,243,0,5,128,120,4 ème
GUADELOUPE,BAIE-MAHAULT,9710057K,154,154,0,0,77,77,4 ème
GUADELOUPE,BAIE-MAHAULT,9710593T,0,0,0,0,0,0,4 ème
GUADELOUPE,BASSE-TERRE,9710061P,38,38,0,0,23,15,4 ème
GUADELOUPE,DESHAIES,9710643X,48,48,0,0,23,25,4 ème
GUADELOUPE,GRAND-BOURG,9711012Y,0,0,0,0,0,0,4 ème
GUADELOUPE,LES ABYMES,9711046K,0,0,0,0,0,0,4 ème
GUADELOUPE,MORNE-A-L'EAU,9710709U,0,0,0,0,0,0,4 ème
GUADELOUPE,PETIT-BOURG,9710016R,230,207,18,5,109,121,4 ème
GUADELOUPE,POINTE-A-PITRE,9710661S,72,72,0,0,37,35,4 ème
GUADELOUPE,POINTE-A-PITRE,9710987W,177,177,0,0,100,77,4 ème
GUADELOUPE,POINTE-A-PITRE,9710988X,80,80,0,0,39,41,4 ème
GUADELOUPE,SAINT-BARTHELEMY,9710035L,87,81,0,6,41,46,4 ème
GUADELOUPE,TROIS-RIVIERES,9710707S,82,80,0,2,37,45,4 ème
GUYANE,CAMOPI,9730451C,27,22,3,2,10,17,4 ème
GUYANE,CAYENNE,9730132F,146,146,0,0,70,76,4 ème
GUYANE,MATOURY,9730536V,90,90,0,0,46,44,4 ème
GUYANE,SAINT-LAURENT-DU-MARONI,9730497C,62,62,0,0,31,31,4 ème
GUYANE,SINNAMARY,9730145V,42,34,4,4,17,25,4 ème
AISNE,ANIZY-LE-GRAND,0020002S,134,128,6,0,65,69,4 ème
AISNE,BOHAIN-EN-VERMANDOIS,0020007X,102,79,16,7,54,48,4 ème
AISNE,BOHAIN-EN-VERMANDOIS,0020498F,0,0,0,0,0,0,4 ème
AISNE,CHAUNY,0020469Z,58,58,0,0,35,23,4 ème
AISNE,CHAUNY,0021906L,0,0,0,0,0,0,4 ème
AISNE,CRECY-SUR-SERRE,0021721K,98,98,0,0,53,45,4 ème
AISNE,FONTAINE-LES-VERVINS,0020470A,43,43,0,0,19,24,4 ème
AISNE,FRESNOY-LE-GRAND,0021661V,103,98,0,5,52,51,4 ème
AISNE,GAUCHY,0021494N,109,98,8,3,52,57,4 ème
AISNE,GUISE,0020030X,85,63,17,5,31,54,4 ème
AISNE,GUISE,0021479X,0,0,0,0,0,0,4 ème
AISNE,HIRSON,0020484R,35,35,0,0,23,12,4 ème
AISNE,LAON,0020034B,0,0,0,0,0,0,4 ème
AISNE,LAON,0020471B,49,49,0,0,27,22,4 ème
AISNE,LAON,0021598B,164,144,15,5,75,89,4 ème
AISNE,LAON,0021685W,158,154,0,4,56,102,4 ème
AISNE,MARLE,0021778X,55,54,0,1,29,26,4 ème
AISNE,SAINS-RICHAUMONT,0020044M,39,39,0,0,22,17,4 ème
AISNE,SAINT-QUENTIN,0020055Z,101,84,16,1,40,61,4 ème
AISNE,SAINT-QUENTIN,0020076X,66,66,0,0,36,30,4 ème
AISNE,SOISSONS,0021525X,189,189,0,0,90,99,4 ème
AISNE,SOISSONS,0021535H,97,88,0,9,46,51,4 ème
OISE,AUNEUIL,0601799E,124,111,10,3,65,59,4 ème
OISE,BEAUVAIS,0601139M,148,145,0,3,69,79,4 ème
OISE,BEAUVAIS,0601190T,159,137,16,6,73,86,4 ème
OISE,BREUIL-LE-VERT,0601834T,200,179,16,5,94,106,4 ème
OISE,CHAUMONT-EN-VEXIN,0600012M,90,90,0,0,39,51,4 ème
OISE,CHAUMONT-EN-VEXIN,0601882V,136,136,0,0,72,64,4 ème
OISE,GUISCARD,0602004C,73,73,0,0,40,33,4 ème
OISE,MERU,0601718S,111,107,0,4,59,52,4 ème
OISE,NOGENT-SUR-OISE,0600036N,145,141,0,4,71,74,4 ème
OISE,NOGENT-SUR-OISE,0601179F,193,191,0,2,95,98,4 ème
OISE,SAINTE-GENEVIEVE,0601938F,141,136,0,5,70,71,4 ème
OISE,SENLIS,0600049C,0,0,0,0,0,0,4 ème
OISE,SENLIS,0601150Z,252,247,0,5,127,125,4 ème
OISE,THOUROTTE,0601446W,162,157,0,5,94,68,4 ème
OISE,VERBERIE,0601407D,128,128,0,0,56,72,4 ème
SOMME,ACHEUX-EN-AMIENOIS,0800003U,74,74,0,0,32,42,4 ème
SOMME,AIRAINES,0801510G,97,76,16,5,47,50,4 ème
SOMME,ALBERT,0801786G,92,69,17,6,46,46,4 ème
SOMME,AMIENS,0800017J,108,80,17,11,41,67,4 ème
SOMME,AMIENS,0800018K,167,145,16,6,76,91,4 ème
SOMME,AMIENS,0801208D,53,53,0,0,27,26,4 ème
SOMME,AMIENS,0801211G,132,132,0,0,65,67,4 ème
SOMME,AMIENS,0802134K,64,61,0,3,27,37,4 ème
SOMME,BEAUCAMPS-LE-VIEUX,0801443J,64,59,0,5,31,33,4 ème
SOMME,FLIXECOURT,0801222U,55,55,0,0,22,33,4 ème
SOMME,PERONNE,0801723N,83,83,0,0,39,44,4 ème
SOMME,VILLERS-BOCAGE,0801339W,127,127,0,0,57,70,4 ème
NORD,ANICHE,0590002G,205,186,17,2,114,91,4 ème
NORD,ARMENTIERES,0593246H,158,141,17,0,86,72,4 ème
NORD,AUBY,0594297A,90,80,5,5,49,41,4 ème
NORD,AUBY,0594532F,0,0,0,0,0,0,4 ème
NORD,AULNOYE-AYMERIES,0595383F,47,47,0,0,18,29,4 ème
NORD,AULNOYE-AYMERIES,0596694F,186,177,6,3,94,92,4 ème
NORD,AULNOY-LEZ-VALENCIENNES,0593673X,113,102,11,0,64,49,4 ème
NORD,AVESNES-LES-AUBERT,0593676A,108,104,0,4,47,61,4 ème
NORD,BEAUCAMPS-LIGNY,0595360F,365,365,0,0,193,172,4 ème
NORD,CAMBRAI,0593061G,0,0,0,0,0,0,4 ème
NORD,CAPPELLE-LA-GRANDE,0593181M,81,77,0,4,47,34,4 ème
NORD,CAUDRY,0590046E,162,162,0,0,76,86,4 ème
NORD,CAUDRY,0595277R,136,103,30,3,71,65,4 ème
NORD,COMINES,0592959W,128,128,0,0,73,55,4 ème
NORD,DOUCHY-LES-MINES,0593484S,173,160,8,5,82,91,4 ème
NORD,ESCAUTPONT,0594409X,68,68,0,0,29,39,4 ème
NORD,ESTAIRES,0597005U,0,0,0,0,0,0,4 ème
NORD,FACHES-THUMESNIL,0592830F,94,94,0,0,50,44,4 ème
NORD,FERRIERE-LA-GRANDE,0593681F,115,103,12,0,60,55,4 ème
NORD,FOURNES-EN-WEPPES,0596801X,35,35,0,0,12,23,4 ème
NORD,FRESNES-SUR-ESCAUT,0593486U,75,75,0,0,41,34,4 ème
NORD,GOUZEAUCOURT,0590087Z,60,60,0,0,39,21,4 ème
NORD,GRANDE-SYNTHE,0594652L,0,0,0,0,0,0,4 ème
NORD,HALLUIN,0592850C,0,0,0,0,0,0,4 ème
NORD,HALLUIN,0593125B,89,89,0,0,46,43,4 ème
NORD,HAUBOURDIN,0594386X,98,98,0,0,40,58,4 ème
NORD,HAZEBROUCK,0590103S,151,130,15,6,70,81,4 ème
NORD,HEM,0594632P,141,122,13,6,60,81,4 ème
NORD,HONDSCHOOTE,0593130G,22,22,0,0,12,10,4 ème
NORD,HONDSCHOOTE,0594642A,95,95,0,0,50,45,4 ème
NORD,JEUMONT,0593132J,81,76,0,5,38,43,4 ème
NORD,JEUMONT,0594418G,83,83,0,0,40,43,4 ème
NORD,LA BASSEE,0590252D,0,0,0,0,0,0,4 ème
NORD,LA BASSEE,0593231S,233,215,18,0,115,118,4 ème
NORD,LALLAING,0593482P,91,78,8,5,54,37,4 ème
NORD,LAMBERSART,0593015G,0,0,0,0,0,0,4 ème
NORD,LAMBERSART,0593134L,210,210,0,0,100,110,4 ème
NORD,LILLE,0590271Z,98,84,14,0,49,49,4 ème
NORD,LILLE,0593177H,50,42,8,0,20,30,4 ème
NORD,LILLE,0593180L,216,203,11,2,92,124,4 ème
NORD,LILLE,0594881K,85,83,0,2,35,50,4 ème
NORD,LILLE,0595396V,105,96,0,9,52,53,4 ème
NORD,LOOS,0593030Y,0,0,0,0,0,0,4 ème
NORD,LYS-LEZ-LANNOY,0593240B,171,157,12,2,82,89,4 ème
NORD,LYS-LEZ-LANNOY,0594380R,11,0,11,0,2,9,4 ème
NORD,MARCHIENNES,0590142J,77,77,0,0,40,37,4 ème
NORD,MARCQ-EN-BAROEUL,0594287P,104,92,10,2,46,58,4 ème
NORD,MARLY,0594302F,0,0,0,0,0,0,4 ème
NORD,MORTAGNE-DU-NORD,0594410Y,81,81,0,0,33,48,4 ème
NORD,NEUVILLE-EN-FERRAIN,0594833H,127,127,0,0,54,73,4 ème
NORD,ORCHIES,0590159C,211,202,9,0,105,106,4 ème
NORD,OSTRICOURT,0594290T,73,63,10,0,31,42,4 ème
NORD,POIX-DU-NORD,0594876E,66,66,0,0,37,29,4 ème
NORD,ROUBAIX,0590187H,0,0,0,0,0,0,4 ème
NORD,ROUBAIX,0592907P,148,145,0,3,78,70,4 ème
NORD,ROUBAIX,0592964B,0,0,0,0,0,0,4 ème
NORD,SAINT-AMAND-LES-EAUX,0594304H,108,108,0,0,44,64,4 ème
NORD,SOLESMES,0594648G,158,145,12,1,65,93,4 ème
NORD,TOURCOING,0593140T,195,195,0,0,94,101,4 ème
NORD,TOURCOING,0594293W,147,147,0,0,75,72,4 ème
NORD,TOURCOING,0596846W,192,192,0,0,99,93,4 ème
NORD,TOURCOING,0596860L,168,154,11,3,81,87,4 ème
NORD,TRELON,0594308M,63,63,0,0,30,33,4 ème
NORD,TRITH-SAINT-LEGER,0594534H,50,45,0,5,21,29,4 ème
NORD,VALENCIENNES,0592715F,124,120,0,4,60,64,4 ème
NORD,WALINCOURT-SELVIGNY,0590228C,95,92,0,3,52,43,4 ème
NORD,WAVRIN,0593475G,143,139,0,4,62,81,4 ème
NORD,WORMHOUT,0593163T,67,67,0,0,27,40,4 ème
PAS-DE-CALAIS,ACHICOURT,0622863A,164,144,17,3,75,89,4 ème
PAS-DE-CALAIS,ARQUES,0622093N,122,122,0,0,62,60,4 ème
PAS-DE-CALAIS,ARRAS,0622082B,96,93,0,3,42,54,4 ème
PAS-DE-CALAIS,ARRAS,0622103Z,135,135,0,0,61,74,4 ème
PAS-DE-CALAIS,ARRAS,0623310L,103,103,0,0,53,50,4 ème
PAS-DE-CALAIS,AUCHY-LES-MINES,0622946R,92,92,0,0,44,48,4 ème
PAS-DE-CALAIS,AUDRUICQ,0620024P,162,144,15,3,68,94,4 ème
PAS-DE-CALAIS,BERCK,0622128B,70,70,0,0,31,39,4 ème
PAS-DE-CALAIS,BEUVRY,0622090K,193,176,12,5,105,88,4 ème
PAS-DE-CALAIS,BILLY-MONTIGNY,0622793Z,141,122,19,0,58,83,4 ème
PAS-DE-CALAIS,BOULOGNE-SUR-MER,0622130D,114,114,0,0,62,52,4 ème
PAS-DE-CALAIS,BRUAY-LA-BUISSIERE,0620192X,0,0,0,0,0,0,4 ème
PAS-DE-CALAIS,CALAIS,0620196B,75,75,0,0,46,29,4 ème
PAS-DE-CALAIS,CALAIS,0622273J,86,67,19,0,42,44,4 ème
PAS-DE-CALAIS,CALAIS,0623918X,107,107,0,0,46,61,4 ème
PAS-DE-CALAIS,CALONNE-RICOUART,0620068M,98,98,0,0,54,44,4 ème
PAS-DE-CALAIS,CARVIN,0620071R,120,109,11,0,56,64,4 ème
PAS-DE-CALAIS,CARVIN,0622134H,222,222,0,0,96,126,4 ème
PAS-DE-CALAIS,ETAPLES,0622136K,83,83,0,0,46,37,4 ème
PAS-DE-CALAIS,FAUQUEMBERGUES,0620082C,80,80,0,0,38,42,4 ème
PAS-DE-CALAIS,FREVENT,0622137L,50,50,0,0,19,31,4 ème
PAS-DE-CALAIS,GRENAY,0622424Y,122,103,19,0,61,61,4 ème
PAS-DE-CALAIS,GUINES,0620088J,99,80,19,0,50,49,4 ème
PAS-DE-CALAIS,HENIN-BEAUMONT,0622795B,168,147,17,4,75,93,4 ème
PAS-DE-CALAIS,HEUCHIN,0622866D,42,42,0,0,22,20,4 ème
PAS-DE-CALAIS,LENS,0622417R,107,107,0,0,47,60,4 ème
PAS-DE-CALAIS,LUMBRES,0622574L,222,204,16,2,119,103,4 ème
PAS-DE-CALAIS,OIGNIES,0620150B,0,0,0,0,0,0,4 ème
PAS-DE-CALAIS,OYE-PLAGE,0623759Z,98,98,0,0,54,44,4 ème
PAS-DE-CALAIS,SAINS-EN-GOHELLE,0622578R,76,76,0,0,43,33,4 ème
PAS-DE-CALAIS,SAINT-MARTIN-BOULOGNE,0623573X,116,116,0,0,46,70,4 ème
PAS-DE-CALAIS,SAINT-OMER,0620162P,0,0,0,0,0,0,4 ème
PAS-DE-CALAIS,SAINT-VENANT,0622091L,115,115,0,0,65,50,4 ème
PAS-DE-CALAIS,SALLAUMINES,0620220C,0,0,0,0,0,0,4 ème
PAS-DE-CALAIS,SAMER,0622950V,145,145,0,0,64,81,4 ème
SEINE-ET-MARNE,BRAY-SUR-SEINE,0770003K,146,146,0,0,72,74,4 ème
SEINE-ET-MARNE,BUSSY-SAINT-GEORGES,0772226B,127,127,0,0,55,72,4 ème
SEINE-ET-MARNE,BUSSY-SAINT-GEORGES,0772601J,90,90,0,0,50,40,4 ème
SEINE-ET-MARNE,CHAMPAGNE-SUR-SEINE,0770920G,0,0,0,0,0,0,4 ème
SEINE-ET-MARNE,CHELLES,0771471F,223,223,0,0,104,119,4 ème
SEINE-ET-MARNE,CHELLES,0771759U,170,153,17,0,86,84,4 ème
SEINE-ET-MARNE,COMBS-LA-VILLE,0771959L,156,156,0,0,75,81,4 ème
SEINE-ET-MARNE,COUILLY-PONT-AUX-DAMES,0771236A,51,51,0,0,24,27,4 ème
SEINE-ET-MARNE,COULOMMIERS,0771233X,60,60,0,0,27,33,4 ème
SEINE-ET-MARNE,CROUY-SUR-OURCQ,0772246Y,80,65,11,4,31,49,4 ème
SEINE-ET-MARNE,EMERAINVILLE,0772119K,86,86,0,0,38,48,4 ème
SEINE-ET-MARNE,FAREMOUTIERS,0771519H,162,162,0,0,79,83,4 ème
SEINE-ET-MARNE,FONTAINEBLEAU,0771200L,0,0,0,0,0,0,4 ème
SEINE-ET-MARNE,LA ROCHETTE,0770943G,0,0,0,0,0,0,4 ème
SEINE-ET-MARNE,LESIGNY,0771421B,200,198,0,2,94,106,4 ème
SEINE-ET-MARNE,LOGNES,0771992X,108,106,0,2,53,55,4 ème
SEINE-ET-MARNE,MEAUX,0770032S,153,149,0,4,81,72,4 ème
SEINE-ET-MARNE,MEAUX,0771880A,0,0,0,0,0,0,4 ème
SEINE-ET-MARNE,MEAUX,0772153X,0,0,0,0,0,0,4 ème
SEINE-ET-MARNE,MELUN,0771339M,197,162,31,4,86,111,4 ème
SEINE-ET-MARNE,MITRY-MORY,0772573D,202,202,0,0,100,102,4 ème
SEINE-ET-MARNE,MONTEREAU-FAULT-YONNE,0771761W,123,123,0,0,57,66,4 ème
SEINE-ET-MARNE,MORMANT,0771620T,190,187,0,3,87,103,4 ème
SEINE-ET-MARNE,NEMOURS,0771478N,119,94,22,3,50,69,4 ème
SEINE-ET-MARNE,OISSERY,0771912K,163,145,16,2,81,82,4 ème
SEINE-ET-MARNE,PONTAULT-COMBAULT,0772331R,136,136,0,0,68,68,4 ème
SEINE-ET-MARNE,PROVINS,0771216D,111,111,0,0,58,53,4 ème
SEINE-ET-MARNE,PROVINS,0772481D,97,96,0,1,46,51,4 ème
SEINE-ET-MARNE,ROISSY-EN-BRIE,0771657H,153,133,15,5,75,78,4 ème
SEINE-ET-MARNE,SAINT-MARD,0771615M,162,162,0,0,72,90,4 ème
SEINE-ET-MARNE,SAVIGNY-LE-TEMPLE,0771518G,167,160,0,7,81,86,4 ème
SEINE-ET-MARNE,TORCY,0771656G,155,136,15,4,64,91,4 ème
SEINE-ET-MARNE,TOURNAN-EN-BRIE,0770051M,240,205,31,4,112,128,4 ème
SEINE-ET-MARNE,VILLENEUVE-SUR-BELLOT,0770057U,100,97,0,3,52,48,4 ème
SEINE-ET-MARNE,VILLEPARISIS,0771333F,106,106,0,0,53,53,4 ème
SEINE-SAINT-DENIS,AUBERVILLIERS,0932043R,55,55,0,0,22,33,4 ème
SEINE-SAINT-DENIS,AULNAY-SOUS-BOIS,0931189M,164,158,0,6,78,86,4 ème
SEINE-SAINT-DENIS,BAGNOLET,0931181D,153,138,14,1,69,84,4 ème
SEINE-SAINT-DENIS,BAGNOLET,0931220W,154,154,0,0,65,89,4 ème
SEINE-SAINT-DENIS,BOBIGNY,0931195U,142,139,0,3,71,71,4 ème
SEINE-SAINT-DENIS,BOBIGNY,0931844Z,91,91,0,0,91,0,4 ème
SEINE-SAINT-DENIS,BOBIGNY,0932123C,0,0,0,0,0,0,4 ème
SEINE-SAINT-DENIS,BONDY,0930933J,0,0,0,0,0,0,4 ème
SEINE-SAINT-DENIS,BONDY,0931788N,138,134,0,4,78,60,4 ème
SEINE-SAINT-DENIS,CLICHY-SOUS-BOIS,0931221X,153,137,16,0,74,79,4 ème
SEINE-SAINT-DENIS,DRANCY,0930907F,96,96,0,0,49,47,4 ème
SEINE-SAINT-DENIS,DRANCY,0931202B,143,143,0,0,61,82,4 ème
SEINE-SAINT-DENIS,DRANCY,0931377S,174,158,16,0,83,91,4 ème
SEINE-SAINT-DENIS,GAGNY,0930858C,132,132,0,0,64,68,4 ème
SEINE-SAINT-DENIS,LA COURNEUVE,0931148T,160,142,14,4,73,87,4 ème
SEINE-SAINT-DENIS,LE BLANC-MESNIL,0931204D,163,163,0,0,85,78,4 ème
SEINE-SAINT-DENIS,LE BLANC-MESNIL,0931433C,204,188,16,0,98,106,4 ème
SEINE-SAINT-DENIS,LE BOURGET,0930963S,54,54,0,0,26,28,4 ème
SEINE-SAINT-DENIS,LE BOURGET,0931187K,165,164,0,1,82,83,4 ème
SEINE-SAINT-DENIS,LES PAVILLONS-SOUS-BOIS,0930100D,97,95,0,2,51,46,4 ème
SEINE-SAINT-DENIS,LES PAVILLONS-SOUS-BOIS,0930136T,0,0,0,0,0,0,4 ème
SEINE-SAINT-DENIS,LIVRY-GARGAN,0932695Z,160,156,0,4,80,80,4 ème
SEINE-SAINT-DENIS,MONTREUIL,0930912L,58,58,0,0,33,25,4 ème
SEINE-SAINT-DENIS,MONTREUIL,0930960N,0,0,0,0,0,0,4 ème
SEINE-SAINT-DENIS,MONTREUIL,0931209J,92,92,0,0,38,54,4 ème
SEINE-SAINT-DENIS,NOISY-LE-GRAND,0931978V,157,156,0,1,89,68,4 ème
SEINE-SAINT-DENIS,NOISY-LE-SEC,0930133P,0,0,0,0,0,0,4 ème
SEINE-SAINT-DENIS,PANTIN,0930135S,0,0,0,0,0,0,4 ème
SEINE-SAINT-DENIS,PANTIN,0931216S,95,95,0,0,42,53,4 ème
SEINE-SAINT-DENIS,PANTIN,0931528F,152,138,14,0,59,93,4 ème
SEINE-SAINT-DENIS,SAINT-DENIS,0931489N,123,104,14,5,63,60,4 ème
SEINE-SAINT-DENIS,SAINT-OUEN,0931143M,172,156,16,0,81,91,4 ème
SEINE-SAINT-DENIS,STAINS,0931226C,180,166,14,0,85,95,4 ème
SEINE-SAINT-DENIS,TREMBLAY-EN-FRANCE,0931191P,140,136,0,4,67,73,4 ème
SEINE-SAINT-DENIS,VILLEPINTE,0932263E,143,143,0,0,78,65,4 ème
SEINE-SAINT-DENIS,VILLETANEUSE,0932334G,137,137,0,0,65,72,4 ème
VAL-DE-MARNE,ALFORTVILLE,0941021Z,98,96,0,2,60,38,4 ème
VAL-DE-MARNE,BOISSY-SAINT-LEGER,0941478W,90,90,0,0,43,47,4 ème
VAL-DE-MARNE,CACHAN,0940823J,0,0,0,0,0,0,4 ème
VAL-DE-MARNE,CACHAN,0941100K,137,137,0,0,66,71,4 ème
VAL-DE-MARNE,CACHAN,0941101L,113,111,0,2,58,55,4 ème
VAL-DE-MARNE,CHAMPIGNY-SUR-MARNE,0940132H,0,0,0,0,0,0,4 ème
VAL-DE-MARNE,CHAMPIGNY-SUR-MARNE,0940807S,81,81,0,0,46,35,4 ème
VAL-DE-MARNE,CHAMPIGNY-SUR-MARNE,0941951K,0,0,0,0,0,0,4 ème
VAL-DE-MARNE,CHAMPIGNY-SUR-MARNE,0942499F,55,55,0,0,30,25,4 ème
VAL-DE-MARNE,CHENNEVIERES-SUR-MARNE,0941470M,0,0,0,0,0,0,4 ème
VAL-DE-MARNE,CHEVILLY-LARUE,0940071S,119,115,0,4,54,65,4 ème
VAL-DE-MARNE,CHEVILLY-LARUE,0940581W,97,97,0,0,49,48,4 ème
VAL-DE-MARNE,CHOISY-LE-ROI,0941231C,120,113,0,7,65,55,4 ème
VAL-DE-MARNE,CHOISY-LE-ROI,0941232D,0,0,0,0,0,0,4 ème
VAL-DE-MARNE,CRETEIL,0940114N,0,0,0,0,0,0,4 ème
VAL-DE-MARNE,CRETEIL,0941942A,43,43,0,0,0,43,4 ème
VAL-DE-MARNE,FONTENAY-SOUS-BOIS,0941090Z,132,132,0,0,69,63,4 ème
VAL-DE-MARNE,FRESNES,0940101Z,113,113,0,0,58,55,4 ème
VAL-DE-MARNE,IVRY-SUR-SEINE,0941026E,138,138,0,0,52,86,4 ème
VAL-DE-MARNE,JOINVILLE-LE-PONT,0940038F,92,92,0,0,29,63,4 ème
VAL-DE-MARNE,JOINVILLE-LE-PONT,0942355Z,0,0,0,0,0,0,4 ème
VAL-DE-MARNE,LA QUEUE-EN-BRIE,0941410X,131,131,0,0,61,70,4 ème
VAL-DE-MARNE,LIMEIL-BREVANNES,0941783C,141,135,0,6,71,70,4 ème
VAL-DE-MARNE,MANDRES-LES-ROSES,0942187S,105,105,0,0,56,49,4 ème
VAL-DE-MARNE,NOGENT-SUR-MARNE,0941599C,103,103,0,0,44,59,4 ème
VAL-DE-MARNE,ORLY,0940138P,0,0,0,0,0,0,4 ème
VAL-DE-MARNE,ORLY,0941042X,147,143,0,4,75,72,4 ème
VAL-DE-MARNE,ORLY,0941891V,29,26,0,3,18,11,4 ème
VAL-DE-MARNE,SUCY-EN-BRIE,0940617K,173,156,17,0,92,81,4 ème
VAL-DE-MARNE,SUCY-EN-BRIE,0941716E,182,182,0,0,89,93,4 ème
VAL-DE-MARNE,THIAIS,0940575P,151,117,30,4,66,85,4 ème
VAL-DE-MARNE,THIAIS,0942119T,9,9,0,0,3,6,4 ème
VAL-DE-MARNE,VILLEJUIF,0941036R,108,108,0,0,52,56,4 ème
VAL-DE-MARNE,VINCENNES,0941718G,145,145,0,0,76,69,4 ème
VAL-DE-MARNE,VITRY-SUR-SEINE,0940042K,107,104,0,3,53,54,4 ème
VAL-DE-MARNE,VITRY-SUR-SEINE,0940794C,140,140,0,0,63,77,4 ème
VAL-DE-MARNE,VITRY-SUR-SEINE,0941029H,133,131,0,2,65,68,4 ème
PARIS,PARIS,0752923V,178,178,0,0,78,100,4 ème
PARIS,PARIS,0750608D,118,116,0,2,60,58,4 ème
PARIS,PARIS,0754290F,49,48,0,1,19,30,4 ème
PARIS,PARIS,0752845K,0,0,0,0,0,0,4 ème
PARIS,PARIS,0750525N,114,110,0,4,53,61,4 ème
PARIS,PARIS,0751710B,0,0,0,0,0,0,4 ème
PARIS,PARIS,0752385K,110,92,17,1,53,57,4 ème
PARIS,PARIS,0752539C,116,115,0,1,70,46,4 ème
PARIS,PARIS,0751563S,112,107,0,5,55,57,4 ème
PARIS,PARIS,0752190Y,122,101,16,5,49,73,4 ème
PARIS,PARIS,0756020L,5,5,0,0,0,5,4 ème
PARIS,PARIS,0752551R,147,144,0,3,73,74,4 ème
PARIS,PARIS,0752917N,184,184,0,0,85,99,4 ème
PARIS,PARIS,0753217P,0,0,0,0,0,0,4 ème
PARIS,PARIS,0755192L,25,25,0,0,8,17,4 ème
PARIS,PARIS,0752319N,0,0,0,0,0,0,4 ème
PARIS,PARIS,0754239A,0,0,0,0,0,0,4 ème
PARIS,PARIS,0755030K,74,69,0,5,35,39,4 ème
PARIS,PARIS,0750484U,73,67,0,6,29,44,4 ème
PARIS,PARIS,0750507U,136,122,14,0,66,70,4 ème
PARIS,PARIS,0750802P,0,0,0,0,0,0,4 ème
PARIS,PARIS,0753345D,96,93,0,3,51,45,4 ème
PARIS,PARIS,0754003U,87,87,0,0,43,44,4 ème
PARIS,PARIS,0755095F,88,85,0,3,49,39,4 ème
PARIS,PARIS,0750550R,96,94,0,2,48,48,4 ème
PARIS,PARIS,0753387Z,10,10,0,0,2,8,4 ème
PARIS,PARIS,0750770E,0,0,0,0,0,0,4 ème
PARIS,PARIS,0752523K,108,104,0,4,49,59,4 ème
PARIS,PARIS,0752524L,111,111,0,0,51,60,4 ème
PARIS,PARIS,0752913J,95,95,0,0,55,40,4 ème
PARIS,PARIS,0753840S,0,0,0,0,0,0,4 ème
PARIS,PARIS,0754757N,96,96,0,0,54,42,4 ème
PARIS,PARIS,0752894N,133,133,0,0,65,68,4 ème
PARIS,PARIS,0752899U,126,126,0,0,66,60,4 ème
PARIS,PARIS,0752842G,269,264,0,5,144,125,4 ème
PARIS,PARIS,0752250N,109,108,0,1,64,45,4 ème
ESSONNE,BOUSSY-SAINT-ANTOINE,0911022S,206,206,0,0,91,115,4 ème
ESSONNE,BRETIGNY-SUR-ORGE,0910827E,136,136,0,0,68,68,4 ème
ESSONNE,BRIIS-SOUS-FORGES,0911920T,130,130,0,0,65,65,4 ème
ESSONNE,BRUNOY,0911746D,215,215,0,0,107,108,4 ème
ESSONNE,CHILLY-MAZARIN,0910777A,209,205,0,4,100,109,4 ème
ESSONNE,CORBEIL-ESSONNES,0910752Y,173,173,0,0,86,87,4 ème
ESSONNE,DOURDAN,0911015J,118,118,0,0,46,72,4 ème
ESSONNE,EVRY-COURCOURONNES,0911250P,132,127,0,5,71,61,4 ème
ESSONNE,EVRY-COURCOURONNES,0911729K,150,147,0,3,79,71,4 ème
ESSONNE,GIF-SUR-YVETTE,0910024G,162,161,0,1,73,89,4 ème
ESSONNE,GRIGNY,0912196T,127,123,0,4,53,74,4 ème
ESSONNE,GUIGNEVILLE-SUR-ESSONNE,0911574S,132,116,14,2,63,69,4 ème
ESSONNE,IGNY,0910969J,175,175,0,0,90,85,4 ème
ESSONNE,ITTEVILLE,0912109Y,134,134,0,0,76,58,4 ème
ESSONNE,MASSY,0910632T,0,0,0,0,0,0,4 ème
ESSONNE,MILLY-LA-FORET,0911404G,171,170,0,1,86,85,4 ème
ESSONNE,MONTGERON,0911396Y,141,129,12,0,81,60,4 ème
ESSONNE,MORANGIS,0910041A,198,194,0,4,96,102,4 ème
ESSONNE,ORSAY,0911749G,87,86,0,1,45,42,4 ème
ESSONNE,QUINCY-SOUS-SENART,0911493D,0,0,0,0,0,0,4 ème
ESSONNE,RIS-ORANGIS,0910049J,247,240,0,7,121,126,4 ème
ESSONNE,RIS-ORANGIS,0911025V,212,194,16,2,95,117,4 ème
ESSONNE,RIS-ORANGIS,0911578W,0,0,0,0,0,0,4 ème
ESSONNE,SAINTE-GENEVIEVE-DES-BOIS,0911042N,170,166,0,4,77,93,4 ème
ESSONNE,SAVIGNY-SUR-ORGE,0911889J,2,2,0,0,1,1,4 ème
ESSONNE,VIRY-CHATILLON,0910056S,95,95,0,0,52,43,4 ème
HAUTS-DE-SEINE,ANTONY,0921243B,110,110,0,0,52,58,4 ème
HAUTS-DE-SEINE,ANTONY,0921868F,89,89,0,0,39,50,4 ème
HAUTS-DE-SEINE,ANTONY,0921901S,374,372,0,2,195,179,4 ème
HAUTS-DE-SEINE,BAGNEUX,0921903U,59,59,0,0,20,39,4 ème
HAUTS-DE-SEINE,BOIS-COLOMBES,0922629H,166,163,0,3,90,76,4 ème
HAUTS-DE-SEINE,BOULOGNE-BILLANCOURT,0921236U,191,188,0,3,98,93,4 ème
HAUTS-DE-SEINE,BOULOGNE-BILLANCOURT,0921239X,181,164,17,0,80,101,4 ème
HAUTS-DE-SEINE,CHATILLON,0920880G,158,148,8,2,65,93,4 ème
HAUTS-DE-SEINE,CLICHY,0921228K,211,198,10,3,104,107,4 ème
HAUTS-DE-SEINE,CLICHY,0922595W,125,122,0,3,62,63,4 ème
HAUTS-DE-SEINE,COLOMBES,0921494Z,139,135,0,4,80,59,4 ème
HAUTS-DE-SEINE,COLOMBES,0921675W,123,110,13,0,58,65,4 ème
HAUTS-DE-SEINE,COLOMBES,0921908Z,226,214,12,0,127,99,4 ème
HAUTS-DE-SEINE,COLOMBES,0922662U,131,131,0,0,62,69,4 ème
HAUTS-DE-SEINE,COURBEVOIE,0921496B,171,158,12,1,79,92,4 ème
HAUTS-DE-SEINE,COURBEVOIE,0922482Y,51,51,0,0,0,51,4 ème
HAUTS-DE-SEINE,COURBEVOIE,0922523T,154,153,0,1,90,64,4 ème
HAUTS-DE-SEINE,GENNEVILLIERS,0921621M,174,173,0,1,77,97,4 ème
HAUTS-DE-SEINE,LEVALLOIS-PERRET,0922630J,153,152,0,1,60,93,4 ème
HAUTS-DE-SEINE,MALAKOFF,0920163C,0,0,0,0,0,0,4 ème
HAUTS-DE-SEINE,MEUDON,0921909A,74,74,0,0,38,36,4 ème
HAUTS-DE-SEINE,MEUDON,0922701L,159,148,11,0,65,94,4 ème
HAUTS-DE-SEINE,MONTROUGE,0920164D,0,0,0,0,0,0,4 ème
HAUTS-DE-SEINE,MONTROUGE,0921190U,99,97,0,2,48,51,4 ème
HAUTS-DE-SEINE,NANTERRE,0920077J,149,136,13,0,76,73,4 ème
HAUTS-DE-SEINE,NANTERRE,0920882J,125,125,0,0,60,65,4 ème
HAUTS-DE-SEINE,NANTERRE,0921353W,141,137,0,4,69,72,4 ème
HAUTS-DE-SEINE,NEUILLY-SUR-SEINE,0921015D,97,97,0,0,39,58,4 ème
HAUTS-DE-SEINE,PUTEAUX,0921500F,0,0,0,0,0,0,4 ème
HAUTS-DE-SEINE,RUEIL-MALMAISON,0921234S,118,118,0,0,63,55,4 ème
HAUTS-DE-SEINE,RUEIL-MALMAISON,0921502H,132,130,0,2,53,79,4 ème
HAUTS-DE-SEINE,SAINT-CLOUD,0922276Z,0,0,0,0,0,0,4 ème
HAUTS-DE-SEINE,SCEAUX,0921785R,177,177,0,0,93,84,4 ème
HAUTS-DE-SEINE,SURESNES,0920884L,155,154,0,1,76,79,4 ème
HAUTS-DE-SEINE,VAUCRESSON,0921935D,30,30,0,0,9,21,4 ème
HAUTS-DE-SEINE,VAUCRESSON,0922143E,70,70,0,0,38,32,4 ème
HAUTS-DE-SEINE,VILLENEUVE-LA-GARENNE,0922277A,0,0,0,0,0,0,4 ème
VAL-D'OISE,ARGENTEUIL,0950800D,0,0,0,0,0,0,4 ème
VAL-D'OISE,ARGENTEUIL,0951138W,165,161,0,4,82,83,4 ème
VAL-D'OISE,ARGENTEUIL,0951139X,125,122,0,3,52,73,4 ème
VAL-D'OISE,ARGENTEUIL,0951230W,168,149,15,4,86,82,4 ème
VAL-D'OISE,ARGENTEUIL,0952114G,148,147,0,1,65,83,4 ème
VAL-D'OISE,BEAUMONT-SUR-OISE,0950933Y,153,148,0,5,70,83,4 ème
VAL-D'OISE,BERNES-SUR-OISE,0952087C,135,135,0,0,68,67,4 ème
VAL-D'OISE,BEZONS,0950888Z,174,158,10,6,79,95,4 ème
VAL-D'OISE,BOUFFEMONT,0951822P,103,103,0,0,52,51,4 ème
VAL-D'OISE,ERMONT,0950657Y,0,0,0,0,0,0,4 ème
VAL-D'OISE,EZANVILLE,0952127W,145,145,0,0,64,81,4 ème
VAL-D'OISE,FRANCONVILLE,0950812S,0,0,0,0,0,0,4 ème
VAL-D'OISE,GOUSSAINVILLE,0950026M,189,166,22,1,105,84,4 ème
VAL-D'OISE,HERBLAY,0950932X,217,203,13,1,102,115,4 ème
VAL-D'OISE,LOUVRES,0950908W,145,139,0,6,63,82,4 ème
VAL-D'OISE,LUZARCHES,0951357J,180,177,0,3,109,71,4 ème
VAL-D'OISE,MERY-SUR-OISE,0951725J,164,161,0,3,72,92,4 ème
VAL-D'OISE,MONTIGNY-LES-CORMEILLES,0951800R,136,136,0,0,83,53,4 ème
VAL-D'OISE,PONTOISE,0950894F,143,142,0,1,77,66,4 ème
VAL-D'OISE,PONTOISE,0951507X,117,117,0,0,51,66,4 ème
VAL-D'OISE,SANNOIS,0951508Y,163,163,0,0,76,87,4 ème
VAL-D'OISE,SARCELLES,0950900M,83,79,0,4,39,44,4 ème
VAL-D'OISE,SARCELLES,0950943J,127,110,16,1,66,61,4 ème
VAL-D'OISE,SARCELLES,0951196J,150,145,0,5,71,79,4 ème
VAL-D'OISE,SOISY-SOUS-MONTMORENCY,0950046J,95,95,0,0,48,47,4 ème
VAL-D'OISE,TAVERNY,0951197K,171,170,0,1,91,80,4 ème
VAL-D'OISE,VILLIERS-LE-BEL,0950749Y,139,139,0,0,66,73,4 ème
YVELINES,ACHERES,0783636D,110,110,0,0,47,63,4 ème
YVELINES,BEYNES,0780713B,196,196,0,0,102,94,4 ème
YVELINES,BUC,0780715D,167,167,0,0,98,69,4 ème
YVELINES,BUC,0783546F,94,94,0,0,41,53,4 ème
YVELINES,CARRIERES-SOUS-POISSY,0780032L,137,137,0,0,71,66,4 ème
YVELINES,CARRIERES-SOUS-POISSY,0781817B,98,98,0,0,52,46,4 ème
YVELINES,CHANTELOUP-LES-VIGNES,0781108F,73,61,12,0,35,38,4 ème
YVELINES,CHATOU,0780575B,118,118,0,0,47,71,4 ème
YVELINES,ECQUEVILLY,0781915H,115,111,0,4,40,75,4 ème
YVELINES,ELANCOURT,0782114Z,135,131,0,4,68,67,4 ème
YVELINES,LE MESNIL-SAINT-DENIS,0780512H,144,137,0,7,66,78,4 ème
YVELINES,LES MUREAUX,0780180X,153,153,0,0,77,76,4 ème
YVELINES,MAISONS-LAFFITTE,0780112Y,96,96,0,0,42,54,4 ème
YVELINES,MANTES-LA-VILLE,0783533S,0,0,0,0,0,0,4 ème
YVELINES,MAUREPAS,0780720J,169,167,0,2,83,86,4 ème
YVELINES,MONTFORT-L'AMAURY,0781600R,161,161,0,0,78,83,4 ème
YVELINES,MONTIGNY-LE-BRETONNEUX,0781662H,255,239,16,0,118,137,4 ème
YVELINES,MONTIGNY-LE-BRETONNEUX,0782087V,127,124,0,3,53,74,4 ème
YVELINES,ORGERUS,0781864C,151,151,0,0,64,87,4 ème
YVELINES,POISSY,0781983G,0,0,0,0,0,0,4 ème
YVELINES,PORCHEVILLE,0781948U,0,0,0,0,0,0,4 ème
YVELINES,RAMBOUILLET,0780256E,160,144,16,0,68,92,4 ème
YVELINES,RAMBOUILLET,0781886B,195,190,0,5,91,104,4 ème
YVELINES,SAINT-GERMAIN-EN-LAYE,0780714C,189,189,0,0,96,93,4 ème
YVELINES,SAINT-GERMAIN-EN-LAYE,0781205L,231,231,0,0,110,121,4 ème
YVELINES,SARTROUVILLE,0783463R,140,134,0,6,70,70,4 ème
YVELINES,TRAPPES,0780187E,116,97,16,3,55,61,4 ème
YVELINES,VELIZY-VILLACOUBLAY,0780265P,140,125,15,0,67,73,4 ème
YVELINES,VERNEUIL-SUR-SEINE,0781537X,251,248,0,3,121,130,4 ème
YVELINES,VILLIERS-SAINT-FREDERIC,0782587N,0,0,0,0,0,0,4 ème
LA REUNION,ENTRE-DEUX,9740006N,100,98,0,2,37,63,4 ème
LA REUNION,LA POSSESSION,9740909V,226,193,32,1,108,118,4 ème
LA REUNION,LES TROIS-BASSINS,9740085Z,103,96,0,7,53,50,4 ème
LA REUNION,L'ETANG-SALE,9741387P,135,132,0,3,66,69,4 ème
LA REUNION,PETITE-ILE,9740654T,185,182,0,3,91,94,4 ème
LA REUNION,SAINT-ANDRE,9740703W,157,156,0,1,87,70,4 ème
LA REUNION,SAINT-DENIS,9740072K,357,357,0,0,191,166,4 ème
LA REUNION,SAINT-DENIS,9740595D,127,125,0,2,60,67,4 ème
LA REUNION,SAINT-DENIS,9740645H,270,251,16,3,121,149,4 ème
LA REUNION,SAINT-DENIS,9741308D,0,0,0,0,0,0,4 ème
LA REUNION,SAINTE-MARIE,9740735F,164,134,29,1,78,86,4 ème
LA REUNION,SAINTE-MARIE,9741323V,190,190,0,0,94,96,4 ème
LA REUNION,SAINTE-SUZANNE,9740679V,0,0,0,0,0,0,4 ème
LA REUNION,SAINT-LOUIS,9740841W,209,172,32,5,96,113,4 ème
LA REUNION,SAINT-PAUL,9741763Y,0,0,0,0,0,0,4 ème
LA REUNION,SAINT-PIERRE,9740027L,195,191,0,4,86,109,4 ème
LA REUNION,SAINT-PIERRE,9740835P,300,294,0,6,147,153,4 ème
LA REUNION,SAINT-PIERRE,9741049X,127,123,0,4,52,75,4 ème
LA REUNION,SALAZIE,9740651P,118,98,16,4,61,57,4 ème
MARTINIQUE,FORT-DE-FRANCE,9720007A,61,61,0,0,33,28,4 ème
MARTINIQUE,FORT-DE-FRANCE,9720515C,0,0,0,0,0,0,4 ème
MARTINIQUE,FORT-DE-FRANCE,9720682J,159,121,31,7,64,95,4 ème
MARTINIQUE,FORT-DE-FRANCE,9720897T,74,74,0,0,24,50,4 ème
MARTINIQUE,LA TRINITE,9720430K,0,0,0,0,0,0,4 ème
MARTINIQUE,LE FRANCOIS,9720428H,145,122,16,7,66,79,4 ème
MARTINIQUE,LE LAMENTIN,9720072W,123,123,0,0,64,59,4 ème
MARTINIQUE,LE LAMENTIN,9720083H,127,113,0,14,69,58,4 ème
MARTINIQUE,LE LAMENTIN,9720470D,160,140,18,2,83,77,4 ème
MARTINIQUE,LE LAMENTIN,9720848P,52,51,0,1,22,30,4 ème
MARTINIQUE,LE MARIGOT,9720028Y,41,41,0,0,25,16,4 ème
MARTINIQUE,LE MORNE-ROUGE,9720016K,31,31,0,0,11,20,4 ème
MARTINIQUE,LE ROBERT,9720043P,79,79,0,0,35,44,4 ème
MARTINIQUE,SAINTE-MARIE,9720006Z,48,44,0,4,22,26,4 ème
MARTINIQUE,SAINTE-MARIE,9720692V,0,0,0,0,0,0,4 ème
MARTINIQUE,SCHOELCHER,9720455M,125,125,0,0,57,68,4 ème
MAYOTTE,DZAOUDZI,9760008E,468,434,29,5,253,215,4 ème
MAYOTTE,MAMOUDZOU,9760314M,389,385,0,4,189,200,4 ème
MAYOTTE,MTSAMBORO,9760230W,397,377,16,4,189,208,4 ème
CALVADOS,CAEN,0141159J,138,138,0,0,81,57,4 ème
CALVADOS,CAEN,0141554N,125,125,0,0,71,54,4 ème
CALVADOS,CAEN,0141810S,151,148,0,3,83,68,4 ème
CALVADOS,CAEN,0141866C,0,0,0,0,0,0,4 ème
CALVADOS,CAUMONT-SUR-AURE,0140038R,88,81,0,7,50,38,4 ème
CALVADOS,DIVES-SUR-MER,0141599M,0,0,0,0,0,0,4 ème
CALVADOS,HEROUVILLE-SAINT-CLAIR,0142173L,47,47,0,0,23,24,4 ème
CALVADOS,IFS,0142271T,181,157,23,1,87,94,4 ème
CALVADOS,LE HOM,0141641H,151,151,0,0,62,89,4 ème
CALVADOS,LE MOLAY-LITTRY,0141642J,67,67,0,0,33,34,4 ème
CALVADOS,LISIEUX,0141197A,0,0,0,0,0,0,4 ème
CALVADOS,LISIEUX,0141219Z,40,36,0,4,14,26,4 ème
CALVADOS,LISIEUX,0141275K,0,0,0,0,0,0,4 ème
CALVADOS,LISIEUX,0141868E,0,0,0,0,0,0,4 ème
CALVADOS,MONDEVILLE,0141256P,145,143,0,2,69,76,4 ème
CALVADOS,NOUES DE SIENNE,0140079K,59,59,0,0,30,29,4 ème
CALVADOS,ORBEC,0141171X,40,40,0,0,19,21,4 ème
CALVADOS,OUISTREHAM,0141271F,141,141,0,0,66,75,4 ème
CALVADOS,TREVIERES,0140082N,43,43,0,0,22,21,4 ème
CALVADOS,VILLERS-BOCAGE,0140088V,143,140,0,3,64,79,4 ème
EURE,BEUZEVILLE,0270006K,116,113,0,3,59,57,4 ème
EURE,CORMEILLES,0270013T,93,93,0,0,42,51,4 ème
EURE,EVREUX,0270019Z,168,166,0,2,75,93,4 ème
EURE,EVREUX,0271104D,95,91,0,4,51,44,4 ème
EURE,EVREUX,0271231S,171,171,0,0,90,81,4 ème
EURE,LES ANDELYS,0271585B,0,0,0,0,0,0,4 ème
EURE,LOUVIERS,0271119V,150,147,0,3,62,88,4 ème
EURE,PACY-SUR-EURE,0271322R,135,135,0,0,73,62,4 ème
EURE,VERNON,0271447B,118,118,0,0,62,56,4 ème
MANCHE,CANISY,0500011R,67,64,0,3,34,33,4 ème
MANCHE,CHERBOURG-EN-COTENTIN,0500024E,60,56,0,4,31,29,4 ème
MANCHE,CHERBOURG-EN-COTENTIN,0500080R,142,120,18,4,70,72,4 ème
MANCHE,CHERBOURG-EN-COTENTIN,0500140F,139,139,0,0,76,63,4 ème
MANCHE,CHERBOURG-EN-COTENTIN,0501702D,134,129,0,5,60,74,4 ème
MANCHE,GRANVILLE,0500036T,0,0,0,0,0,0,4 ème
MANCHE,GRANVILLE,0501705G,123,123,0,0,53,70,4 ème
MANCHE,MARIGNY-LE-LOZON,0500046D,81,78,0,3,37,44,4 ème
MANCHE,MONTEBOURG,0500047E,53,53,0,0,22,31,4 ème
MANCHE,MORTAIN-BOCAGE,0500144K,24,24,0,0,13,11,4 ème
MANCHE,SAINT-HILAIRE-DU-HARCOUET,0500087Y,0,0,0,0,0,0,4 ème
MANCHE,SARTILLY-BAIE-BOCAGE,0500075K,63,63,0,0,27,36,4 ème
MANCHE,SOURDEVAL,0500153V,35,35,0,0,18,17,4 ème
MANCHE,VILLEDIEU-LES-POELES-ROUFFIGNY,0500083U,96,83,11,2,44,52,4 ème
ORNE,ALENCON,0610693X,79,79,0,0,38,41,4 ème
ORNE,ALENCON,0610918S,166,148,14,4,82,84,4 ème
ORNE,ALENCON,0611091E,88,88,0,0,45,43,4 ème
ORNE,ARGENTAN,0610721C,0,0,0,0,0,0,4 ème
ORNE,BELLEME,0610010E,69,64,0,5,33,36,4 ème
ORNE,FLERS,0610021S,0,0,0,0,0,0,4 ème
ORNE,FLERS,0610057F,101,82,17,2,61,40,4 ème
ORNE,FLERS,0611092F,144,142,0,2,80,64,4 ème
ORNE,LA FERTE MACE,0610800N,57,53,0,4,32,25,4 ème
ORNE,MORTAGNE-AU-PERCHE,0610033E,124,105,17,2,64,60,4 ème
ORNE,REMALARD EN PERCHE,0610740Y,59,59,0,0,30,29,4 ème
ORNE,SEES,0610040M,99,96,0,3,48,51,4 ème
ORNE,TINCHEBRAY-BOCAGE,0610714V,51,51,0,0,24,27,4 ème
SEINE MARITIME,AUMALE,0761722J,58,57,0,1,30,28,4 ème
SEINE MARITIME,BIHOREL,0761692B,69,67,0,2,38,31,4 ème
SEINE MARITIME,DEVILLE-LES-ROUEN,0761727P,124,124,0,0,55,69,4 ème
SEINE MARITIME,DEVILLE-LES-ROUEN,0762202F,87,87,0,0,47,40,4 ème
SEINE MARITIME,DIEPPE,0760026R,99,80,13,6,41,58,4 ème
SEINE MARITIME,DIEPPE,0762569E,92,92,0,0,57,35,4 ème
SEINE MARITIME,EU,0760032X,0,0,0,0,0,0,4 ème
SEINE MARITIME,EU,0761730T,41,41,0,0,19,22,4 ème
SEINE MARITIME,FECAMP,0761704P,77,73,0,4,38,39,4 ème
SEINE MARITIME,GOURNAY-EN-BRAY,0760046M,141,126,9,6,65,76,4 ème
SEINE MARITIME,GRAND-COURONNE,0762080Y,76,57,14,5,42,34,4 ème
SEINE MARITIME,HARFLEUR,0762129B,139,139,0,0,77,62,4 ème
SEINE MARITIME,LE HAVRE,0760058A,0,0,0,0,0,0,4 ème
SEINE MARITIME,LE HAVRE,0761325C,118,114,0,4,62,56,4 ème
SEINE MARITIME,LE HAVRE,0761697G,113,110,0,3,45,68,4 ème
SEINE MARITIME,LE HAVRE,0761698H,61,57,0,4,27,34,4 ème
SEINE MARITIME,LE HAVRE,0761783A,59,59,0,0,24,35,4 ème
SEINE MARITIME,LE HAVRE,0762765T,0,0,0,0,0,0,4 ème
SEINE MARITIME,LE TREPORT,0762087F,103,100,0,3,54,49,4 ème
SEINE MARITIME,LUNERAY,0762199C,92,92,0,0,42,50,4 ème
SEINE MARITIME,OFFRANVILLE,0762125X,116,116,0,0,55,61,4 ème
SEINE MARITIME,PORT-JEROME-SUR-SEINE,0762176C,133,129,0,4,61,72,4 ème
SEINE MARITIME,ROUEN,0760100W,64,60,0,4,40,24,4 ème
SEINE MARITIME,ROUEN,0761745J,111,111,0,0,56,55,4 ème
SEINE MARITIME,ROUEN,0761780X,107,104,0,3,52,55,4 ème
SEINE MARITIME,ROUEN,0762566B,126,126,0,0,56,70,4 ème
SEINE MARITIME,SAINT-ETIENNE-DU-ROUVRAY,0762133F,110,110,0,0,54,56,4 ème
SEINE MARITIME,SAINT-VALERY-EN-CAUX,0760108E,154,132,18,4,74,80,4 ème
SEINE MARITIME,SOTTEVILLE-LES-ROUEN,0762211R,32,0,32,0,11,21,4 ème
SEINE MARITIME,YVETOT,0761338S,250,250,0,0,124,126,4 ème
DORDOGNE,BERGERAC,0240119Z,145,126,16,3,70,75,4 ème
DORDOGNE,COULOUNIEIX-CHAMIERS,0240047W,85,70,11,4,36,49,4 ème
DORDOGNE,LA COQUILLE,0240045U,38,38,0,0,26,12,4 ème
DORDOGNE,MAREUIL EN PERIGORD,0240016M,47,47,0,0,24,23,4 ème
DORDOGNE,PAYS DE BELVES,0240962R,78,71,7,0,43,35,4 ème
DORDOGNE,PERIGUEUX,0240029B,126,125,0,1,58,68,4 ème
DORDOGNE,PERIGUEUX,0241042C,168,168,0,0,75,93,4 ème
DORDOGNE,SAINT AULAYE-PUYMANGOU,0240055E,48,48,0,0,15,33,4 ème
DORDOGNE,TOCANE-SAINT-APRE,0240073Z,55,55,0,0,26,29,4 ème
DORDOGNE,VELINES,0240106K,77,77,0,0,37,40,4 ème
GIRONDE,ARCACHON,0332487Z,133,129,0,4,71,62,4 ème
GIRONDE,BAZAS,0330011H,0,0,0,0,0,0,4 ème
GIRONDE,BLANQUEFORT,0333129X,25,25,0,0,5,20,4 ème
GIRONDE,BORDEAUX,0330033G,0,0,0,0,0,0,4 ème
GIRONDE,BORDEAUX,0330140Y,139,113,15,11,73,66,4 ème
GIRONDE,BORDEAUX,0332285E,87,70,14,3,35,52,4 ème
GIRONDE,BORDEAUX,0332488A,245,242,0,3,113,132,4 ème
GIRONDE,BORDEAUX,0332746F,112,112,0,0,54,58,4 ème
GIRONDE,BRUGES,0333274E,118,117,0,1,61,57,4 ème
GIRONDE,CADAUJAC,0333133B,164,164,0,0,78,86,4 ème
GIRONDE,CENON,0331885V,175,152,17,6,83,92,4 ème
GIRONDE,LACANAU,0333287U,141,141,0,0,71,70,4 ème
GIRONDE,LA REOLE,0332248P,159,154,0,5,76,83,4 ème
GIRONDE,LA TESTE-DE-BUCH,0330129L,206,199,0,7,100,106,4 ème
GIRONDE,LATRESNE,0331620G,244,240,0,4,120,124,4 ème
GIRONDE,LE BOUSCAT,0331669K,193,175,15,3,96,97,4 ème
GIRONDE,LEGE-CAP-FERRET,0332657J,144,144,0,0,64,80,4 ème
GIRONDE,LE HAILLAN,0333530H,68,68,0,0,36,32,4 ème
GIRONDE,LEOGNAN,0332244K,183,183,0,0,92,91,4 ème
GIRONDE,LORMONT,0331895F,113,113,0,0,55,58,4 ème
GIRONDE,PAUILLAC,0330102G,0,0,0,0,0,0,4 ème
GIRONDE,PESSAC,0331529H,155,155,0,0,82,73,4 ème
GIRONDE,PESSAC,0331623K,208,208,0,0,108,100,4 ème
GIRONDE,PESSAC,0332191C,120,98,17,5,69,51,4 ème
GIRONDE,PESSAC,0332345V,0,0,0,0,0,0,4 ème
GIRONDE,RAUZAN,0331433D,101,90,0,11,38,63,4 ème
GIRONDE,SAINT-AUBIN-DE-MEDOC,0333093H,182,182,0,0,81,101,4 ème
GIRONDE,SAINTE-FOY-LA-GRANDE,0330163Y,138,117,16,5,64,74,4 ème
GIRONDE,SALLES,0331666G,249,249,0,0,127,122,4 ème
GIRONDE,TALENCE,0331500B,101,101,0,0,56,45,4 ème
LANDES,CAPBRETON,0400071K,85,85,0,0,35,50,4 ème
LANDES,LABRIT,0401077D,81,81,0,0,43,38,4 ème
LANDES,LINXE,0401015L,112,107,0,5,47,65,4 ème
LANDES,MORCENX-LA-NOUVELLE,0400093J,74,71,0,3,32,42,4 ème
LANDES,PARENTIS-EN-BORN,0400046H,0,0,0,0,0,0,4 ème
LANDES,SAINT-PAUL-LES-DAX,0400096M,102,84,15,3,41,61,4 ème
LANDES,SAINT-PIERRE-DU-MONT,0400080V,0,0,0,0,0,0,4 ème
LANDES,SAINT-VINCENT-DE-PAUL,0400916D,0,0,0,0,0,0,4 ème
LANDES,VILLENEUVE-DE-MARSAN,0400043E,95,93,0,2,44,51,4 ème
LOT-ET-GARONNE,AGEN,0470677F,144,142,0,2,70,74,4 ème
LOT-ET-GARONNE,AIGUILLON,0470774L,103,100,0,3,45,58,4 ème
LOT-ET-GARONNE,FUMEL,0470046V,89,74,15,0,41,48,4 ème
LOT-ET-GARONNE,MONSEMPRON-LIBOS,0470048X,79,78,0,1,31,48,4 ème
LOT-ET-GARONNE,NERAC,0470029B,0,0,0,0,0,0,4 ème
LOT-ET-GARONNE,PENNE-D'AGENAIS,0470031D,132,132,0,0,66,66,4 ème
PYRENEES-ATLANTIQUES,ARETTE,0640004G,34,34,0,0,19,15,4 ème
PYRENEES-ATLANTIQUES,ARTIX,0640231D,119,115,0,4,49,70,4 ème
PYRENEES-ATLANTIQUES,BAYONNE,0640144J,22,22,0,0,12,10,4 ème
PYRENEES-ATLANTIQUES,BAYONNE,0641652Y,117,114,0,3,60,57,4 ème
PYRENEES-ATLANTIQUES,BIARRITZ,0640078M,157,152,0,5,77,80,4 ème
PYRENEES-ATLANTIQUES,BIDACHE,0640019Y,56,56,0,0,33,23,4 ème
PYRENEES-ATLANTIQUES,HASPARREN,0640119G,85,85,0,0,38,47,4 ème
PYRENEES-ATLANTIQUES,HASPARREN,0640181Z,0,0,0,0,0,0,4 ème
PYRENEES-ATLANTIQUES,JURANCON,0641411L,181,158,16,7,75,106,4 ème
PYRENEES-ATLANTIQUES,LARUNS,0640035R,26,26,0,0,15,11,4 ème
PYRENEES-ATLANTIQUES,NAY,0641509T,216,213,0,3,102,114,4 ème
PYRENEES-ATLANTIQUES,OLORON-SAINTE-MARIE,0640048E,89,85,0,4,42,47,4 ème
PYRENEES-ATLANTIQUES,ORTHEZ,0640128S,24,24,0,0,11,13,4 ème
PYRENEES-ATLANTIQUES,PAU,0640133X,155,155,0,0,91,64,4 ème
PYRENEES-ATLANTIQUES,SAINT-ETIENNE-DE-BAIGORRY,0640064X,20,20,0,0,11,9,4 ème
PYRENEES-ATLANTIQUES,SAINT-ETIENNE-DE-BAIGORRY,0640162D,16,16,0,0,10,6,4 ème
PYRENEES-ATLANTIQUES,SAINT-JEAN-DE-LUZ,0641559X,110,110,0,0,57,53,4 ème
PYRENEES-ATLANTIQUES,SALIES-DE-BEARN,0640170M,18,18,0,0,9,9,4 ème
PYRENEES-ATLANTIQUES,SAUVETERRE-DE-BEARN,0640171N,17,17,0,0,12,5,4 ème
PYRENEES-ATLANTIQUES,TARDETS-SORHOLUS,0640074H,17,17,0,0,7,10,4 ème
PYRENEES-ATLANTIQUES,USTARITZ,0640136A,84,84,0,0,58,26,4 ème
CORREZE,ARGENTAT-SUR-DORDOGNE,0190779U,35,34,0,1,14,21,4 ème
CORREZE,CORREZE,0190016P,36,36,0,0,17,19,4 ème
CORREZE,LARCHE,0190720E,155,155,0,0,81,74,4 ème
CORREZE,TULLE,0190613N,150,131,15,4,73,77,4 ème
CORREZE,UZERCHE,0190568P,71,71,0,0,37,34,4 ème
CREUSE,BOURGANEUF,0230507B,69,56,13,0,33,36,4 ème
CREUSE,CHATELUS-MALVALEIX,0230011M,37,27,10,0,16,21,4 ème
CREUSE,FELLETIN,0230019W,0,0,0,0,0,0,4 ème
HAUTE-VIENNE,AIXE-SUR-VIENNE,0870086W,31,29,0,2,18,13,4 ème
HAUTE-VIENNE,LE DORAT,0870819T,45,42,0,3,12,33,4 ème
HAUTE-VIENNE,LIMOGES,0870058R,0,0,0,0,0,0,4 ème
HAUTE-VIENNE,LIMOGES,0870071E,176,176,0,0,88,88,4 ème
HAUTE-VIENNE,LIMOGES,0870083T,123,122,0,1,60,63,4 ème
HAUTE-VIENNE,LIMOGES,0870729V,67,67,0,0,37,30,4 ème
HAUTE-VIENNE,LIMOGES,0870791M,122,105,15,2,62,60,4 ème
HAUTE-VIENNE,LIMOGES,0871030X,0,0,0,0,0,0,4 ème
HAUTE-VIENNE,NANTIAT,0870031L,96,96,0,0,42,54,4 ème
HAUTE-VIENNE,SAINT-JUNIEN,0870041X,0,0,0,0,0,0,4 ème
HAUTE-VIENNE,SAINT-JUNIEN,0870042Y,139,120,16,3,69,70,4 ème
HAUTE-VIENNE,SAINT-SULPICE-LAURIERE,0870048E,48,48,0,0,18,30,4 ème
HAUTE-VIENNE,SAINT-YRIEIX-LA-PERCHE,0870051H,0,0,0,0,0,0,4 ème
CHARENTE,ANGOULEME,0160884Z,75,75,0,0,26,49,4 ème
CHARENTE,BAIGNES-SAINTE-RADEGONDE,0160895L,43,43,0,0,23,20,4 ème
CHARENTE,COGNAC,0160119T,0,0,0,0,0,0,4 ème
CHARENTE,COGNAC,0160864C,108,92,16,0,46,62,4 ème
CHARENTE,COGNAC,0161050E,118,118,0,0,59,59,4 ème
CHARENTE,COTEAUX-DU-BLANZACAIS,0160012B,54,54,0,0,28,26,4 ème
CHARENTE,LA ROCHEFOUCAULD-EN-ANGOUMOIS,0160867F,105,105,0,0,55,50,4 ème
CHARENTE,PUYMOYEN,0160968R,16,0,16,0,7,9,4 ème
CHARENTE,RUELLE-SUR-TOUVRE,0160094R,144,141,0,3,82,62,4 ème
CHARENTE,RUFFEC,0160039F,84,62,16,6,38,46,4 ème
CHARENTE,SAINT-MICHEL,0160969S,113,106,0,7,49,64,4 ème
CHARENTE,TERRES-DE-HAUTE-CHARENTE,0160793A,40,40,0,0,17,23,4 ème
CHARENTE-MARITIME,ARCHIAC,0170002K,79,79,0,0,36,43,4 ème
CHARENTE-MARITIME,COZES,0170008S,86,86,0,0,40,46,4 ème
CHARENTE-MARITIME,LA ROCHELLE,0170077S,146,139,0,7,76,70,4 ème
CHARENTE-MARITIME,LA ROCHELLE,0170099R,228,226,0,2,115,113,4 ème
CHARENTE-MARITIME,PONS,0170389F,140,124,12,4,65,75,4 ème
CHARENTE-MARITIME,PONT-L'ABBE-D'ARNOULT,0171340P,137,137,0,0,72,65,4 ème
CHARENTE-MARITIME,ROCHEFORT,0170025K,0,0,0,0,0,0,4 ème
CHARENTE-MARITIME,ROCHEFORT,0171057G,127,123,0,4,61,66,4 ème
CHARENTE-MARITIME,SAINT-AGNANT,0170047J,155,155,0,0,77,78,4 ème
CHARENTE-MARITIME,SAINT-PIERRE-D'OLERON,0171215D,104,104,0,0,55,49,4 ème
CHARENTE-MARITIME,SURGERES,0170070J,0,0,0,0,0,0,4 ème
CHARENTE-MARITIME,SURGERES,0170071K,224,203,16,5,100,124,4 ème
DEUX-SEVRES,BRIOUX-SUR-BOUTONNE,0790010G,62,62,0,0,23,39,4 ème
DEUX-SEVRES,CHEF-BOUTONNE,0790015M,0,0,0,0,0,0,4 ème
DEUX-SEVRES,FRONTENAY-ROHAN-ROHAN,0790699F,153,153,0,0,76,77,4 ème
DEUX-SEVRES,MAZIERES-EN-GATINE,0790044U,57,55,0,2,25,32,4 ème
DEUX-SEVRES,NIORT,0790703K,114,111,0,3,66,48,4 ème
DEUX-SEVRES,NIORT,0790928E,0,0,0,0,0,0,4 ème
DEUX-SEVRES,SAINT-MAIXENT-L'ECOLE,0790072Z,84,84,0,0,39,45,4 ème
DEUX-SEVRES,SECONDIGNY,0790074B,24,24,0,0,11,13,4 ème
DEUX-SEVRES,THOUARS,0791002K,100,65,31,4,51,49,4 ème
VIENNE,CIVRAY,0860010U,0,0,0,0,0,0,4 ème
VIENNE,LENCLOITRE,0860020E,123,123,0,0,50,73,4 ème
VIENNE,LOUDUN,0860765P,62,62,0,0,30,32,4 ème
VIENNE,LUSSAC-LES-CHATEAUX,0860026L,105,104,0,1,46,59,4 ème
VIENNE,MONTMORILLON,0860029P,0,0,0,0,0,0,4 ème
VIENNE,MONTMORILLON,0860031S,94,91,0,3,38,56,4 ème
VIENNE,POITIERS,0860774Z,0,0,0,0,0,0,4 ème
VIENNE,POITIERS,0860789R,0,0,0,0,0,0,4 ème
VIENNE,POITIERS,0861447F,89,89,0,0,38,51,4 ème
VIENNE,VOUILLE,0860772X,109,109,0,0,62,47,4 ème
AUDE,CAPENDU,0110003U,84,81,0,3,43,41,4 ème
AUDE,CARCASSONNE,0110045P,0,0,0,0,0,0,4 ème
AUDE,CARCASSONNE,0110672W,156,137,17,2,80,76,4 ème
AUDE,CHALABRE,0110870L,18,18,0,0,9,9,4 ème
AUDE,LIMOUX,0110859Z,263,228,29,6,121,142,4 ème
AUDE,QUILLAN,0110027V,0,0,0,0,0,0,4 ème
GARD,ALES,0300002P,0,0,0,0,0,0,4 ème
GARD,ALES,0300028T,0,0,0,0,0,0,4 ème
GARD,ALES,0301013N,117,93,17,7,48,69,4 ème
GARD,ALES,0301014P,166,143,15,8,85,81,4 ème
GARD,ALES,0301354J,179,175,0,4,91,88,4 ème
GARD,ANDUZE,0300006U,125,125,0,0,50,75,4 ème
GARD,BAGNOLS-SUR-CEZE,0300950V,0,0,0,0,0,0,4 ème
GARD,BAGNOLS-SUR-CEZE,0301211D,144,119,24,1,82,62,4 ème
GARD,BEAUCAIRE,0300011Z,0,0,0,0,0,0,4 ème
GARD,CLARENSAC,0301723K,168,168,0,0,69,99,4 ème
GARD,NIMES,0300058A,0,0,0,0,0,0,4 ème
GARD,NIMES,0301284H,170,165,0,5,87,83,4 ème
GARD,PONT-SAINT-ESPRIT,0300031W,127,124,0,3,48,79,4 ème
GARD,PONT-SAINT-ESPRIT,0300098U,83,83,0,0,41,42,4 ème
GARD,SAINT-CHRISTOL-LES-ALES,0301778V,0,0,0,0,0,0,4 ème
GARD,SAINT-JEAN-DU-GARD,0300042H,43,43,0,0,15,28,4 ème
GARD,SALINDRES,0300043J,155,150,0,5,60,95,4 ème
GARD,SOMMIERES,0300101X,87,87,0,0,39,48,4 ème
GARD,UZES,0301244P,56,56,0,0,27,29,4 ème
GARD,VILLENEUVE-LES-AVIGNON,0300085E,73,73,0,0,39,34,4 ème
HERAULT,BEZIERS,0340012D,0,0,0,0,0,0,4 ème
HERAULT,BEZIERS,0340016H,134,131,0,3,79,55,4 ème
HERAULT,FLORENSAC,0340024S,77,77,0,0,42,35,4 ème
HERAULT,LA GRANDE-MOTTE,0341656R,87,87,0,0,45,42,4 ème
HERAULT,LANSARGUES,0342076X,231,215,16,0,126,105,4 ème
HERAULT,LATTES,0341028H,183,180,0,3,97,86,4 ème
HERAULT,LODEVE,0340117T,192,176,15,1,90,102,4 ème
HERAULT,MARAUSSAN,0342399Y,8,8,0,0,4,4,4 ème
HERAULT,MARSEILLAN,0342130F,96,94,0,2,42,54,4 ème
HERAULT,MARSILLARGUES,0340034C,79,76,0,3,33,46,4 ème
HERAULT,MAUGUIO,0341368C,237,237,0,0,117,120,4 ème
HERAULT,MONTARNAUD,0342051V,167,164,0,3,83,84,4 ème
HERAULT,MONTPELLIER,0340902W,126,125,0,1,65,61,4 ème
HERAULT,MONTPELLIER,0340904Y,116,116,0,0,53,63,4 ème
HERAULT,MONTPELLIER,0341364Y,111,110,0,1,47,64,4 ème
HERAULT,MONTPELLIER,0341385W,0,0,0,0,0,0,4 ème
HERAULT,MONTPELLIER,0342131G,136,134,0,2,79,57,4 ème
HERAULT,MONTPELLIER,0342147Z,5,5,0,0,2,3,4 ème
HERAULT,OLONZAC,0340057C,58,58,0,0,28,30,4 ème
HERAULT,PEROLS,0341537L,119,119,0,0,55,64,4 ème
HERAULT,PIGNAN,0341870Y,191,187,0,4,93,98,4 ème
HERAULT,ROUJAN,0342326U,115,112,0,3,61,54,4 ème
HERAULT,SAINT-CLEMENT-DE-RIVIERE,0340110K,232,225,0,7,102,130,4 ème
HERAULT,SAINT-GELY-DU-FESC,0341764H,206,203,0,3,108,98,4 ème
HERAULT,SAINT-MATHIEU-DE-TREVIERS,0341705U,139,139,0,0,67,72,4 ème
HERAULT,SERVIAN,0341387Y,156,154,0,2,69,87,4 ème
HERAULT,VENDRES,0342050U,169,169,0,0,83,86,4 ème
LOZERE,MENDE,0480019K,0,0,0,0,0,0,4 ème
LOZERE,SAINT-CHELY-D'APCHER,0480013D,100,97,0,3,51,49,4 ème
LOZERE,SAINT-CHELY-D'APCHER,0480688M,0,0,0,0,0,0,4 ème
LOZERE,SAINT-ETIENNE-VALLEE-FRANCAISE,0480015F,17,17,0,0,11,6,4 ème
LOZERE,VILLEFORT,0480017H,18,18,0,0,8,10,4 ème
PYRENEES-ORIENTALES,ARLES-SUR-TECH,0660480N,67,67,0,0,30,37,4 ème
PYRENEES-ORIENTALES,PERPIGNAN,0660051X,100,100,0,0,49,51,4 ème
PYRENEES-ORIENTALES,PERPIGNAN,0660063K,156,156,0,0,67,89,4 ème
PYRENEES-ORIENTALES,PERPIGNAN,0660522J,161,138,17,6,77,84,4 ème
PYRENEES-ORIENTALES,PRADES,0660068R,47,47,0,0,18,29,4 ème
PYRENEES-ORIENTALES,SAINT-ESTEVE,0660431K,214,194,17,3,90,124,4 ème
PYRENEES-ORIENTALES,SAINT-PAUL-DE-FENOUILLET,0660029Y,40,40,0,0,21,19,4 ème
ARIEGE,LE MAS-D'AZIL,0090010M,76,76,0,0,41,35,4 ème
ARIEGE,LEZAT-SUR-LEZE,0090009L,88,88,0,0,41,47,4 ème
ARIEGE,PAMIERS,0090045A,0,0,0,0,0,0,4 ème
ARIEGE,PAMIERS,0090055L,172,167,0,5,84,88,4 ème
ARIEGE,SAINT-GIRONS,0090038T,21,21,0,0,7,14,4 ème
ARIEGE,SAINT-GIRONS,0090574A,175,163,8,4,85,90,4 ème
ARIEGE,TARASCON-SUR-ARIEGE,0090546V,116,114,0,2,46,70,4 ème
AVEYRON,CRANSAC,0120004P,28,23,0,5,15,13,4 ème
AVEYRON,MARCILLAC-VALLON,0120092K,69,66,0,3,27,42,4 ème
AVEYRON,NAUCELLE,0120017D,42,42,0,0,28,14,4 ème
AVEYRON,NAUCELLE,0121174L,27,27,0,0,13,14,4 ème
AVEYRON,RODEZ,0121309H,0,0,0,0,0,0,4 ème
AVEYRON,SAINT-AFFRIQUE,0121256A,52,51,0,1,24,28,4 ème
GERS,AIGNAN,0320001C,25,25,0,0,17,8,4 ème
GERS,AUCH,0320563N,143,136,0,7,59,84,4 ème
GERS,AUCH,0320650H,91,85,3,3,39,52,4 ème
GERS,CONDOM,0320059R,37,37,0,0,17,20,4 ème
GERS,GIMONT,0320013R,105,100,0,5,44,61,4 ème
GERS,L'ISLE-JOURDAIN,0320014S,118,115,0,3,62,56,4 ème
GERS,L'ISLE-JOURDAIN,0320056M,77,77,0,0,42,35,4 ème
GERS,PLAISANCE,0320028G,41,41,0,0,21,20,4 ème
HAUTE-GARONNE,BAGNERES-DE-LUCHON,0310005M,61,58,0,3,24,37,4 ème
HAUTE-GARONNE,BESSIERES,0312799Z,160,149,0,11,88,72,4 ème
HAUTE-GARONNE,BLAGNAC,0311581A,114,113,0,1,46,68,4 ème
HAUTE-GARONNE,CINTEGABELLE,0313045S,46,46,0,0,20,26,4 ème
HAUTE-GARONNE,COLOMIERS,0311092U,0,0,0,0,0,0,4 ème
HAUTE-GARONNE,COLOMIERS,0312191N,0,0,0,0,0,0,4 ème
HAUTE-GARONNE,FENOUILLET,0312423R,130,121,0,9,63,67,4 ème
HAUTE-GARONNE,LE FOUSSERET,0310015Y,109,106,0,3,48,61,4 ème
HAUTE-GARONNE,MURET,0311319R,187,166,21,0,91,96,4 ème
HAUTE-GARONNE,PIBRAC,0311176K,159,159,0,0,73,86,4 ème
HAUTE-GARONNE,PIBRAC,0311263E,172,161,0,11,89,83,4 ème
HAUTE-GARONNE,PINS-JUSTARET,0312220V,209,202,0,7,99,110,4 ème
HAUTE-GARONNE,PLAISANCE-DU-TOUCH,0312071H,196,193,0,3,93,103,4 ème
HAUTE-GARONNE,PORTET-SUR-GARONNE,0311686P,168,166,0,2,79,89,4 ème
HAUTE-GARONNE,REVEL,0311209W,49,49,0,0,25,24,4 ème
HAUTE-GARONNE,RIEUMES,0310029N,91,91,0,0,39,52,4 ème
HAUTE-GARONNE,SAINT-JEAN,0311722D,192,187,0,5,97,95,4 ème
HAUTE-GARONNE,SAINT-JORY,0312842W,144,140,0,4,68,76,4 ème
HAUTE-GARONNE,SALIES-DU-SALAT,0310035V,119,114,0,5,54,65,4 ème
HAUTE-GARONNE,SEILH,0311967V,146,146,0,0,68,78,4 ème
HAUTE-GARONNE,TOULOUSE,0310037X,172,154,15,3,82,90,4 ème
HAUTE-GARONNE,TOULOUSE,0310052N,0,0,0,0,0,0,4 ème
HAUTE-GARONNE,TOULOUSE,0310054R,0,0,0,0,0,0,4 ème
HAUTE-GARONNE,TOULOUSE,0310056T,0,0,0,0,0,0,4 ème
HAUTE-GARONNE,TOULOUSE,0311111P,195,189,0,6,80,115,4 ème
HAUTE-GARONNE,TOULOUSE,0311265G,97,79,14,4,44,53,4 ème
HAUTE-GARONNE,TOULOUSE,0311630D,148,115,28,5,82,66,4 ème
HAUTE-GARONNE,TOULOUSE,0312064A,0,0,0,0,0,0,4 ème
HAUTE-GARONNE,TOULOUSE,0312759F,0,0,0,0,0,0,4 ème
HAUTE-GARONNE,TOULOUSE,0312885T,21,21,0,0,6,15,4 ème
HAUTE-GARONNE,TOULOUSE,0313080E,108,106,0,2,53,55,4 ème
HAUTE-GARONNE,VILLENEUVE-TOLOSANE,0312611V,166,166,0,0,87,79,4 ème
HAUTES-PYRENEES,BAGNERES-DE-BIGORRE,0650089U,148,146,0,2,74,74,4 ème
LOT,CAHORS,0460493L,0,0,0,0,0,0,4 ème
LOT,MARTEL,0460021Y,41,41,0,0,24,17,4 ème
LOT,PRAYSSAC,0460024B,38,38,0,0,23,15,4 ème
TARN,ALBI,0810004P,0,0,0,0,0,0,4 ème
TARN,ALBI,0810051R,129,125,0,4,69,60,4 ème
TARN,ALBI,0811070Y,0,0,0,0,0,0,4 ème
TARN,CARMAUX,0810787R,106,103,0,3,47,59,4 ème
TARN,CASTRES,0810960D,131,128,0,3,75,56,4 ème
TARN,CASTRES,0810961E,90,87,0,3,42,48,4 ème
TARN,GAILLAC,0811331G,128,128,0,0,59,69,4 ème
TARN,MAZAMET,0810108C,0,0,0,0,0,0,4 ème
TARN,MAZAMET,0810127Y,70,70,0,0,37,33,4 ème
TARN,RABASTENS,0810037A,111,110,0,1,57,54,4 ème
TARN-ET-GARONNE,CASTELSARRASIN,0820066B,196,177,14,5,92,104,4 ème
TARN-ET-GARONNE,GRISOLLES,0820683X,135,133,0,2,61,74,4 ème
TARN-ET-GARONNE,MOISSAC,0820753Y,75,72,0,3,34,41,4 ème
TARN-ET-GARONNE,MONTECH,0820891Y,144,140,0,4,74,70,4 ème
TARN-ET-GARONNE,VALENCE,0820029L,214,198,8,8,120,94,4 ème
TARN-ET-GARONNE,VALENCE,0820899G,0,0,0,0,0,0,4 ème
TARN-ET-GARONNE,VERDUN-SUR-GARONNE,0820922G,110,103,0,7,58,52,4 ème
LOIRE-ATLANTIQUE,ANCENIS-SAINT-GEREON,0441928G,188,188,0,0,99,89,4 ème
LOIRE-ATLANTIQUE,BOUAYE,0441858F,185,185,0,0,92,93,4 ème
LOIRE-ATLANTIQUE,CHATEAUBRIANT,0440005S,0,0,0,0,0,0,4 ème
LOIRE-ATLANTIQUE,CHATEAUBRIANT,0440293E,128,127,0,1,48,80,4 ème
LOIRE-ATLANTIQUE,CHATEAUBRIANT,0441929H,146,143,0,3,59,87,4 ème
LOIRE-ATLANTIQUE,CLISSON,0440008V,146,130,15,1,77,69,4 ème
LOIRE-ATLANTIQUE,CLISSON,0442781J,145,145,0,0,72,73,4 ème
LOIRE-ATLANTIQUE,CORDEMAIS,0442023K,134,130,0,4,69,65,4 ème
LOIRE-ATLANTIQUE,DONGES,0441727N,86,81,0,5,44,42,4 ème
LOIRE-ATLANTIQUE,LA CHAPELLE-SUR-ERDRE,0441547T,126,126,0,0,74,52,4 ème
LOIRE-ATLANTIQUE,LOIREAUXENCE,0442921L,79,79,0,0,41,38,4 ème
LOIRE-ATLANTIQUE,NANTES,0440025N,95,91,0,4,43,52,4 ème
LOIRE-ATLANTIQUE,NANTES,0440034Y,0,0,0,0,0,0,4 ème
LOIRE-ATLANTIQUE,NANTES,0440035Z,0,0,0,0,0,0,4 ème
LOIRE-ATLANTIQUE,NANTES,0440284V,139,139,0,0,70,69,4 ème
LOIRE-ATLANTIQUE,NANTES,0441931K,254,254,0,0,117,137,4 ème
LOIRE-ATLANTIQUE,NANTES,0441933M,181,173,8,0,100,81,4 ème
LOIRE-ATLANTIQUE,NANTES,0441935P,208,194,14,0,120,88,4 ème
LOIRE-ATLANTIQUE,NANTES,0441936R,162,158,0,4,83,79,4 ème
LOIRE-ATLANTIQUE,NANTES,0442775C,0,0,0,0,0,0,4 ème
LOIRE-ATLANTIQUE,PAIMBOEUF,0440056X,0,0,0,0,0,0,4 ème
LOIRE-ATLANTIQUE,PONTCHATEAU,0440541Z,0,0,0,0,0,0,4 ème
LOIRE-ATLANTIQUE,PONTCHATEAU,0442807M,131,131,0,0,54,77,4 ème
LOIRE-ATLANTIQUE,REZE,0440063E,0,0,0,0,0,0,4 ème
LOIRE-ATLANTIQUE,REZE,0440229K,203,203,0,0,106,97,4 ème
LOIRE-ATLANTIQUE,REZE,0440274J,0,0,0,0,0,0,4 ème
LOIRE-ATLANTIQUE,SAINTE-PAZANNE,0442625P,234,229,0,5,111,123,4 ème
LOIRE-ATLANTIQUE,SAINT-JOACHIM,0441728P,72,72,0,0,33,39,4 ème
LOIRE-ATLANTIQUE,SAINT-NAZAIRE,0441941W,186,186,0,0,88,98,4 ème
LOIRE-ATLANTIQUE,SAINT-PHILBERT-DE-GRAND-LIEU,0442186M,96,95,0,1,60,36,4 ème
LOIRE-ATLANTIQUE,SAINT-SEBASTIEN-SUR-LOIRE,0440291C,121,120,0,1,57,64,4 ème
LOIRE-ATLANTIQUE,SAVENAY,0440241Y,277,277,0,0,146,131,4 ème
LOIRE-ATLANTIQUE,SAVENAY,0441657M,126,126,0,0,66,60,4 ème
LOIRE-ATLANTIQUE,TRIGNAC,0441616T,140,120,17,3,68,72,4 ème
LOIRE-ATLANTIQUE,VALLET,0442052S,165,161,0,4,84,81,4 ème
LOIRE-ATLANTIQUE,VERTOU,0442595G,166,159,0,7,71,95,4 ème
MAINE-ET-LOIRE,ANGERS,0490843A,97,93,0,4,48,49,4 ème
MAINE-ET-LOIRE,ANGERS,0491825T,146,146,0,0,88,58,4 ème
MAINE-ET-LOIRE,BAUGE-EN-ANJOU,0490010V,105,101,0,4,59,46,4 ème
MAINE-ET-LOIRE,BEAUFORT-EN-ANJOU,0490922L,180,180,0,0,70,110,4 ème
MAINE-ET-LOIRE,BRISSAC LOIRE AUBANCE,0490853L,120,120,0,0,53,67,4 ème
MAINE-ET-LOIRE,CHEMILLE-EN-ANJOU,0491929F,59,59,0,0,34,25,4 ème
MAINE-ET-LOIRE,CHOLET,0490862W,148,148,0,0,88,60,4 ème
MAINE-ET-LOIRE,CHOLET,0490886X,0,0,0,0,0,0,4 ème
MAINE-ET-LOIRE,DURTAL,0490956Y,83,83,0,0,36,47,4 ème
MAINE-ET-LOIRE,LONGUE-JUMELLES,0490867B,111,111,0,0,58,53,4 ème
MAINE-ET-LOIRE,MAUGES-SUR-LOIRE,0490039B,60,57,0,3,37,23,4 ème
MAINE-ET-LOIRE,MONTREVAULT-SUR-EVRE,0490876L,147,147,0,0,60,87,4 ème
MAINE-ET-LOIRE,OREE D'ANJOU,0490057W,142,142,0,0,65,77,4 ème
MAINE-ET-LOIRE,OREE D'ANJOU,0490856P,126,126,0,0,54,72,4 ème
MAINE-ET-LOIRE,SAUMUR,0491648A,69,53,14,2,37,32,4 ème
MAINE-ET-LOIRE,SEGRE-EN-ANJOU BLEU,0490878N,162,162,0,0,77,85,4 ème
MAINE-ET-LOIRE,SEVREMOINE,0490875K,167,167,0,0,83,84,4 ème
MAINE-ET-LOIRE,SEVREMOINE,0491706N,94,94,0,0,45,49,4 ème
MAINE-ET-LOIRE,TRELAZE,0491646Y,0,0,0,0,0,0,4 ème
MAINE-ET-LOIRE,VERRIERES-EN-ANJOU,0491921X,108,106,0,2,52,56,4 ème
MAYENNE,CHATEAU-GONTIER-SUR-MAYENNE,0530779J,136,117,15,4,77,59,4 ème
MAYENNE,COSSE-LE-VIVIEN,0530030V,68,65,0,3,35,33,4 ème
MAYENNE,ERNEE,0530077W,94,77,17,0,48,46,4 ème
MAYENNE,LAVAL,0530015D,136,132,0,4,60,76,4 ème
MAYENNE,LAVAL,0530914F,70,67,0,3,34,36,4 ème
MAYENNE,MESLAY-DU-MAINE,0530063F,76,75,0,1,35,41,4 ème
MAYENNE,PORT-BRILLET,0530021K,85,85,0,0,47,38,4 ème
MAYENNE,PRE-EN-PAIL-SAINT-SAMSON,0530583W,52,52,0,0,25,27,4 ème
SARTHE,ARNAGE,0720903R,119,119,0,0,57,62,4 ème
SARTHE,BALLON-SAINT MARS,0720004N,102,85,14,3,43,59,4 ème
SARTHE,BEAUMONT-SUR-SARTHE,0720904S,57,51,0,6,30,27,4 ème
SARTHE,BONNETABLE,0721093X,113,113,0,0,53,60,4 ème
SARTHE,CHAMPAGNE,0721086P,109,107,0,2,61,48,4 ème
SARTHE,FRESNAY-SUR-SARTHE,0720019E,64,63,0,1,33,31,4 ème
SARTHE,LA FERTE-BERNARD,0720017C,0,0,0,0,0,0,4 ème
SARTHE,LA FERTE-BERNARD,0720806K,85,85,0,0,45,40,4 ème
SARTHE,LA FLECHE,0720062B,96,92,0,4,42,54,4 ème
SARTHE,LE GRAND-LUCE,0721044U,69,68,0,1,33,36,4 ème
SARTHE,LE LUDE,0721226S,77,77,0,0,40,37,4 ème
SARTHE,LE MANS,0720040C,108,108,0,0,55,53,4 ème
SARTHE,LE MANS,0720797A,113,96,17,0,59,54,4 ème
SARTHE,LE MANS,0720798B,114,110,0,4,60,54,4 ème
SARTHE,LE MANS,0720800D,73,70,0,3,36,37,4 ème
SARTHE,LE MANS,0720815V,106,106,0,0,59,47,4 ème
SARTHE,LE MANS,0720836T,108,97,0,11,52,56,4 ème
SARTHE,LE MANS,0720838V,143,143,0,0,74,69,4 ème
SARTHE,LE MANS,0720983C,59,59,0,0,35,24,4 ème
SARTHE,LE MANS,0721262F,88,86,0,2,42,46,4 ème
SARTHE,LOUE,0720024K,137,137,0,0,64,73,4 ème
SARTHE,MAMERS,0720027N,0,0,0,0,0,0,4 ème
SARTHE,MOULINS-LE-CARBONNEL,0720046J,71,71,0,0,36,35,4 ème
SARTHE,PONTVALLAIN,0721304B,93,90,0,3,48,45,4 ème
SARTHE,SABLE-SUR-SARTHE,0721408P,134,130,0,4,79,55,4 ème
SARTHE,SAINT-CALAIS,0720051P,37,33,0,4,18,19,4 ème
VENDEE,AIZENAY,0850090L,124,124,0,0,58,66,4 ème
VENDEE,AIZENAY,0851560J,178,174,0,4,87,91,4 ème
VENDEE,BELLEVIGNY,0851435Y,161,156,0,5,86,75,4 ème
VENDEE,CHANTONNAY,0851191H,219,216,0,3,90,129,4 ème
VENDEE,CHAVAGNES-EN-PAILLERS,0850073T,119,119,0,0,49,70,4 ème
VENDEE,FONTENAY-LE-COMTE,0850074U,180,163,16,1,73,107,4 ème
VENDEE,LA ROCHE-SUR-YON,0850605W,177,170,0,7,82,95,4 ème
VENDEE,LA ROCHE-SUR-YON,0851643Z,0,0,0,0,0,0,4 ème
VENDEE,LES SABLES-D'OLONNE,0850148Z,108,105,0,3,49,59,4 ème
VENDEE,LES SABLES-D'OLONNE,0850149A,95,77,18,0,48,47,4 ème
VENDEE,LUCON,0850069N,100,98,0,2,49,51,4 ème
VENDEE,MONTAIGU-VENDEE,0851662V,145,143,0,2,79,66,4 ème
VENDEE,MORTAGNE-SUR-SEVRE,0851388X,125,125,0,0,60,65,4 ème
VENDEE,SAINTE-HERMINE,0851146J,79,75,0,4,41,38,4 ème
VENDEE,SAINT-GILLES-CROIX-DE-VIE,0850065J,229,214,15,0,122,107,4 ème
VENDEE,TIFFAUGES,0850125Z,102,102,0,0,51,51,4 ème
ALPES-DE-HTE-PROVENCE,BARCELONNETTE,0040419J,81,81,0,0,35,46,4 ème
ALPES-DE-HTE-PROVENCE,LA MOTTE-DU-CAIRE,0040014U,25,25,0,0,13,12,4 ème
ALPES-DE-HTE-PROVENCE,MANOSQUE,0040055N,143,117,22,4,71,72,4 ème
ALPES-DE-HTE-PROVENCE,SISTERON,0040023D,0,0,0,0,0,0,4 ème
BOUCHES-DU-RHONE,AIX-EN-PROVENCE,0130001F,0,0,0,0,0,0,4 ème
BOUCHES-DU-RHONE,AIX-EN-PROVENCE,0131318M,60,57,0,3,28,32,4 ème
BOUCHES-DU-RHONE,AIX-EN-PROVENCE,0131712R,203,179,24,0,92,111,4 ème
BOUCHES-DU-RHONE,AIX-EN-PROVENCE,0132955S,61,61,0,0,26,35,4 ème
BOUCHES-DU-RHONE,AIX-EN-PROVENCE,0132973L,147,147,0,0,64,83,4 ème
BOUCHES-DU-RHONE,ALLAUCH,0133490Y,239,239,0,0,119,120,4 ème
BOUCHES-DU-RHONE,ARLES,0133274N,0,0,0,0,0,0,4 ème
BOUCHES-DU-RHONE,BOUC-BEL-AIR,0132833J,150,149,0,1,78,72,4 ème
BOUCHES-DU-RHONE,CASSIS,0132324F,169,169,0,0,78,91,4 ème
BOUCHES-DU-RHONE,GEMENOS,0133351X,180,180,0,0,95,85,4 ème
BOUCHES-DU-RHONE,ISTRES,0132318Z,181,176,0,5,89,92,4 ème
BOUCHES-DU-RHONE,ISTRES,0132409Y,161,138,23,0,80,81,4 ème
BOUCHES-DU-RHONE,LA CIOTAT,0130022D,148,146,0,2,70,78,4 ème
BOUCHES-DU-RHONE,LES PENNES-MIRABEAU,0131369T,154,151,0,3,90,64,4 ème
BOUCHES-DU-RHONE,MARSEILLE,0131424C,0,0,0,0,0,0,4 ème
BOUCHES-DU-RHONE,MARSEILLE,0131922U,145,145,0,0,70,75,4 ème
BOUCHES-DU-RHONE,MARSEILLE,0131750G,161,161,0,0,81,80,4 ème
BOUCHES-DU-RHONE,MARSEILLE,0131261A,96,94,0,2,49,47,4 ème
BOUCHES-DU-RHONE,MARSEILLE,0131445A,0,0,0,0,0,0,4 ème
BOUCHES-DU-RHONE,MARSEILLE,0132314V,177,173,0,4,89,88,4 ème
BOUCHES-DU-RHONE,MARSEILLE,0132907P,186,184,0,2,97,89,4 ème
BOUCHES-DU-RHONE,MARSEILLE,0132908R,51,51,0,0,35,16,4 ème
BOUCHES-DU-RHONE,MARSEILLE,0130056R,0,0,0,0,0,0,4 ème
BOUCHES-DU-RHONE,MARSEILLE,0132207D,140,137,0,3,62,78,4 ème
BOUCHES-DU-RHONE,MARSEILLE,0132730X,111,107,0,4,58,53,4 ème
BOUCHES-DU-RHONE,MARSEILLE,0131329Z,72,72,0,0,37,35,4 ème
BOUCHES-DU-RHONE,MARSEILLE,0132407W,139,101,31,7,75,64,4 ème
BOUCHES-DU-RHONE,MARSEILLE,0131757P,149,146,0,3,73,76,4 ème
BOUCHES-DU-RHONE,MARSEILLE,0131375Z,59,59,0,0,31,28,4 ème
BOUCHES-DU-RHONE,MARSEILLE,0131884C,143,143,0,0,75,68,4 ème
BOUCHES-DU-RHONE,MARSEILLE,0131935H,139,139,0,0,76,63,4 ème
BOUCHES-DU-RHONE,MARSEILLE,0131381F,114,114,0,0,65,49,4 ème
BOUCHES-DU-RHONE,MARSEILLE,0132315W,129,127,0,2,71,58,4 ème
BOUCHES-DU-RHONE,MARSEILLE,0132923G,138,136,0,2,66,72,4 ème
BOUCHES-DU-RHONE,MARSEILLE,0132946G,115,115,0,0,59,56,4 ème
BOUCHES-DU-RHONE,MARSEILLE,0131689R,75,59,16,0,22,53,4 ème
BOUCHES-DU-RHONE,MARSEILLE,0132909S,94,94,0,0,45,49,4 ème
BOUCHES-DU-RHONE,MARSEILLE,0133374X,48,48,0,0,26,22,4 ème
BOUCHES-DU-RHONE,MARSEILLE,0132205B,126,126,0,0,54,72,4 ème
BOUCHES-DU-RHONE,MARSEILLE,0131923V,237,231,0,6,121,116,4 ème
BOUCHES-DU-RHONE,MARSEILLE,0131382G,98,98,0,0,47,51,4 ème
BOUCHES-DU-RHONE,MARSEILLE,0133866G,32,32,0,0,17,15,4 ème
BOUCHES-DU-RHONE,MARTIGUES,0132496T,110,110,0,0,53,57,4 ème
BOUCHES-DU-RHONE,PORT-DE-BOUC,0130150T,0,0,0,0,0,0,4 ème
BOUCHES-DU-RHONE,PORT-DE-BOUC,0130151U,0,0,0,0,0,0,4 ème
BOUCHES-DU-RHONE,PORT-SAINT-LOUIS-DU-RHONE,0132323E,153,140,10,3,66,87,4 ème
BOUCHES-DU-RHONE,ROGNAC,0131706J,162,162,0,0,76,86,4 ème
BOUCHES-DU-RHONE,ROGNONAS,0131387M,89,89,0,0,50,39,4 ème
BOUCHES-DU-RHONE,SAINT-MARTIN-DE-CRAU,0132834K,262,260,0,2,135,127,4 ème
BOUCHES-DU-RHONE,SALON-DE-PROVENCE,0130161E,0,0,0,0,0,0,4 ème
BOUCHES-DU-RHONE,SIMIANE-COLLONGUE,0133789Y,128,128,0,0,58,70,4 ème
BOUCHES-DU-RHONE,TRETS,0130166K,113,113,0,0,55,58,4 ème
HAUTES-ALPES,EMBRUN,0050023Y,131,126,0,5,63,68,4 ème
HAUTES-ALPES,GUILLESTRE,0050013M,81,81,0,0,44,37,4 ème
HAUTES-ALPES,LA BATIE-NEUVE,0050639T,93,93,0,0,55,38,4 ème
HAUTES-ALPES,SAINT-BONNET-EN-CHAMPSAUR,0050019U,130,130,0,0,75,55,4 ème
HAUTES-ALPES,SAINT-JEAN-SAINT-NICOLAS,0050039R,0,0,0,0,0,0,4 ème
VAUCLUSE,AVIGNON,0840004Y,0,0,0,0,0,0,4 ème
VAUCLUSE,AVIGNON,0840058G,78,78,0,0,38,40,4 ème
VAUCLUSE,AVIGNON,0840060J,203,200,0,3,92,111,4 ème
VAUCLUSE,AVIGNON,0840064N,77,77,0,0,47,30,4 ème
VAUCLUSE,AVIGNON,0840082H,0,0,0,0,0,0,4 ème
VAUCLUSE,BEDARRIDES,0840011F,109,104,0,5,53,56,4 ème
VAUCLUSE,CADENET,0840014J,156,152,0,4,83,73,4 ème
VAUCLUSE,CARPENTRAS,0840114T,201,169,26,6,93,108,4 ème
VAUCLUSE,CARPENTRAS,0840760V,124,121,0,3,50,74,4 ème
VAUCLUSE,MONTEUX,0840066R,135,135,0,0,57,78,4 ème
VAUCLUSE,ORANGE,0840046U,0,0,0,0,0,0,4 ème
VAUCLUSE,ORANGE,0840762X,124,119,0,5,55,69,4 ème
VAUCLUSE,VALREAS,0840700E,0,0,0,0,0,0,4 ème
ALPES-MARITIMES,ANTIBES,0060823M,48,48,0,0,20,28,4 ème
ALPES-MARITIMES,BREIL-SUR-ROYA,0060008B,29,29,0,0,13,16,4 ème
ALPES-MARITIMES,CAGNES-SUR-MER,0060911H,135,118,17,0,61,74,4 ème
ALPES-MARITIMES,CAGNES-SUR-MER,0061280J,166,166,0,0,85,81,4 ème
ALPES-MARITIMES,CAGNES-SUR-MER,0061737F,150,142,0,8,63,87,4 ème
ALPES-MARITIMES,CANNES,0060720A,162,162,0,0,77,85,4 ème
ALPES-MARITIMES,CANNES,0060799L,194,170,16,8,96,98,4 ème
ALPES-MARITIMES,CONTES,0060019N,182,163,16,3,93,89,4 ème
ALPES-MARITIMES,GRASSE,0060023T,0,0,0,0,0,0,4 ème
ALPES-MARITIMES,LE CANNET,0061239P,185,164,15,6,83,102,4 ème
ALPES-MARITIMES,LE ROURET,0061853G,156,154,0,2,64,92,4 ème
ALPES-MARITIMES,MENTON,0061824A,176,166,7,3,84,92,4 ème
ALPES-MARITIMES,MOUGINS,0061068D,194,174,16,4,103,91,4 ème
ALPES-MARITIMES,NICE,0060038J,0,0,0,0,0,0,4 ème
ALPES-MARITIMES,NICE,0060715V,0,0,0,0,0,0,4 ème
ALPES-MARITIMES,NICE,0060753L,89,89,0,0,43,46,4 ème
ALPES-MARITIMES,NICE,0060838D,112,110,0,2,44,68,4 ème
ALPES-MARITIMES,NICE,0061127T,125,125,0,0,63,62,4 ème
ALPES-MARITIMES,PUGET-THENIERS,0060061J,53,53,0,0,17,36,4 ème
ALPES-MARITIMES,SAINT-LAURENT-DU-VAR,0061738G,160,143,17,0,84,76,4 ème
ALPES-MARITIMES,TENDE,0060072W,23,23,0,0,7,16,4 ème
ALPES-MARITIMES,TOURRETTE-LEVENS,0060068S,169,169,0,0,89,80,4 ème
ALPES-MARITIMES,VALBONNE,0061925K,203,203,0,0,106,97,4 ème
VAR,BORMES-LES-MIMOSAS,0830927G,124,124,0,0,67,57,4 ème
VAR,HYERES,0831014B,0,0,0,0,0,0,4 ème
VAR,HYERES,0831563Y,0,0,0,0,0,0,4 ème
VAR,LA CRAU,0830012M,230,230,0,0,129,101,4 ème
VAR,LA VALETTE-DU-VAR,0830182X,178,164,8,6,96,82,4 ème
VAR,LA VALETTE-DU-VAR,0831218Y,133,115,12,6,51,82,4 ème
VAR,LE MUY,0830958R,116,115,0,1,67,49,4 ème
VAR,PUGET-SUR-ARGENS,0830168G,144,144,0,0,76,68,4 ème
VAR,SAINTE-MAXIME,0830039S,143,143,0,0,76,67,4 ème
VAR,SAINT-RAPHAEL,0830108S,122,122,0,0,60,62,4 ème
VAR,SIX-FOURS-LES-PLAGES,0830051E,161,161,0,0,78,83,4 ème
VAR,SOLLIES-PONT,0831355X,107,107,0,0,57,50,4 ème
VAR,TOULON,0830148K,95,95,0,0,48,47,4 ème
MAYOTTE,M'TSANGAMOUJI,9760167C,299,281,14,4,151,148,4 ème
MAYOTTE,TSINGONI,9760274U,322,304,17,1,145,177,4 ème
CALVADOS,BAYEUX,0140006F,187,166,15,6,88,99,4 ème
CALVADOS,BAYEUX,0141762P,120,116,0,4,59,61,4 ème
CALVADOS,BRETTEVILLE-SUR-LAIZE,0141312A,125,125,0,0,70,55,4 ème
CALVADOS,CAEN,0140018U,0,0,0,0,0,0,4 ème
CALVADOS,CAEN,0141597K,148,131,17,0,69,79,4 ème
CALVADOS,CAEN,0141867D,0,0,0,0,0,0,4 ème
CALVADOS,CONDE-EN-NORMANDIE,0141214U,22,22,0,0,9,13,4 ème
CALVADOS,CONDE-EN-NORMANDIE,0141258S,80,80,0,0,42,38,4 ème
CALVADOS,DEAUVILLE,0141763R,71,71,0,0,28,43,4 ème
CALVADOS,FALAISE,0140052F,0,0,0,0,0,0,4 ème
CALVADOS,FALAISE,0141167T,61,61,0,0,30,31,4 ème
CALVADOS,HONFLEUR,0140056K,0,0,0,0,0,0,4 ème
CALVADOS,ISIGNY-SUR-MER,0141257R,46,41,0,5,26,20,4 ème
CALVADOS,LES MONTS D'AUNAY,0141662F,112,94,18,0,62,50,4 ème
CALVADOS,MEZIDON VALLEE D'AUGE,0140070A,116,107,0,9,56,60,4 ème
CALVADOS,MONDEVILLE,0141687H,0,0,0,0,0,0,4 ème
CALVADOS,POTIGNY,0140077H,90,84,0,6,39,51,4 ème
CALVADOS,SALINE,0141684E,134,131,0,3,67,67,4 ème
CALVADOS,SOULEUVRE EN BOCAGE,0140008H,85,85,0,0,43,42,4 ème
CALVADOS,TROUVILLE-SUR-MER,0141273H,80,64,12,4,43,37,4 ème
CALVADOS,VALDALLIERE,0140086T,55,55,0,0,24,31,4 ème
CALVADOS,VIRE NORMANDIE,0141767V,114,97,16,1,64,50,4 ème
EURE,BOURG-ACHARD,0270007L,172,172,0,0,88,84,4 ème
EURE,BRIONNE,0271606Z,0,0,0,0,0,0,4 ème
EURE,EVREUX,0270022C,174,169,0,5,88,86,4 ème
EURE,EVREUX,0270051J,0,0,0,0,0,0,4 ème
EURE,EVREUX,0271095U,142,119,17,6,69,73,4 ème
EURE,EVREUX,0271173D,131,114,16,1,59,72,4 ème
EURE,GRAND BOURGTHEROULDE,0271317K,223,204,17,2,111,112,4 ème
EURE,LE NEUBOURG,0270032N,139,122,15,2,67,72,4 ème
EURE,LE NEUBOURG,0271885C,147,147,0,0,74,73,4 ème
EURE,LE VAUDREUIL,0271632C,126,124,0,2,66,60,4 ème
EURE,LOUVIERS,0271065L,176,176,0,0,89,87,4 ème
EURE,MANNEVILLE-SUR-RISLE,0271284Z,122,106,16,0,53,69,4 ème
EURE,MONTFORT-SUR-RISLE,0270054M,132,132,0,0,72,60,4 ème
EURE,PONT-AUDEMER,0270036T,157,151,0,6,74,83,4 ème
EURE,PONT-DE-L'ARCHE,0270038V,174,172,0,2,78,96,4 ème
EURE,SAINT-ANDRE-DE-L'EURE,0270041Y,156,138,15,3,84,72,4 ème
EURE,SAINT-MARCEL,0271123Z,136,136,0,0,55,81,4 ème
MANCHE,AVRANCHES,0501525L,88,66,12,10,44,44,4 ème
MANCHE,AVRANCHES,0501704F,129,129,0,0,58,71,4 ème
MANCHE,AVRANCHES,0501787W,0,0,0,0,0,0,4 ème
MANCHE,BRECEY,0501302U,106,106,0,0,58,48,4 ème
MANCHE,BREHAL,0501239A,92,89,0,3,53,39,4 ème
MANCHE,CARENTAN-LES-MARAIS,0501941N,0,0,0,0,0,0,4 ème
MANCHE,CHERBOURG-EN-COTENTIN,0500032N,0,0,0,0,0,0,4 ème
MANCHE,CHERBOURG-EN-COTENTIN,0501677B,0,0,0,0,0,0,4 ème
MANCHE,COUTANCES,0501206P,126,93,28,5,57,69,4 ème
MANCHE,COUTANCES,0501703E,115,115,0,0,50,65,4 ème
MANCHE,COUTANCES,0502009M,0,0,0,0,0,0,4 ème
MANCHE,DUCEY-LES CHERIS,0501240B,69,68,0,1,34,35,4 ème
MANCHE,GRANVILLE,0500039W,157,141,11,5,66,91,4 ème
MANCHE,LA HAGUE,0500006K,107,107,0,0,56,51,4 ème
MANCHE,LESSAY,0501458N,61,56,0,5,33,28,4 ème
MANCHE,MORTAIN-BOCAGE,0500050H,88,84,0,4,44,44,4 ème
MANCHE,PERCY-EN-NORMANDIE,0500052K,58,58,0,0,29,29,4 ème
MANCHE,PERIERS,0500053L,54,54,0,0,30,24,4 ème
MANCHE,PONTORSON,0501241C,62,62,0,0,29,33,4 ème
MANCHE,SAINTE-MERE-EGLISE,0500068C,55,44,11,0,26,29,4 ème
MANCHE,SAINT-HILAIRE-DU-HARCOUET,0500061V,97,86,8,3,53,44,4 ème
MANCHE,VALOGNES,0500155X,71,71,0,0,36,35,4 ème
ORNE,ALENCON,0610003X,122,105,14,3,68,54,4 ème
ORNE,ALENCON,0610004Y,0,0,0,0,0,0,4 ème
ORNE,ALENCON,0611026J,72,69,0,3,37,35,4 ème
ORNE,ARGENTAN,0610006A,0,0,0,0,0,0,4 ème
ORNE,BRIOUZE,0611024G,39,39,0,0,23,16,4 ème
ORNE,LA FERTE MACE,0610019P,0,0,0,0,0,0,4 ème
ORNE,LA FERTE MACE,0610996B,14,0,14,0,4,10,4 ème
ORNE,L'AIGLE,0611156A,108,104,0,4,54,54,4 ème
ORNE,MORTAGNE-AU-PERCHE,0611094H,57,57,0,0,25,32,4 ème
ORNE,MOULINS-LA-MARCHE,0610036H,55,55,0,0,24,31,4 ème
ORNE,TINCHEBRAY-BOCAGE,0610042P,65,65,0,0,32,33,4 ème
SEINE MARITIME,CANTELEU,0760017F,101,82,16,3,60,41,4 ème
SEINE MARITIME,CAUDEBEC-LES-ELBEUF,0762919K,109,103,0,6,54,55,4 ème
SEINE MARITIME,CLERES,0762197A,122,122,0,0,44,78,4 ème
SEINE MARITIME,DOUDEVILLE,0762123V,92,89,0,3,51,41,4 ème
SEINE MARITIME,ELBEUF,0760030V,0,0,0,0,0,0,4 ème
SEINE MARITIME,ELBEUF,0762563Y,180,180,0,0,97,83,4 ème
SEINE MARITIME,FECAMP,0760036B,0,0,0,0,0,0,4 ème
SEINE MARITIME,FECAMP,0761731U,168,168,0,0,95,73,4 ème
SEINE MARITIME,FECAMP,0761785C,146,129,17,0,75,71,4 ème
SEINE MARITIME,FECAMP,0762287Y,67,67,0,0,35,32,4 ème
SEINE MARITIME,GRAND-COURONNE,0762461M,81,81,0,0,44,37,4 ème
SEINE MARITIME,GRUCHET-LE-VALASSE,0762861X,91,88,0,3,44,47,4 ème
SEINE MARITIME,LE HAVRE,0760050S,113,113,0,0,56,57,4 ème
SEINE MARITIME,LE HAVRE,0761739C,79,62,17,0,44,35,4 ème
SEINE MARITIME,LE HAVRE,0761782Z,107,88,16,3,50,57,4 ème
SEINE MARITIME,LE HAVRE,0762081Z,15,0,15,0,5,10,4 ème
SEINE MARITIME,LE HAVRE,0762128A,90,70,16,4,38,52,4 ème
SEINE MARITIME,LE PETIT-QUEVILLY,0761737A,105,105,0,0,47,58,4 ème
SEINE MARITIME,LE TRAIT,0762085D,66,66,0,0,35,31,4 ème
SEINE MARITIME,LILLEBONNE,0762738N,78,78,0,0,44,34,4 ème
SEINE MARITIME,MESNIERES-EN-BRAY,0761330H,32,32,0,0,15,17,4 ème
SEINE MARITIME,MONTIVILLIERS,0761331J,107,107,0,0,60,47,4 ème
SEINE MARITIME,MONTIVILLIERS,0762288Z,117,117,0,0,66,51,4 ème
SEINE MARITIME,MONTVILLE,0762090J,97,97,0,0,49,48,4 ème
SEINE MARITIME,NEUFCHATEL-EN-BRAY,0760079Y,150,131,16,3,79,71,4 ème
SEINE MARITIME,OFFRANVILLE,0760082B,0,0,0,0,0,0,4 ème
SEINE MARITIME,OISSEL,0760083C,124,121,0,3,63,61,4 ème
SEINE MARITIME,PETIT-COURONNE,0760086F,136,136,0,0,61,75,4 ème
SEINE MARITIME,ROUEN,0761337R,80,80,0,0,37,43,4 ème
SEINE MARITIME,ROUEN,0762568D,146,142,0,4,73,73,4 ème
SEINE MARITIME,ROUEN,0763406P,136,126,10,0,64,72,4 ème
SEINE MARITIME,SAINT-AUBIN-LES-ELBEUF,0760101X,95,90,0,5,49,46,4 ème
SEINE MARITIME,SAINT-ROMAIN-DE-COLBOSC,0761689Y,230,230,0,0,129,101,4 ème
SEINE MARITIME,VAL-DE-SCIE,0761956N,169,153,16,0,88,81,4 ème
DORDOGNE,BERGERAC,0240004Z,113,111,0,2,55,58,4 ème
DORDOGNE,BERGERAC,0240007C,0,0,0,0,0,0,4 ème
DORDOGNE,EXCIDEUIL,0241007P,74,74,0,0,37,37,4 ème
DORDOGNE,EYMET,0240014K,62,62,0,0,34,28,4 ème
DORDOGNE,MONTPON-MENESTEROL,0240117X,163,158,0,5,83,80,4 ème
DORDOGNE,PERIGUEUX,0240030C,187,154,32,1,84,103,4 ème
DORDOGNE,PERIGUEUX,0240077D,73,73,0,0,38,35,4 ème
DORDOGNE,PERIGUEUX,0240089S,0,0,0,0,0,0,4 ème
DORDOGNE,PERIGUEUX,0241075N,122,119,0,3,53,69,4 ème
DORDOGNE,PIEGUT-PLUVIERS,0240043S,37,37,0,0,19,18,4 ème
DORDOGNE,RIBERAC,0240086N,20,20,0,0,11,9,4 ème
DORDOGNE,RIBERAC,0241011U,112,92,17,3,63,49,4 ème
DORDOGNE,SAINT-ANTOINE-DE-BREUILH,0240087P,38,38,0,0,20,18,4 ème
DORDOGNE,SAINT-ASTIER,0240650B,131,116,12,3,67,64,4 ème
DORDOGNE,SARLAT-LA-CANEDA,0240048X,0,0,0,0,0,0,4 ème
DORDOGNE,SARLAT-LA-CANEDA,0241076P,49,49,0,0,30,19,4 ème
GIRONDE,AMBARES-ET-LAGRAVE,0331617D,212,208,0,4,101,111,4 ème
GIRONDE,ARSAC,0332704K,146,146,0,0,68,78,4 ème
GIRONDE,BEGLES,0331880P,158,137,16,5,70,88,4 ème
GIRONDE,BLANQUEFORT,0331754C,198,179,16,3,87,111,4 ème
GIRONDE,BLANQUEFORT,0332535B,0,0,0,0,0,0,4 ème
GIRONDE,BORDEAUX,0331492T,156,155,0,1,82,74,4 ème
GIRONDE,BORDEAUX,0331519X,58,58,0,0,28,30,4 ème
GIRONDE,BORDEAUX,0331753B,104,104,0,0,46,58,4 ème
GIRONDE,BORDEAUX,0332490C,329,329,0,0,176,153,4 ème
GIRONDE,CADILLAC,0330059K,175,168,0,7,82,93,4 ème
GIRONDE,CENON,0331464M,162,160,0,2,76,86,4 ème
GIRONDE,COUTRAS,0331621H,220,200,13,7,104,116,4 ème
GIRONDE,CREON,0332283C,238,228,6,4,114,124,4 ème
GIRONDE,LA BREDE,0332494G,156,156,0,0,76,80,4 ème
GIRONDE,LE BOUSCAT,0331523B,184,184,0,0,94,90,4 ème
GIRONDE,LE PIAN-MEDOC,0333529G,156,156,0,0,69,87,4 ème
GIRONDE,LESPARRE-MEDOC,0331528G,61,58,0,3,39,22,4 ème
GIRONDE,LE TEICH,0332982M,102,101,0,1,46,56,4 ème
GIRONDE,LIBOURNE,0330089T,0,0,0,0,0,0,4 ème
GIRONDE,MARTIGNAS-SUR-JALLE,0332743C,114,114,0,0,55,59,4 ème
GIRONDE,MERIGNAC,0331435F,199,199,0,0,88,111,4 ème
GIRONDE,PEUJARD,0332723F,134,128,0,6,57,77,4 ème
GIRONDE,SAINT-ANDRE-DE-CUBZAC,0331757F,223,204,14,5,116,107,4 ème
GIRONDE,SAINT-CIERS-SUR-GIRONDE,0330113U,129,126,0,3,69,60,4 ème
GIRONDE,SAINT-MEDARD-DE-GUIZIERES,0331569B,0,0,0,0,0,0,4 ème
GIRONDE,SAINT-MEDARD-EN-JALLES,0332187Y,222,202,13,7,99,123,4 ème
GIRONDE,SAINT-SYMPHORIEN,0330122D,109,106,0,3,59,50,4 ème
GIRONDE,SAUVETERRE-DE-GUYENNE,0331667H,96,81,13,2,50,46,4 ème
GIRONDE,VILLENAVE-D'ORNON,0332246M,209,192,15,2,86,123,4 ème
LANDES,GABARRET,0400010U,47,47,0,0,20,27,4 ème
LANDES,GABARRET,0400883T,0,0,0,0,0,0,4 ème
LANDES,GRENADE-SUR-L'ADOUR,0400012W,88,88,0,0,47,41,4 ème
LANDES,LABOUHEYRE,0400014Y,110,108,0,2,47,63,4 ème
LANDES,PEYREHORADE,0400027M,0,0,0,0,0,0,4 ème
LANDES,ROQUEFORT,0400034V,64,60,0,4,35,29,4 ème
LANDES,SAINT-MARTIN-DE-SEIGNANX,0400874H,138,138,0,0,77,61,4 ème
LANDES,SAINT-SEVER,0400075P,39,39,0,0,18,21,4 ème
LANDES,SAINT-VINCENT-DE-PAUL,0400068G,45,34,8,3,21,24,4 ème
LANDES,TARNOS,0400049L,0,0,0,0,0,0,4 ème
LANDES,TARTAS,0400042D,109,106,0,3,53,56,4 ème
LOT-ET-GARONNE,AGEN,0470004Z,0,0,0,0,0,0,4 ème
LOT-ET-GARONNE,AGEN,0470008D,143,143,0,0,78,65,4 ème
LOT-ET-GARONNE,BON-ENCONTRE,0470720C,188,171,16,1,97,91,4 ème
LOT-ET-GARONNE,CASSENEUIL,0470067T,81,69,12,0,34,47,4 ème
LOT-ET-GARONNE,CASTELJALOUX,0470012H,81,81,0,0,42,39,4 ème
LOT-ET-GARONNE,CASTELJALOUX,0470068U,43,41,0,2,15,28,4 ème
LOT-ET-GARONNE,DURAS,0470017N,43,43,0,0,20,23,4 ème
LOT-ET-GARONNE,MIRAMONT-DE-GUYENNE,0470024W,124,120,0,4,54,70,4 ème
LOT-ET-GARONNE,MONBAHUS,0470071X,26,25,0,1,12,14,4 ème
LOT-ET-GARONNE,PORT-SAINTE-MARIE,0470032E,59,57,0,2,21,38,4 ème
LOT-ET-GARONNE,TONNEINS,0470073Z,57,57,0,0,34,23,4 ème
LOT-ET-GARONNE,VILLENEUVE-SUR-LOT,0470811B,105,105,0,0,58,47,4 ème
PYRENEES-ATLANTIQUES,ANGLET,0640001D,0,0,0,0,0,0,4 ème
PYRENEES-ATLANTIQUES,ARUDY,0640007K,78,78,0,0,35,43,4 ème
PYRENEES-ATLANTIQUES,ARZACQ-ARRAZIGUET,0640008L,84,84,0,0,41,43,4 ème
PYRENEES-ATLANTIQUES,BAYONNE,0640112Z,172,170,0,2,91,81,4 ème
PYRENEES-ATLANTIQUES,BAYONNE,0640143H,87,87,0,0,44,43,4 ème
PYRENEES-ATLANTIQUES,BAYONNE,0640609P,140,125,9,6,60,80,4 ème
PYRENEES-ATLANTIQUES,BIARRITZ,0640146L,54,54,0,0,27,27,4 ème
PYRENEES-ATLANTIQUES,BOUCAU,0640023C,95,95,0,0,43,52,4 ème
PYRENEES-ATLANTIQUES,CIBOURE,0641941M,86,84,0,2,34,52,4 ème
PYRENEES-ATLANTIQUES,GARLIN,0640025E,77,74,0,3,38,39,4 ème
PYRENEES-ATLANTIQUES,HENDAYE,0640151S,70,70,0,0,31,39,4 ème
PYRENEES-ATLANTIQUES,JURANCON,0641405E,46,46,0,0,25,21,4 ème
PYRENEES-ATLANTIQUES,LEMBEYE,0640037T,68,68,0,0,33,35,4 ème
PYRENEES-ATLANTIQUES,LESCAR,0641391P,201,197,0,4,103,98,4 ème
PYRENEES-ATLANTIQUES,MAULEON-LICHARRE,0640039V,80,79,0,1,41,39,4 ème
PYRENEES-ATLANTIQUES,NAVARRENX,0640045B,47,47,0,0,23,24,4 ème
PYRENEES-ATLANTIQUES,OLORON-SAINTE-MARIE,0640049F,0,0,0,0,0,0,4 ème
PYRENEES-ATLANTIQUES,OLORON-SAINTE-MARIE,0641658E,72,72,0,0,41,31,4 ème
PYRENEES-ATLANTIQUES,PAU,0640132W,48,42,0,6,26,22,4 ème
PYRENEES-ATLANTIQUES,PAU,0642095E,56,56,0,0,29,27,4 ème
PYRENEES-ATLANTIQUES,PONTACQ,0640161C,59,59,0,0,30,29,4 ème
PYRENEES-ATLANTIQUES,SAINT-JEAN-PIED-DE-PORT,0640069C,60,46,14,0,28,32,4 ème
PYRENEES-ATLANTIQUES,SAINT-PEE-SUR-NIVELLE,0640169L,80,80,0,0,36,44,4 ème
CORREZE,ARGENTAT-SUR-DORDOGNE,0190002Z,58,58,0,0,36,22,4 ème
CORREZE,BORT-LES-ORGUES,0190009G,39,39,0,0,22,17,4 ème
CORREZE,BRIVE-LA-GAILLARDE,0190012K,0,0,0,0,0,0,4 ème
CORREZE,BRIVE-LA-GAILLARDE,0190014M,169,139,29,1,68,101,4 ème
CORREZE,USSEL,0190615R,143,125,15,3,62,81,4 ème
CREUSE,CHAMBON-SUR-VOUEIZE,0230010L,42,42,0,0,17,25,4 ème
CREUSE,DUN-LE-PALESTEL,0230408U,60,60,0,0,38,22,4 ème
CREUSE,GUERET,0230487E,109,89,15,5,54,55,4 ème
CREUSE,GUERET,0230488F,149,149,0,0,73,76,4 ème
CREUSE,SAINT-VAURY,0230027E,0,0,0,0,0,0,4 ème
HAUTE-VIENNE,CHATEAUPONSAC,0870009M,44,44,0,0,23,21,4 ème
HAUTE-VIENNE,COUZEIX,0870871Z,173,155,0,18,79,94,4 ème
HAUTE-VIENNE,ISLE,0870658T,172,172,0,0,84,88,4 ème
HAUTE-VIENNE,LIMOGES,0870023C,116,112,0,4,60,56,4 ème
HAUTE-VIENNE,LIMOGES,0870919B,0,0,0,0,0,0,4 ème
HAUTE-VIENNE,SAINT-GERMAIN-LES-BELLES,0870039V,64,64,0,0,33,31,4 ème
HAUTE-VIENNE,SAINT-YRIEIX-LA-PERCHE,0870821V,129,114,14,1,70,59,4 ème
CHARENTE,ANGOULEME,0160005U,87,87,0,0,48,39,4 ème
CHARENTE,ANGOULEME,0161106R,71,70,0,1,31,40,4 ème
CHARENTE,CHABANAIS,0160120U,69,54,15,0,33,36,4 ème
CHARENTE,CHATEAUNEUF-SUR-CHARENTE,0160863B,115,115,0,0,57,58,4 ème
CHARENTE,LA COURONNE,0160024P,132,132,0,0,61,71,4 ème
CHARENTE,MANSLE,0160029V,76,71,0,5,42,34,4 ème
CHARENTE,SAINT-AMANT-DE-BOIXE,0160040G,93,89,0,4,51,42,4 ème
CHARENTE,SAINT-YRIEIX-SUR-CHARENTE,0160083D,0,0,0,0,0,0,4 ème
CHARENTE,SOYAUX,0160894K,116,111,0,5,56,60,4 ème
CHARENTE,VILLEBOIS-LAVALETTE,0160043K,91,91,0,0,47,44,4 ème
CHARENTE-MARITIME,BURIE,0170004M,75,75,0,0,33,42,4 ème
CHARENTE-MARITIME,CHATELAILLON-PLAGE,0171211Z,175,172,0,3,83,92,4 ème
CHARENTE-MARITIME,JONZAC,0170011V,130,125,0,5,61,69,4 ème
CHARENTE-MARITIME,LA ROCHELLE,0170031S,0,0,0,0,0,0,4 ème
CHARENTE-MARITIME,LOULAY,0170012W,54,49,0,5,29,25,4 ème
CHARENTE-MARITIME,MARENNES-HIERS-BROUAGE,0170386C,125,107,14,4,50,75,4 ème
CHARENTE-MARITIME,MATHA,0171159T,92,92,0,0,45,47,4 ème
CHARENTE-MARITIME,MONTENDRE,0170390G,115,81,29,5,56,59,4 ème
CHARENTE-MARITIME,MONTGUYON,0171160U,55,55,0,0,30,25,4 ème
CHARENTE-MARITIME,ROCHEFORT,0170113F,60,60,0,0,41,19,4 ème
CHARENTE-MARITIME,ROCHEFORT,0171056F,167,162,0,5,86,81,4 ème
CHARENTE-MARITIME,ROYAN,0171120A,149,129,18,2,79,70,4 ème
CHARENTE-MARITIME,SAINTES,0170063B,222,196,22,4,120,102,4 ème
CHARENTE-MARITIME,SAINTES,0170102U,56,56,0,0,29,27,4 ème
CHARENTE-MARITIME,SAINTES,0170144P,205,204,0,1,113,92,4 ème
CHARENTE-MARITIME,SAINT-GENIS-DE-SAINTONGE,0170049L,84,80,0,4,35,49,4 ème
CHARENTE-MARITIME,SAINT-JEAN-D'ANGELY,0170052P,0,0,0,0,0,0,4 ème
CHARENTE-MARITIME,SAINT-MARTIN-DE-RE,0171034G,147,147,0,0,72,75,4 ème
CHARENTE-MARITIME,SAINT-PORCHAIRE,0170055T,125,124,0,1,66,59,4 ème
CHARENTE-MARITIME,SAUJON,0170387D,152,146,0,6,70,82,4 ème
DEUX-SEVRES,ARGENTONNAY,0790003Z,56,56,0,0,22,34,4 ème
DEUX-SEVRES,L'ABSIE,0790001X,24,24,0,0,11,13,4 ème
DEUX-SEVRES,LA MOTHE-SAINT-HERAY,0790021U,66,63,0,3,31,35,4 ème
DEUX-SEVRES,MONCOUTANT-SUR-SEVRE,0790966W,85,81,0,4,46,39,4 ème
DEUX-SEVRES,NIORT,0790052C,183,151,27,5,89,94,4 ème
DEUX-SEVRES,NIORT,0790089T,141,140,0,1,75,66,4 ème
DEUX-SEVRES,NIORT,0790709S,172,169,0,3,75,97,4 ème
DEUX-SEVRES,NUEIL-LES-AUBIERS,0790061M,73,73,0,0,40,33,4 ème
DEUX-SEVRES,PARTHENAY,0790071Y,80,79,0,1,46,34,4 ème
DEUX-SEVRES,PARTHENAY,0790090U,0,0,0,0,0,0,4 ème
DEUX-SEVRES,PRAHECQ,0790950D,126,123,0,3,48,78,4 ème
DEUX-SEVRES,SAUZE-VAUSSAIS,0790033G,32,32,0,0,18,14,4 ème
DEUX-SEVRES,THOUARS,0791017B,80,80,0,0,40,40,4 ème
VIENNE,BUXEROLLES,0860799B,149,148,0,1,81,68,4 ème
VIENNE,CHARROUX,0860002K,42,42,0,0,22,20,4 ème
VIENNE,CHATELLERAULT,0860702W,92,84,0,8,43,49,4 ème
VIENNE,CHATELLERAULT,0860753B,127,122,0,5,65,62,4 ème
VIENNE,DANGE-SAINT-ROMAIN,0860015Z,88,85,0,3,44,44,4 ème
VIENNE,LOUDUN,0860023H,123,101,17,5,71,52,4 ème
VIENNE,MONTMORILLON,0860768T,51,51,0,0,24,27,4 ème
VIENNE,POITIERS,0860723U,165,163,0,2,86,79,4 ème
VIENNE,POITIERS,0860758G,150,147,0,3,80,70,4 ème
VIENNE,POITIERS,0860791T,180,178,0,2,86,94,4 ème
VIENNE,VOUNEUIL-SOUS-BIARD,0861457S,148,148,0,0,78,70,4 ème
VIENNE,VOUNEUIL-SUR-VIENNE,0860049L,139,136,0,3,82,57,4 ème
AUDE,CARCASSONNE,0110010B,92,92,0,0,47,45,4 ème
AUDE,CARCASSONNE,0110810W,217,193,17,7,106,111,4 ème
AUDE,COURSAN,0110067N,202,191,0,11,95,107,4 ème
AUDE,CUXAC-CABARDES,0110721Z,77,77,0,0,40,37,4 ème
AUDE,LEZIGNAN-CORBIERES,0110686L,188,184,0,4,98,90,4 ème
AUDE,NARBONNE,0110049U,200,196,0,4,112,88,4 ème
AUDE,PORT-LA-NOUVELLE,0110725D,79,75,0,4,33,46,4 ème
AUDE,QUILLAN,0110675Z,46,46,0,0,26,20,4 ème
AUDE,SAINT-NAZAIRE-D'AUDE,0111015U,174,174,0,0,91,83,4 ème
AUDE,SIGEAN,0110724C,164,164,0,0,79,85,4 ème
GARD,ALES,0300125Y,0,0,0,0,0,0,4 ème
GARD,ALES,0300947S,156,136,16,4,69,87,4 ème
GARD,ALES,0300949U,176,173,0,3,84,92,4 ème
GARD,BEAUCAIRE,0301282F,154,137,15,2,74,80,4 ème
GARD,BELLEGARDE,0301827Y,110,104,0,6,48,62,4 ème
GARD,LA GRAND-COMBE,0301012M,78,76,0,2,34,44,4 ème
GARD,LE GRAU-DU-ROI,0301751R,122,119,0,3,57,65,4 ème
GARD,LE VIGAN,0301326D,126,112,14,0,66,60,4 ème
GARD,NIMES,0300025P,79,77,0,2,44,35,4 ème
GARD,NIMES,0300093N,227,216,11,0,102,125,4 ème
GARD,NIMES,0301356L,299,297,0,2,138,161,4 ème
GARD,UZES,0301283G,171,155,16,0,84,87,4 ème
GARD,UZES,0301721H,104,98,0,6,58,46,4 ème
GARD,VAUVERT,0301096D,245,221,20,4,113,132,4 ème
HERAULT,BEZIERS,0340891J,49,49,0,0,26,23,4 ème
HERAULT,BEZIERS,0341321B,161,135,16,10,75,86,4 ème
HERAULT,CAPESTANG,0341367B,161,161,0,0,94,67,4 ème
HERAULT,CLAPIERS,0341826A,150,148,0,2,71,79,4 ème
HERAULT,CLERMONT-L'HERAULT,0341366A,220,216,0,4,115,105,4 ème
HERAULT,FRONTIGNAN,0342052W,141,136,0,5,73,68,4 ème
HERAULT,GANGES,0340896P,46,46,0,0,25,21,4 ème
HERAULT,LOUPIAN,0342224H,140,124,16,0,69,71,4 ème
HERAULT,LUNEL,0340031Z,178,176,0,2,81,97,4 ème
HERAULT,MONTPELLIER,0340874R,219,219,0,0,113,106,4 ème
HERAULT,MONTPELLIER,0340876T,119,119,0,0,65,54,4 ème
HERAULT,MONTPELLIER,0340996Y,179,158,15,6,97,82,4 ème
HERAULT,MONTPELLIER,0340998A,132,129,0,3,68,64,4 ème
HERAULT,MONTPELLIER,0342012C,41,41,0,0,19,22,4 ème
HERAULT,PAULHAN,0340974Z,135,135,0,0,73,62,4 ème
HERAULT,PEZENAS,0340061G,0,0,0,0,0,0,4 ème
HERAULT,PEZENAS,0340907B,75,75,0,0,28,47,4 ème
HERAULT,SAINT-CHINIAN,0340065L,93,91,0,2,44,49,4 ème
HERAULT,SETE,0340076Y,0,0,0,0,0,0,4 ème
HERAULT,SETE,0341065Y,100,79,16,5,45,55,4 ème
LOZERE,MARVEJOLS,0480024R,81,81,0,0,44,37,4 ème
LOZERE,SAINT-CHELY-D'APCHER,0480038F,60,60,0,0,37,23,4 ème
LOZERE,VIALAS,0480016G,9,9,0,0,3,6,4 ème
PYRENEES-ORIENTALES,ARGELES-SUR-MER,0660001T,161,140,17,4,84,77,4 ème
PYRENEES-ORIENTALES,CERET,0660004W,0,0,0,0,0,0,4 ème
PYRENEES-ORIENTALES,ESTAGEL,0660007Z,97,97,0,0,49,48,4 ème
PYRENEES-ORIENTALES,ILLE-SUR-TET,0660008A,121,119,0,2,58,63,4 ème
PYRENEES-ORIENTALES,LE SOLER,0660653B,167,167,0,0,86,81,4 ème
PYRENEES-ORIENTALES,MILLAS,0660925X,158,153,0,5,85,73,4 ème
PYRENEES-ORIENTALES,PERPIGNAN,0660012E,164,143,15,6,80,84,4 ème
PYRENEES-ORIENTALES,PERPIGNAN,0660017K,108,108,0,0,53,55,4 ème
PYRENEES-ORIENTALES,PERPIGNAN,0660018L,149,148,0,1,74,75,4 ème
PYRENEES-ORIENTALES,PERPIGNAN,0660019M,171,151,15,5,88,83,4 ème
PYRENEES-ORIENTALES,PERPIGNAN,0660049V,198,195,0,3,105,93,4 ème
PYRENEES-ORIENTALES,PERPIGNAN,0660061H,149,147,0,2,83,66,4 ème
PYRENEES-ORIENTALES,PERPIGNAN,0660809W,0,0,0,0,0,0,4 ème
PYRENEES-ORIENTALES,SAINT-CYPRIEN,0660848N,184,183,0,1,95,89,4 ème
PYRENEES-ORIENTALES,TOULOUGES,0660864F,180,180,0,0,84,96,4 ème
ARIEGE,PAMIERS,0090056M,129,124,0,5,63,66,4 ème
ARIEGE,PAMIERS,0090591U,84,84,0,0,42,42,4 ème
ARIEGE,SAVERDUN,0090023B,86,86,0,0,43,43,4 ème
AVEYRON,BARAQUEVILLE,0120032V,115,112,0,3,59,56,4 ème
AVEYRON,BARAQUEVILLE,0120080X,18,18,0,0,9,9,4 ème
AVEYRON,BELMONT-SUR-RANCE,0120081Y,39,39,0,0,21,18,4 ème
AVEYRON,CAPDENAC-GARE,0120002M,66,66,0,0,29,37,4 ème
AVEYRON,CASSAGNES-BEGONHES,0120084B,22,22,0,0,10,12,4 ème
AVEYRON,LAGUIOLE,0120091J,12,12,0,0,8,4,4 ème
AVEYRON,MILLAU,0121259D,140,140,0,0,70,70,4 ème
AVEYRON,MUR-DE-BARREZ,0120016C,31,31,0,0,16,15,4 ème
AVEYRON,REQUISTA,0120019F,54,54,0,0,29,25,4 ème
AVEYRON,REQUISTA,0120068J,22,22,0,0,8,14,4 ème
AVEYRON,RODEZ,0120038B,0,0,0,0,0,0,4 ème
AVEYRON,RODEZ,0120101V,205,198,0,7,99,106,4 ème
AVEYRON,RODEZ,0121430P,209,187,15,7,109,100,4 ème
AVEYRON,SAINT-AMANS-DES-COTS,0121295T,37,34,0,3,19,18,4 ème
AVEYRON,SAINT GENIEZ D'OLT ET D'AUBRAC,0120028R,38,38,0,0,23,15,4 ème
AVEYRON,SALLES-CURAN,0120077U,27,27,0,0,13,14,4 ème
GERS,AUCH,0320006H,107,102,0,5,46,61,4 ème
GERS,EAUZE,0320011N,85,80,0,5,46,39,4 ème
GERS,LECTOURE,0320015T,0,0,0,0,0,0,4 ème
GERS,MIELAN,0320074G,38,38,0,0,17,21,4 ème
HAUTE-GARONNE,ASPET,0310001H,40,35,0,5,20,20,4 ème
HAUTE-GARONNE,BLAGNAC,0311237B,142,139,0,3,62,80,4 ème
HAUTE-GARONNE,BLAGNAC,0311965T,123,123,0,0,62,61,4 ème
HAUTE-GARONNE,CADOURS,0310008R,171,171,0,0,75,96,4 ème
HAUTE-GARONNE,COLOMIERS,0311160T,121,121,0,0,73,48,4 ème
HAUTE-GARONNE,COLOMIERS,0312092F,90,85,0,5,43,47,4 ème
HAUTE-GARONNE,CUGNAUX,0311093V,226,223,0,3,113,113,4 ème
HAUTE-GARONNE,FRONTON,0311721C,238,234,0,4,115,123,4 ème
HAUTE-GARONNE,GRATENTOUR,0312478A,172,164,0,8,89,83,4 ème
HAUTE-GARONNE,GRENADE,0311769E,194,166,23,5,94,100,4 ème
HAUTE-GARONNE,L'ISLE-EN-DODON,0310019C,23,23,0,0,17,6,4 ème
HAUTE-GARONNE,L'UNION,0311094W,214,194,15,5,113,101,4 ème
HAUTE-GARONNE,MONTASTRUC-LA-CONSEILLERE,0310021E,185,179,0,6,87,98,4 ème
HAUTE-GARONNE,MONTESQUIEU-VOLVESTRE,0310022F,83,83,0,0,38,45,4 ème
HAUTE-GARONNE,MURET,0312822Z,0,0,0,0,0,0,4 ème
HAUTE-GARONNE,REVEL,0311846N,135,135,0,0,66,69,4 ème
HAUTE-GARONNE,SAINT-GAUDENS,0310033T,0,0,0,0,0,0,4 ème
HAUTE-GARONNE,SAINT-ORENS-DE-GAMEVILLE,0312140H,167,167,0,0,84,83,4 ème
HAUTE-GARONNE,TOULOUSE,0310093H,144,140,0,4,65,79,4 ème
HAUTE-GARONNE,TOULOUSE,0311112R,172,155,14,3,90,82,4 ème
HAUTE-GARONNE,TOULOUSE,0311144A,114,109,0,5,49,65,4 ème
HAUTE-GARONNE,TOULOUSE,0311150G,91,91,0,0,49,42,4 ème
HAUTE-GARONNE,TOULOUSE,0311169C,94,92,0,2,48,46,4 ème
HAUTE-GARONNE,TOULOUSE,0311171E,105,105,0,0,56,49,4 ème
HAUTE-GARONNE,TOULOUSE,0311219G,0,0,0,0,0,0,4 ème
HAUTE-GARONNE,TOULOUSE,0311327Z,118,96,17,5,55,63,4 ème
HAUTE-GARONNE,TOULOUSE,0311582B,88,88,0,0,46,42,4 ème
HAUTE-GARONNE,TOULOUSE,0311972A,273,267,6,0,140,133,4 ème
HAUTE-GARONNE,TOURNEFEUILLE,0312746S,0,0,0,0,0,0,4 ème
HAUTE-GARONNE,VILLEFRANCHE-DE-LAURAGAIS,0311634H,188,183,0,5,76,112,4 ème
HAUTE-GARONNE,VILLEMUR-SUR-TARN,0311689T,111,97,14,0,53,58,4 ème
HAUTES-PYRENEES,PIERREFITTE-NESTALAS,0650020U,22,22,0,0,11,11,4 ème
HAUTES-PYRENEES,SEMEAC,0650088T,140,134,0,6,61,79,4 ème
HAUTES-PYRENEES,TARBES,0650029D,0,0,0,0,0,0,4 ème
HAUTES-PYRENEES,TRIE-SUR-BAISE,0650037M,63,63,0,0,27,36,4 ème
HAUTES-PYRENEES,VIC-EN-BIGORRE,0650075D,29,29,0,0,12,17,4 ème
LOT,CAHORS,0460006G,214,211,0,3,112,102,4 ème
LOT,CAHORS,0460528Z,181,150,30,1,80,101,4 ème
LOT,CAJARC,0460001B,78,78,0,0,40,38,4 ème
LOT,CASTELNAU MONTRATIER-STE ALAUZIE,0460008J,45,45,0,0,18,27,4 ème
LOT,FIGEAC,0460621A,82,80,0,2,45,37,4 ème
LOT,GOURDON,0460013P,0,0,0,0,0,0,4 ème
LOT,LUZECH,0460020X,81,81,0,0,42,39,4 ème
LOT,MONTCUQ-EN-QUERCY-BLANC,0460022Z,20,20,0,0,10,10,4 ème
LOT,PUY-L'EVEQUE,0460530B,49,49,0,0,25,24,4 ème
LOT,SAINT-CERE,0460593V,82,64,16,2,35,47,4 ème
LOT,SALVIAC,0460027E,34,34,0,0,17,17,4 ème
TARN,ALBI,0810100U,0,0,0,0,0,0,4 ème
TARN,CASTRES,0811064S,120,115,0,5,59,61,4 ème
TARN,GAILLAC,0810993P,200,181,16,3,98,102,4 ème
TARN,GRAULHET,0810995S,0,0,0,0,0,0,4 ème
TARN,LABRUGUIERE,0810026N,110,109,0,1,52,58,4 ème
TARN,LISLE-SUR-TARN,0811340S,87,87,0,0,41,46,4 ème
TARN,MAZAMET,0811324Z,0,0,0,0,0,0,4 ème
TARN,VALENCE-D'ALBIGEOIS,0810043G,62,62,0,0,29,33,4 ème
TARN,VIELMUR-SUR-AGOUT,0810044H,90,90,0,0,36,54,4 ème
TARN-ET-GARONNE,BEAUMONT-DE-LOMAGNE,0820001F,0,0,0,0,0,0,4 ème
TARN-ET-GARONNE,BEAUMONT-DE-LOMAGNE,0820067C,124,113,0,11,61,63,4 ème
TARN-ET-GARONNE,CASTELSARRASIN,0820004J,0,0,0,0,0,0,4 ème
TARN-ET-GARONNE,CAUSSADE,0820048G,87,86,0,1,49,38,4 ème
TARN-ET-GARONNE,LAFRANCAISE,0820011S,137,137,0,0,77,60,4 ème
TARN-ET-GARONNE,LAUZERTE,0820014V,75,70,0,5,47,28,4 ème
LOIRE-ATLANTIQUE,ANCENIS-SAINT-GEREON,0440001M,0,0,0,0,0,0,4 ème
LOIRE-ATLANTIQUE,ANCENIS-SAINT-GEREON,0440147W,149,131,15,3,76,73,4 ème
LOIRE-ATLANTIQUE,BLAIN,0440182J,138,137,0,1,62,76,4 ème
LOIRE-ATLANTIQUE,BLAIN,0440308W,176,145,29,2,86,90,4 ème
LOIRE-ATLANTIQUE,CARQUEFOU,0440422V,174,172,0,2,78,96,4 ème
LOIRE-ATLANTIQUE,CHATEAUBRIANT,0440348P,136,117,14,5,76,60,4 ème
LOIRE-ATLANTIQUE,COUERON,0440010X,193,193,0,0,97,96,4 ème
LOIRE-ATLANTIQUE,COUERON,0440190T,188,188,0,0,94,94,4 ème
LOIRE-ATLANTIQUE,GUEMENE-PENFAO,0440013A,99,93,0,6,50,49,4 ème
LOIRE-ATLANTIQUE,GUEMENE-PENFAO,0440192V,93,93,0,0,45,48,4 ème
LOIRE-ATLANTIQUE,GUERANDE,0440538W,129,125,0,4,71,58,4 ème
LOIRE-ATLANTIQUE,HAUTE-GOULAINE,0440153C,92,92,0,0,45,47,4 ème
LOIRE-ATLANTIQUE,LA MONTAGNE,0440347N,121,120,0,1,60,61,4 ème
LOIRE-ATLANTIQUE,LEGE,0441612N,56,56,0,0,26,30,4 ème
LOIRE-ATLANTIQUE,MACHECOUL-SAINT-MEME,0440352U,0,0,0,0,0,0,4 ème
LOIRE-ATLANTIQUE,NANTES,0440023L,187,164,16,7,92,95,4 ème
LOIRE-ATLANTIQUE,NANTES,0440203G,38,38,0,0,22,16,4 ème
LOIRE-ATLANTIQUE,NANTES,0440206K,37,37,0,0,16,21,4 ème
LOIRE-ATLANTIQUE,NANTES,0440207L,40,40,0,0,10,30,4 ème
LOIRE-ATLANTIQUE,NANTES,0441820P,82,82,0,0,38,44,4 ème
LOIRE-ATLANTIQUE,NANTES,0441821R,66,66,0,0,37,29,4 ème
LOIRE-ATLANTIQUE,NORT-SUR-ERDRE,0441654J,186,181,0,5,94,92,4 ème
LOIRE-ATLANTIQUE,PONTCHATEAU,0440224E,146,146,0,0,67,79,4 ème
LOIRE-ATLANTIQUE,PONTCHATEAU,0440540Y,111,75,32,4,59,52,4 ème
LOIRE-ATLANTIQUE,PORNIC,0440226G,154,154,0,0,76,78,4 ème
LOIRE-ATLANTIQUE,PORNIC,0440289A,193,187,0,6,78,115,4 ème
LOIRE-ATLANTIQUE,REZE,0440534S,113,95,16,2,61,52,4 ème
LOIRE-ATLANTIQUE,RIAILLE,0440232N,97,97,0,0,42,55,4 ème
LOIRE-ATLANTIQUE,SAINT-BREVIN-LES-PINS,0440066H,162,160,0,2,96,66,4 ème
LOIRE-ATLANTIQUE,SAINT-HERBLAIN,0440287Y,96,95,0,1,45,51,4 ème
LOIRE-ATLANTIQUE,SAINT-HERBLAIN,0440311Z,138,118,16,4,72,66,4 ème
LOIRE-ATLANTIQUE,SAINT-HERBLAIN,0441610L,130,112,16,2,72,58,4 ème
LOIRE-ATLANTIQUE,SAINT-NAZAIRE,0442759K,163,160,0,3,86,77,4 ème
LOIRE-ATLANTIQUE,SAINT-SEBASTIEN-SUR-LOIRE,0441548U,216,200,16,0,97,119,4 ème
LOIRE-ATLANTIQUE,SAINT-SEBASTIEN-SUR-LOIRE,0441653H,0,0,0,0,0,0,4 ème
LOIRE-ATLANTIQUE,VALLET,0440242Z,157,157,0,0,80,77,4 ème
MAINE-ET-LOIRE,ANGERS,0490003M,0,0,0,0,0,0,4 ème
MAINE-ET-LOIRE,ANGERS,0492432C,0,0,0,0,0,0,4 ème
MAINE-ET-LOIRE,AVRILLE,0491674D,162,142,16,4,83,79,4 ème
MAINE-ET-LOIRE,BEAUPREAU-EN-MAUGES,0490865Z,86,86,0,0,42,44,4 ème
MAINE-ET-LOIRE,CHEMILLE-EN-ANJOU,0490017C,86,84,0,2,40,46,4 ème
MAINE-ET-LOIRE,CHOLET,0490022H,113,111,0,2,58,55,4 ème
MAINE-ET-LOIRE,CHOLET,0490054T,0,0,0,0,0,0,4 ème
MAINE-ET-LOIRE,CHOLET,0490860U,142,110,32,0,58,84,4 ème
MAINE-ET-LOIRE,CHOLET,0491859E,136,116,16,4,46,90,4 ème
MAINE-ET-LOIRE,LOIRE-AUTHION,0490013Y,0,0,0,0,0,0,4 ème
MAINE-ET-LOIRE,MAUGES-SUR-LOIRE,0491928E,226,210,15,1,117,109,4 ème
MAINE-ET-LOIRE,MONTREUIL-BELLAY,0491262F,120,104,15,1,62,58,4 ème
MAINE-ET-LOIRE,SAINT-BARTHELEMY-D'ANJOU,0490957Z,163,160,0,3,84,79,4 ème
MAINE-ET-LOIRE,SAUMUR,0490910Y,0,0,0,0,0,0,4 ème
MAINE-ET-LOIRE,SEICHES-SUR-LE-LOIR,0491024X,160,158,0,2,73,87,4 ème
MAINE-ET-LOIRE,SEVREMOINE,0490842Z,116,116,0,0,72,44,4 ème
MAINE-ET-LOIRE,VERRIERES-EN-ANJOU,0492420P,0,0,0,0,0,0,4 ème
MAYENNE,CHATEAU-GONTIER-SUR-MAYENNE,0530827L,118,118,0,0,57,61,4 ème
MAYENNE,COSSE-LE-VIVIEN,0530054W,81,81,0,0,53,28,4 ème
MAYENNE,CRAON,0530005T,74,57,17,0,27,47,4 ème
MAYENNE,CRAON,0530055X,95,95,0,0,51,44,4 ème
MAYENNE,EVRON,0530949U,0,0,0,0,0,0,4 ème
MAYENNE,LANDIVY,0530804L,43,43,0,0,18,25,4 ème
MAYENNE,LAVAL,0530068L,0,0,0,0,0,0,4 ème
MAYENNE,LAVAL,0530790W,115,108,0,7,54,61,4 ème
MAYENNE,MAYENNE,0530078X,145,122,16,7,67,78,4 ème
MAYENNE,MAYENNE,0530079Y,0,0,0,0,0,0,4 ème
MAYENNE,VILLAINES-LA-JUHEL,0530066J,47,47,0,0,21,26,4 ème
SARTHE,ARNAGE,0720003M,0,0,0,0,0,0,4 ème
SARTHE,BOULOIRE,0720007S,105,89,16,0,49,56,4 ème
SARTHE,COULAINES,0720906U,170,163,0,7,86,84,4 ème
SARTHE,LA SUZE-SUR-SARTHE,0720905T,150,146,0,4,81,69,4 ème
SARTHE,LE MANS,0720822C,0,0,0,0,0,0,4 ème
SARTHE,LE MANS,0720825F,0,0,0,0,0,0,4 ème
SARTHE,LE MANS,0721090U,109,94,15,0,58,51,4 ème
SARTHE,LOUE,0720808M,47,47,0,0,21,26,4 ème
SARTHE,MAMERS,0720069J,95,81,14,0,55,40,4 ème
SARTHE,MAMERS,0721657K,39,39,0,0,18,21,4 ème
SARTHE,SABLE-SUR-SARTHE,0720070K,150,150,0,0,70,80,4 ème
SARTHE,SABLE-SUR-SARTHE,0720843A,0,0,0,0,0,0,4 ème
SARTHE,SAINT-CALAIS,0720803G,24,24,0,0,11,13,4 ème
VENDEE,CHALLANS,0850146X,0,0,0,0,0,0,4 ème
VENDEE,ESSARTS EN BOCAGE,0850099W,165,165,0,0,84,81,4 ème
VENDEE,FONTENAY-LE-COMTE,0850067L,148,125,21,2,61,87,4 ème
VENDEE,LA CHATAIGNERAIE,0851163C,54,54,0,0,27,27,4 ème
VENDEE,LA ROCHE-SUR-YON,0850028U,0,0,0,0,0,0,4 ème
VENDEE,LA ROCHE-SUR-YON,0850114M,172,172,0,0,88,84,4 ème
VENDEE,LA ROCHE-SUR-YON,0851304F,190,170,17,3,98,92,4 ème
VENDEE,LES BROUZILS,0850091M,110,110,0,0,44,66,4 ème
VENDEE,LES HERBIERS,0851159Y,385,365,16,4,193,192,4 ème
VENDEE,LES SABLES-D'OLONNE,0850043K,0,0,0,0,0,0,4 ème
VENDEE,L'ILE-D'YEU,0850015E,20,20,0,0,13,7,4 ème
VENDEE,L'ILE-D'YEU,0850103A,12,12,0,0,5,7,4 ème
VENDEE,POUZAUGES,0851160Z,202,198,0,4,112,90,4 ème
VENDEE,SAINTE-HERMINE,0850122W,70,70,0,0,36,34,4 ème
VENDEE,SAINT-LAURENT-SUR-SEVRE,0851504Y,0,0,0,0,0,0,4 ème
ALPES-DE-HTE-PROVENCE,DIGNE-LES-BAINS,0040022C,153,126,23,4,78,75,4 ème
ALPES-DE-HTE-PROVENCE,DIGNE-LES-BAINS,0040461E,58,58,0,0,28,30,4 ème
BOUCHES-DU-RHONE,AIX-EN-PROVENCE,0130007M,133,101,32,0,60,73,4 ème
BOUCHES-DU-RHONE,AIX-EN-PROVENCE,0132009N,140,138,0,2,63,77,4 ème
BOUCHES-DU-RHONE,AUBAGNE,0131266F,142,139,0,3,68,74,4 ème
BOUCHES-DU-RHONE,AURIOL,0133510V,193,188,0,5,90,103,4 ème
BOUCHES-DU-RHONE,CARNOUX-EN-PROVENCE,0133335E,116,116,0,0,64,52,4 ème
BOUCHES-DU-RHONE,CHATEAURENARD,0131366P,113,113,0,0,58,55,4 ème
BOUCHES-DU-RHONE,CHATEAURENARD,0131881Z,268,265,0,3,122,146,4 ème
BOUCHES-DU-RHONE,GARDANNE,0131701D,103,95,0,8,41,62,4 ème
BOUCHES-DU-RHONE,ISTRES,0133203L,145,145,0,0,66,79,4 ème
BOUCHES-DU-RHONE,MALLEMORT,0130032P,138,138,0,0,74,64,4 ème
BOUCHES-DU-RHONE,MARSEILLE,0134022B,151,125,23,3,65,86,4 ème
BOUCHES-DU-RHONE,MARSEILLE,0132403S,99,99,0,0,51,48,4 ème
BOUCHES-DU-RHONE,MARSEILLE,0133881Y,154,151,0,3,65,89,4 ème
BOUCHES-DU-RHONE,MARSEILLE,0131260Z,96,91,0,5,51,45,4 ème
BOUCHES-DU-RHONE,MARSEILLE,0131262B,140,113,23,4,57,83,4 ème
BOUCHES-DU-RHONE,MARSEILLE,0132313U,93,91,0,2,49,44,4 ème
BOUCHES-DU-RHONE,MARSEILLE,0130065A,0,0,0,0,0,0,4 ème
BOUCHES-DU-RHONE,MARSEILLE,0131704G,134,110,16,8,57,77,4 ème
BOUCHES-DU-RHONE,MARSEILLE,0131887F,94,92,0,2,46,48,4 ème
BOUCHES-DU-RHONE,MARSEILLE,0130039X,0,0,0,0,0,0,4 ème
BOUCHES-DU-RHONE,MARSEILLE,0131931D,110,110,0,0,50,60,4 ème
BOUCHES-DU-RHONE,MARSEILLE,0132283L,59,59,0,0,32,27,4 ème
BOUCHES-DU-RHONE,MARSEILLE,0130110Z,108,108,0,0,55,53,4 ème
BOUCHES-DU-RHONE,MARSEILLE,0131403E,0,0,0,0,0,0,4 ème
BOUCHES-DU-RHONE,MARSEILLE,0132958V,124,124,0,0,55,69,4 ème
BOUCHES-DU-RHONE,MARSEILLE,0133396W,0,0,0,0,0,0,4 ème
BOUCHES-DU-RHONE,MARSEILLE,0130049H,0,0,0,0,0,0,4 ème
BOUCHES-DU-RHONE,MARSEILLE,0130071G,0,0,0,0,0,0,4 ème
BOUCHES-DU-RHONE,MARSEILLE,0131371V,60,60,0,0,29,31,4 ème
BOUCHES-DU-RHONE,MARSEILLE,0131548M,185,165,19,1,77,108,4 ème
BOUCHES-DU-RHONE,MARSEILLE,0131602W,167,167,0,0,85,82,4 ème
BOUCHES-DU-RHONE,MARSEILLE,0132310R,149,142,0,7,56,93,4 ème
BOUCHES-DU-RHONE,MARSEILLE,0132951M,115,115,0,0,58,57,4 ème
BOUCHES-DU-RHONE,MARTIGUES,0131789Z,112,111,0,1,56,56,4 ème
BOUCHES-DU-RHONE,MARTIGUES,0132210G,0,0,0,0,0,0,4 ème
BOUCHES-DU-RHONE,MIRAMAS,0130146N,0,0,0,0,0,0,4 ème
BOUCHES-DU-RHONE,MIRAMAS,0132326H,140,137,0,3,78,62,4 ème
BOUCHES-DU-RHONE,MIRAMAS,0132327J,116,93,23,0,61,55,4 ème
BOUCHES-DU-RHONE,MIRAMAS,0134245U,58,52,0,6,27,31,4 ème
BOUCHES-DU-RHONE,PORT-DE-BOUC,0132212J,96,79,17,0,46,50,4 ème
BOUCHES-DU-RHONE,SAINT-CHAMAS,0130157A,0,0,0,0,0,0,4 ème
BOUCHES-DU-RHONE,SALON-DE-PROVENCE,0131265E,125,125,0,0,57,68,4 ème
BOUCHES-DU-RHONE,SAUSSET-LES-PINS,0133449D,210,210,0,0,109,101,4 ème
BOUCHES-DU-RHONE,SEPTEMES-LES-VALLONS,0131675A,0,0,0,0,0,0,4 ème
BOUCHES-DU-RHONE,SEPTEMES-LES-VALLONS,0133765X,135,135,0,0,66,69,4 ème
BOUCHES-DU-RHONE,TARASCON,0131388N,57,57,0,0,28,29,4 ème
HAUTES-ALPES,BRIANCON,0050043V,117,116,0,1,66,51,4 ème
HAUTES-ALPES,GAP,0050009H,0,0,0,0,0,0,4 ème
HAUTES-ALPES,GAP,0050562J,147,147,0,0,77,70,4 ème
VAUCLUSE,AVIGNON,0840006A,87,83,0,4,45,42,4 ème
VAUCLUSE,AVIGNON,0840108L,153,122,28,3,66,87,4 ème
VAUCLUSE,AVIGNON,0840697B,132,127,0,5,67,65,4 ème
VAUCLUSE,CARPENTRAS,0840015K,0,0,0,0,0,0,4 ème
VAUCLUSE,LE THOR,0840915N,165,161,0,4,83,82,4 ème
VAUCLUSE,MORIERES-LES-AVIGNON,0841116G,207,207,0,0,95,112,4 ème
VAUCLUSE,ORANGE,0840116V,198,171,24,3,96,102,4 ème
VAUCLUSE,ORANGE,0840853W,204,204,0,0,99,105,4 ème
VAUCLUSE,PERNES-LES-FONTAINES,0840028Z,146,142,0,4,78,68,4 ème
VAUCLUSE,SAULT,0840032D,48,48,0,0,22,26,4 ème
VAUCLUSE,SORGUES,0840068T,166,151,8,7,83,83,4 ème
ALPES-MARITIMES,ANTIBES,0060002V,0,0,0,0,0,0,4 ème
ALPES-MARITIMES,ANTIBES,0060842H,163,145,16,2,88,75,4 ème
ALPES-MARITIMES,ANTIBES,0061119J,147,147,0,0,76,71,4 ème
ALPES-MARITIMES,BEAULIEU-SUR-MER,0061209G,141,137,0,4,63,78,4 ème
ALPES-MARITIMES,BIOT,0061670H,211,211,0,0,95,116,4 ème
ALPES-MARITIMES,CAGNES-SUR-MER,0061635V,0,0,0,0,0,0,4 ème
ALPES-MARITIMES,CANNES,0061279H,100,100,0,0,54,46,4 ème
ALPES-MARITIMES,CANNES,0061342B,117,117,0,0,55,62,4 ème
ALPES-MARITIMES,CANNES,0062122Z,11,11,0,0,7,4,4 ème
ALPES-MARITIMES,GRASSE,0060021R,107,104,0,3,60,47,4 ème
ALPES-MARITIMES,LE CANNET,0061723R,144,144,0,0,76,68,4 ème
ALPES-MARITIMES,MOUANS-SARTOUX,0061795U,168,168,0,0,85,83,4 ème
ALPES-MARITIMES,NICE,0060032C,150,150,0,0,71,79,4 ème
ALPES-MARITIMES,NICE,0060042N,0,0,0,0,0,0,4 ème
ALPES-MARITIMES,NICE,0060050X,172,167,0,5,94,78,4 ème
ALPES-MARITIMES,NICE,0061002G,136,135,0,1,72,64,4 ème
ALPES-MARITIMES,NICE,0061006L,255,255,0,0,138,117,4 ème
ALPES-MARITIMES,NICE,0061129V,122,114,0,8,56,66,4 ème
ALPES-MARITIMES,NICE,0061277F,188,166,17,5,84,104,4 ème
ALPES-MARITIMES,NICE,0061694J,200,191,0,9,103,97,4 ème
ALPES-MARITIMES,PEYMEINADE,0061796V,166,166,0,0,72,94,4 ème
ALPES-MARITIMES,ROQUEBRUNE-CAP-MARTIN,0061458C,134,134,0,0,57,77,4 ème
ALPES-MARITIMES,SAINT-ETIENNE-DE-TINEE,0060063L,52,52,0,0,24,28,4 ème
ALPES-MARITIMES,SAINT-LAURENT-DU-VAR,0061134A,164,158,0,6,81,83,4 ème
ALPES-MARITIMES,SAINT-MARTIN-DU-VAR,0061400P,123,120,0,3,65,58,4 ème
ALPES-MARITIMES,VILLENEUVE-LOUBET,0061825B,164,156,0,8,83,81,4 ème
VAR,CARCES,0831709G,141,140,0,1,81,60,4 ème
VAR,CARQUEIRANNE,0830836H,162,162,0,0,71,91,4 ème
VAR,COGOLIN,0831424X,88,88,0,0,41,47,4 ème
VAR,CUERS,0830013N,198,180,16,2,99,99,4 ème
VAR,CUERS,0830114Y,0,0,0,0,0,0,4 ème
VAR,DRAGUIGNAN,0830016S,0,0,0,0,0,0,4 ème
VAR,DRAGUIGNAN,0831274J,169,150,16,3,78,91,4 ème
VAR,FAYENCE,0830019V,182,181,0,1,86,96,4 ème
VAR,FIGANIERES,0831609Y,114,114,0,0,64,50,4 ème
VAR,FREJUS,0830023Z,150,150,0,0,63,87,4 ème
VAR,FREJUS,0830834F,137,137,0,0,73,64,4 ème
VAR,GASSIN,0831537V,141,141,0,0,65,76,4 ème
VAR,LA FARLEDE,0831514V,119,118,0,1,64,55,4 ème
VAR,LE CASTELLET,0831644L,88,88,0,0,37,51,4 ème
VAR,LE LUC,0830163B,218,202,11,5,102,116,4 ème
VAR,OLLIOULES,0830922B,115,115,0,0,66,49,4 ème
VAR,SAINT-CYR-SUR-MER,0830106P,94,94,0,0,47,47,4 ème
VAR,SAINT-TROPEZ,0830996G,36,36,0,0,20,16,4 ème
VAR,SIX-FOURS-LES-PLAGES,0831354W,0,0,0,0,0,0,4 ème
VAR,TOULON,0830069Z,225,201,11,13,109,116,4 ème
VAR,TOULON,0830181W,118,102,11,5,51,67,4 ème
VAR,TOULON,0830661T,0,0,0,0,0,0,4 ème
VAR,TOULON,0830954L,141,141,0,0,63,78,4 ème
CALVADOS,BAYEUX,0141274J,0,0,0,0,0,0,4 ème
CALVADOS,CAEN,0140025B,163,160,0,3,82,81,4 ème
CALVADOS,CAEN,0141163N,141,141,0,0,58,83,4 ème
CALVADOS,CAEN,0141268C,166,166,0,0,80,86,4 ème
CALVADOS,CAEN,0142133T,0,0,0,0,0,0,4 ème
CALVADOS,DOUVRES-LA-DELIVRANDE,0141193W,0,0,0,0,0,0,4 ème
CALVADOS,FALAISE,0141764S,205,187,15,3,104,101,4 ème
CALVADOS,GIBERVILLE,0141964J,104,101,0,3,55,49,4 ème
CALVADOS,HEROUVILLE-SAINT-CLAIR,0141136J,50,48,0,2,24,26,4 ème
CALVADOS,HEROUVILLE-SAINT-CLAIR,0141363F,74,71,0,3,34,40,4 ème
CALVADOS,LE HOM,0141228J,75,68,0,7,39,36,4 ème
CALVADOS,LIVAROT-PAYS-D'AUGE,0140067X,48,48,0,0,20,28,4 ème
CALVADOS,MERVILLE-FRANCEVILLE-PLAGE,0140069Z,94,94,0,0,48,46,4 ème
CALVADOS,TROUVILLE-SUR-MER,0141863Z,156,156,0,0,80,76,4 ème
EURE,BEAUMONT-LE-ROGER,0271056B,54,54,0,0,32,22,4 ème
EURE,EVREUX,0270018Y,0,0,0,0,0,0,4 ème
EURE,EZY-SUR-EURE,0271238Z,179,177,0,2,92,87,4 ème
EURE,FLEURY-SUR-ANDELLE,0271098X,166,148,16,2,73,93,4 ème
EURE,GISORS,0271321P,151,131,15,5,76,75,4 ème
EURE,GISORS,0271631B,154,154,0,0,87,67,4 ème
EURE,GRAVIGNY,0271172C,185,179,0,6,93,92,4 ème
EURE,LA SAUSSAYE,0271105E,131,131,0,0,73,58,4 ème
EURE,LES ANDELYS,0271320N,130,126,0,4,61,69,4 ème
EURE,MESNIL-EN-OUCHE,0271121X,68,63,0,5,40,28,4 ème
EURE,PONT-AUDEMER,0271097W,0,0,0,0,0,0,4 ème
EURE,ROUTOT,0271285A,95,95,0,0,48,47,4 ème
EURE,RUGLES,0270040X,72,71,0,1,38,34,4 ème
EURE,VAL-DE-REUIL,0271286B,86,68,16,2,39,47,4 ème
EURE,VERNEUIL D'AVRE ET D'ITON,0271319M,0,0,0,0,0,0,4 ème
EURE,VERNON,0271073V,0,0,0,0,0,0,4 ème
EURE,VERNON,0271288D,98,98,0,0,40,58,4 ème
MANCHE,AGNEAUX,0501825M,0,0,0,0,0,0,4 ème
MANCHE,CHERBOURG-EN-COTENTIN,0500132X,0,0,0,0,0,0,4 ème
MANCHE,FLAMANVILLE,0501799J,57,57,0,0,29,28,4 ème
MANCHE,LA HAYE-PESNEL,0500042Z,68,68,0,0,34,34,4 ème
MANCHE,LES PIEUX,0501220E,97,92,0,5,45,52,4 ème
MANCHE,MONTMARTIN-SUR-MER,0500048F,65,65,0,0,39,26,4 ème
MANCHE,SAINT-JAMES,0500149R,24,24,0,0,15,9,4 ème
MANCHE,SAINT-JAMES,0501242D,80,68,12,0,35,45,4 ème
MANCHE,SAINT-LO,0500095G,104,75,25,4,49,55,4 ème
MANCHE,SAINT-LO,0500121K,85,82,0,3,38,47,4 ème
MANCHE,SAINT-SAUVEUR-LE-VICOMTE,0500152U,72,72,0,0,38,34,4 ème
MANCHE,TESSY-BOCAGE,0500078N,66,66,0,0,34,32,4 ème
MANCHE,VILLEDIEU-LES-POELES-ROUFFIGNY,0500123M,36,36,0,0,21,15,4 ème
ORNE,ALENCON,0610692W,0,0,0,0,0,0,4 ème
ORNE,CARROUGES,0610012G,37,37,0,0,20,17,4 ème
ORNE,CEAUCE,0611220V,54,54,0,0,27,27,4 ème
ORNE,FLERS,0610023U,122,116,0,6,52,70,4 ème
ORNE,GACE,0610710R,15,15,0,0,7,8,4 ème
ORNE,L'AIGLE,0610745D,125,105,15,5,62,63,4 ème
ORNE,TRUN,0610044S,71,68,0,3,38,33,4 ème
ORNE,VIMOUTIERS,0610045T,51,51,0,0,22,29,4 ème
SEINE MARITIME,BIHOREL,0761724L,75,75,0,0,36,39,4 ème
SEINE MARITIME,BLANGY-SUR-BRESLE,0760009X,116,99,13,4,46,70,4 ème
SEINE MARITIME,BOIS-GUILLAUME,0761950G,142,125,14,3,59,83,4 ème
SEINE MARITIME,BONSECOURS,0760010Y,110,110,0,0,49,61,4 ème
SEINE MARITIME,BOOS,0762816Y,138,138,0,0,68,70,4 ème
SEINE MARITIME,CANTELEU,0762089H,114,114,0,0,59,55,4 ème
SEINE MARITIME,CANY-BARVILLE,0762126Y,113,110,0,3,59,54,4 ème
SEINE MARITIME,CLEON,0762679Z,89,70,14,5,38,51,4 ème
SEINE MARITIME,CRIQUETOT-L'ESNEVAL,0761784B,211,209,0,2,111,100,4 ème
SEINE MARITIME,DARNETAL,0761778V,115,100,13,2,50,65,4 ème
SEINE MARITIME,DUCLAIR,0760136K,173,168,0,5,72,101,4 ème
SEINE MARITIME,ELBEUF,0761347B,0,0,0,0,0,0,4 ème
SEINE MARITIME,ELBEUF,0762459K,170,154,15,1,88,82,4 ème
SEINE MARITIME,FORGES-LES-EAUX,0761695E,147,138,9,0,76,71,4 ème
SEINE MARITIME,GONFREVILLE-L'ORCHER,0761954L,138,115,16,7,66,72,4 ème
SEINE MARITIME,GOURNAY-EN-BRAY,0761734X,43,43,0,0,20,23,4 ème
SEINE MARITIME,LE GRAND-QUEVILLY,0761690Z,82,79,0,3,37,45,4 ème
SEINE MARITIME,LE HAVRE,0760053V,196,194,0,2,92,104,4 ème
SEINE MARITIME,LE HAVRE,0760069M,105,105,0,0,49,56,4 ème
SEINE MARITIME,LE HAVRE,0761696F,122,122,0,0,68,54,4 ème
SEINE MARITIME,LE HAVRE,0761711X,189,183,0,6,98,91,4 ème
SEINE MARITIME,LE HAVRE,0762226G,88,88,0,0,48,40,4 ème
SEINE MARITIME,LE MESNIL-ESNARD,0761343X,0,0,0,0,0,0,4 ème
SEINE MARITIME,LE MESNIL-ESNARD,0762229K,166,166,0,0,83,83,4 ème
SEINE MARITIME,LONDINIERES,0760137L,46,46,0,0,21,25,4 ème
SEINE MARITIME,LONGUEVILLE-SUR-SCIE,0762086E,95,88,0,7,52,43,4 ème
SEINE MARITIME,MAROMME,0760022L,0,0,0,0,0,0,4 ème
SEINE MARITIME,MONT-SAINT-AIGNAN,0760077W,130,127,0,3,60,70,4 ème
SEINE MARITIME,PAVILLY,0761694D,121,118,0,3,63,58,4 ème
SEINE MARITIME,ROUEN,0761356L,0,0,0,0,0,0,4 ème
SEINE MARITIME,ROUEN,0761720G,135,133,0,2,58,77,4 ème
SEINE MARITIME,ROUEN,0762091K,253,236,16,1,142,111,4 ème
SEINE MARITIME,ROUEN,0762602R,0,0,0,0,0,0,4 ème
SEINE MARITIME,SAINTE-ADRESSE,0762405B,86,86,0,0,42,44,4 ème
SEINE MARITIME,SAINT-ETIENNE-DU-ROUVRAY,0761777U,127,118,0,9,64,63,4 ème
SEINE MARITIME,SAINT-ETIENNE-DU-ROUVRAY,0762964J,0,0,0,0,0,0,4 ème
SEINE MARITIME,SAINT-NICOLAS-D'ALIERMONT,0760105B,196,178,13,5,92,104,4 ème
SEINE MARITIME,SAINT-PIERRE-LES-ELBEUF,0761776T,132,132,0,0,65,67,4 ème
SEINE MARITIME,SAINT-SAENS,0761953K,107,102,0,5,47,60,4 ème
SEINE MARITIME,VALMONT,0760116N,96,96,0,0,45,51,4 ème
SEINE MARITIME,YERVILLE,0761951H,130,110,17,3,64,66,4 ème
SEINE MARITIME,YVETOT,0760118R,191,174,15,2,106,85,4 ème
DORDOGNE,BRANTOME EN PERIGORD,0240010F,73,73,0,0,37,36,4 ème
DORDOGNE,LA ROCHE-CHALAIS,0240083K,25,25,0,0,17,8,4 ème
DORDOGNE,NONTRON,0241041B,81,70,9,2,37,44,4 ème
DORDOGNE,PERIGUEUX,0240984P,0,0,0,0,0,0,4 ème
DORDOGNE,THIVIERS,0240039M,0,0,0,0,0,0,4 ème
DORDOGNE,VERGT,0240056F,104,104,0,0,50,54,4 ème
GIRONDE,ANDERNOS-LES-BAINS,0331890A,204,196,5,3,104,100,4 ème
GIRONDE,ARVEYRES,0332085M,148,144,0,4,71,77,4 ème
GIRONDE,AUDENGE,0330008E,144,144,0,0,75,69,4 ème
GIRONDE,BASSENS,0331884U,119,99,14,6,60,59,4 ème
GIRONDE,BAZAS,0332288H,182,175,5,2,91,91,4 ème
GIRONDE,BLAYE,0332781U,0,0,0,0,0,0,4 ème
GIRONDE,BORDEAUX,0330065S,154,152,0,2,72,82,4 ème
GIRONDE,BORDEAUX,0331461J,181,180,0,1,90,91,4 ème
GIRONDE,BORDEAUX,0331618E,79,76,0,3,35,44,4 ème
GIRONDE,BORDEAUX,0332489B,70,70,0,0,27,43,4 ème
GIRONDE,BORDEAUX,0332493F,243,238,0,5,137,106,4 ème
GIRONDE,BORDEAUX,0332768E,176,169,0,7,99,77,4 ème
GIRONDE,BORDEAUX,0332806W,92,89,0,3,43,49,4 ème
GIRONDE,BORDEAUX,0333532K,23,23,0,0,15,8,4 ème
GIRONDE,CADILLAC,0331524C,46,46,0,0,14,32,4 ème
GIRONDE,CARIGNAN-DE-BORDEAUX,0331490R,131,129,0,2,67,64,4 ème
GIRONDE,CASTELNAU-DE-MEDOC,0330062N,169,167,0,2,90,79,4 ème
GIRONDE,EYSINES,0330076D,0,0,0,0,0,0,4 ème
GIRONDE,EYSINES,0332084L,252,252,0,0,124,128,4 ème
GIRONDE,FLOIRAC,0332189A,113,113,0,0,61,52,4 ème
GIRONDE,FLOIRAC,0332486Y,129,127,0,2,53,76,4 ème
GIRONDE,GRADIGNAN,0331622J,196,196,0,0,89,107,4 ème
GIRONDE,GUITRES,0330138W,111,108,0,3,57,54,4 ème
GIRONDE,GUJAN-MESTRAS,0332870R,0,0,0,0,0,0,4 ème
GIRONDE,LA BREDE,0332343T,130,130,0,0,64,66,4 ème
GIRONDE,LE BOUSCAT,0333108Z,106,106,0,0,58,48,4 ème
GIRONDE,LE HAILLAN,0332437V,115,115,0,0,44,71,4 ème
GIRONDE,LIBOURNE,0333213N,163,144,14,5,75,88,4 ème
GIRONDE,LORMONT,0331619F,165,133,23,9,90,75,4 ème
GIRONDE,LORMONT,0332441Z,0,0,0,0,0,0,4 ème
GIRONDE,MERIGNAC,0330146E,137,137,0,0,65,72,4 ème
GIRONDE,MERIGNAC,0332090T,188,167,17,4,85,103,4 ème
GIRONDE,MIOS,0333329P,155,155,0,0,73,82,4 ème
GIRONDE,PELLEGRUE,0330105K,52,52,0,0,20,32,4 ème
GIRONDE,SAINT-ANDRE-DE-CUBZAC,0332346W,0,0,0,0,0,0,4 ème
GIRONDE,SAINTE-EULALIE,0332705L,103,100,0,3,47,56,4 ème
GIRONDE,SAINT-JEAN-D'ILLAC,0333134C,132,132,0,0,64,68,4 ème
GIRONDE,SAINT-MEDARD-EN-JALLES,0331664E,177,175,0,2,79,98,4 ème
GIRONDE,SAINT-YZAN-DE-SOUDIAC,0331888Y,156,152,0,4,82,74,4 ème
GIRONDE,VERAC,0332706M,155,152,0,3,77,78,4 ème
LANDES,AIRE-SUR-L'ADOUR,0400002K,2,2,0,0,2,0,4 ème
LANDES,BISCARROSSE,0400092H,112,108,0,4,60,52,4 ème
LANDES,CAPBRETON,0400004M,0,0,0,0,0,0,4 ème
LANDES,GABARRET,0400072L,52,52,0,0,17,35,4 ème
LANDES,MIMIZAN,0400105X,141,140,0,1,69,72,4 ème
LANDES,PEYREHORADE,0400028N,150,147,0,3,74,76,4 ème
LANDES,SAINT-GEOURS-DE-MAREMNE,0401070W,133,127,0,6,62,71,4 ème
LANDES,SAINT-PIERRE-DU-MONT,0400103V,148,115,28,5,73,75,4 ème
LANDES,SAINT-SEVER,0400038Z,114,110,0,4,54,60,4 ème
LANDES,TARTAS,0400077S,45,45,0,0,19,26,4 ème
LOT-ET-GARONNE,AGEN,0470005A,143,143,0,0,82,61,4 ème
LOT-ET-GARONNE,AGEN,0470066S,158,144,11,3,75,83,4 ème
LOT-ET-GARONNE,CASTELMORON-SUR-LOT,0470732R,53,53,0,0,26,27,4 ème
LOT-ET-GARONNE,CASTILLONNES,0470014K,55,55,0,0,29,26,4 ème
LOT-ET-GARONNE,FUMEL,0470641S,0,0,0,0,0,0,4 ème
LOT-ET-GARONNE,MARMANDE,0470020S,0,0,0,0,0,0,4 ème
LOT-ET-GARONNE,MARMANDE,0470103G,173,156,14,3,88,85,4 ème
LOT-ET-GARONNE,MEZIN,0470023V,36,36,0,0,14,22,4 ème
LOT-ET-GARONNE,MONFLANQUIN,0470026Y,87,87,0,0,46,41,4 ème
LOT-ET-GARONNE,SAINTE-LIVRADE-SUR-LOT,0470102F,72,67,0,5,31,41,4 ème
LOT-ET-GARONNE,TONNEINS,0470104H,146,127,17,2,69,77,4 ème
LOT-ET-GARONNE,VILLENEUVE-SUR-LOT,0470678G,91,73,16,2,53,38,4 ème
PYRENEES-ATLANTIQUES,BAYONNE,0640179X,0,0,0,0,0,0,4 ème
PYRENEES-ATLANTIQUES,BAYONNE,0641907A,0,0,0,0,0,0,4 ème
PYRENEES-ATLANTIQUES,BAYONNE,0642114A,41,41,0,0,26,15,4 ème
PYRENEES-ATLANTIQUES,CAMBO-LES-BAINS,0640147M,77,77,0,0,42,35,4 ème
PYRENEES-ATLANTIQUES,JURANCON,0640031L,0,0,0,0,0,0,4 ème
PYRENEES-ATLANTIQUES,MORLAAS,0641412M,184,178,0,6,89,95,4 ème
PYRENEES-ATLANTIQUES,NAY,0641657D,119,119,0,0,65,54,4 ème
PYRENEES-ATLANTIQUES,PAU,0640184C,0,0,0,0,0,0,4 ème
PYRENEES-ATLANTIQUES,PAU,0641653Z,181,180,0,1,80,101,4 ème
PYRENEES-ATLANTIQUES,SAINT-JEAN-PIED-DE-PORT,0640165G,22,22,0,0,13,9,4 ème
PYRENEES-ATLANTIQUES,SAINT-JEAN-PIED-DE-PORT,0641844G,0,0,0,0,0,0,4 ème
PYRENEES-ATLANTIQUES,SAINT-PIERRE-D'IRUBE,0642038T,195,195,0,0,105,90,4 ème
CORREZE,BRIVE-LA-GAILLARDE,0190740B,119,118,0,1,64,55,4 ème
CORREZE,LUBERSAC,0190695C,75,75,0,0,44,31,4 ème
CORREZE,MEYMAC,0190089U,11,11,0,0,1,10,4 ème
CORREZE,NEUVIC,0190821P,26,26,0,0,18,8,4 ème
CORREZE,TULLE,0190034J,0,0,0,0,0,0,4 ème
CREUSE,BOURGANEUF,0230008J,0,0,0,0,0,0,4 ème
CREUSE,CHENERAILLES,0230012N,35,35,0,0,16,19,4 ème
CREUSE,CROCQ,0230014R,24,24,0,0,13,11,4 ème
CREUSE,LA SOUTERRAINE,0230032K,110,92,15,3,57,53,4 ème
CREUSE,PARSAC-RIMONDEIX,0230023A,44,44,0,0,23,21,4 ème
HAUTE-VIENNE,AIXE-SUR-VIENNE,0870001D,189,189,0,0,96,93,4 ème
HAUTE-VIENNE,BELLAC,0870120H,118,98,17,3,59,59,4 ème
HAUTE-VIENNE,BESSINES-SUR-GARTEMPE,0870006J,53,53,0,0,35,18,4 ème
HAUTE-VIENNE,CHATEAUNEUF-LA-FORET,0870008L,52,52,0,0,26,26,4 ème
HAUTE-VIENNE,LIMOGES,0870072F,161,160,0,1,83,78,4 ème
HAUTE-VIENNE,LIMOGES,0870960W,72,67,0,5,34,38,4 ème
HAUTE-VIENNE,LIMOGES,0875087G,31,31,0,0,21,10,4 ème
HAUTE-VIENNE,SAINT-LEONARD-DE-NOBLAT,0870820U,131,131,0,0,65,66,4 ème
HAUTE-VIENNE,SAINT-SULPICE-LES-FEUILLES,0870049F,38,38,0,0,21,17,4 ème
CHARENTE,ANGOULEME,0160049S,0,0,0,0,0,0,4 ème
CHARENTE,ANGOULEME,0161048C,182,182,0,0,81,101,4 ème
CHARENTE,ANGOULEME,0161075G,96,93,0,3,49,47,4 ème
CHARENTE,BARBEZIEUX-SAINT-HILAIRE,0160866E,112,96,15,1,50,62,4 ème
CHARENTE,CHASSENEUIL-SUR-BONNIEURE,0160882X,86,70,15,1,54,32,4 ème
CHARENTE,COGNAC,0160116P,105,105,0,0,45,60,4 ème
CHARENTE,CONFOLENS,0160944P,79,76,0,3,41,38,4 ème
CHARENTE,LA ROCHEFOUCAULD-EN-ANGOUMOIS,0160076W,42,42,0,0,24,18,4 ème
CHARENTE,MONTBRON,0160030W,48,48,0,0,25,23,4 ème
CHARENTE-MARITIME,AULNAY,0171213B,54,54,0,0,30,24,4 ème
CHARENTE-MARITIME,COZES,0170111D,36,36,0,0,17,19,4 ème
CHARENTE-MARITIME,JONZAC,0170135E,0,0,0,0,0,0,4 ème
CHARENTE-MARITIME,LA ROCHELLE,0170035W,198,180,16,2,96,102,4 ème
CHARENTE-MARITIME,LA ROCHELLE,0170100S,0,0,0,0,0,0,4 ème
CHARENTE-MARITIME,LA ROCHELLE,0170142M,92,70,15,7,36,56,4 ème
CHARENTE-MARITIME,LA ROCHELLE,0171117X,155,151,0,4,83,72,4 ème
CHARENTE-MARITIME,MARANS,0171022U,120,120,0,0,68,52,4 ème
CHARENTE-MARITIME,MIRAMBEAU,0170016A,67,67,0,0,25,42,4 ème
CHARENTE-MARITIME,ROYAN,0171122C,188,186,0,2,97,91,4 ème
CHARENTE-MARITIME,ROYAN,0171571R,0,0,0,0,0,0,4 ème
CHARENTE-MARITIME,SAINTES,0170059X,186,183,0,3,93,93,4 ème
CHARENTE-MARITIME,SAINTES,0170078T,0,0,0,0,0,0,4 ème
CHARENTE-MARITIME,SAINTES,0170392J,15,0,15,0,5,10,4 ème
CHARENTE-MARITIME,SAINT-HILAIRE-DE-VILLEFRANCHE,0170050M,87,87,0,0,45,42,4 ème
CHARENTE-MARITIME,SAINT-JEAN-D'ANGELY,0171118Y,172,134,32,6,85,87,4 ème
CHARENTE-MARITIME,SAINT-SAVINIEN,0170056U,100,100,0,0,48,52,4 ème
CHARENTE-MARITIME,SURGERES,0170120N,68,68,0,0,34,34,4 ème
CHARENTE-MARITIME,TONNAY-BOUTONNE,0170082X,75,75,0,0,39,36,4 ème
DEUX-SEVRES,ARGENTONNAY,0790060L,55,55,0,0,35,20,4 ème
DEUX-SEVRES,CHAMPDENIERS-SAINT-DENIS,0790013K,81,81,0,0,36,45,4 ème
DEUX-SEVRES,LA CRECHE,0790965V,184,184,0,0,97,87,4 ème
DEUX-SEVRES,LEZAY,0790017P,38,38,0,0,17,21,4 ème
DEUX-SEVRES,NIORT,0790027A,124,120,0,4,67,57,4 ème
DEUX-SEVRES,NIORT,0790710T,126,103,17,6,61,65,4 ème
DEUX-SEVRES,NIORT,0791134D,153,141,12,0,78,75,4 ème
DEUX-SEVRES,SAINT-AUBIN-LE-CLOUD,0790979K,14,0,14,0,6,8,4 ème
DEUX-SEVRES,SAINT-VARENT,0790032F,67,67,0,0,33,34,4 ème
VIENNE,CHATELLERAULT,0860876K,157,140,17,0,84,73,4 ème
VIENNE,CHATELLERAULT,0860984C,183,164,17,2,81,102,4 ème
VIENNE,CIVRAY,0860053R,65,48,17,0,36,29,4 ème
VIENNE,JAUNAY-MARIGNY,0860764N,115,115,0,0,64,51,4 ème
VIENNE,LA ROCHE-POSAY,0860043E,80,80,0,0,44,36,4 ème
VIENNE,MIREBEAU,0860027M,78,72,0,6,34,44,4 ème
VIENNE,POITIERS,0860039A,0,0,0,0,0,0,4 ème
VIENNE,POITIERS,0860756E,113,113,0,0,50,63,4 ème
VIENNE,POITIERS,0861072Y,166,146,17,3,77,89,4 ème
VIENNE,SAINT-GERVAIS-LES-TROIS-CLOCHERS,0860044F,73,73,0,0,35,38,4 ème
VIENNE,SAINT-SAVIN,0860046H,50,50,0,0,20,30,4 ème
AUDE,CARCASSONNE,0110037F,110,110,0,0,53,57,4 ème
AUDE,CARCASSONNE,0110044N,145,145,0,0,72,73,4 ème
AUDE,CARCASSONNE,0110666P,145,135,0,10,69,76,4 ème
AUDE,CARCASSONNE,0110823K,0,0,0,0,0,0,4 ème
AUDE,CASTELNAUDARY,0110825M,186,160,18,8,96,90,4 ème
AUDE,LEZIGNAN-CORBIERES,0111048E,0,0,0,0,0,0,4 ème
AUDE,NARBONNE,0110025T,120,120,0,0,66,54,4 ème
AUDE,NARBONNE,0110068P,123,123,0,0,58,65,4 ème
GARD,AIGUES-MORTES,0300001N,131,131,0,0,68,63,4 ème
GARD,ALES,0300922P,124,124,0,0,73,51,4 ème
GARD,ALES,0301728R,45,45,0,0,20,25,4 ème
GARD,CALVISSON,0301671D,142,141,0,1,67,75,4 ème
GARD,LE VIGAN,0300052U,0,0,0,0,0,0,4 ème
GARD,MANDUEL,0301746K,118,118,0,0,66,52,4 ème
GARD,NIMES,0300062E,146,140,0,6,75,71,4 ème
GARD,NIMES,0300096S,85,85,0,0,45,40,4 ème
GARD,NIMES,0300929X,133,113,16,4,64,69,4 ème
GARD,NIMES,0300945P,246,246,0,0,139,107,4 ème
GARD,NIMES,0301357M,123,123,0,0,61,62,4 ème
GARD,REMOULINS,0300033Y,149,149,0,0,75,74,4 ème
GARD,ROQUEMAURE,0301213F,190,190,0,0,93,97,4 ème
GARD,SAINT-GILLES,0300037C,192,173,16,3,88,104,4 ème
GARD,SAINT-HIPPOLYTE-DU-FORT,0300039E,80,79,0,1,47,33,4 ème
GARD,SAINT-JEAN-DU-GARD,0300041G,0,0,0,0,0,0,4 ème
GARD,VILLENEUVE-LES-AVIGNON,0301214G,228,228,0,0,120,108,4 ème
HERAULT,AGDE,0341032M,140,137,0,3,79,61,4 ème
HERAULT,BEZIERS,0340869K,180,179,0,1,89,91,4 ème
HERAULT,BEZIERS,0340872N,113,113,0,0,58,55,4 ème
HERAULT,CASTRIES,0341280G,214,214,0,0,101,113,4 ème
HERAULT,FRONTIGNAN,0340025T,188,171,15,2,94,94,4 ème
HERAULT,FRONTIGNAN,0340894M,91,91,0,0,47,44,4 ème
HERAULT,LODEVE,0340028W,0,0,0,0,0,0,4 ème
HERAULT,LUNEL,0340897R,122,122,0,0,75,47,4 ème
HERAULT,MAGALAS,0340032A,101,97,0,4,42,59,4 ème
HERAULT,MONTFERRIER-SUR-LEZ,0342297M,62,62,0,0,33,29,4 ème
HERAULT,MONTPELLIER,0340045P,0,0,0,0,0,0,4 ème
HERAULT,MONTPELLIER,0340883A,114,111,0,3,51,63,4 ème
HERAULT,MONTPELLIER,0340955D,184,166,16,2,94,90,4 ème
HERAULT,MONTPELLIER,0341030K,110,110,0,0,51,59,4 ème
HERAULT,MONTPELLIER,0341592W,134,118,14,2,64,70,4 ème
HERAULT,POUSSAN,0340062H,216,212,0,4,106,110,4 ème
HERAULT,SETE,0340078A,0,0,0,0,0,0,4 ème
HERAULT,SETE,0340885C,133,133,0,0,62,71,4 ème
HERAULT,SETE,0340972X,125,117,0,8,55,70,4 ème
HERAULT,VILLENEUVE-LES-MAGUELONE,0342078Z,147,147,0,0,66,81,4 ème
LOZERE,LANGOGNE,0480004U,51,51,0,0,27,24,4 ème
LOZERE,LANGOGNE,0480678B,32,32,0,0,13,19,4 ème
LOZERE,MENDE,0480032Z,90,90,0,0,50,40,4 ème
LOZERE,SAINT-CHELY-D'APCHER,0480680D,0,0,0,0,0,0,4 ème
PYRENEES-ORIENTALES,ARGELES-SUR-MER,0660924W,0,0,0,0,0,0,4 ème
PYRENEES-ORIENTALES,ELNE,0660523K,264,258,0,6,113,151,4 ème
PYRENEES-ORIENTALES,FONT-ROMEU-ODEILLO-VIA,0660057D,0,0,0,0,0,0,4 ème
PYRENEES-ORIENTALES,PERPIGNAN,0660016J,124,122,0,2,63,61,4 ème
PYRENEES-ORIENTALES,PERPIGNAN,0660058E,282,282,0,0,140,142,4 ème
PYRENEES-ORIENTALES,PERPIGNAN,0660077A,24,24,0,0,6,18,4 ème
PYRENEES-ORIENTALES,PERPIGNAN,0660078B,15,0,15,0,5,10,4 ème
PYRENEES-ORIENTALES,PERPIGNAN,0660520G,0,0,0,0,0,0,4 ème
PYRENEES-ORIENTALES,PIA,0660866H,177,174,0,3,68,109,4 ème
PYRENEES-ORIENTALES,PORT-VENDRES,0660038H,84,84,0,0,35,49,4 ème
PYRENEES-ORIENTALES,THUIR,0660030Z,260,238,16,6,118,142,4 ème
ARIEGE,FERRIERES-SUR-ARIEGE,0090003E,0,0,0,0,0,0,4 ème
ARIEGE,PAMIERS,0090015T,0,0,0,0,0,0,4 ème
ARIEGE,SEIX,0090025D,29,29,0,0,8,21,4 ème
AVEYRON,CAPDENAC-GARE,0120082Z,35,35,0,0,20,15,4 ème
AVEYRON,DECAZEVILLE,0120622L,103,89,11,3,52,51,4 ème
AVEYRON,DECAZEVILLE,0121257B,39,33,0,6,14,25,4 ème
AVEYRON,ESPALION,0121176N,85,77,0,8,40,45,4 ème
AVEYRON,ESPALION,0121258C,59,59,0,0,29,30,4 ème
AVEYRON,LA FOUILLADE,0120090H,25,25,0,0,12,13,4 ème
AVEYRON,MARCILLAC-VALLON,0120011X,77,77,0,0,36,41,4 ème
AVEYRON,MILLAU,0120105Z,0,0,0,0,0,0,4 ème
AVEYRON,ONET-LE-CHATEAU,0121500R,77,77,0,0,43,34,4 ème
AVEYRON,RIEUPEYROUX,0120055V,23,23,0,0,8,15,4 ème
AVEYRON,RODEZ,0120037A,0,0,0,0,0,0,4 ème
AVEYRON,SAINT-AFFRIQUE,0120025M,0,0,0,0,0,0,4 ème
AVEYRON,SAINT-AFFRIQUE,0121297V,122,112,7,3,58,64,4 ème
AVEYRON,SEVERAC D'AVEYRON,0120029S,44,44,0,0,23,21,4 ème
AVEYRON,VILLEFRANCHE-DE-ROUERGUE,0121178R,15,0,15,0,2,13,4 ème
GERS,AUCH,0320067Z,0,0,0,0,0,0,4 ème
GERS,CONDOM,0320010M,98,95,0,3,49,49,4 ème
GERS,LECTOURE,0320651J,71,71,0,0,40,31,4 ème
GERS,L'ISLE-JOURDAIN,0320740F,135,120,10,5,59,76,4 ème
GERS,MASSEUBE,0320004F,54,54,0,0,20,34,4 ème
HAUTE-GARONNE,AUSSONNE,0312729Y,220,216,0,4,101,119,4 ème
HAUTE-GARONNE,BAGNERES-DE-LUCHON,0311334G,0,0,0,0,0,0,4 ème
HAUTE-GARONNE,CARBONNE,0311580Z,120,103,14,3,57,63,4 ème
HAUTE-GARONNE,COLOMIERS,0311325X,104,84,20,0,51,53,4 ème
HAUTE-GARONNE,LA SALVETAT-SAINT-GILLES,0312612W,193,174,18,1,85,108,4 ème
HAUTE-GARONNE,LEGUEVIN,0312063Z,0,0,0,0,0,0,4 ème
HAUTE-GARONNE,LHERM,0312697N,146,143,0,3,72,74,4 ème
HAUTE-GARONNE,MONTRABE,0312698P,101,94,0,7,54,47,4 ème
HAUTE-GARONNE,MURET,0310025J,210,207,0,3,95,115,4 ème
HAUTE-GARONNE,PECHBONNIEU,0312700S,194,188,0,6,104,90,4 ème
HAUTE-GARONNE,RAMONVILLE-SAINT-AGNE,0311633G,148,133,13,2,79,69,4 ème
HAUTE-GARONNE,REVEL,0310088C,0,0,0,0,0,0,4 ème
HAUTE-GARONNE,SAINT-BEAT-LEZ,0310031R,19,19,0,0,7,12,4 ème
HAUTE-GARONNE,SAINT-GAUDENS,0311131L,0,0,0,0,0,0,4 ème
HAUTE-GARONNE,SAINT-JORY,0311162V,92,92,0,0,40,52,4 ème
HAUTE-GARONNE,SEYSSES,0313081F,118,118,0,0,45,73,4 ème
HAUTE-GARONNE,TOULOUSE,0310051M,0,0,0,0,0,0,4 ème
HAUTE-GARONNE,TOULOUSE,0310085Z,175,171,0,4,91,84,4 ème
HAUTE-GARONNE,TOULOUSE,0310086A,102,95,0,7,52,50,4 ème
HAUTE-GARONNE,TOULOUSE,0311148E,80,80,0,0,39,41,4 ème
HAUTE-GARONNE,TOULOUSE,0311332E,116,109,0,7,49,67,4 ème
HAUTE-GARONNE,TOULOUSE,0311338L,130,127,0,3,50,80,4 ème
HAUTE-GARONNE,TOULOUSE,0311584D,88,80,0,8,50,38,4 ème
HAUTE-GARONNE,TOULOUSE,0311718Z,148,143,0,5,75,73,4 ème
HAUTE-GARONNE,TOULOUSE,0311963R,117,117,0,0,46,71,4 ème
HAUTE-GARONNE,TOULOUSE,0311964S,184,184,0,0,105,79,4 ème
HAUTE-GARONNE,VERNET,0312610U,140,138,0,2,68,72,4 ème
HAUTES-PYRENEES,LUZ-SAINT-SAUVEUR,0650018S,16,16,0,0,8,8,4 ème
HAUTES-PYRENEES,MONLEON-MAGNOAC,0650885J,0,0,0,0,0,0,4 ème
HAUTES-PYRENEES,TARBES,0650740B,137,119,18,0,65,72,4 ème
HAUTES-PYRENEES,TARBES,0650835E,151,143,0,8,66,85,4 ème
HAUTES-PYRENEES,TARBES,0650880D,127,125,0,2,61,66,4 ème
LOT,GRAMAT,0460565P,77,77,0,0,35,42,4 ème
LOT,LACAPELLE-MARIVAL,0460015S,44,42,0,2,19,25,4 ème
LOT,VAYRAC,0460030H,51,51,0,0,25,26,4 ème
TARN,ALBI,0810003N,0,0,0,0,0,0,4 ème
TARN,ALBI,0810052S,146,146,0,0,83,63,4 ème
TARN,CARMAUX,0810012Y,0,0,0,0,0,0,4 ème
TARN,CASTRES,0811063R,127,117,10,0,56,71,4 ème
TARN,GAILLAC,0811065T,89,89,0,0,52,37,4 ème
TARN,LABASTIDE-ROUAIROUX,0810025M,32,32,0,0,17,15,4 ème
TARN,LACAUNE,0810027P,56,48,8,0,29,27,4 ème
TARN,MASSAC-SERAN,0811066U,49,49,0,0,20,29,4 ème
TARN,RABASTENS,0810092K,48,48,0,0,26,22,4 ème
TARN,SAINT-JUERY,0810124V,177,174,0,3,77,100,4 ème
TARN,SAINT-SULPICE-LA-POINTE,0810122T,65,52,13,0,29,36,4 ème
TARN-ET-GARONNE,BEAUMONT-DE-LOMAGNE,0820047F,42,42,0,0,24,18,4 ème
TARN-ET-GARONNE,CASTELSARRASIN,0820713E,125,117,0,8,68,57,4 ème
TARN-ET-GARONNE,MONTAUBAN,0820684Y,154,150,0,4,74,80,4 ème
TARN-ET-GARONNE,MONTAUBAN,0820755A,112,112,0,0,47,65,4 ème
TARN-ET-GARONNE,NEGREPELISSE,0820824A,138,132,0,6,66,72,4 ème
TARN-ET-GARONNE,SAINT-ANTONIN-NOBLE-VAL,0820704V,78,78,0,0,38,40,4 ème
LOIRE-ATLANTIQUE,AIGREFEUILLE-SUR-MAINE,0440179F,147,145,0,2,66,81,4 ème
LOIRE-ATLANTIQUE,CARQUEFOU,0442029S,209,209,0,0,102,107,4 ème
LOIRE-ATLANTIQUE,COUERON,0440310Y,0,0,0,0,0,0,4 ème
LOIRE-ATLANTIQUE,DERVAL,0440423W,90,90,0,0,40,50,4 ème
LOIRE-ATLANTIQUE,GUERANDE,0440193W,181,178,0,3,89,92,4 ème
LOIRE-ATLANTIQUE,HERIC,0442728B,155,152,0,3,75,80,4 ème
LOIRE-ATLANTIQUE,LA BAULE-ESCOUBLAC,0441859G,116,100,16,0,51,65,4 ème
LOIRE-ATLANTIQUE,LA CHAPELLE-SUR-ERDRE,0442011X,129,126,0,3,50,79,4 ème
LOIRE-ATLANTIQUE,LA CHAPELLE-SUR-ERDRE,0442388G,46,46,0,0,19,27,4 ème
LOIRE-ATLANTIQUE,LEGE,0440196Z,57,57,0,0,26,31,4 ème
LOIRE-ATLANTIQUE,LIGNE,0442691L,187,181,0,6,97,90,4 ème
LOIRE-ATLANTIQUE,LOIREAUXENCE,0440243A,98,98,0,0,53,45,4 ème
LOIRE-ATLANTIQUE,MACHECOUL-SAINT-MEME,0440018F,110,93,16,1,45,65,4 ème
LOIRE-ATLANTIQUE,MACHECOUL-SAINT-MEME,0441930J,194,179,15,0,87,107,4 ème
LOIRE-ATLANTIQUE,NANTES,0440211R,43,39,0,4,24,19,4 ème
LOIRE-ATLANTIQUE,NANTES,0440283U,104,88,16,0,51,53,4 ème
LOIRE-ATLANTIQUE,NANTES,0440285W,135,135,0,0,63,72,4 ème
LOIRE-ATLANTIQUE,NANTES,0440286X,75,75,0,0,31,44,4 ème
LOIRE-ATLANTIQUE,NANTES,0441932L,198,195,0,3,99,99,4 ème
LOIRE-ATLANTIQUE,NANTES,0441937S,107,107,0,0,46,61,4 ème
LOIRE-ATLANTIQUE,NANTES,0442119P,22,22,0,0,10,12,4 ème
LOIRE-ATLANTIQUE,NANTES,0442835T,142,139,0,3,67,75,4 ème
LOIRE-ATLANTIQUE,PORNICHET,0440228J,117,117,0,0,56,61,4 ème
LOIRE-ATLANTIQUE,SAINTE-PAZANNE,0440236T,97,97,0,0,51,46,4 ème
LOIRE-ATLANTIQUE,SAINT-GILDAS-DES-BOIS,0441939U,158,158,0,0,94,64,4 ème
LOIRE-ATLANTIQUE,SAINT-HERBLAIN,0440016D,179,178,0,1,76,103,4 ème
LOIRE-ATLANTIQUE,SAINT-HERBLAIN,0442637C,15,15,0,0,6,9,4 ème
LOIRE-ATLANTIQUE,SAINT-NAZAIRE,0440074S,0,0,0,0,0,0,4 ème
LOIRE-ATLANTIQUE,SAINT-NAZAIRE,0440235S,111,95,16,0,55,56,4 ème
LOIRE-ATLANTIQUE,SAINT-NAZAIRE,0440314C,191,170,15,6,93,98,4 ème
LOIRE-ATLANTIQUE,SAINT-NAZAIRE,0441613P,89,71,16,2,45,44,4 ème
LOIRE-ATLANTIQUE,SAVENAY,0442806L,143,136,0,7,75,68,4 ème
LOIRE-ATLANTIQUE,VALLONS-DE-L'ERDRE,0441655K,67,65,0,2,30,37,4 ème
MAINE-ET-LOIRE,ANGERS,0490004N,147,143,0,4,69,78,4 ème
MAINE-ET-LOIRE,ANGERS,0490061A,110,105,0,5,51,59,4 ème
MAINE-ET-LOIRE,ANGERS,0490783K,94,89,0,5,48,46,4 ème
MAINE-ET-LOIRE,ANGERS,0490844B,209,191,16,2,96,113,4 ème
MAINE-ET-LOIRE,ANGERS,0491703K,83,65,16,2,30,53,4 ème
MAINE-ET-LOIRE,ANGERS,0491922Y,177,177,0,0,86,91,4 ème
MAINE-ET-LOIRE,ANGERS,0491924A,205,205,0,0,102,103,4 ème
MAINE-ET-LOIRE,BAUGE-EN-ANJOU,0490849G,113,113,0,0,54,59,4 ème
MAINE-ET-LOIRE,BELLEVIGNE-EN-LAYON,0490046J,91,91,0,0,51,40,4 ème
MAINE-ET-LOIRE,BRISSAC LOIRE AUBANCE,0490014Z,112,112,0,0,57,55,4 ème
MAINE-ET-LOIRE,CANDE,0490854M,102,102,0,0,47,55,4 ème
MAINE-ET-LOIRE,CHOLET,0490829K,136,133,0,3,67,69,4 ème
MAINE-ET-LOIRE,DOUE-EN-ANJOU,0490023J,99,96,0,3,41,58,4 ème
MAINE-ET-LOIRE,LE LION-D'ANGERS,0490027N,164,161,0,3,92,72,4 ème
MAINE-ET-LOIRE,LE MAY-SUR-EVRE,0490869D,64,64,0,0,32,32,4 ème
MAINE-ET-LOIRE,LES HAUTS-D'ANJOU,0491705M,129,127,0,2,59,70,4 ème
MAINE-ET-LOIRE,LES PONTS-DE-CE,0491260D,172,168,0,4,82,90,4 ème
MAINE-ET-LOIRE,LONGUE-JUMELLES,0490028P,122,103,16,3,64,58,4 ème
MAINE-ET-LOIRE,SAINT-BARTHELEMY-D'ANJOU,0490925P,14,0,14,0,5,9,4 ème
MAINE-ET-LOIRE,SAINT-GEORGES-SUR-LOIRE,0491645X,152,152,0,0,71,81,4 ème
MAINE-ET-LOIRE,SAUMUR,0491826U,57,57,0,0,31,26,4 ème
MAINE-ET-LOIRE,SEGRE-EN-ANJOU BLEU,0490782J,0,0,0,0,0,0,4 ème
MAINE-ET-LOIRE,SEGRE-EN-ANJOU BLEU,0490840X,0,0,0,0,0,0,4 ème
MAINE-ET-LOIRE,SEGRE-EN-ANJOU BLEU,0491927D,37,37,0,0,13,24,4 ème
MAYENNE,BAIS,0530003R,48,48,0,0,32,16,4 ème
MAYENNE,EVRON,0530007V,94,76,16,2,39,55,4 ème
MAYENNE,GREZ-EN-BOUERE,0530031W,66,66,0,0,31,35,4 ème
MAYENNE,LAVAL,0530041G,166,147,16,3,81,85,4 ème
MAYENNE,LAVAL,0530051T,179,177,0,2,78,101,4 ème
MAYENNE,LAVAL,0530082B,156,155,0,1,67,89,4 ème
MAYENNE,LAVAL,0530778H,0,0,0,0,0,0,4 ème
MAYENNE,LAVAL,0530904V,0,0,0,0,0,0,4 ème
MAYENNE,MAYENNE,0530053V,167,147,16,4,80,87,4 ème
MAYENNE,SAINT-PIERRE-LA-COUR,0530065H,87,87,0,0,42,45,4 ème
SARTHE,ANCINNES,0720002L,85,85,0,0,45,40,4 ème
SARTHE,BEAUMONT-SUR-SARTHE,0721655H,62,62,0,0,30,32,4 ème
SARTHE,BESSE-SUR-BRAYE,0721089T,46,46,0,0,21,25,4 ème
SARTHE,LA FERTE-BERNARD,0721364S,157,137,16,4,76,81,4 ème
SARTHE,LE MANS,0720068H,88,88,0,0,46,42,4 ème
SARTHE,LE MANS,0720081X,98,98,0,0,54,44,4 ème
SARTHE,LE MANS,0720799C,133,131,0,2,68,65,4 ème
SARTHE,LE MANS,0720835S,86,86,0,0,35,51,4 ème
SARTHE,LE MANS,0720984D,153,150,0,3,82,71,4 ème
SARTHE,LE MANS,0720987G,89,87,0,2,49,40,4 ème
SARTHE,LE MANS,0721363R,144,144,0,0,61,83,4 ème
SARTHE,MAYET,0720988H,69,69,0,0,33,36,4 ème
SARTHE,MONTVAL-SUR-LOIR,0720013Y,0,0,0,0,0,0,4 ème
SARTHE,MONTVAL-SUR-LOIR,0720067G,103,81,16,6,49,54,4 ème
SARTHE,MULSANNE,0721281B,64,64,0,0,31,33,4 ème
SARTHE,NOYEN-SUR-SARTHE,0721263G,105,105,0,0,50,55,4 ème
SARTHE,SABLE-SUR-SARTHE,0720989J,119,100,16,3,68,51,4 ème
SARTHE,SAINT-COSME-EN-VAIRAIS,0720053S,52,49,0,3,23,29,4 ème
SARTHE,VIBRAYE,0720058X,72,72,0,0,32,40,4 ème
VENDEE,AUBIGNY-LES CLOUZEAUX,0851620Z,189,186,0,3,98,91,4 ème
VENDEE,FONTENAY-LE-COMTE,0850068M,0,0,0,0,0,0,4 ème
VENDEE,FONTENAY-LE-COMTE,0851344Z,0,0,0,0,0,0,4 ème
VENDEE,LA ROCHE-SUR-YON,0850063G,209,189,16,4,91,118,4 ème
VENDEE,LA ROCHE-SUR-YON,0850082C,197,169,25,3,76,121,4 ème
VENDEE,LE POIRE-SUR-VIE,0850111J,165,165,0,0,78,87,4 ème
VENDEE,LES SABLES-D'OLONNE,0850084E,135,135,0,0,69,66,4 ème
VENDEE,LES SABLES-D'OLONNE,0851220P,134,134,0,0,80,54,4 ème
VENDEE,L'ILE-D'ELLE,0850014D,60,60,0,0,34,26,4 ème
VENDEE,LUCON,0850607Y,89,72,17,0,38,51,4 ème
VENDEE,POUZAUGES,0850024P,105,103,0,2,51,54,4 ème
VENDEE,ROCHESERVIERE,0850113L,129,129,0,0,57,72,4 ème
VENDEE,SAINTE-CECILE,0851295W,29,29,0,0,0,29,4 ème
VENDEE,SAINT-GILLES-CROIX-DE-VIE,0851181X,245,243,0,2,108,137,4 ème
ALPES-DE-HTE-PROVENCE,BEVONS,0040378P,20,0,20,0,4,16,4 ème
ALPES-DE-HTE-PROVENCE,CASTELLANE,0040004H,33,33,0,0,15,18,4 ème
ALPES-DE-HTE-PROVENCE,DIGNE-LES-BAINS,0040034R,0,0,0,0,0,0,4 ème
ALPES-DE-HTE-PROVENCE,DIGNE-LES-BAINS,0040044B,87,87,0,0,38,49,4 ème
ALPES-DE-HTE-PROVENCE,ORAISON,0040051J,130,126,0,4,71,59,4 ème
ALPES-DE-HTE-PROVENCE,SISTERON,0040420K,151,146,0,5,76,75,4 ème
ALPES-DE-HTE-PROVENCE,VOLX,0040535K,122,117,0,5,43,79,4 ème
BOUCHES-DU-RHONE,AIX-EN-PROVENCE,0132568W,205,205,0,0,104,101,4 ème
BOUCHES-DU-RHONE,AIX-EN-PROVENCE,0132915Y,153,153,0,0,86,67,4 ème
BOUCHES-DU-RHONE,ARLES,0130171R,0,0,0,0,0,0,4 ème
BOUCHES-DU-RHONE,AUBAGNE,0131622T,186,182,0,4,73,113,4 ème
BOUCHES-DU-RHONE,BERRE-L'ETANG,0131705H,172,158,14,0,68,104,4 ème
BOUCHES-DU-RHONE,CHATEAUNEUF-LES-MARTIGUES,0132494R,204,202,0,2,104,100,4 ème
BOUCHES-DU-RHONE,GARDANNE,0131700C,166,166,0,0,91,75,4 ème
BOUCHES-DU-RHONE,GARDANNE,0133244F,0,0,0,0,0,0,4 ème
BOUCHES-DU-RHONE,GIGNAC-LA-NERTHE,0133381E,165,162,0,3,79,86,4 ème
BOUCHES-DU-RHONE,LA FARE-LES-OLIVIERS,0133016H,181,178,0,3,79,102,4 ème
BOUCHES-DU-RHONE,LES PENNES-MIRABEAU,0132565T,174,174,0,0,90,84,4 ème
BOUCHES-DU-RHONE,MARIGNANE,0132921E,216,215,0,1,108,108,4 ème
BOUCHES-DU-RHONE,MARSEILLE,0130072H,0,0,0,0,0,0,4 ème
BOUCHES-DU-RHONE,MARSEILLE,0132732Z,149,149,0,0,74,75,4 ème
BOUCHES-DU-RHONE,MARSEILLE,0132947H,168,168,0,0,87,81,4 ème
BOUCHES-DU-RHONE,MARSEILLE,0132404T,114,114,0,0,50,64,4 ème
BOUCHES-DU-RHONE,MARSEILLE,0131606A,0,0,0,0,0,0,4 ème
BOUCHES-DU-RHONE,MARSEILLE,0130058T,0,0,0,0,0,0,4 ème
BOUCHES-DU-RHONE,MARSEILLE,0130136C,84,84,0,0,33,51,4 ème
BOUCHES-DU-RHONE,MARSEILLE,0132954R,90,90,0,0,52,38,4 ème
BOUCHES-DU-RHONE,MARSEILLE,0130093F,138,137,0,1,70,68,4 ème
BOUCHES-DU-RHONE,MARSEILLE,0131336G,83,83,0,0,38,45,4 ème
BOUCHES-DU-RHONE,MARSEILLE,0131434N,0,0,0,0,0,0,4 ème
BOUCHES-DU-RHONE,MARSEILLE,0132561N,94,89,0,5,39,55,4 ème
BOUCHES-DU-RHONE,MARSEILLE,0130063Y,0,0,0,0,0,0,4 ème
BOUCHES-DU-RHONE,MARTIGUES,0132208E,136,123,13,0,70,66,4 ème
BOUCHES-DU-RHONE,MIRAMAS,0132497U,108,108,0,0,43,65,4 ème
BOUCHES-DU-RHONE,ORGON,0132217P,133,117,16,0,64,69,4 ème
BOUCHES-DU-RHONE,PELISSANNE,0133114P,143,139,0,4,68,75,4 ème
BOUCHES-DU-RHONE,PORT-SAINT-LOUIS-DU-RHONE,0132280H,0,0,0,0,0,0,4 ème
BOUCHES-DU-RHONE,SAINT-VICTORET,0132007L,166,166,0,0,88,78,4 ème
BOUCHES-DU-RHONE,SALON-DE-PROVENCE,0131485U,0,0,0,0,0,0,4 ème
HAUTES-ALPES,BRIANCON,0050519M,123,108,13,2,51,72,4 ème
HAUTES-ALPES,GAP,0050010J,145,145,0,0,60,85,4 ème
HAUTES-ALPES,GAP,0050025A,147,126,17,4,77,70,4 ème
VAUCLUSE,APT,0840070V,55,55,0,0,31,24,4 ème
VAUCLUSE,AVIGNON,0840041N,0,0,0,0,0,0,4 ème
VAUCLUSE,AVIGNON,0840051Z,101,101,0,0,46,55,4 ème
VAUCLUSE,AVIGNON,0840073Y,126,122,0,4,73,53,4 ème
VAUCLUSE,AVIGNON,0840738W,121,119,0,2,51,70,4 ème
VAUCLUSE,AVIGNON,0840758T,128,128,0,0,70,58,4 ème
VAUCLUSE,AVIGNON,0840970Y,123,119,0,4,59,64,4 ème
VAUCLUSE,BOLLENE,0840699D,127,127,0,0,73,54,4 ème
VAUCLUSE,CABRIERES-D'AVIGNON,0841019B,157,157,0,0,61,96,4 ème
VAUCLUSE,CARPENTRAS,0840016L,0,0,0,0,0,0,4 ème
VAUCLUSE,CAVAILLON,0840020R,167,166,0,1,86,81,4 ème
VAUCLUSE,ORANGE,0840763Y,0,0,0,0,0,0,4 ème
VAUCLUSE,PERTUIS,0840029A,169,153,16,0,79,90,4 ème
VAUCLUSE,PERTUIS,0840918S,0,0,0,0,0,0,4 ème
VAUCLUSE,VAISON-LA-ROMAINE,0840035G,186,186,0,0,93,93,4 ème
ALPES-MARITIMES,ANTIBES,0060076A,85,82,0,3,35,50,4 ème
ALPES-MARITIMES,ANTIBES,0061133Z,107,104,0,3,47,60,4 ème
ALPES-MARITIMES,GRASSE,0061240R,121,121,0,0,62,59,4 ème
ALPES-MARITIMES,GRASSE,0061459D,212,212,0,0,104,108,4 ème
ALPES-MARITIMES,L'ESCARENE,0061826C,78,78,0,0,41,37,4 ème
ALPES-MARITIMES,MENTON,0060028Y,0,0,0,0,0,0,4 ème
ALPES-MARITIMES,MENTON,0060744B,93,93,0,0,48,45,4 ème
ALPES-MARITIMES,NICE,0060045S,110,109,0,1,47,63,4 ème
ALPES-MARITIMES,NICE,0060048V,230,228,0,2,131,99,4 ème
ALPES-MARITIMES,NICE,0060776L,0,0,0,0,0,0,4 ème
ALPES-MARITIMES,NICE,0060841G,182,155,27,0,97,85,4 ème
ALPES-MARITIMES,NICE,0061131X,194,173,11,10,98,96,4 ème
ALPES-MARITIMES,NICE,0061461F,152,152,0,0,74,78,4 ème
ALPES-MARITIMES,NICE,0061722P,14,14,0,0,6,8,4 ème
ALPES-MARITIMES,NICE,0061772U,27,27,0,0,13,14,4 ème
ALPES-MARITIMES,SAINT-SAUVEUR-SUR-TINEE,0060066P,47,47,0,0,15,32,4 ème
ALPES-MARITIMES,SAINT-VALLIER-DE-THIEY,0061986B,108,108,0,0,49,59,4 ème
ALPES-MARITIMES,SOSPEL,0060067R,50,50,0,0,25,25,4 ème
ALPES-MARITIMES,VALDEBLORE,0061987C,0,0,0,0,0,0,4 ème
ALPES-MARITIMES,VENCE,0061135B,204,204,0,0,106,98,4 ème
VAR,COGOLIN,0830837J,189,167,16,6,87,102,4 ème
VAR,LA LONDE-LES-MAURES,0830031H,80,80,0,0,46,34,4 ème
VAR,LA SEYNE-SUR-MER,0830180V,153,125,23,5,74,79,4 ème
VAR,LA SEYNE-SUR-MER,0830925E,206,202,0,4,97,109,4 ème
VAR,MONTAUROUX,0831610Z,202,182,17,3,99,103,4 ème
VAR,OLLIOULES,0831187P,0,0,0,0,0,0,4 ème
VAR,SAINT-MAXIMIN-LA-SAINTE-BAUME,0831442S,235,231,0,4,108,127,4 ème
VAR,SAINT-MAXIMIN-LA-SAINTE-BAUME,0831559U,0,0,0,0,0,0,4 ème
VAR,SAINT-RAPHAEL,0830075F,139,139,0,0,70,69,4 ème
VAR,SIX-FOURS-LES-PLAGES,0831012Z,194,174,17,3,98,96,4 ème
VAR,SOLLIES-PONT,0830831C,197,197,0,0,91,106,4 ème
VAR,TOULON,0830116A,0,0,0,0,0,0,4 ème
VAR,TOULON,0830128N,0,0,0,0,0,0,4 ème
VAR,TOULON,0830955M,69,67,0,2,27,42,4 ème
VAR,TOULON,0831053U,156,137,16,3,74,82,4 ème
ALLIER,CUSSET,0030010V,190,172,16,2,103,87,4 ème
ALLIER,DOMERAT,0030956Y,68,64,0,4,36,32,4 ème
ALLIER,GANNAT,0030905T,0,0,0,0,0,0,4 ème
ALLIER,LE DONJON,0030014Z,29,29,0,0,15,14,4 ème
ALLIER,MONTLUCON,0030026M,0,0,0,0,0,0,4 ème
ALLIER,MONTLUCON,0030105Y,0,0,0,0,0,0,4 ème
ALLIER,MOULINS,0030062B,166,161,0,5,81,85,4 ème
ALLIER,TRONGET,0030046J,30,30,0,0,15,15,4 ème
ALLIER,VALLON-EN-SULLY,0030047K,50,50,0,0,32,18,4 ème
CANTAL,AURILLAC,0150005Z,142,136,0,6,77,65,4 ème
CANTAL,AURILLAC,0150006A,0,0,0,0,0,0,4 ème
CANTAL,MURAT,0150023U,36,36,0,0,22,14,4 ème
CANTAL,NEUSSARGUES EN PINATELLE,0150065P,9,9,0,0,7,2,4 ème
CANTAL,PLEAUX,0150025W,18,18,0,0,10,8,4 ème
CANTAL,SAINT-CERNIN,0150028Z,39,38,0,1,23,16,4 ème
CANTAL,SAINT-FLOUR,0150030B,0,0,0,0,0,0,4 ème
CANTAL,SAINT-FLOUR,0150666T,57,57,0,0,24,33,4 ème
HAUTE-LOIRE,AUREC-SUR-LOIRE,0430052Y,68,68,0,0,35,33,4 ème
HAUTE-LOIRE,BLESLE,0430002U,13,13,0,0,3,10,4 ème
HAUTE-LOIRE,BRIVES-CHARENSAC,0430899U,76,58,14,4,30,46,4 ème
HAUTE-LOIRE,LANDOS,0430012E,37,37,0,0,18,19,4 ème
HAUTE-LOIRE,LE PUY-EN-VELAY,0431009N,91,91,0,0,41,50,4 ème
HAUTE-LOIRE,PAULHAGUET,0430019M,20,20,0,0,6,14,4 ème
HAUTE-LOIRE,SAUGUES,0430092S,19,19,0,0,6,13,4 ème
HAUTE-LOIRE,TENCE,0430034D,38,38,0,0,21,17,4 ème
PUY-DE-DOME,AIGUEPERSE,0630079U,174,174,0,0,78,96,4 ème
PUY-DE-DOME,AIGUEPERSE,0631084L,18,18,0,0,5,13,4 ème
PUY-DE-DOME,BILLOM,0631080G,55,53,0,2,21,34,4 ème
PUY-DE-DOME,BRASSAC-LES-MINES,0630012W,0,0,0,0,0,0,4 ème
PUY-DE-DOME,BRASSAC-LES-MINES,0631503S,33,33,0,0,18,15,4 ème
PUY-DE-DOME,CHAMALIERES,0631125F,191,188,0,3,102,89,4 ème
PUY-DE-DOME,CLERMONT-FERRAND,0631099C,52,52,0,0,30,22,4 ème
PUY-DE-DOME,CLERMONT-FERRAND,0631199L,105,103,0,2,52,53,4 ème
PUY-DE-DOME,CLERMONT-FERRAND,0631408N,0,0,0,0,0,0,4 ème
PUY-DE-DOME,CLERMONT-FERRAND,0631411S,109,109,0,0,49,60,4 ème
PUY-DE-DOME,ISSOIRE,0631448G,110,107,0,3,64,46,4 ème
PUY-DE-DOME,LA MONNERIE-LE-MONTEL,0631762Y,70,70,0,0,37,33,4 ème
PUY-DE-DOME,MURAT-LE-QUAIRE,0630010U,41,37,0,4,23,18,4 ème
PUY-DE-DOME,RIOM,0631735U,136,134,0,2,69,67,4 ème
PUY-DE-DOME,RIOM,0631985R,0,0,0,0,0,0,4 ème
PUY-DE-DOME,SAINT-GERMAIN-L'HERM,0630064C,42,42,0,0,19,23,4 ème
PUY-DE-DOME,THIERS,0631407M,33,33,0,0,20,13,4 ème
ARDECHE,ANNONAY,0070059B,127,124,0,3,55,72,4 ème
ARDECHE,ANNONAY,0070060C,162,162,0,0,80,82,4 ème
ARDECHE,ANNONAY,0071300A,121,120,0,1,63,58,4 ème
ARDECHE,AUBENAS,0071245R,74,72,0,2,40,34,4 ème
ARDECHE,BOURG-SAINT-ANDEOL,0070860X,118,114,0,4,59,59,4 ème
ARDECHE,CHOMERAC,0070009X,0,0,0,0,0,0,4 ème
ARDECHE,LARGENTIERE,0070080Z,55,50,0,5,28,27,4 ème
ARDECHE,LE CHEYLARD,0070861Y,47,47,0,0,23,24,4 ème
ARDECHE,PRIVAS,0070114L,0,0,0,0,0,0,4 ème
ARDECHE,PRIVAS,0071246S,221,217,0,4,105,116,4 ème
ARDECHE,PRIVAS,0071281E,58,58,0,0,32,26,4 ème
ARDECHE,SAINT-AGREVE,0070023M,21,21,0,0,12,9,4 ème
ARDECHE,TOURNON-SUR-RHONE,0070031W,0,0,0,0,0,0,4 ème
DROME,CHABEUIL,0260003M,174,172,0,2,87,87,4 ème
DROME,CHATEAUNEUF-DE-GALAURE,0261134S,51,51,0,0,0,51,4 ème
DROME,CREST,0260006R,0,0,0,0,0,0,4 ème
DROME,CREST,0260945L,107,107,0,0,38,69,4 ème
DROME,CREST,0261030D,168,144,16,8,87,81,4 ème
DROME,LE GRAND-SERRE,0260011W,89,89,0,0,45,44,4 ème
DROME,LIVRON-SUR-DROME,0260096N,145,145,0,0,69,76,4 ème
DROME,NYONS,0261089T,154,149,0,5,74,80,4 ème
DROME,PIERRELATTE,0260098R,109,109,0,0,54,55,4 ème
DROME,PIERRELATTE,0261010G,121,105,10,6,57,64,4 ème
DROME,ROMANS-SUR-ISERE,0260067G,96,96,0,0,43,53,4 ème
DROME,SAINT-DONAT-SUR-L'HERBASSE,0260099S,55,55,0,0,27,28,4 ème
DROME,SAINT-JEAN-EN-ROYANS,0260027N,66,66,0,0,32,34,4 ème
DROME,VALENCE,0260117L,115,115,0,0,58,57,4 ème
HAUTE SAVOIE,ABONDANCE,0740001Z,44,44,0,0,19,25,4 ème
HAUTE SAVOIE,ANNECY,0740083N,118,115,0,3,54,64,4 ème
HAUTE SAVOIE,ANNECY,0740274W,140,139,0,1,54,86,4 ème
HAUTE SAVOIE,ANNECY,0741101V,0,0,0,0,0,0,4 ème
HAUTE SAVOIE,ANNECY,0741164N,0,0,0,0,0,0,4 ème
HAUTE SAVOIE,ANNECY,0741285V,0,0,0,0,0,0,4 ème
HAUTE SAVOIE,ANNEMASSE,0741165P,278,274,0,4,130,148,4 ème
HAUTE SAVOIE,EVIAN-LES-BAINS,0740021W,169,165,0,4,70,99,4 ème
HAUTE SAVOIE,FAVERGES-SEYTHENEX,0740023Y,151,148,0,3,59,92,4 ème
HAUTE SAVOIE,MARIGNIER,0741501E,149,146,0,3,73,76,4 ème
HAUTE SAVOIE,SAINT-JEAN-D'AULPS,0740034K,99,99,0,0,53,46,4 ème
HAUTE SAVOIE,SALLANCHES,0740155S,0,0,0,0,0,0,4 ème
HAUTE SAVOIE,SEYSSEL,0740041T,144,144,0,0,71,73,4 ème
ISERE,BEAUREPAIRE,0382101C,130,126,0,4,61,69,4 ème
ISERE,CROLLES,0382781S,143,138,0,5,67,76,4 ème
ISERE,EYBENS,0383494S,116,110,0,6,53,63,4 ème
ISERE,GRENOBLE,0381696M,116,116,0,0,54,62,4 ème
ISERE,GRENOBLE,0382035F,183,153,28,2,97,86,4 ème
ISERE,GRENOBLE,0382111N,137,137,0,0,50,87,4 ème
ISERE,JARRIE,0382782T,130,127,0,3,69,61,4 ème
ISERE,LA COTE-SAINT-ANDRE,0381689E,176,172,0,4,83,93,4 ème
ISERE,LE BOURG-D'OISANS,0380007B,129,129,0,0,60,69,4 ème
ISERE,LE PONT-DE-BEAUVOISIN,0381703V,110,110,0,0,55,55,4 ème
ISERE,L'ISLE-D'ABEAU,0382786X,135,114,17,4,65,70,4 ème
ISERE,MENS,0380039L,49,49,0,0,22,27,4 ème
ISERE,PONT-DE-CHERUY,0381602K,0,0,0,0,0,0,4 ème
ISERE,SAINT-CHEF,0383301G,146,146,0,0,63,83,4 ème
ISERE,SAINT-MARTIN-D'HERES,0380065P,103,97,0,6,53,50,4 ème
ISERE,SAINT-MARTIN-D'HERES,0381812N,135,132,0,3,65,70,4 ème
ISERE,SAINT-QUENTIN-FALLAVIER,0382706K,102,97,0,5,62,40,4 ème
ISERE,SAINT-SIMEON-DE-BRESSIEUX,0380068T,104,100,0,4,54,50,4 ème
ISERE,TULLINS,0380067S,136,136,0,0,70,66,4 ème
ISERE,VIENNE,0381907S,179,148,26,5,75,104,4 ème
ISERE,VILLEFONTAINE,0382864G,90,90,0,0,50,40,4 ème
ISERE,VOIRON,0380092U,0,0,0,0,0,0,4 ème
ISERE,VOIRON,0381710C,170,170,0,0,88,82,4 ème
ISERE,VOREPPE,0381805F,0,0,0,0,0,0,4 ème
ISERE,VOREPPE,0382663N,118,118,0,0,62,56,4 ème
SAVOIE,AIX-LES-BAINS,0731041K,124,124,0,0,68,56,4 ème
SAVOIE,AIX-LES-BAINS,0731271K,12,12,0,0,12,0,4 ème
SAVOIE,ALBERTVILLE,0731224J,76,73,0,3,37,39,4 ème
SAVOIE,CHAMBERY,0730764J,254,254,0,0,123,131,4 ème
SAVOIE,CHAMBERY,0730901H,128,128,0,0,68,60,4 ème
SAVOIE,CHAMBERY,0731042L,179,174,0,5,86,93,4 ème
SAVOIE,ENTRELACS,0730004H,104,104,0,0,57,47,4 ème
SAVOIE,LA MOTTE-SERVOLEX,0731441V,155,152,0,3,76,79,4 ème
SAVOIE,LA RAVOIRE,0730032N,0,0,0,0,0,0,4 ème
SAVOIE,LA RAVOIRE,0730765K,118,88,30,0,40,78,4 ème
SAVOIE,MOUTIERS,0730029K,0,0,0,0,0,0,4 ème
SAVOIE,NOVALAISE,0730031M,84,84,0,0,35,49,4 ème
SAVOIE,SAINT-MICHEL-DE-MAURIENNE,0730984Y,51,51,0,0,30,21,4 ème
AIN,AMBERIEU-EN-BUGEY,0010002X,198,195,0,3,90,108,4 ème
AIN,AMBERIEU-EN-BUGEY,0010076C,115,115,0,0,51,64,4 ème
AIN,BOURG-EN-BRESSE,0010021T,0,0,0,0,0,0,4 ème
AIN,BOURG-EN-BRESSE,0010082J,196,192,0,4,102,94,4 ème
AIN,BOURG-EN-BRESSE,0010823P,122,122,0,0,59,63,4 ème
AIN,MARBOZ,0010089S,21,21,0,0,15,6,4 ème
AIN,MIRIBEL,0010964T,135,119,16,0,71,64,4 ème
AIN,MONTREAL-LA-CLUSE,0011325K,159,155,0,4,87,72,4 ème
AIN,NANTUA,0010032E,0,0,0,0,0,0,4 ème
AIN,OYONNAX,0010034G,0,0,0,0,0,0,4 ème
AIN,OYONNAX,0010035H,150,148,0,2,68,82,4 ème
AIN,PERON,0011388D,175,174,0,1,84,91,4 ème
AIN,PONT-DE-VEYLE,0010820L,138,134,0,4,76,62,4 ème
AIN,SAINT-DIDIER-SUR-CHALARONNE,0010095Y,144,144,0,0,67,77,4 ème
AIN,SAINT-GENIS-POUILLY,0010975E,155,153,0,2,73,82,4 ème
AIN,SAINT-TRIVIER-DE-COURTES,0010040N,73,71,0,2,32,41,4 ème
AIN,THOISSEY,0010042R,108,108,0,0,62,46,4 ème
AIN,VALSERHONE,0010008D,150,138,11,1,62,88,4 ème
AIN,VALSERHONE,0011066D,138,136,0,2,79,59,4 ème
AIN,VILLARS-LES-DOMBES,0010939R,143,140,0,3,76,67,4 ème
LOIRE,ANDREZIEUX-BOUTHEON,0421487N,224,200,17,7,99,125,4 ème
LOIRE,BOEN-SUR-LIGNON,0421085B,126,125,0,1,64,62,4 ème
LOIRE,BOURG-ARGENTAL,0421043F,44,44,0,0,31,13,4 ème
LOIRE,CHARLIEU,0420008F,0,0,0,0,0,0,4 ème
LOIRE,CHARLIEU,0421800D,100,100,0,0,49,51,4 ème
LOIRE,FEURS,0421057W,118,118,0,0,62,56,4 ème
LOIRE,LA GRAND-CROIX,0421086C,188,185,0,3,83,105,4 ème
LOIRE,LA RICAMARIE,0421689H,63,60,0,3,30,33,4 ème
LOIRE,LA TALAUDIERE,0421171V,234,230,0,4,120,114,4 ème
LOIRE,LE COTEAU,0421489R,0,0,0,0,0,0,4 ème
LOIRE,MABLY,0421852K,121,103,16,2,59,62,4 ème
LOIRE,MONTBRISON,0421032U,154,150,0,4,87,67,4 ème
LOIRE,RENAISON,0421735H,134,134,0,0,66,68,4 ème
LOIRE,RIVE-DE-GIER,0420029D,0,0,0,0,0,0,4 ème
LOIRE,RIVE-DE-GIER,0421014Z,143,143,0,0,76,67,4 ème
LOIRE,RIVE-DE-GIER,0421680Y,99,98,0,1,49,50,4 ème
LOIRE,ROANNE,0420076E,0,0,0,0,0,0,4 ème
LOIRE,ROANNE,0420978K,121,121,0,0,62,59,4 ème
LOIRE,SAINT-CHAMOND,0420078G,0,0,0,0,0,0,4 ème
LOIRE,SAINT-CHAMOND,0420996E,0,0,0,0,0,0,4 ème
LOIRE,SAINT-CHAMOND,0421799C,291,287,0,4,143,148,4 ème
LOIRE,SAINT-ETIENNE,0420916T,123,105,16,2,67,56,4 ème
LOIRE,SAINT-ETIENNE,0420958N,0,0,0,0,0,0,4 ème
LOIRE,SAINT-ETIENNE,0420991Z,0,0,0,0,0,0,4 ème
LOIRE,SAINT-ETIENNE,0421016B,56,56,0,0,30,26,4 ème
LOIRE,SAINT-ETIENNE,0421678W,238,235,0,3,112,126,4 ème
LOIRE,SAINT-ETIENNE,0421679X,149,138,0,11,59,90,4 ème
LOIRE,SAINT-HEAND,0421565Y,194,194,0,0,89,105,4 ème
LOIRE,SORBIERS,0421608V,0,0,0,0,0,0,4 ème
RHONE,AMPLEPUIS,0690001B,77,74,0,3,42,35,4 ème
RHONE,BRIGNAIS,0690008J,0,0,0,0,0,0,4 ème
RHONE,BRON,0690010L,0,0,0,0,0,0,4 ème
RHONE,CLAVEISOLLES,0690585L,34,34,0,0,11,23,4 ème
RHONE,CONDRIEU,0690015S,143,138,0,5,68,75,4 ème
RHONE,DARDILLY,0693504J,0,0,0,0,0,0,4 ème
RHONE,DECINES-CHARPIEU,0691495A,155,154,0,1,70,85,4 ème
RHONE,DECINES-CHARPIEU,0692800U,0,0,0,0,0,0,4 ème
RHONE,ECULLY,0690510E,181,179,0,2,97,84,4 ème
RHONE,FONTAINES-SUR-SAONE,0691736M,166,162,0,4,79,87,4 ème
RHONE,GIVORS,0690210D,94,94,0,0,44,50,4 ème
RHONE,LA MULATIERE,0692923C,117,117,0,0,56,61,4 ème
RHONE,LENTILLY,0693286X,213,213,0,0,113,100,4 ème
RHONE,LIMAS,0692420F,167,148,14,5,85,82,4 ème
RHONE,LYON,0692928H,188,188,0,0,103,85,4 ème
RHONE,LYON,0690053H,163,142,16,5,73,90,4 ème
RHONE,LYON,0690131T,115,111,0,4,54,61,4 ème
RHONE,LYON,0692411W,118,116,0,2,53,65,4 ème
RHONE,LYON,0692921A,478,474,0,4,230,248,4 ème
RHONE,LYON,0692936S,157,157,0,0,60,97,4 ème
RHONE,LYON,0693371P,0,0,0,0,0,0,4 ème
RHONE,LYON,0690046A,0,0,0,0,0,0,4 ème
RHONE,LYON,0692578C,124,123,0,1,66,58,4 ème
RHONE,LYON,0690092A,0,0,0,0,0,0,4 ème
RHONE,MEYZIEU,0692704P,144,139,0,5,73,71,4 ème
RHONE,RILLIEUX-LA-PAPE,0691626T,0,0,0,0,0,0,4 ème
RHONE,RILLIEUX-LA-PAPE,0691651V,152,152,0,0,90,62,4 ème
RHONE,SAINTE-FOY-L'ARGENTIERE,0690078K,125,124,0,1,63,62,4 ème
RHONE,SAINT-GENIS-LAVAL,0693287Y,86,86,0,0,44,42,4 ème
RHONE,SAINT-PRIEST,0693094N,0,0,0,0,0,0,4 ème
RHONE,SOUCIEU-EN-JARREST,0693046L,143,141,0,2,66,77,4 ème
RHONE,TARARE,0690085T,0,0,0,0,0,0,4 ème
RHONE,VAULX-EN-VELIN,0693045K,0,0,0,0,0,0,4 ème
RHONE,VENISSIEUX,0690094C,197,194,0,3,103,94,4 ème
RHONE,VENISSIEUX,0691480J,155,152,0,3,85,70,4 ème
RHONE,VENISSIEUX,0691730F,200,197,0,3,90,110,4 ème
RHONE,VENISSIEUX,0692343X,178,158,16,4,88,90,4 ème
RHONE,VILLEURBANNE,0690103M,0,0,0,0,0,0,4 ème
RHONE,VILLEURBANNE,0690109U,0,0,0,0,0,0,4 ème
RHONE,VILLEURBANNE,0690280E,177,171,0,6,103,74,4 ème
RHONE,VILLEURBANNE,0692390Y,9,6,0,3,2,7,4 ème
RHONE,VILLEURBANNE,0694497N,0,0,0,0,0,0,4 ème
DOUBS,BESANCON,0251573Z,258,258,0,0,129,129,4 ème
DOUBS,BETHONCOURT,0251209D,84,84,0,0,42,42,4 ème
DOUBS,CHATILLON-LE-DUC,0251857H,171,165,0,6,92,79,4 ème
DOUBS,LES FONTENELLES,0251064W,16,16,0,0,4,12,4 ème
DOUBS,MONTBELIARD,0250035C,139,138,0,1,61,78,4 ème
DOUBS,MONTBELIARD,0251057N,130,130,0,0,72,58,4 ème
DOUBS,MORTEAU,0251067Z,105,105,0,0,46,59,4 ème
DOUBS,PAYS-DE-CLERVAL,0250016G,40,40,0,0,22,18,4 ème
DOUBS,POUILLEY-LES-VIGNES,0251673H,138,138,0,0,70,68,4 ème
DOUBS,VOUJEAUCOURT,0251130T,173,153,17,3,79,94,4 ème
HAUTE-SAONE,FAVERNEY,0700006B,56,53,0,3,22,34,4 ème
HAUTE-SAONE,HERICOURT,0700063N,86,86,0,0,42,44,4 ème
HAUTE-SAONE,LURE,0700065R,56,56,0,0,32,24,4 ème
HAUTE-SAONE,SCEY-SUR-SAONE-ET-SAINT-ALBIN,0700894S,99,99,0,0,43,56,4 ème
JURA,CHAMPAGNOLE,0390075V,68,68,0,0,33,35,4 ème
JURA,CROTENAY,0390055Y,18,0,18,0,5,13,4 ème
JURA,HAUTS DE BIENNE,0390028U,85,81,0,4,42,43,4 ème
JURA,HAUTS DE BIENNE,0390081B,26,26,0,0,10,16,4 ème
JURA,LONS-LE-SAUNIER,0391003D,52,52,0,0,30,22,4 ème
JURA,MOIRANS-EN-MONTAGNE,0390024P,0,0,0,0,0,0,4 ème
JURA,POLIGNY,0390072S,22,22,0,0,10,12,4 ème
JURA,POLIGNY,0390798F,122,104,16,2,54,68,4 ème
JURA,SAINT-LAURENT-EN-GRANDVAUX,0390916J,69,66,0,3,30,39,4 ème
TERRITOIRE DE BELFORT,BELFORT,0900006T,150,144,0,6,61,89,4 ème
TERRITOIRE DE BELFORT,BELFORT,0900425Y,0,0,0,0,0,0,4 ème
TERRITOIRE DE BELFORT,GIROMAGNY,0900009W,113,112,0,1,52,61,4 ème
COTE D'OR,AUXONNE,0211452P,163,143,16,4,74,89,4 ème
COTE D'OR,BEAUNE,0211230Y,152,135,15,2,64,88,4 ème
COTE D'OR,BRAZEY-EN-PLAINE,0211756V,101,86,15,0,49,52,4 ème
COTE D'OR,CHENOVE,0211096C,72,72,0,0,32,40,4 ème
COTE D'OR,CHENOVE,0211356K,0,0,0,0,0,0,4 ème
COTE D'OR,DIJON,0211151M,237,234,0,3,121,116,4 ème
COTE D'OR,DIJON,0211526V,102,102,0,0,50,52,4 ème
COTE D'OR,FONTAINE-FRANCAISE,0210027R,39,39,0,0,17,22,4 ème
COTE D'OR,IS-SUR-TILLE,0210029T,183,167,12,4,104,79,4 ème
COTE D'OR,LAIGNES,0210030U,27,27,0,0,12,15,4 ème
COTE D'OR,POUILLY-EN-AUXOIS,0210041F,67,67,0,0,39,28,4 ème
COTE D'OR,SELONGEY,0211557D,59,59,0,0,33,26,4 ème
COTE D'OR,SEMUR-EN-AUXOIS,0211527W,112,95,16,1,53,59,4 ème
NIEVRE,COSNE-COURS-SUR-LOIRE,0580014A,0,0,0,0,0,0,4 ème
NIEVRE,COSNE-COURS-SUR-LOIRE,0580066G,45,45,0,0,20,25,4 ème
NIEVRE,DECIZE,0580017D,96,72,16,8,41,55,4 ème
NIEVRE,DECIZE,0580761M,0,0,0,0,0,0,4 ème
NIEVRE,DONZY,0580018E,32,32,0,0,14,18,4 ème
NIEVRE,LORMES,0580026N,24,24,0,0,17,7,4 ème
NIEVRE,NEVERS,0580061B,150,148,0,2,74,76,4 ème
NIEVRE,POUILLY-SUR-LOIRE,0580035Y,36,36,0,0,18,18,4 ème
NIEVRE,SAINT-AMAND-EN-PUISAYE,0580037A,22,22,0,0,13,9,4 ème
NIEVRE,VARZY,0581009G,31,20,7,4,13,18,4 ème
SAONE-ET-LOIRE,AUTUN,0711350G,54,53,0,1,32,22,4 ème
SAONE-ET-LOIRE,BLANZY,0711384U,0,0,0,0,0,0,4 ème
SAONE-ET-LOIRE,CHALON-SUR-SAONE,0710106E,218,218,0,0,93,125,4 ème
SAONE-ET-LOIRE,CHALON-SUR-SAONE,0710537Y,88,87,0,1,51,37,4 ème
SAONE-ET-LOIRE,CHALON-SUR-SAONE,0711448N,157,157,0,0,90,67,4 ème
SAONE-ET-LOIRE,CHARNAY-LES-MACON,0711050F,24,0,24,0,7,17,4 ème
SAONE-ET-LOIRE,CUISERY,0710034B,116,116,0,0,57,59,4 ème
SAONE-ET-LOIRE,ETANG-SUR-ARROUX,0710038F,45,45,0,0,19,26,4 ème
SAONE-ET-LOIRE,LA CLAYETTE,0710022N,60,60,0,0,34,26,4 ème
SAONE-ET-LOIRE,LOUHANS,0711925G,42,42,0,0,18,24,4 ème
SAONE-ET-LOIRE,MACON,0710110J,173,173,0,0,92,81,4 ème
SAONE-ET-LOIRE,MACON,0711052H,202,198,0,4,85,117,4 ème
SAONE-ET-LOIRE,MACON,0711053J,130,125,0,5,57,73,4 ème
SAONE-ET-LOIRE,SAINT-GERMAIN-DU-PLAIN,0710067M,130,127,0,3,71,59,4 ème
SAONE-ET-LOIRE,SAINT-MARTIN-EN-BRESSE,0711451S,79,73,0,6,45,34,4 ème
SAONE-ET-LOIRE,SAINT-VALLIER,0711296Y,129,129,0,0,65,64,4 ème
SAONE-ET-LOIRE,SENNECEY-LE-GRAND,0710070R,81,81,0,0,26,55,4 ème
YONNE,AVALLON,0890009B,62,60,0,2,29,33,4 ème
YONNE,AVALLON,0891053L,21,21,0,0,13,8,4 ème
YONNE,CHARNY OREE DE PUISAYE,0890014G,63,63,0,0,36,27,4 ème
YONNE,SAINT-FARGEAU,0890022R,107,103,0,4,54,53,4 ème
YONNE,SAINT-GEORGES-SUR-BAULCHE,0891043A,172,168,0,4,87,85,4 ème
YONNE,SENS,0890053Z,0,0,0,0,0,0,4 ème
YONNE,SENS,0890067P,0,0,0,0,0,0,4 ème
YONNE,TOUCY,0890035E,99,86,13,0,51,48,4 ème
COTES D'ARMOR,BROONS,0221127F,146,145,0,1,83,63,4 ème
COTES D'ARMOR,CHATELAUDREN-PLOUAGAT,0220006M,149,148,0,1,73,76,4 ème
COTES D'ARMOR,GUERLEDAN,0220032R,53,53,0,0,24,29,4 ème
COTES D'ARMOR,GUINGAMP,0220098M,162,160,0,2,75,87,4 ème
COTES D'ARMOR,LANNION,0220082V,129,114,15,0,58,71,4 ème
COTES D'ARMOR,LANVOLLON,0220144M,61,61,0,0,36,25,4 ème
COTES D'ARMOR,LOUDEAC,0221509W,151,126,23,2,66,85,4 ème
COTES D'ARMOR,LOUDEAC,0221747E,78,76,0,2,33,45,4 ème
COTES D'ARMOR,MATIGNON,0220029M,45,45,0,0,22,23,4 ème
COTES D'ARMOR,PLEMET,0221037H,46,43,0,3,22,24,4 ème
COTES D'ARMOR,PLESTIN-LES-GREVES,0221541F,67,67,0,0,34,33,4 ème
COTES D'ARMOR,PLOEUC-L'HERMITAGE,0220157B,51,51,0,0,25,26,4 ème
COTES D'ARMOR,PLOEUC-L'HERMITAGE,0221568K,58,57,0,1,42,16,4 ème
COTES D'ARMOR,PLOUARET,0220045E,54,54,0,0,28,26,4 ème
COTES D'ARMOR,PONTRIEUX,0221542G,59,59,0,0,30,29,4 ème
COTES D'ARMOR,SAINT-BRIEUC,0220117H,0,0,0,0,0,0,4 ème
COTES D'ARMOR,SAINT-BRIEUC,0221999D,53,51,0,2,32,21,4 ème
FINISTERE,BREST,0290243G,86,84,0,2,37,49,4 ème
FINISTERE,BREST,0291089B,108,92,16,0,66,42,4 ème
FINISTERE,BREST,0291103S,22,22,0,0,13,9,4 ème
FINISTERE,BREST,0291595B,141,141,0,0,66,75,4 ème
FINISTERE,BREST,0291866W,54,54,0,0,30,24,4 ème
FINISTERE,BRIEC,0290019N,104,104,0,0,50,54,4 ème
FINISTERE,CHATEAULIN,0291590W,134,133,0,1,76,58,4 ème
FINISTERE,CHATEAULIN,0291872C,94,88,0,6,40,54,4 ème
FINISTERE,CHATEAUNEUF-DU-FAOU,0292006Y,93,87,0,6,45,48,4 ème
FINISTERE,GUILERS,0291716H,101,101,0,0,55,46,4 ème
FINISTERE,GUILVINEC,0291631R,57,57,0,0,38,19,4 ème
FINISTERE,MORLAIX,0290105G,0,0,0,0,0,0,4 ème
FINISTERE,MORLAIX,0290163V,81,81,0,0,30,51,4 ème
FINISTERE,PLEYBEN,0290288F,15,15,0,0,5,10,4 ème
FINISTERE,PLOUGASTEL-DAOULAS,0290297R,86,86,0,0,51,35,4 ème
FINISTERE,PONT-L'ABBE,0290064M,217,205,12,0,116,101,4 ème
FINISTERE,PONT-L'ABBE,0291877H,121,119,0,2,52,69,4 ème
FINISTERE,QUIMPER,0291878J,186,184,0,2,93,93,4 ème
FINISTERE,QUIMPER,0291880L,217,199,14,4,107,110,4 ème
FINISTERE,QUIMPERLE,0290078C,0,0,0,0,0,0,4 ème
FINISTERE,QUIMPERLE,0290307B,21,21,0,0,8,13,4 ème
FINISTERE,QUIMPERLE,0291635V,160,143,15,2,85,75,4 ème
FINISTERE,QUIMPERLE,0291881M,115,115,0,0,59,56,4 ème
FINISTERE,SAINT-RENAN,0290314J,243,238,0,5,115,128,4 ème
FINISTERE,SAINT-THEGONNEC LOC-EGUINER,0290316L,39,39,0,0,21,18,4 ème
ILLE-ET-VILAINE,FOUGERES,0350762N,155,151,0,4,89,66,4 ème
ILLE-ET-VILAINE,REDON,0350732F,16,0,16,0,5,11,4 ème
ILLE-ET-VILAINE,REDON,0350969N,118,101,17,0,60,58,4 ème
ILLE-ET-VILAINE,RENNES,0350033W,133,133,0,0,66,67,4 ème
ILLE-ET-VILAINE,RENNES,0350747X,15,0,15,0,3,12,4 ème
ILLE-ET-VILAINE,RENNES,0350895H,130,107,15,8,72,58,4 ème
ILLE-ET-VILAINE,RENNES,0351796M,143,143,0,0,73,70,4 ème
ILLE-ET-VILAINE,RENNES,0351851X,150,135,15,0,69,81,4 ème
ILLE-ET-VILAINE,RENNES,0352070K,257,256,0,1,129,128,4 ème
ILLE-ET-VILAINE,SAINT-GEORGES-DE-REINTEMBAULT,0350041E,41,41,0,0,22,19,4 ème
ILLE-ET-VILAINE,SAINT-GREGOIRE,0350780H,207,207,0,0,96,111,4 ème
ILLE-ET-VILAINE,SAINT-MALO,0350773A,130,127,0,3,63,67,4 ème
ILLE-ET-VILAINE,SAINT-MALO,0350896J,97,95,0,2,43,54,4 ème
ILLE-ET-VILAINE,SAINT-MEEN-LE-GRAND,0350887Z,56,56,0,0,28,28,4 ème
ILLE-ET-VILAINE,SAINT-MEEN-LE-GRAND,0351850W,102,102,0,0,42,60,4 ème
ILLE-ET-VILAINE,TINTENIAC,0350051R,136,132,0,4,57,79,4 ème
ILLE-ET-VILAINE,VAL-COUESNON,0350052S,38,38,0,0,20,18,4 ème
ILLE-ET-VILAINE,VITRE,0350892E,108,103,0,5,50,58,4 ème
ILLE-ET-VILAINE,VITRE,0351785A,259,259,0,0,149,110,4 ème
MORBIHAN,ARRADON,0560122D,59,59,0,0,22,37,4 ème
MORBIHAN,GRAND-CHAMP,0560132P,85,85,0,0,44,41,4 ème
MORBIHAN,GUEMENE-SUR-SCORFF,0561358X,61,61,0,0,28,33,4 ème
MORBIHAN,HENNEBONT,0560214D,113,93,16,4,50,63,4 ème
MORBIHAN,LANESTER,0560215E,103,86,17,0,50,53,4 ème
MORBIHAN,LA ROCHE-BERNARD,0560169E,146,146,0,0,79,67,4 ème
MORBIHAN,LE FAOUET,0560158T,32,32,0,0,19,13,4 ème
MORBIHAN,LOCMINE,0561377T,137,137,0,0,71,66,4 ème
MORBIHAN,LORIENT,0560181T,0,0,0,0,0,0,4 ème
MORBIHAN,MALESTROIT,0560150J,142,140,0,2,82,60,4 ème
MORBIHAN,PLOERMEL,0560105K,0,0,0,0,0,0,4 ème
MORBIHAN,QUESTEMBERT,0560166B,133,129,0,4,72,61,4 ème
MORBIHAN,ROHAN,0560171G,67,67,0,0,41,26,4 ème
MORBIHAN,SAINT-JEAN-BREVELAY,0560063P,39,39,0,0,24,15,4 ème
MORBIHAN,SAINT-JEAN-BREVELAY,0560172H,103,103,0,0,56,47,4 ème
MORBIHAN,THEIX-NOYALO,0561940E,107,107,0,0,52,55,4 ème
MORBIHAN,VANNES,0560223N,170,148,22,0,81,89,4 ème
MORBIHAN,VANNES,0561544Z,213,213,0,0,94,119,4 ème
CHER,BOURGES,0180568V,28,22,0,6,17,11,4 ème
CHER,BOURGES,0180571Y,15,15,0,0,2,13,4 ème
CHER,BOURGES,0180721L,144,144,0,0,71,73,4 ème
CHER,HENRICHEMONT,0180019Y,86,84,0,2,44,42,4 ème
CHER,LIGNIERES,0180020Z,39,39,0,0,21,18,4 ème
CHER,SAINT-DOULCHARD,0180643B,151,146,0,5,72,79,4 ème
CHER,VIERZON,0180037T,117,116,0,1,55,62,4 ème
EURE-ET-LOIR,CHATEAUDUN,0280679L,59,59,0,0,29,30,4 ème
EURE-ET-LOIR,CHATEAUDUN,0280957N,97,95,0,2,42,55,4 ème
EURE-ET-LOIR,JANVILLE-EN-BEAUCE,0280680M,79,79,0,0,49,30,4 ème
EURE-ET-LOIR,LA LOUPE,0280869T,112,112,0,0,51,61,4 ème
EURE-ET-LOIR,LUCE,0280803W,105,98,0,7,56,49,4 ème
EURE-ET-LOIR,MAINVILLIERS,0280034K,109,108,0,1,56,53,4 ème
EURE-ET-LOIR,NOGENT-LE-ROTROU,0280903E,101,75,21,5,42,59,4 ème
EURE-ET-LOIR,NOGENT-LE-ROTROU,0281021H,0,0,0,0,0,0,4 ème
INDRE,ARDENTES,0360573C,66,66,0,0,25,41,4 ème
INDRE,CHATEAUROUX,0360050J,16,0,16,0,6,10,4 ème
INDRE,CHATEAUROUX,0360690E,89,86,0,3,45,44,4 ème
INDRE,ISSOUDUN,0360544W,90,88,0,2,40,50,4 ème
INDRE,SAINT-BENOIT-DU-SAULT,0360033R,45,45,0,0,20,25,4 ème
INDRE,SAINTE-SEVERE-SUR-INDRE,0360037V,33,33,0,0,16,17,4 ème
INDRE,TOURNON-SAINT-MARTIN,0360038W,37,37,0,0,13,24,4 ème
INDRE-ET-LOIRE,AVOINE,0370994E,126,123,0,3,54,72,4 ème
INDRE-ET-LOIRE,BALLAN-MIRE,0371403Z,135,135,0,0,70,65,4 ème
INDRE-ET-LOIRE,CHINON,0371100V,0,0,0,0,0,0,4 ème
INDRE-ET-LOIRE,JOUE-LES-TOURS,0370740D,198,183,15,0,89,109,4 ème
INDRE-ET-LOIRE,JOUE-LES-TOURS,0370791J,55,54,0,1,20,35,4 ème
INDRE-ET-LOIRE,JOUE-LES-TOURS,0370888P,0,0,0,0,0,0,4 ème
INDRE-ET-LOIRE,MONTBAZON,0370793L,171,166,0,5,80,91,4 ème
INDRE-ET-LOIRE,MONTLOUIS-SUR-LOIRE,0370799T,181,178,0,3,71,110,4 ème
INDRE-ET-LOIRE,MONTS,0370993D,172,172,0,0,91,81,4 ème
INDRE-ET-LOIRE,RICHELIEU,0370739C,35,35,0,0,14,21,4 ème
INDRE-ET-LOIRE,SAVIGNE-SUR-LATHAN,0370034L,81,81,0,0,39,42,4 ème
INDRE-ET-LOIRE,TOURS,0370033K,161,128,28,5,73,88,4 ème
INDRE-ET-LOIRE,TOURS,0370039S,53,53,0,0,34,19,4 ème
INDRE-ET-LOIRE,TOURS,0370886M,133,129,0,4,60,73,4 ème
INDRE-ET-LOIRE,TOURS,0371327S,141,141,0,0,64,77,4 ème
LOIRET,BEAUGENCY,0450759F,0,0,0,0,0,0,4 ème
LOIRET,BRIARE,0450008P,92,80,11,1,50,42,4 ème
LOIRET,CHALETTE-SUR-LOING,0450840U,178,144,31,3,87,91,4 ème
LOIRET,CHALETTE-SUR-LOING,0451442Y,0,0,0,0,0,0,4 ème
LOIRET,FLEURY-LES-AUBRAIS,0451544J,151,151,0,0,78,73,4 ème
LOIRET,GIEN,0451331C,76,76,0,0,41,35,4 ème
LOIRET,INGRE,0451068S,222,219,0,3,107,115,4 ème
LOIRET,MEUNG-SUR-LOIRE,0451735S,54,54,0,0,24,30,4 ème
LOIRET,MONTARGIS,0450789N,92,89,0,3,44,48,4 ème
LOIRET,OLIVET,0450118J,114,114,0,0,59,55,4 ème
LOIRET,OLIVET,0451499K,118,114,0,4,67,51,4 ème
LOIRET,ORLEANS,0450758E,37,37,0,0,18,19,4 ème
LOIRET,ORLEANS,0451333E,116,116,0,0,51,65,4 ème
LOIRET,POILLY-LEZ-GIEN,0451286D,102,84,16,2,53,49,4 ème
LOIRET,SAINT-JEAN-DE-BRAYE,0451072W,190,171,16,3,97,93,4 ème
LOIRET,SAINT-JEAN-DE-LA-RUELLE,0450066C,0,0,0,0,0,0,4 ème
LOIRET,SAINT-JEAN-DE-LA-RUELLE,0450069F,114,107,0,7,63,51,4 ème
LOIR-ET-CHER,BEAUCE LA ROMAINE,0410016V,86,83,0,3,38,48,4 ème
LOIR-ET-CHER,BLOIS,0410832G,0,0,0,0,0,0,4 ème
LOIR-ET-CHER,MER,0410631N,125,122,0,3,62,63,4 ème
LOIR-ET-CHER,MONTRICHARD VAL DE CHER,0410632P,129,127,0,2,61,68,4 ème
LOIR-ET-CHER,MOREE,0410013S,76,75,0,1,36,40,4 ème
LOIR-ET-CHER,ROMORANTIN-LANTHENAY,0410684W,59,59,0,0,23,36,4 ème
LOIR-ET-CHER,SAINT-AMAND-LONGPRE,0410024D,62,60,0,2,26,36,4 ème
LOIR-ET-CHER,VEUZAIN-SUR-LOIRE,0410716F,143,141,0,2,60,83,4 ème
LOIR-ET-CHER,VINEUIL,0410715E,160,158,0,2,82,78,4 ème
CORSE-DU-SUD,PORTO-VECCHIO,6200040Z,176,176,0,0,89,87,4 ème
CORSE-DU-SUD,PROPRIANO,6200041A,59,58,0,1,28,31,4 ème
CORSE-DU-SUD,SANTA-MARIA-SICHE,6200045E,35,35,0,0,18,17,4 ème
CORSE-DU-SUD,SARTENE,6200055R,47,40,7,0,22,25,4 ème
HAUTE-CORSE,BASTIA,7200013B,170,151,16,3,66,104,4 ème
HAUTE-CORSE,LURI,7200027S,25,25,0,0,14,11,4 ème
HAUTE-CORSE,MOLTIFAO,7200028T,40,40,0,0,15,25,4 ème
HAUTE-CORSE,PRUNELLI-DI-FIUMORBO,7200086F,217,210,2,5,113,104,4 ème
MEURTHE-ET-MOSELLE,AUDUN-LE-ROMAN,0541470E,79,79,0,0,40,39,4 ème
MEURTHE-ET-MOSELLE,BLAINVILLE-SUR-L'EAU,0540005M,155,125,27,3,76,79,4 ème
MEURTHE-ET-MOSELLE,DOMBASLE-SUR-MEURTHE,0541325X,98,98,0,0,49,49,4 ème
MEURTHE-ET-MOSELLE,ESSEY-LES-NANCY,0541211Y,138,138,0,0,66,72,4 ème
MEURTHE-ET-MOSELLE,LAXOU,0540047H,58,54,0,4,28,30,4 ème
MEURTHE-ET-MOSELLE,LAXOU,0541469D,72,67,0,5,40,32,4 ème
MEURTHE-ET-MOSELLE,LONGWY,0541334G,86,82,0,4,41,45,4 ème
MEURTHE-ET-MOSELLE,LUNEVILLE,0541329B,140,106,31,3,80,60,4 ème
MEURTHE-ET-MOSELLE,LUNEVILLE,0542293Z,0,0,0,0,0,0,4 ème
MEURTHE-ET-MOSELLE,MONT-SAINT-MARTIN,0540088C,67,67,0,0,36,31,4 ème
MEURTHE-ET-MOSELLE,NANCY,0541339M,146,146,0,0,75,71,4 ème
MEURTHE-ET-MOSELLE,NANCY,0541568L,53,53,0,0,29,24,4 ème
MEURTHE-ET-MOSELLE,NANCY,0541778P,142,142,0,0,78,64,4 ème
MEURTHE-ET-MOSELLE,NANCY,0541994Z,66,66,0,0,29,37,4 ème
MEURTHE-ET-MOSELLE,POMPEY,0540085Z,0,0,0,0,0,0,4 ème
MEURTHE-ET-MOSELLE,PONT-SAINT-VINCENT,0540060X,0,0,0,0,0,0,4 ème
MEURTHE-ET-MOSELLE,PULNOY,0541956H,108,107,0,1,59,49,4 ème
MEURTHE-ET-MOSELLE,THIAUCOURT-REGNIEVILLE,0540064B,70,70,0,0,38,32,4 ème
MEURTHE-ET-MOSELLE,TOMBLAINE,0541569M,166,166,0,0,74,92,4 ème
MEURTHE-ET-MOSELLE,VAL DE BRIEY,0540008R,81,81,0,0,45,36,4 ème
MEUSE,BAR-LE-DUC,0550890U,86,81,0,5,47,39,4 ème
MEUSE,BOULIGNY,0550006H,47,47,0,0,26,21,4 ème
MEUSE,DAMVILLERS,0550009L,44,44,0,0,20,24,4 ème
MEUSE,ETAIN,0550011N,116,99,14,3,60,56,4 ème
MEUSE,FRESNES-EN-WOEVRE,0550012P,73,71,0,2,39,34,4 ème
MEUSE,GONDRECOURT-LE-CHATEAU,0550013R,29,29,0,0,11,18,4 ème
MEUSE,LIGNY-EN-BARROIS,0550014S,98,97,0,1,53,45,4 ème
MEUSE,VAUBECOURT,0550022A,42,42,0,0,24,18,4 ème
MEUSE,VERDUN,0550891V,0,0,0,0,0,0,4 ème
MOSELLE,ALGRANGE,0572169Y,58,58,0,0,28,30,4 ème
MOSELLE,ARS-SUR-MOSELLE,0572015F,124,120,0,4,69,55,4 ème
MOSELLE,BITCHE,0573361U,138,122,10,6,62,76,4 ème
MOSELLE,BOULAY-MOSELLE,0570010B,166,147,15,4,72,94,4 ème
MOSELLE,BOUZONVILLE,0570248K,0,0,0,0,0,0,4 ème
MOSELLE,COCHEREN,0572490X,90,87,0,3,44,46,4 ème
MOSELLE,CREUTZWALD,0572690P,156,132,9,15,68,88,4 ème
MOSELLE,FAULQUEMONT,0570026U,96,96,0,0,45,51,4 ème
MOSELLE,FORBACH,0572813Y,114,110,0,4,47,67,4 ème
MOSELLE,HOMBOURG-HAUT,0572491Y,68,68,0,0,38,30,4 ème
MOSELLE,L'HOPITAL,0572487U,73,73,0,0,39,34,4 ème
MOSELLE,MARANGE-SILVANGE,0572586B,90,90,0,0,48,42,4 ème
MOSELLE,METZ,0570055A,133,130,0,3,75,58,4 ème
MOSELLE,METZ,0570124A,0,0,0,0,0,0,4 ème
MOSELLE,METZ,0572640K,120,118,0,2,52,68,4 ème
MOSELLE,METZ,0572923T,100,100,0,0,54,46,4 ème
MOSELLE,MONTIGNY-LES-METZ,0572927X,240,240,0,0,121,119,4 ème
MOSELLE,MOUSSEY,0570074W,45,45,0,0,27,18,4 ème
MOSELLE,MOYEUVRE-GRANDE,0572017H,75,67,8,0,37,38,4 ème
MOSELLE,PHALSBOURG,0572929Z,89,89,0,0,48,41,4 ème
MOSELLE,ROHRBACH-LES-BITCHE,0572496D,130,127,0,3,52,78,4 ème
MOSELLE,ROMBAS,0570146Z,0,0,0,0,0,0,4 ème
MOSELLE,SAINT-AVOLD,0570223H,61,61,0,0,42,19,4 ème
MOSELLE,SAINTE-MARIE-AUX-CHENES,0570091P,166,166,0,0,81,85,4 ème
MOSELLE,SARREBOURG,0570095U,0,0,0,0,0,0,4 ème
MOSELLE,SARREGUEMINES,0570099Y,0,0,0,0,0,0,4 ème
MOSELLE,SIERCK-LES-BAINS,0572026T,130,130,0,0,75,55,4 ème
MOSELLE,THIONVILLE,0572355A,120,91,24,5,52,68,4 ème
MOSELLE,THIONVILLE,0572932C,301,301,0,0,158,143,4 ème
MOSELLE,VIGY,0572354Z,97,97,0,0,48,49,4 ème
MOSELLE,YUTZ,0570115R,194,188,0,6,99,95,4 ème
VOSGES,CHATENOIS,0880011J,41,41,0,0,22,19,4 ème
VOSGES,CONTREXEVILLE,0880013L,0,0,0,0,0,0,4 ème
VOSGES,CORCIEUX,0880014M,55,51,0,4,32,23,4 ème
VOSGES,CORNIMONT,0881397R,92,92,0,0,47,45,4 ème
VOSGES,EPINAL,0881530K,0,0,0,0,0,0,4 ème
VOSGES,GERARDMER,0881446U,97,97,0,0,51,46,4 ème
VOSGES,MIRECOURT,0880035K,130,117,0,13,60,70,4 ème
VOSGES,NEUFCHATEAU,0880041S,115,104,8,3,56,59,4 ème
VOSGES,NEUFCHATEAU,0880112U,18,18,0,0,9,9,4 ème
VOSGES,REMIREMONT,0880096B,90,82,0,8,43,47,4 ème
VOSGES,REMIREMONT,0880155R,101,99,0,2,51,50,4 ème
VOSGES,SAINT-DIE-DES-VOSGES,0880098D,73,73,0,0,36,37,4 ème
VOSGES,SAINT-DIE-DES-VOSGES,0881099S,126,122,0,4,62,64,4 ème
ARDENNES,ATTIGNY,0081100C,75,75,0,0,37,38,4 ème
ARDENNES,CHARLEVILLE-MEZIERES,0080894D,86,70,16,0,36,50,4 ème
ARDENNES,CHARLEVILLE-MEZIERES,0080954U,81,76,0,5,33,48,4 ème
ARDENNES,MONTHERME,0080827F,63,63,0,0,37,26,4 ème
ARDENNES,NOUVION-SUR-MEUSE,0080896F,88,86,0,2,40,48,4 ème
ARDENNES,RETHEL,0080039Z,0,0,0,0,0,0,4 ème
ARDENNES,REVIN,0080040A,0,0,0,0,0,0,4 ème
ARDENNES,SEDAN,0080046G,66,64,0,2,32,34,4 ème
ARDENNES,SEDAN,0080047H,0,0,0,0,0,0,4 ème
ARDENNES,SIGNY-LE-PETIT,0081105H,69,69,0,0,38,31,4 ème
ARDENNES,VILLERS-SEMEUSE,0081001V,79,76,0,3,46,33,4 ème
ARDENNES,VOUZIERS,0080089D,38,38,0,0,18,20,4 ème
AUBE,ARCIS-SUR-AUBE,0100665U,132,132,0,0,78,54,4 ème
AUBE,BAR-SUR-AUBE,0100003Z,0,0,0,0,0,0,4 ème
AUBE,CHAOURCE,0100008E,44,44,0,0,17,27,4 ème
AUBE,ERVY-LE-CHATEL,0100010G,56,56,0,0,29,27,4 ème
AUBE,LA CHAPELLE-SAINT-LUC,0100807Y,133,118,12,3,60,73,4 ème
AUBE,TROYES,0100078F,0,0,0,0,0,0,4 ème
AUBE,TROYES,0100962S,121,121,0,0,58,63,4 ème
AUBE,VENDEUVRE-SUR-BARSE,0100028B,70,70,0,0,37,33,4 ème
HAUTE-MARNE,BOURMONT-ENTRE-MEUSE-ET-MOUZON,0520004X,42,42,0,0,17,25,4 ème
HAUTE-MARNE,FAYL-BILLOT,0520017L,35,35,0,0,14,21,4 ème
HAUTE-MARNE,LE MONTSAUGEONNAIS,0520026W,54,54,0,0,32,22,4 ème
HAUTE-MARNE,NOGENT,0520025V,90,87,0,3,51,39,4 ème
HAUTE-MARNE,SAINT-DIZIER,0520029Z,0,0,0,0,0,0,4 ème
HAUTE-MARNE,SAINT-DIZIER,0520049W,103,80,19,4,50,53,4 ème
HAUTE-MARNE,WASSY,0520709N,20,0,20,0,6,14,4 ème
MARNE,AVIZE,0510002A,98,98,0,0,47,51,4 ème
MARNE,AY-CHAMPAGNE,0511432E,102,102,0,0,45,57,4 ème
MARNE,CHALONS-EN-CHAMPAGNE,0510007F,0,0,0,0,0,0,4 ème
MARNE,CORMONTREUIL,0511961E,140,133,0,7,62,78,4 ème
MARNE,EPERNAY,0510016R,115,114,0,1,62,53,4 ème
MARNE,EPERNAY,0511173Y,125,125,0,0,63,62,4 ème
MARNE,EPERNAY,0511189R,97,83,12,2,43,54,4 ème
MARNE,FRIGNICOURT,0511474A,101,97,0,4,48,53,4 ème
MARNE,MAREUIL-LE-PORT,0510028D,66,66,0,0,26,40,4 ème
MARNE,MOURMELON-LE-GRAND,0510029E,119,113,0,6,70,49,4 ème
MARNE,REIMS,0510037N,0,0,0,0,0,0,4 ème
MARNE,REIMS,0510044W,136,135,0,1,60,76,4 ème
MARNE,REIMS,0511085C,142,138,0,4,82,60,4 ème
MARNE,REIMS,0511108C,148,128,14,6,67,81,4 ème
MARNE,REIMS,0511139L,139,139,0,0,65,74,4 ème
MARNE,REIMS,0511531M,129,124,0,5,60,69,4 ème
MARNE,SAINTE-MENEHOULD,0511191T,128,116,8,4,62,66,4 ème
MARNE,VITRY-LE-FRANCOIS,0511476C,111,108,0,3,64,47,4 ème
BAS-RHIN,BARR,0672133E,116,116,0,0,57,59,4 ème
BAS-RHIN,BRUMATH,0670009W,179,175,0,4,83,96,4 ème
BAS-RHIN,DETTWILLER,0672197Z,62,62,0,0,28,34,4 ème
BAS-RHIN,ECKBOLSHEIM,0670016D,109,109,0,0,55,54,4 ème
BAS-RHIN,LINGOLSHEIM,0672765S,185,177,0,8,87,98,4 ème
BAS-RHIN,MARCKOLSHEIM,0671600A,131,125,0,6,72,59,4 ème
BAS-RHIN,MUNDOLSHEIM,0672013Z,140,119,15,6,73,67,4 ème
BAS-RHIN,OBERNAI,0672078V,157,134,18,5,80,77,4 ème
BAS-RHIN,SARRE-UNION,0672614C,0,0,0,0,0,0,4 ème
BAS-RHIN,SAVERNE,0670058Z,0,0,0,0,0,0,4 ème
BAS-RHIN,SCHILTIGHEIM,0670065G,105,105,0,0,50,55,4 ème
BAS-RHIN,SELESTAT,0671696E,0,0,0,0,0,0,4 ème
BAS-RHIN,SELTZ,0671597X,127,117,9,1,64,63,4 ème
BAS-RHIN,STRASBOURG,0670105A,153,140,9,4,78,75,4 ème
BAS-RHIN,STRASBOURG,0671608J,298,298,0,0,163,135,4 ème
BAS-RHIN,STRASBOURG,0671691Z,183,160,20,3,86,97,4 ème
BAS-RHIN,STRASBOURG,0672303P,92,92,0,0,43,49,4 ème
BAS-RHIN,WISSEMBOURG,0670114K,0,0,0,0,0,0,4 ème
HAUT-RHIN,CERNAY,0681810Y,0,0,0,0,0,0,4 ème
HAUT-RHIN,COLMAR,0680132Z,120,115,0,5,69,51,4 ème
HAUT-RHIN,DANNEMARIE,0680012U,115,114,0,1,52,63,4 ème
HAUT-RHIN,FESSENHEIM,0681965S,101,101,0,0,49,52,4 ème
HAUT-RHIN,GUEBWILLER,0680016Y,0,0,0,0,0,0,4 ème
HAUT-RHIN,ILLFURTH,0681932F,114,114,0,0,50,64,4 ème
HAUT-RHIN,MASEVAUX-NIEDERBRUCK,0680027K,0,0,0,0,0,0,4 ème
HAUT-RHIN,MULHOUSE,0681661L,175,175,0,0,93,82,4 ème
HAUT-RHIN,OTTMARSHEIM,0680056S,91,91,0,0,52,39,4 ème
HAUT-RHIN,RIBEAUVILLE,0680137E,29,29,0,0,15,14,4 ème
HAUT-RHIN,SAINT-LOUIS,0680065B,92,89,0,3,46,46,4 ème
HAUT-RHIN,ZILLISHEIM,0681663N,184,184,0,0,99,85,4 ème
GUADELOUPE,BOUILLANTE,9710026B,78,61,15,2,40,38,4 ème
GUADELOUPE,CAPESTERRE-BELLE-EAU,9711231L,89,88,0,1,39,50,4 ème
GUADELOUPE,GOYAVE,9710644Y,68,66,0,2,42,26,4 ème
GUADELOUPE,LA DESIRADE,9710033J,11,11,0,0,3,8,4 ème
GUADELOUPE,LE MOULE,9710064T,87,87,0,0,43,44,4 ème
GUADELOUPE,LE MOULE,9711218X,164,162,0,2,90,74,4 ème
GUADELOUPE,LES ABYMES,9710405N,128,107,15,6,65,63,4 ème
GUADELOUPE,LES ABYMES,9710710V,222,199,16,7,115,107,4 ème
GUADELOUPE,PORT-LOUIS,9710584H,50,50,0,0,25,25,4 ème
GUADELOUPE,SAINT-MARTIN,9711087E,121,105,12,4,55,66,4 ème
GUYANE,APATOU,9730337D,134,118,11,5,62,72,4 ème
GUYANE,CAYENNE,9730130D,157,156,0,1,74,83,4 ème
GUYANE,KOUROU,9730306V,126,119,0,7,68,58,4 ème
GUYANE,MACOURIA,9730374U,232,198,26,8,108,124,4 ème
GUYANE,MARIPASOULA,9730193X,144,126,18,0,74,70,4 ème
GUYANE,MATOURY,9730182K,227,225,0,2,117,110,4 ème
GUYANE,MATOURY,9730218Z,206,195,0,11,98,108,4 ème
GUYANE,SAINT-LAURENT-DU-MARONI,9730248G,251,244,0,7,128,123,4 ème
AISNE,CHARLY-SUR-MARNE,0020011B,193,191,0,2,95,98,4 ème
AISNE,CHAUNY,0020015F,93,93,0,0,44,49,4 ème
AISNE,CONDE-EN-BRIE,0020016G,83,83,0,0,43,40,4 ème
AISNE,COUCY-LE-CHATEAU-AUFFRIQUE,0020018J,99,94,0,5,46,53,4 ème
AISNE,LA FERE,0021518P,99,98,0,1,52,47,4 ème
AISNE,LAON,0020090M,172,156,16,0,80,92,4 ème
AISNE,MONTCORNET,0021489H,44,44,0,0,23,21,4 ème
AISNE,ROZOY-SUR-SERRE,0020043L,45,45,0,0,22,23,4 ème
AISNE,SAINT-QUENTIN,0020054Y,78,77,0,1,39,39,4 ème
AISNE,SAINT-QUENTIN,0021823W,114,107,0,7,54,60,4 ème
AISNE,TERGNIER,0022113L,25,24,0,1,12,13,4 ème
AISNE,VAILLY-SUR-AISNE,0020065K,62,62,0,0,30,32,4 ème
AISNE,VERMAND,0020066L,104,104,0,0,52,52,4 ème
AISNE,VIC-SUR-AISNE,0021722L,107,107,0,0,53,54,4 ème
OISE,BEAUVAIS,0600003C,0,0,0,0,0,0,4 ème
OISE,BRETEUIL,0601406C,104,101,0,3,45,59,4 ème
OISE,COMPIEGNE,0600016S,0,0,0,0,0,0,4 ème
OISE,COMPIEGNE,0600018U,105,105,0,0,47,58,4 ème
OISE,COMPIEGNE,0601142R,258,254,0,4,115,143,4 ème
OISE,COMPIEGNE,0601501F,73,73,0,0,35,38,4 ème
OISE,CREPY-EN-VALOIS,0601833S,119,116,0,3,56,63,4 ème
OISE,FROISSY,0601176C,110,103,0,7,61,49,4 ème
OISE,GRANDVILLIERS,0601897L,0,0,0,0,0,0,4 ème
OISE,LACROIX-SAINT-OUEN,0601937E,152,149,0,3,59,93,4 ème
OISE,LIANCOURT,0600032J,144,140,0,4,69,75,4 ème
OISE,MARSEILLE-EN-BEAUVAISIS,0601365H,142,142,0,0,74,68,4 ème
OISE,MERU,0601157G,105,105,0,0,60,45,4 ème
OISE,MERU,0601470X,0,0,0,0,0,0,4 ème
OISE,MONTATAIRE,0601870G,0,0,0,0,0,0,4 ème
OISE,NEUILLY-EN-THELLE,0601847G,211,202,9,0,103,108,4 ème
OISE,NOGENT-SUR-OISE,0601846F,44,44,0,0,21,23,4 ème
OISE,PONT-SAINTE-MAXENCE,0601896K,0,0,0,0,0,0,4 ème
OISE,RESSONS-SUR-MATZ,0600045Y,135,135,0,0,63,72,4 ème
SOMME,AILLY-SUR-SOMME,0801325F,138,132,0,6,65,73,4 ème
SOMME,AMIENS,0801210F,107,105,0,2,48,59,4 ème
SOMME,AMIENS,0801264P,108,86,15,7,59,49,4 ème
SOMME,AMIENS,0801437C,188,184,0,4,95,93,4 ème
SOMME,AMIENS,0801616X,84,64,15,5,30,54,4 ème
SOMME,BERNAVILLE,0800022P,74,70,0,4,40,34,4 ème
SOMME,DOMART-EN-PONTHIEU,0801485E,96,82,11,3,47,49,4 ème
SOMME,DOULLENS,0801213J,44,44,0,0,25,19,4 ème
SOMME,FEUQUIERES-EN-VIMEU,0801371F,113,94,13,6,47,66,4 ème
SOMME,FRIVILLE-ESCARBOTIN,0801864S,0,0,0,0,0,0,4 ème
SOMME,LONGUEAU,0800038G,110,109,0,1,54,56,4 ème
SOMME,MONTDIDIER,0800041K,112,92,16,4,58,54,4 ème
SOMME,MOREUIL,0801439E,107,105,0,2,56,51,4 ème
SOMME,PERONNE,0801537L,167,143,15,9,78,89,4 ème
SOMME,RIVERY,0801373H,156,139,12,5,80,76,4 ème
SOMME,ROYE,0801227Z,94,94,0,0,45,49,4 ème
SOMME,RUE,0801228A,43,41,0,2,21,22,4 ème
SOMME,SAINT-VALERY-SUR-SOMME,0801490K,82,77,0,5,47,35,4 ème
SOMME,VILLERS-BRETONNEUX,0800057C,100,96,0,4,44,56,4 ème
NORD,BAILLEUL,0592930P,172,172,0,0,92,80,4 ème
NORD,BOUCHAIN,0593672W,202,189,13,0,104,98,4 ème
NORD,BOURBOURG,0594640Y,103,88,15,0,50,53,4 ème
NORD,BRAY-DUNES,0590030M,100,91,5,4,55,45,4 ème
NORD,CAMBRAI,0592611T,0,0,0,0,0,0,4 ème
NORD,CAMBRAI,0595174D,150,150,0,0,63,87,4 ème
NORD,CASSEL,0594872A,115,110,0,5,56,59,4 ème
NORD,COMINES,0593244F,96,84,9,3,45,51,4 ème
NORD,COUSOLRE,0590055P,45,45,0,0,20,25,4 ème
NORD,CROCHTE,0595595L,82,68,14,0,40,42,4 ème
NORD,DENAIN,0590062X,153,135,12,6,69,84,4 ème
NORD,DENAIN,0594299C,94,94,0,0,45,49,4 ème
NORD,DENAIN,0594300D,108,91,14,3,52,56,4 ème
NORD,DOUAI,0592733A,107,88,16,3,48,59,4 ème
NORD,DOUAI,0593071T,0,0,0,0,0,0,4 ème
NORD,DUNKERQUE,0590179Z,99,95,0,4,44,55,4 ème
NORD,DUNKERQUE,0592713D,109,109,0,0,52,57,4 ème
NORD,DUNKERQUE,0595389M,162,162,0,0,92,70,4 ème
NORD,DUNKERQUE,0595918M,0,0,0,0,0,0,4 ème
NORD,ESCAUDAIN,0592751V,126,126,0,0,59,67,4 ème
NORD,FEIGNIES,0594168K,72,72,0,0,46,26,4 ème
NORD,GONDECOURT,0595166V,128,128,0,0,67,61,4 ème
NORD,GRANDE-SYNTHE,0590088A,98,98,0,0,52,46,4 ème
NORD,GRAVELINES,0590090C,92,90,0,2,61,31,4 ème
NORD,HAUBOURDIN,0596059R,159,142,16,1,78,81,4 ème
NORD,HAZEBROUCK,0590102R,0,0,0,0,0,0,4 ème
NORD,HOUPLINES,0594638W,131,120,6,5,66,65,4 ème
NORD,LAMBERSART,0593226L,141,137,0,4,64,77,4 ème
NORD,LAMBERSART,0595393S,156,153,0,3,75,81,4 ème
NORD,LILLE,0592890W,101,101,0,0,56,45,4 ème
NORD,LILLE,0593168Y,175,175,0,0,99,76,4 ème
NORD,LILLE,0595286A,204,204,0,0,88,116,4 ème
NORD,LILLE,0595394T,69,69,0,0,39,30,4 ème
NORD,LILLE,0595397W,167,167,0,0,79,88,4 ème
NORD,LILLE,0595483P,12,0,12,0,4,8,4 ème
NORD,LILLE,0596833G,124,120,0,4,56,68,4 ème
NORD,LOUVROIL,0593034C,0,0,0,0,0,0,4 ème
NORD,MARCQ-EN-BAROEUL,0595993U,78,78,0,0,40,38,4 ème
NORD,MARLY,0593674Y,161,146,11,4,76,85,4 ème
NORD,MARQUETTE-LEZ-LILLE,0593474F,153,153,0,0,69,84,4 ème
NORD,MAUBEUGE,0590150T,124,120,0,4,70,54,4 ème
NORD,MERVILLE,0594294X,95,85,7,3,39,56,4 ème
NORD,NEUVILLE-EN-FERRAIN,0594537L,90,85,0,5,42,48,4 ème
NORD,NIEPPE,0594505B,69,69,0,0,33,36,4 ème
NORD,PERENCHIES,0592901H,56,56,0,0,27,29,4 ème
NORD,PETITE-FORET,0590007M,135,135,0,0,67,68,4 ème
NORD,PROVIN,0595758N,128,124,0,4,64,64,4 ème
NORD,RONCHIN,0593237Y,107,94,9,4,55,52,4 ème
NORD,ROUBAIX,0590183D,87,84,0,3,42,45,4 ème
NORD,ROUBAIX,0592973L,0,0,0,0,0,0,4 ème
NORD,ROUBAIX,0594389A,119,104,15,0,58,61,4 ème
NORD,ROUBAIX,0595168X,121,121,0,0,69,52,4 ème
NORD,SAINS-DU-NORD,0594538M,49,48,0,1,21,28,4 ème
NORD,SECLIN,0593145Y,175,171,0,4,85,90,4 ème
NORD,SOLESMES,0595401A,137,137,0,0,64,73,4 ème
NORD,SOMAIN,0590248Z,139,136,0,3,63,76,4 ème
NORD,SOMAIN,0594405T,162,143,16,3,74,88,4 ème
NORD,STEENVOORDE,0593147A,44,44,0,0,19,25,4 ème
NORD,STEENVOORDE,0593992U,123,123,0,0,52,71,4 ème
NORD,TOURCOING,0594394F,128,116,9,3,67,61,4 ème
NORD,VALENCIENNES,0590270Y,0,0,0,0,0,0,4 ème
NORD,VILLERS-OUTREAUX,0593157L,50,50,0,0,31,19,4 ème
NORD,WALLERS,0593678C,106,106,0,0,48,58,4 ème
NORD,WASQUEHAL,0593241C,110,110,0,0,60,50,4 ème
NORD,WATTEN,0594650J,138,138,0,0,66,72,4 ème
NORD,WATTIGNIES,0594524X,84,64,16,4,40,44,4 ème
PAS-DE-CALAIS,ANNEZIN,0622797D,152,152,0,0,71,81,4 ème
PAS-DE-CALAIS,ARRAS,0622083C,149,149,0,0,67,82,4 ème
PAS-DE-CALAIS,ARRAS,0622864B,105,105,0,0,53,52,4 ème
PAS-DE-CALAIS,AUCHEL,0620021L,104,84,17,3,51,53,4 ème
PAS-DE-CALAIS,BAPAUME,0620030W,0,0,0,0,0,0,4 ème
PAS-DE-CALAIS,BAPAUME,0620031X,149,146,0,3,64,85,4 ème
PAS-DE-CALAIS,BAPAUME,0622104A,84,84,0,0,41,43,4 ème
PAS-DE-CALAIS,BARLIN,0622268D,147,131,16,0,79,68,4 ème
PAS-DE-CALAIS,BEAURAINVILLE,0622435K,101,101,0,0,54,47,4 ème
PAS-DE-CALAIS,BERCK,0620036C,166,151,12,3,83,83,4 ème
PAS-DE-CALAIS,BETHUNE,0622425Z,153,149,0,4,77,76,4 ème
PAS-DE-CALAIS,BETHUNE,0623569T,168,165,0,3,86,82,4 ème
PAS-DE-CALAIS,BIACHE-SAINT-VAAST,0620047P,142,142,0,0,67,75,4 ème
PAS-DE-CALAIS,BOULOGNE-SUR-MER,0620051U,112,92,17,3,60,52,4 ème
PAS-DE-CALAIS,BOULOGNE-SUR-MER,0620055Y,69,55,14,0,37,32,4 ème
PAS-DE-CALAIS,BOURLON,0622132F,52,52,0,0,26,26,4 ème
PAS-DE-CALAIS,BRUAY-LA-BUISSIERE,0622428C,140,120,16,4,62,78,4 ème
PAS-DE-CALAIS,BULLY-LES-MINES,0620197C,141,138,0,3,64,77,4 ème
PAS-DE-CALAIS,CALAIS,0623570U,135,135,0,0,71,64,4 ème
PAS-DE-CALAIS,COURRIERES,0622264Z,115,101,11,3,56,59,4 ème
PAS-DE-CALAIS,DAINVILLE,0620014D,175,156,15,4,94,81,4 ème
PAS-DE-CALAIS,DOURGES,0623322Z,147,147,0,0,78,69,4 ème
PAS-DE-CALAIS,ETAPLES,0622572J,134,118,16,0,70,64,4 ème
PAS-DE-CALAIS,HENIN-BEAUMONT,0622581U,112,112,0,0,49,63,4 ème
PAS-DE-CALAIS,HOUDAIN,0622871J,168,147,18,3,89,79,4 ème
PAS-DE-CALAIS,LEFOREST,0622085E,151,151,0,0,78,73,4 ème
PAS-DE-CALAIS,LIEVIN,0620119T,170,153,17,0,81,89,4 ème
PAS-DE-CALAIS,LILLERS,0622799F,115,102,9,4,65,50,4 ème
PAS-DE-CALAIS,LONGUENESSE,0622575M,98,96,0,2,36,62,4 ème
PAS-DE-CALAIS,MARQUION,0620130E,152,133,15,4,76,76,4 ème
PAS-DE-CALAIS,NOEUX-LES-MINES,0622269E,154,131,18,5,73,81,4 ème
PAS-DE-CALAIS,OIGNIES,0623018U,95,79,16,0,51,44,4 ème
PAS-DE-CALAIS,SAINT-ETIENNE-AU-MONT,0623115Z,126,106,16,4,63,63,4 ème
PAS-DE-CALAIS,SAINT-MARTIN-BOULOGNE,0622434J,128,124,0,4,63,65,4 ème
PAS-DE-CALAIS,SAINT-OMER,0623574Y,69,69,0,0,35,34,4 ème
PAS-DE-CALAIS,SAINT-POL-SUR-TERNOISE,0620167V,0,0,0,0,0,0,4 ème
PAS-DE-CALAIS,SALLAUMINES,0620170Y,124,105,19,0,57,67,4 ème
PAS-DE-CALAIS,VENDIN-LE-VIEIL,0622792Y,162,159,0,3,74,88,4 ème
SEINE-ET-MARNE,BAILLY-ROMAINVILLIERS,0772548B,122,122,0,0,70,52,4 ème
SEINE-ET-MARNE,BRIE-COMTE-ROBERT,0771225N,56,56,0,0,28,28,4 ème
SEINE-ET-MARNE,BROU-SUR-CHANTEREINE,0770005M,66,62,0,4,32,34,4 ème
SEINE-ET-MARNE,CHAMPS-SUR-MARNE,0772090D,107,89,15,3,50,57,4 ème
SEINE-ET-MARNE,CHELLES,0772923J,0,0,0,0,0,0,4 ème
SEINE-ET-MARNE,CLAYE-SOUILLY,0770014X,131,131,0,0,55,76,4 ème
SEINE-ET-MARNE,CLAYE-SOUILLY,0771911J,151,150,0,1,71,80,4 ème
SEINE-ET-MARNE,CLAYE-SOUILLY,0771995A,0,0,0,0,0,0,4 ème
SEINE-ET-MARNE,COMBS-LA-VILLE,0771997C,0,0,0,0,0,0,4 ème
SEINE-ET-MARNE,CONGIS-SUR-THEROUANNE,0771658J,0,0,0,0,0,0,4 ème
SEINE-ET-MARNE,COULOMMIERS,0771760V,139,135,0,4,60,79,4 ème
SEINE-ET-MARNE,DAMMARIE-LES-LYS,0771027Y,0,0,0,0,0,0,4 ème
SEINE-ET-MARNE,DAMMARIE-LES-LYS,0771476L,137,137,0,0,78,59,4 ème
SEINE-ET-MARNE,DAMMARTIN-EN-GOELE,0772190M,184,181,0,3,84,100,4 ème
SEINE-ET-MARNE,DONNEMARIE-DONTILLY,0770020D,117,115,0,2,56,61,4 ème
SEINE-ET-MARNE,FONTAINEBLEAU,0770928R,238,238,0,0,127,111,4 ème
SEINE-ET-MARNE,FONTENAY-TRESIGNY,0772227C,123,123,0,0,51,72,4 ème
SEINE-ET-MARNE,LAGNY-SUR-MARNE,0770027L,144,140,0,4,68,76,4 ème
SEINE-ET-MARNE,LIZY-SUR-OURCQ,0771362M,112,112,0,0,50,62,4 ème
SEINE-ET-MARNE,MEAUX,0771172F,125,90,31,4,45,80,4 ème
SEINE-ET-MARNE,MEAUX,0771921V,331,331,0,0,175,156,4 ème
SEINE-ET-MARNE,MELUN,0770033T,102,102,0,0,48,54,4 ème
SEINE-ET-MARNE,MOISSY-CRAMAYEL,0771618R,146,146,0,0,72,74,4 ème
SEINE-ET-MARNE,MONTEVRAIN,0772819W,145,145,0,0,68,77,4 ème
SEINE-ET-MARNE,NANDY,0772126T,119,110,0,9,58,61,4 ème
SEINE-ET-MARNE,NOISIEL,0771841H,116,114,0,2,58,58,4 ème
SEINE-ET-MARNE,OZOIR-LA-FERRIERE,0771217E,243,243,0,0,123,120,4 ème
SEINE-ET-MARNE,PONTAULT-COMBAULT,0771175J,217,214,0,3,112,105,4 ème
SEINE-ET-MARNE,REBAIS,0771770F,136,130,0,6,61,75,4 ème
SEINE-ET-MARNE,ROZAY-EN-BRIE,0771514C,151,151,0,0,80,71,4 ème
SEINE-ET-MARNE,SAINT-PIERRE-LES-NEMOURS,0771218F,84,84,0,0,46,38,4 ème
SEINE-ET-MARNE,SOUPPES-SUR-LOING,0770048J,78,78,0,0,36,42,4 ème
SEINE-ET-MARNE,TORCY,0771991W,107,105,0,2,46,61,4 ème
SEINE-ET-MARNE,TOURNAN-EN-BRIE,0772342C,0,0,0,0,0,0,4 ème
SEINE-ET-MARNE,VARENNES-SUR-SEINE,0770945J,0,0,0,0,0,0,4 ème
SEINE-ET-MARNE,VERT-SAINT-DENIS,0771365R,218,213,0,5,109,109,4 ème
SEINE-ET-MARNE,VILLENEUVE-LE-COMTE,0772650M,11,11,0,0,5,6,4 ème
SEINE-ET-MARNE,VILLEPARISIS,0772868Z,113,113,0,0,53,60,4 ème
SEINE-SAINT-DENIS,AUBERVILLIERS,0931024H,0,0,0,0,0,0,4 ème
SEINE-SAINT-DENIS,AUBERVILLIERS,0931185H,167,167,0,0,82,85,4 ème
SEINE-SAINT-DENIS,AUBERVILLIERS,0931709C,110,110,0,0,56,54,4 ème
SEINE-SAINT-DENIS,AUBERVILLIERS,0932694Y,136,135,0,1,71,65,4 ème
SEINE-SAINT-DENIS,AUBERVILLIERS,0932726H,107,102,0,5,47,60,4 ème
SEINE-SAINT-DENIS,AULNAY-SOUS-BOIS,0930859D,215,215,0,0,104,111,4 ème
SEINE-SAINT-DENIS,AULNAY-SOUS-BOIS,0930891N,150,132,14,4,65,85,4 ème
SEINE-SAINT-DENIS,AULNAY-SOUS-BOIS,0931843Y,196,196,0,0,105,91,4 ème
SEINE-SAINT-DENIS,AULNAY-SOUS-BOIS,0932578X,156,156,0,0,73,83,4 ème
SEINE-SAINT-DENIS,BOBIGNY,0931196V,154,154,0,0,72,82,4 ème
SEINE-SAINT-DENIS,BONDY,0930906E,115,115,0,0,58,57,4 ème
SEINE-SAINT-DENIS,DRANCY,0931200Z,179,164,15,0,79,100,4 ème
SEINE-SAINT-DENIS,DUGNY,0931573E,0,0,0,0,0,0,4 ème
SEINE-SAINT-DENIS,EPINAY-SUR-SEINE,0930893R,206,187,16,3,114,92,4 ème
SEINE-SAINT-DENIS,LA COURNEUVE,0931429Y,165,161,0,4,81,84,4 ème
SEINE-SAINT-DENIS,LE BLANC-MESNIL,0930611J,137,137,0,0,62,75,4 ème
SEINE-SAINT-DENIS,LE BLANC-MESNIL,0930831Y,0,0,0,0,0,0,4 ème
SEINE-SAINT-DENIS,LE BLANC-MESNIL,0930884F,179,179,0,0,90,89,4 ème
SEINE-SAINT-DENIS,L'ILE-SAINT-DENIS,0931765N,79,79,0,0,40,39,4 ème
SEINE-SAINT-DENIS,LIVRY-GARGAN,0930620U,176,161,15,0,86,90,4 ème
SEINE-SAINT-DENIS,MONTFERMEIL,0931707A,182,166,16,0,85,97,4 ème
SEINE-SAINT-DENIS,MONTREUIL,0931151W,150,134,16,0,76,74,4 ème
SEINE-SAINT-DENIS,MONTREUIL,0931448U,135,134,0,1,65,70,4 ème
SEINE-SAINT-DENIS,MONTREUIL,0931712F,117,117,0,0,56,61,4 ème
SEINE-SAINT-DENIS,MONTREUIL,0932696A,100,99,0,1,39,61,4 ème
SEINE-SAINT-DENIS,NEUILLY-SUR-MARNE,0931485J,139,136,0,3,69,70,4 ème
SEINE-SAINT-DENIS,NOISY-LE-GRAND,0931214P,175,159,16,0,87,88,4 ème
SEINE-SAINT-DENIS,NOISY-LE-SEC,0932725G,165,165,0,0,79,86,4 ème
SEINE-SAINT-DENIS,ROMAINVILLE,0931381W,177,161,16,0,90,87,4 ème
SEINE-SAINT-DENIS,ROSNY-SOUS-BOIS,0930586G,139,138,0,1,67,72,4 ème
SEINE-SAINT-DENIS,SAINT-DENIS,0931490P,118,118,0,0,54,64,4 ème
SEINE-SAINT-DENIS,SAINT-OUEN,0931144N,81,80,0,1,39,42,4 ème
SEINE-SAINT-DENIS,SEVRAN,0930897V,148,145,0,3,80,68,4 ème
SEINE-SAINT-DENIS,STAINS,0930920V,125,125,0,0,61,64,4 ème
SEINE-SAINT-DENIS,STAINS,0931147S,134,132,0,2,72,62,4 ème
SEINE-SAINT-DENIS,TREMBLAY-EN-FRANCE,0931497X,154,143,7,4,65,89,4 ème
SEINE-SAINT-DENIS,VILLEMOMBLE,0930043S,148,148,0,0,75,73,4 ème
SEINE-SAINT-DENIS,VILLEMOMBLE,0931846B,233,233,0,0,126,107,4 ème
SEINE-SAINT-DENIS,VILLEPINTE,0932260B,0,0,0,0,0,0,4 ème
SEINE-SAINT-DENIS,VILLETANEUSE,0931206F,143,139,0,4,72,71,4 ème
VAL-DE-MARNE,ABLON-SUR-SEINE,0941709X,99,99,0,0,47,52,4 ème
VAL-DE-MARNE,ALFORTVILLE,0941020Y,105,98,0,7,47,58,4 ème
VAL-DE-MARNE,BRY-SUR-MARNE,0940887D,104,104,0,0,41,63,4 ème
VAL-DE-MARNE,BRY-SUR-MARNE,0941014S,191,191,0,0,107,84,4 ème
VAL-DE-MARNE,CACHAN,0940806R,82,82,0,0,40,42,4 ème
VAL-DE-MARNE,CHAMPIGNY-SUR-MARNE,0940786U,154,154,0,0,88,66,4 ème
VAL-DE-MARNE,CHOISY-LE-ROI,0941040V,116,116,0,0,61,55,4 ème
VAL-DE-MARNE,FONTENAY-SOUS-BOIS,0941298A,0,0,0,0,0,0,4 ème
VAL-DE-MARNE,FRESNES,0940094S,87,87,0,0,50,37,4 ème
VAL-DE-MARNE,FRESNES,0940582X,82,82,0,0,45,37,4 ème
VAL-DE-MARNE,IVRY-SUR-SEINE,0941972H,0,0,0,0,0,0,4 ème
VAL-DE-MARNE,L'HAY-LES-ROSES,0940551N,140,124,16,0,63,77,4 ème
VAL-DE-MARNE,MAISONS-ALFORT,0941023B,56,56,0,0,32,24,4 ème
VAL-DE-MARNE,MAISONS-ALFORT,0941712A,183,183,0,0,87,96,4 ème
VAL-DE-MARNE,NOGENT-SUR-MARNE,0940137N,0,0,0,0,0,0,4 ème
VAL-DE-MARNE,NOGENT-SUR-MARNE,0940810V,86,86,0,0,42,44,4 ème
VAL-DE-MARNE,NOGENT-SUR-MARNE,0941091A,141,136,0,5,77,64,4 ème
VAL-DE-MARNE,NOGENT-SUR-MARNE,0941713B,153,152,0,1,73,80,4 ème
VAL-DE-MARNE,SAINT-MAUR-DES-FOSSES,0941093C,204,204,0,0,95,109,4 ème
VAL-DE-MARNE,SAINT-MAUR-DES-FOSSES,0941220R,201,181,16,4,99,102,4 ème
VAL-DE-MARNE,SANTENY,0941782B,106,104,0,2,51,55,4 ème
VAL-DE-MARNE,THIAIS,0940853S,0,0,0,0,0,0,4 ème
VAL-DE-MARNE,THIAIS,0941233E,117,117,0,0,59,58,4 ème
VAL-DE-MARNE,VALENTON,0942482M,117,117,0,0,66,51,4 ème
VAL-DE-MARNE,VILLEJUIF,0941037S,135,135,0,0,60,75,4 ème
VAL-DE-MARNE,VINCENNES,0941598B,110,110,0,0,60,50,4 ème
PARIS,PARIS,0750584C,91,91,0,0,43,48,4 ème
PARIS,PARIS,0750609E,134,134,0,0,63,71,4 ème
PARIS,PARIS,0752189X,111,111,0,0,58,53,4 ème
PARIS,PARIS,0752542F,107,101,0,6,57,50,4 ème
PARIS,PARIS,0753936W,112,96,16,0,59,53,4 ème
PARIS,PARIS,0750553U,0,0,0,0,0,0,4 ème
PARIS,PARIS,0752694W,94,94,0,0,42,52,4 ème
PARIS,PARIS,0752906B,158,158,0,0,77,81,4 ème
PARIS,PARIS,0752799K,0,0,0,0,0,0,4 ème
PARIS,PARIS,0752901W,84,84,0,0,38,46,4 ème
PARIS,PARIS,0752935H,204,204,0,0,98,106,4 ème
PARIS,PARIS,0753256G,0,0,0,0,0,0,4 ème
PARIS,PARIS,0750588G,0,0,0,0,0,0,4 ème
PARIS,PARIS,0752547L,89,88,0,1,42,47,4 ème
PARIS,PARIS,0752550P,208,208,0,0,90,118,4 ème
PARIS,PARIS,0752926Y,144,144,0,0,58,86,4 ème
PARIS,PARIS,0752553T,219,219,0,0,110,109,4 ème
PARIS,PARIS,0752927Z,177,177,0,0,99,78,4 ème
PARIS,PARIS,0750546L,87,87,0,0,49,38,4 ème
PARIS,PARIS,0752252R,202,186,13,3,102,100,4 ème
PARIS,PARIS,0753206C,41,40,0,1,41,0,4 ème
PARIS,PARIS,0753381T,191,191,0,0,95,96,4 ème
PARIS,PARIS,0755433Y,103,88,13,2,54,49,4 ème
PARIS,PARIS,0752695X,114,114,0,0,63,51,4 ème
PARIS,PARIS,0753369E,105,105,0,0,85,20,4 ème
PARIS,PARIS,0755747P,89,86,0,3,40,49,4 ème
PARIS,PARIS,0751703U,77,76,0,1,39,38,4 ème
PARIS,PARIS,0750478M,111,98,13,0,54,57,4 ème
PARIS,PARIS,0750508V,0,0,0,0,0,0,4 ème
PARIS,PARIS,0750591K,133,133,0,0,65,68,4 ème
PARIS,PARIS,0750808W,0,0,0,0,0,0,4 ème
PARIS,PARIS,0750828T,0,0,0,0,0,0,4 ème
PARIS,PARIS,0752557X,80,80,0,0,46,34,4 ème
PARIS,PARIS,0752696Y,135,135,0,0,66,69,4 ème
PARIS,PARIS,0754007Y,126,126,0,0,65,61,4 ème
PARIS,PARIS,0754355B,106,94,8,4,51,55,4 ème
PARIS,PARIS,0751790N,150,147,0,3,74,76,4 ème
PARIS,PARIS,0752187V,83,82,0,1,41,42,4 ème
PARIS,PARIS,0752874S,169,169,0,0,86,83,4 ème
PARIS,PARIS,0754025T,7,7,0,0,2,5,4 ème
PARIS,PARIS,0752534X,95,90,0,5,47,48,4 ème
ESSONNE,ATHIS-MONS,0910025H,142,138,0,4,58,84,4 ème
ESSONNE,BRETIGNY-SUR-ORGE,0911490A,161,145,16,0,73,88,4 ème
ESSONNE,BRUNOY,0910009R,192,174,15,3,81,111,4 ème
ESSONNE,BURES-SUR-YVETTE,0910967G,120,120,0,0,52,68,4 ème
ESSONNE,CORBEIL-ESSONNES,0910829G,248,245,0,3,122,126,4 ème
ESSONNE,CORBEIL-ESSONNES,0911024U,144,138,0,6,74,70,4 ème
ESSONNE,DRAVEIL,0910016Y,180,180,0,0,93,87,4 ème
ESSONNE,EPINAY-SUR-ORGE,0910017Z,143,143,0,0,72,71,4 ème
ESSONNE,ETRECHY,0911447D,135,132,0,3,61,74,4 ème
ESSONNE,EVRY-COURCOURONNES,0911444A,115,113,0,2,51,64,4 ème
ESSONNE,EVRY-COURCOURONNES,0911865H,140,134,0,6,66,74,4 ème
ESSONNE,GIF-SUR-YVETTE,0911354C,191,185,0,6,85,106,4 ème
ESSONNE,JUVISY-SUR-ORGE,0911028Y,144,144,0,0,68,76,4 ème
ESSONNE,LA NORVILLE,0911152H,205,205,0,0,111,94,4 ème
ESSONNE,LARDY,0912276E,121,117,0,4,52,69,4 ème
ESSONNE,LA VILLE-DU-BOIS,0911751J,256,254,0,2,132,124,4 ème
ESSONNE,LIMOURS,0910028L,183,183,0,0,83,100,4 ème
ESSONNE,MARCOUSSIS,0911032C,114,110,0,4,60,54,4 ème
ESSONNE,MAROLLES-EN-HUREPOIX,0911572P,147,143,0,4,61,86,4 ème
ESSONNE,MONTGERON,0910817U,163,163,0,0,81,82,4 ème
ESSONNE,MONTLHERY,0911345T,239,235,0,4,114,125,4 ème
ESSONNE,MORSANG-SUR-ORGE,0911488Y,108,108,0,0,57,51,4 ème
ESSONNE,ORSAY,0911143Y,149,149,0,0,73,76,4 ème
ESSONNE,PALAISEAU,0911034E,148,146,0,2,72,76,4 ème
ESSONNE,SAINT-GERMAIN-LES-ARPAJON,0911899V,127,122,0,5,58,69,4 ème
ESSONNE,SAVIGNY-SUR-ORGE,0910716J,80,80,0,0,46,34,4 ème
ESSONNE,SAVIGNY-SUR-ORGE,0911252S,241,222,16,3,122,119,4 ème
ESSONNE,SAVIGNY-SUR-ORGE,0912142J,0,0,0,0,0,0,4 ème
ESSONNE,SOISY-SUR-SEINE,0912086Y,139,137,0,2,62,77,4 ème
ESSONNE,VIGNEUX-SUR-SEINE,0911146B,185,170,15,0,92,93,4 ème
ESSONNE,VILLABE,0912257J,149,145,0,4,78,71,4 ème
ESSONNE,VILLEBON-SUR-YVETTE,0911750H,127,127,0,0,65,62,4 ème
HAUTS-DE-SEINE,ASNIERES-SUR-SEINE,0921622N,170,170,0,0,76,94,4 ème
HAUTS-DE-SEINE,BAGNEUX,0921778H,96,96,0,0,49,47,4 ème
HAUTS-DE-SEINE,BOULOGNE-BILLANCOURT,0920905J,217,217,0,0,113,104,4 ème
HAUTS-DE-SEINE,BOULOGNE-BILLANCOURT,0922443F,0,0,0,0,0,0,4 ème
HAUTS-DE-SEINE,CHATENAY-MALABRY,0921181J,138,135,0,3,63,75,4 ème
HAUTS-DE-SEINE,CLAMART,0920068Z,208,208,0,0,94,114,4 ème
HAUTS-DE-SEINE,CLAMART,0920854D,143,143,0,0,74,69,4 ème
HAUTS-DE-SEINE,COLOMBES,0920592U,148,147,0,1,80,68,4 ème
HAUTS-DE-SEINE,COURBEVOIE,0921625S,0,0,0,0,0,0,4 ème
HAUTS-DE-SEINE,GARCHES,0920810F,9,0,9,0,6,3,4 ème
HAUTS-DE-SEINE,GARCHES,0920881H,177,175,0,2,88,89,4 ème
HAUTS-DE-SEINE,GENNEVILLIERS,0921541A,172,154,18,0,93,79,4 ème
HAUTS-DE-SEINE,ISSY-LES-MOULINEAUX,0920877D,111,107,0,4,56,55,4 ème
HAUTS-DE-SEINE,ISSY-LES-MOULINEAUX,0921396T,133,129,0,4,64,69,4 ème
HAUTS-DE-SEINE,ISSY-LES-MOULINEAUX,0922610M,118,118,0,0,47,71,4 ème
HAUTS-DE-SEINE,LA GARENNE-COLOMBES,0921162N,129,124,0,5,53,76,4 ème
HAUTS-DE-SEINE,LEVALLOIS-PERRET,0921007V,253,253,0,0,134,119,4 ème
HAUTS-DE-SEINE,LEVALLOIS-PERRET,0922751R,18,18,0,0,0,18,4 ème
HAUTS-DE-SEINE,MEUDON,0921554P,119,118,0,1,56,63,4 ème
HAUTS-DE-SEINE,MEUDON,0922340U,25,25,0,0,1,24,4 ème
HAUTS-DE-SEINE,MONTROUGE,0920855E,118,111,7,0,64,54,4 ème
HAUTS-DE-SEINE,NANTERRE,0921589C,110,110,0,0,54,56,4 ème
HAUTS-DE-SEINE,NEUILLY-SUR-SEINE,0921781L,144,139,0,5,69,75,4 ème
HAUTS-DE-SEINE,NEUILLY-SUR-SEINE,0921912D,123,123,0,0,123,0,4 ème
HAUTS-DE-SEINE,RUEIL-MALMAISON,0921915G,287,287,0,0,0,287,4 ème
HAUTS-DE-SEINE,SAINT-CLOUD,0920700L,131,128,0,3,71,60,4 ème
HAUTS-DE-SEINE,SAINT-CLOUD,0921020J,29,29,0,0,0,29,4 ème
HAUTS-DE-SEINE,SCEAUX,0921918K,151,151,0,0,86,65,4 ème
HAUTS-DE-SEINE,SEVRES,0921244C,251,251,0,0,129,122,4 ème
HAUTS-DE-SEINE,VANVES,0921240Y,116,116,0,0,54,62,4 ème
HAUTS-DE-SEINE,VANVES,0921783N,144,144,0,0,69,75,4 ème
VAL-D'OISE,ARGENTEUIL,0950884V,106,104,0,2,40,66,4 ème
VAL-D'OISE,ARGENTEUIL,0951094Y,164,161,0,3,81,83,4 ème
VAL-D'OISE,ARGENTEUIL,0951356H,149,148,0,1,72,77,4 ème
VAL-D'OISE,ARNOUVILLE,0951143B,169,164,0,5,77,92,4 ème
VAL-D'OISE,AUVERS-SUR-OISE,0951823R,142,142,0,0,69,73,4 ème
VAL-D'OISE,BEAUCHAMP,0952086B,140,140,0,0,66,74,4 ème
VAL-D'OISE,BEZONS,0950887Y,180,178,0,2,85,95,4 ème
VAL-D'OISE,BEZONS,0952173W,0,0,0,0,0,0,4 ème
VAL-D'OISE,CERGY,0951617S,117,113,0,4,60,57,4 ème
VAL-D'OISE,CERGY,0952282P,39,39,0,0,18,21,4 ème
VAL-D'OISE,COURDIMANCHE,0951724H,201,201,0,0,105,96,4 ème
VAL-D'OISE,DEUIL-LA-BARRE,0950682A,138,134,0,4,56,82,4 ème
VAL-D'OISE,DEUIL-LA-BARRE,0952140K,95,95,0,0,44,51,4 ème
VAL-D'OISE,ECOUEN,0950752B,116,116,0,0,58,58,4 ème
VAL-D'OISE,ENGHIEN-LES-BAINS,0951504U,254,254,0,0,129,125,4 ème
VAL-D'OISE,ERMONT,0950739M,149,133,16,0,73,76,4 ème
VAL-D'OISE,FRANCONVILLE,0950022H,125,124,0,1,69,56,4 ème
VAL-D'OISE,FRANCONVILLE,0951100E,182,160,17,5,95,87,4 ème
VAL-D'OISE,FRANCONVILLE,0952088D,111,110,0,1,63,48,4 ème
VAL-D'OISE,GARGES-LES-GONESSE,0950023J,179,163,12,4,96,83,4 ème
VAL-D'OISE,GARGES-LES-GONESSE,0950711G,152,151,0,1,84,68,4 ème
VAL-D'OISE,GARGES-LES-GONESSE,0951098C,150,131,14,5,77,73,4 ème
VAL-D'OISE,GARGES-LES-GONESSE,0951787B,0,0,0,0,0,0,4 ème
VAL-D'OISE,GONESSE,0951920W,105,103,0,2,55,50,4 ème
VAL-D'OISE,GOUSSAINVILLE,0951050A,146,140,0,6,75,71,4 ème
VAL-D'OISE,GOUSSAINVILLE,0952128X,134,133,0,1,65,69,4 ème
VAL-D'OISE,HERBLAY,0951696C,127,121,0,6,63,64,4 ème
VAL-D'OISE,HERBLAY,0952205F,113,113,0,0,58,55,4 ème
VAL-D'OISE,MARGENCY,0951505V,204,204,0,0,103,101,4 ème
VAL-D'OISE,MERIEL,0951991Y,138,136,0,2,74,64,4 ème
VAL-D'OISE,MONTIGNY-LES-CORMEILLES,0951154N,150,147,0,3,79,71,4 ème
VAL-D'OISE,MONTMAGNY,0951909J,112,111,0,1,56,56,4 ème
VAL-D'OISE,MONTMORENCY,0951799P,139,139,0,0,70,69,4 ème
VAL-D'OISE,PERSAN,0950934Z,196,179,16,1,96,100,4 ème
VAL-D'OISE,PISCOP,0951817J,52,52,0,0,23,29,4 ème
VAL-D'OISE,SAINT-OUEN-L'AUMONE,0951195H,179,161,16,2,88,91,4 ème
VAL-D'OISE,SANNOIS,0950722U,135,130,0,5,72,63,4 ème
VAL-D'OISE,SANNOIS,0952136F,37,37,0,0,0,37,4 ème
VAL-D'OISE,SARCELLES,0950045H,159,140,16,3,80,79,4 ème
VAL-D'OISE,SARCELLES,0950947N,0,0,0,0,0,0,4 ème
VAL-D'OISE,SARCELLES,0951682M,29,29,0,0,29,0,4 ème
VAL-D'OISE,SARCELLES,0951945Y,121,112,0,9,48,73,4 ème
VAL-D'OISE,VAUREAL,0951636M,112,112,0,0,58,54,4 ème
VAL-D'OISE,VILLIERS-LE-BEL,0951916S,79,79,0,0,36,43,4 ème
YVELINES,AUBERGENVILLE,0780506B,173,161,12,0,79,94,4 ème
YVELINES,BONNELLES,0781846H,88,88,0,0,42,46,4 ème
YVELINES,CHAMBOURCY,0781683F,135,135,0,0,63,72,4 ème
YVELINES,CROISSY-SUR-SEINE,0780847X,105,100,0,5,40,65,4 ème
YVELINES,FONTENAY-LE-FLEURY,0780185C,154,138,15,1,71,83,4 ème
YVELINES,GUYANCOURT,0780581H,124,122,0,2,60,64,4 ème
YVELINES,GUYANCOURT,0783378Y,103,102,0,1,56,47,4 ème
YVELINES,HOUILLES,0780269U,201,197,0,4,96,105,4 ème
YVELINES,HOUILLES,0783253M,174,174,0,0,72,102,4 ème
YVELINES,LA CELLE-SAINT-CLOUD,0780036R,145,141,0,4,80,65,4 ème
YVELINES,LE CHESNAY-ROCQUENCOURT,0781586A,272,272,0,0,152,120,4 ème
YVELINES,LES ESSARTS-LE-ROI,0780574A,203,200,0,3,106,97,4 ème
YVELINES,LES MUREAUX,0780572Y,148,132,16,0,74,74,4 ème
YVELINES,LES MUREAUX,0781914G,134,133,0,1,63,71,4 ème
YVELINES,LE VESINET,0781105C,156,156,0,0,81,75,4 ème
YVELINES,LIMAY,0782115A,151,136,12,3,76,75,4 ème
YVELINES,MANTES-LA-JOLIE,0781896M,92,92,0,0,44,48,4 ème
YVELINES,MANTES-LA-JOLIE,0783774D,141,125,16,0,56,85,4 ème
YVELINES,MARLY-LE-ROI,0780119F,240,240,0,0,118,122,4 ème
YVELINES,MAUREPAS,0780419G,179,163,16,0,87,92,4 ème
YVELINES,MEULAN-EN-YVELINES,0780571X,200,179,16,5,87,113,4 ème
YVELINES,MONTIGNY-LE-BRETONNEUX,0781263Z,118,118,0,0,58,60,4 ème
YVELINES,MONTIGNY-LE-BRETONNEUX,0783592F,30,30,0,0,15,15,4 ème
YVELINES,POISSY,0783358B,202,199,0,3,102,100,4 ème
YVELINES,RAMBOUILLET,0780846W,90,90,0,0,44,46,4 ème
YVELINES,RAMBOUILLET,0783338E,165,165,0,0,87,78,4 ème
YVELINES,ROSNY-SUR-SEINE,0781916J,142,137,0,5,72,70,4 ème
YVELINES,SAINT-GERMAIN-EN-LAYE,0781204K,232,232,0,0,105,127,4 ème
YVELINES,SAINT-GERMAIN-EN-LAYE,0781620M,226,224,0,2,120,106,4 ème
YVELINES,SARTROUVILLE,0780577D,103,103,0,0,50,53,4 ème
YVELINES,SARTROUVILLE,0780579F,116,111,0,5,63,53,4 ème
YVELINES,TRAPPES,0781618K,135,130,0,5,64,71,4 ème
YVELINES,VELIZY-VILLACOUBLAY,0780210E,160,159,0,1,84,76,4 ème
YVELINES,VERSAILLES,0781106D,169,169,0,0,82,87,4 ème
YVELINES,VERSAILLES,0781298M,81,79,0,2,41,40,4 ème
YVELINES,VILLEPREUX,0780260J,187,187,0,0,92,95,4 ème
YVELINES,VOISINS-LE-BRETONNEUX,0781789W,110,109,0,1,56,54,4 ème
LA REUNION,LA POSSESSION,9740084Y,170,167,0,3,90,80,4 ème
LA REUNION,SAINT-ANDRE,9740598G,253,219,32,2,126,127,4 ème
LA REUNION,SAINT-BENOIT,9740065C,150,147,0,3,73,77,4 ème
LA REUNION,SAINTE-MARIE,9741649Z,78,78,0,0,40,38,4 ème
LA REUNION,SAINTE-SUZANNE,9740094J,182,153,20,9,84,98,4 ème
LA REUNION,SAINT-JOSEPH,9740577J,237,201,32,4,114,123,4 ème
LA REUNION,SAINT-LEU,9740546A,270,264,0,6,127,143,4 ème
LA REUNION,SAINT-PAUL,9740069G,166,164,0,2,75,91,4 ème
LA REUNION,SAINT-PAUL,9740469S,194,194,0,0,97,97,4 ème
LA REUNION,SAINT-PAUL,9740596E,114,113,0,1,62,52,4 ème
LA REUNION,SAINT-PIERRE,9741346V,199,183,16,0,98,101,4 ème
MARTINIQUE,BASSE-POINTE,9720472F,52,44,8,0,21,31,4 ème
MARTINIQUE,FORT-DE-FRANCE,9720411P,114,108,0,6,48,66,4 ème
MARTINIQUE,FORT-DE-FRANCE,9720708M,99,95,0,4,57,42,4 ème
MARTINIQUE,FORT-DE-FRANCE,9720774J,162,162,0,0,147,15,4 ème
MARTINIQUE,LE DIAMANT,9720035F,74,72,0,2,36,38,4 ème
MARTINIQUE,LE LAMENTIN,9720091S,0,0,0,0,0,0,4 ème
MARTINIQUE,LE LORRAIN,9720445B,57,54,0,3,33,24,4 ème
MARTINIQUE,LES TROIS-ILETS,9720498J,91,91,0,0,44,47,4 ème
MARTINIQUE,LE VAUCLIN,9720031B,62,62,0,0,30,32,4 ème
MARTINIQUE,SCHOELCHER,9720424D,0,0,0,0,0,0,4 ème
MARTINIQUE,SCHOELCHER,9720684L,66,66,0,0,30,36,4 ème
MAYOTTE,BANDRABOUA,9760094Y,312,310,0,2,154,158,4 ème
MAYOTTE,KANI-KELI,9760166B,165,163,0,2,91,74,4 ème
MAYOTTE,KOUNGOU,9760244L,436,406,27,3,218,218,4 ème
MAYOTTE,MAMOUDZOU,9760219J,444,438,0,6,221,223,4 ème
ALLIER,COSNE-D'ALLIER,0030009U,64,62,0,2,29,35,4 ème
ALLIER,CUSSET,0031082K,0,0,0,0,0,0,4 ème
ALLIER,DESERTINES,0030860U,120,101,16,3,72,48,4 ème
ALLIER,GANNAT,0030980Z,31,31,0,0,23,8,4 ème
ALLIER,LURCY-LEVIS,0030021G,50,50,0,0,28,22,4 ème
ALLIER,MONTLUCON,0030119N,50,47,0,3,24,26,4 ème
ALLIER,MOULINS,0030112F,0,0,0,0,0,0,4 ème
ALLIER,NERIS-LES-BAINS,0030042E,73,73,0,0,40,33,4 ème
ALLIER,YZEURE,0030038A,0,0,0,0,0,0,4 ème
CANTAL,AURILLAC,0150613K,10,0,10,0,4,6,4 ème
CANTAL,AURILLAC,0150708N,94,94,0,0,49,45,4 ème
CANTAL,AURILLAC,0150729L,140,118,13,9,64,76,4 ème
CANTAL,AURILLAC,0150760V,0,0,0,0,0,0,4 ème
CANTAL,CHAUDES-AIGUES,0150010E,32,32,0,0,13,19,4 ème
CANTAL,LAROQUEBROU,0150013H,40,40,0,0,19,21,4 ème
CANTAL,MAURS,0150018N,45,43,0,2,26,19,4 ème
CANTAL,SAINT-MAMET-LA-SALVETAT,0150581A,77,76,0,1,42,35,4 ème
HAUTE-LOIRE,ALLEGRE,0430001T,58,58,0,0,31,27,4 ème
HAUTE-LOIRE,AUREC-SUR-LOIRE,0430987P,75,75,0,0,39,36,4 ème
HAUTE-LOIRE,BRIOUDE,0430003V,0,0,0,0,0,0,4 ème
HAUTE-LOIRE,DUNIERES,0430069S,45,45,0,0,29,16,4 ème
HAUTE-LOIRE,LE PUY-EN-VELAY,0430020N,0,0,0,0,0,0,4 ème
HAUTE-LOIRE,LE PUY-EN-VELAY,0430024T,0,0,0,0,0,0,4 ème
HAUTE-LOIRE,LE PUY-EN-VELAY,0430043N,149,141,0,8,73,76,4 ème
HAUTE-LOIRE,SAINT-DIDIER-EN-VELAY,0430084H,102,102,0,0,47,55,4 ème
HAUTE-LOIRE,SAINT-JULIEN-CHAPTEUIL,0430030Z,102,100,0,2,38,64,4 ème
HAUTE-LOIRE,TENCE,0430093T,40,40,0,0,15,25,4 ème
PUY-DE-DOME,AMBERT,0631083K,35,35,0,0,18,17,4 ème
PUY-DE-DOME,AMBERT,0631153L,94,79,12,3,39,55,4 ème
PUY-DE-DOME,AUBIERE,0631451K,219,202,15,2,107,112,4 ème
PUY-DE-DOME,BOURG-LASTIC,0630011V,20,20,0,0,10,10,4 ème
PUY-DE-DOME,CHAMALIERES,0631730N,111,111,0,0,59,52,4 ème
PUY-DE-DOME,CHAMPEIX,0630016A,117,115,0,2,55,62,4 ème
PUY-DE-DOME,CLERMONT-FERRAND,0630022G,0,0,0,0,0,0,4 ème
PUY-DE-DOME,LES ANCIZES-COMPS,0631482U,52,52,0,0,22,30,4 ème
PUY-DE-DOME,MARINGUES,0631097A,28,28,0,0,15,13,4 ème
PUY-DE-DOME,PIONSAT,0630046H,19,19,0,0,13,6,4 ème
PUY-DE-DOME,PONT-DU-CHATEAU,0631101E,63,63,0,0,33,30,4 ème
PUY-DE-DOME,ROCHEFORT-MONTAGNE,0630056U,63,63,0,0,30,33,4 ème
PUY-DE-DOME,SAINT-AMANT-ROCHE-SAVINE,0630057V,2,2,0,0,0,2,4 ème
PUY-DE-DOME,SAINT-GERMAIN-LEMBRON,0630062A,98,95,0,3,48,50,4 ème
PUY-DE-DOME,SAINT-GERVAIS-D'AUVERGNE,0630065D,34,31,0,3,18,16,4 ème
PUY-DE-DOME,THIERS,0630078T,0,0,0,0,0,0,4 ème
PUY-DE-DOME,VIC-LE-COMTE,0630072L,115,114,0,1,57,58,4 ème
ARDECHE,ANNONAY,0070001N,0,0,0,0,0,0,4 ème
ARDECHE,CRUAS,0070010Y,69,69,0,0,35,34,4 ème
ARDECHE,LAMASTRE,0070872K,49,49,0,0,26,23,4 ème
ARDECHE,LARGENTIERE,0070016E,0,0,0,0,0,0,4 ème
ARDECHE,LA VOULTE-SUR-RHONE,0070042H,143,126,17,0,80,63,4 ème
ARDECHE,LE CHEYLARD,0070849K,57,57,0,0,28,29,4 ème
ARDECHE,LE TEIL,0070847H,172,170,0,2,76,96,4 ème
ARDECHE,MONTPEZAT-SOUS-BAUZON,0070018G,65,65,0,0,34,31,4 ème
ARDECHE,SAINT-CIRGUES-EN-MONTAGNE,0070024N,21,21,0,0,11,10,4 ème
ARDECHE,SAINT-SAUVEUR-DE-MONTAGUT,0070025P,52,52,0,0,28,24,4 ème
ARDECHE,TOURNON-SUR-RHONE,0070092M,115,115,0,0,53,62,4 ème
ARDECHE,VALS-LES-BAINS,0070846G,102,98,0,4,53,49,4 ème
ARDECHE,VERNOUX-EN-VIVARAIS,0070890E,55,55,0,0,30,25,4 ème
DROME,BOURG-LES-VALENCE,0260766S,204,172,32,0,110,94,4 ème
DROME,BUIS-LES-BARONNIES,0260002L,55,55,0,0,27,28,4 ème
DROME,CHATEAUNEUF-DE-GALAURE,0261133R,57,57,0,0,57,0,4 ème
DROME,LA CHAPELLE-EN-VERCORS,0260004N,54,54,0,0,30,24,4 ème
DROME,LORIOL-SUR-DROME,0260012X,102,102,0,0,48,54,4 ème
DROME,MONTELIMAR,0261135T,119,119,0,0,55,64,4 ème
DROME,PIERRELATTE,0261090U,99,99,0,0,53,46,4 ème
DROME,ROMANS-SUR-ISERE,0260850H,151,132,15,4,76,75,4 ème
DROME,ROMANS-SUR-ISERE,0260997T,179,163,15,1,93,86,4 ème
DROME,SAINT-PAUL-TROIS-CHATEAUX,0261032F,143,143,0,0,76,67,4 ème
DROME,SAINT-SORLIN-EN-VALLOIRE,0260030S,117,111,0,6,57,60,4 ème
DROME,VALENCE,0261095Z,121,120,0,1,58,63,4 ème
DROME,VALENCE,0261137V,168,168,0,0,74,94,4 ème
HAUTE SAVOIE,ALBY-SUR-CHERAN,0740002A,147,147,0,0,85,62,4 ème
HAUTE SAVOIE,ANNECY,0740071A,167,133,28,6,79,88,4 ème
HAUTE SAVOIE,ANNECY,0740105M,178,178,0,0,87,91,4 ème
HAUTE SAVOIE,CLUSES,0740112V,159,159,0,0,71,88,4 ème
HAUTE SAVOIE,CLUSES,0740911N,247,236,0,11,116,131,4 ème
HAUTE SAVOIE,COLLONGES-SOUS-SALEVE,0740144E,0,0,0,0,0,0,4 ème
HAUTE SAVOIE,DOUVAINE,0740020V,156,156,0,0,74,82,4 ème
HAUTE SAVOIE,RUMILLY,0740126K,182,182,0,0,97,85,4 ème
HAUTE SAVOIE,RUMILLY,0741757H,147,141,0,6,66,81,4 ème
HAUTE SAVOIE,SAINT-PAUL-EN-CHABLAIS,0741308V,99,92,0,7,49,50,4 ème
HAUTE SAVOIE,SAMOENS,0740040S,44,44,0,0,29,15,4 ème
HAUTE SAVOIE,THONES,0741187N,140,140,0,0,60,80,4 ème
HAUTE SAVOIE,THONON-LES-BAINS,0740059M,0,0,0,0,0,0,4 ème
HAUTE SAVOIE,VILLE-LA-GRAND,0741284U,224,223,0,1,115,109,4 ème
ISERE,BOURGOIN-JALLIEU,0382271M,0,0,0,0,0,0,4 ème
ISERE,CORENC,0382041M,113,111,0,2,57,56,4 ème
ISERE,CORENC,0382579X,144,143,0,1,76,68,4 ème
ISERE,COUBLEVIE,0382495F,190,167,16,7,99,91,4 ème
ISERE,ECHIROLLES,0382031B,0,0,0,0,0,0,4 ème
ISERE,FONTAINE,0380356F,106,102,0,4,51,55,4 ème
ISERE,GIERES,0381694K,155,150,0,5,76,79,4 ème
ISERE,GONCELIN,0383300F,130,126,0,4,61,69,4 ème
ISERE,GRENOBLE,0383370G,144,144,0,0,73,71,4 ème
ISERE,LA COTE-SAINT-ANDRE,0382147C,135,107,25,3,66,69,4 ème
ISERE,LA MURE,0381701T,57,57,0,0,30,27,4 ème
ISERE,LA TOUR-DU-PIN,0380278W,204,172,29,3,107,97,4 ème
ISERE,LA TOUR-DU-PIN,0381706Y,151,147,0,4,83,68,4 ème
ISERE,LE TOUVET,0382204P,154,154,0,0,68,86,4 ème
ISERE,L'ISLE-D'ABEAU,0383455Z,158,154,0,4,78,80,4 ème
ISERE,MEYLAN,0381777A,148,145,0,3,73,75,4 ème
ISERE,MOIRANS,0381908T,139,135,0,4,69,70,4 ème
ISERE,SAINT-GEORGES-D'ESPERANCHE,0383141H,111,111,0,0,53,58,4 ème
ISERE,SAINT-JEAN-DE-MOIRANS,0381704W,78,78,0,0,34,44,4 ème
ISERE,SAINT-JEAN-DE-SOUDAIN,0382621T,163,163,0,0,83,80,4 ème
ISERE,SAINT-MARCELLIN,0380063M,0,0,0,0,0,0,4 ème
ISERE,TIGNIEU-JAMEYZIEU,0382705J,161,161,0,0,82,79,4 ème
ISERE,VIENNE,0380083J,0,0,0,0,0,0,4 ème
ISERE,VILLEFONTAINE,0382104F,135,111,21,3,60,75,4 ème
ISERE,VILLEFONTAINE,0382506T,116,109,0,7,64,52,4 ème
ISERE,VILLEMOIRIEU,0383475W,126,126,0,0,61,65,4 ème
ISERE,VIZILLE,0381779C,163,150,10,3,72,91,4 ème
ISERE,VOIRON,0382169B,0,0,0,0,0,0,4 ème
ISERE,VOIRON,0382584C,111,111,0,0,66,45,4 ème
SAVOIE,ALBERTVILLE,0730904L,173,152,17,4,101,72,4 ème
SAVOIE,ALBERTVILLE,0731045P,15,0,15,0,4,11,4 ème
SAVOIE,BOURG-SAINT-MAURICE,0730009N,163,163,0,0,85,78,4 ème
SAVOIE,BOZEL,0730010P,70,70,0,0,38,32,4 ème
SAVOIE,CHAMBERY,0730016W,0,0,0,0,0,0,4 ème
SAVOIE,CHAMBERY,0730762G,97,97,0,0,43,54,4 ème
SAVOIE,CHAMBERY,0730855H,93,89,0,4,42,51,4 ème
SAVOIE,LA MOTTE-SERVOLEX,0730028J,72,67,0,5,34,38,4 ème
SAVOIE,LA RAVOIRE,0730982W,111,94,14,3,66,45,4 ème
SAVOIE,MODANE,0730049G,100,100,0,0,50,50,4 ème
SAVOIE,SAINT-JEAN-DE-MAURIENNE,0730037U,0,0,0,0,0,0,4 ème
SAVOIE,SAINT-JEAN-DE-MAURIENNE,0730903K,166,147,15,4,89,77,4 ème
SAVOIE,SAINT-PIERRE-D'ALBIGNY,0730042Z,121,117,0,4,60,61,4 ème
SAVOIE,VAL-D'ARC,0730001E,89,87,0,2,45,44,4 ème
AIN,BELLEY,0011067E,246,221,15,10,125,121,4 ème
AIN,BEYNOST,0011360Y,142,139,0,3,59,83,4 ème
AIN,BOURG-EN-BRESSE,0010079F,119,119,0,0,39,80,4 ème
AIN,BOURG-EN-BRESSE,0010099C,0,0,0,0,0,0,4 ème
AIN,BOURG-EN-BRESSE,0010966V,16,0,16,0,6,10,4 ème
AIN,BRIORD,0011429Y,166,166,0,0,84,82,4 ème
AIN,CESSY,0010878Z,0,0,0,0,0,0,4 ème
AIN,CEYZERIAT,0011387C,169,166,0,3,83,86,4 ème
AIN,CHATILLON-SUR-CHALARONNE,0010084L,38,38,0,0,17,21,4 ème
AIN,DAGNEUX,0010083K,185,185,0,0,79,106,4 ème
AIN,DIVONNE-LES-BAINS,0011011U,115,115,0,0,68,47,4 ème
AIN,GEX,0010088R,224,223,0,1,128,96,4 ème
AIN,MONTCEAUX,0011415H,174,169,0,5,90,84,4 ème
AIN,MONTREVEL-EN-BRESSE,0010895T,169,167,0,2,88,81,4 ème
AIN,OYONNAX,0010092V,126,124,0,2,70,56,4 ème
AIN,OYONNAX,0010802S,190,163,24,3,89,101,4 ème
AIN,PONT-D'AIN,0010037K,144,143,0,1,62,82,4 ème
AIN,PREVESSIN-MOENS,0011301J,177,174,0,3,81,96,4 ème
LOIRE,CHARLIEU,0421572F,199,199,0,0,113,86,4 ème
LOIRE,FIRMINY,0420073B,0,0,0,0,0,0,4 ème
LOIRE,MONTBRISON,0420075D,0,0,0,0,0,0,4 ème
LOIRE,PELUSSIN,0421049M,41,41,0,0,16,25,4 ème
LOIRE,REGNY,0421490S,90,90,0,0,42,48,4 ème
LOIRE,RIVE-DE-GIER,0420982P,0,0,0,0,0,0,4 ème
LOIRE,ROANNE,0420035K,163,143,17,3,97,66,4 ème
LOIRE,ROANNE,0420077F,0,0,0,0,0,0,4 ème
LOIRE,ROANNE,0421683B,110,108,0,2,52,58,4 ème
LOIRE,ROANNE,0421684C,78,78,0,0,37,41,4 ème
LOIRE,ROANNE,0421797A,180,165,13,2,91,89,4 ème
LOIRE,ROCHE-LA-MOLIERE,0421174Y,163,160,0,3,87,76,4 ème
LOIRE,SAINT-BONNET-LE-CHATEAU,0420038N,120,120,0,0,60,60,4 ème
LOIRE,SAINT-CHAMOND,0421006R,0,0,0,0,0,0,4 ème
LOIRE,SAINT-ETIENNE,0420058K,210,209,0,1,97,113,4 ème
LOIRE,SAINT-ETIENNE,0421452A,231,229,0,2,111,120,4 ème
LOIRE,SAINT-ETIENNE,0421677V,120,120,0,0,58,62,4 ème
LOIRE,SAINT-ETIENNE,0421798B,85,70,15,0,41,44,4 ème
LOIRE,SAINT-ETIENNE,0421980Z,0,0,0,0,0,0,4 ème
LOIRE,SAINT-GENEST-MALIFAUX,0421059Y,105,105,0,0,56,49,4 ème
LOIRE,SAINT-GERMAIN-LAVAL,0420060M,63,63,0,0,25,38,4 ème
LOIRE,SAINT-ROMAIN-LE-PUY,0422136U,218,216,0,2,109,109,4 ème
LOIRE,UNIEUX,0421068H,133,127,0,6,67,66,4 ème
LOIRE,VEAUCHE,0422293P,194,190,0,4,87,107,4 ème
RHONE,AMPLEPUIS,0690672F,99,99,0,0,50,49,4 ème
RHONE,BRINDAS,0693890D,206,201,0,5,113,93,4 ème
RHONE,BRON,0692576A,144,122,16,6,76,68,4 ème
RHONE,BRON,0693834T,126,122,0,4,50,76,4 ème
RHONE,CHASSIEU,0691614E,155,152,0,3,77,78,4 ème
RHONE,DECINES-CHARPIEU,0691649T,121,121,0,0,63,58,4 ème
RHONE,DECINES-CHARPIEU,0692157V,157,139,15,3,63,94,4 ème
RHONE,FEYZIN,0692520P,118,114,0,4,58,60,4 ème
RHONE,GIVORS,0692583H,124,112,10,2,59,65,4 ème
RHONE,GRIGNY,0692419E,160,143,16,1,79,81,4 ème
RHONE,L'ARBRESLE,0691482L,166,146,15,5,73,93,4 ème
RHONE,LYON,0692932M,176,172,0,4,93,83,4 ème
RHONE,LYON,0690597Z,90,90,0,0,46,44,4 ème
RHONE,LYON,0692933N,305,304,0,1,147,158,4 ème
RHONE,LYON,0692694D,88,85,0,3,43,45,4 ème
RHONE,LYON,0692934P,86,84,0,2,40,46,4 ème
RHONE,LYON,0690534F,174,174,0,0,92,82,4 ème
RHONE,LYON,0692338S,189,189,0,0,89,100,4 ème
RHONE,LYON,0690040U,0,0,0,0,0,0,4 ème
RHONE,LYON,0690651H,0,0,0,0,0,0,4 ème
RHONE,LYON,0693374T,0,0,0,0,0,0,4 ème
RHONE,LYON,0690036P,102,89,12,1,46,56,4 ème
RHONE,MIONS,0692579D,146,145,0,1,55,91,4 ème
RHONE,MORNANT,0690611P,123,123,0,0,63,60,4 ème
RHONE,MORNANT,0692346A,169,169,0,0,71,98,4 ème
RHONE,OULLINS,0690281F,0,0,0,0,0,0,4 ème
RHONE,OULLINS,0690653K,0,0,0,0,0,0,4 ème
RHONE,OULLINS,0692942Y,46,46,0,0,22,24,4 ème
RHONE,PIERRE-BENITE,0690076H,74,72,0,2,34,40,4 ème
RHONE,SAINT-FONS,0692342W,211,193,16,2,107,104,4 ème
RHONE,SAINT-GENIS-LAVAL,0692521R,112,108,0,4,47,65,4 ème
RHONE,SAINT-GEORGES-DE-RENEINS,0690080M,181,167,10,4,92,89,4 ème
RHONE,SAINT-LAURENT-DE-CHAMOUSSET,0690614T,82,82,0,0,48,34,4 ème
RHONE,SAINT-MARTIN-EN-HAUT,0690615U,120,120,0,0,51,69,4 ème
RHONE,SAINT-PRIEST,0692160Y,139,123,14,2,67,72,4 ème
RHONE,SAINT-SYMPHORIEN-D'OZON,0691496B,165,162,0,3,84,81,4 ème
RHONE,SAINT-SYMPHORIEN-SUR-COISE,0692925E,95,92,0,3,52,43,4 ème
RHONE,TARARE,0690618X,109,106,0,3,50,59,4 ème
RHONE,TARARE,0692700K,223,205,16,2,104,119,4 ème
RHONE,VAULX-EN-VELIN,0691793Z,119,115,0,4,59,60,4 ème
RHONE,VILLEURBANNE,0692155T,185,165,16,4,92,93,4 ème
RHONE,VILLEURBANNE,0693491V,25,25,0,0,10,15,4 ème
RHONE,VILLIE-MORGON,0690117C,138,133,0,5,76,62,4 ème
DOUBS,BAUME-LES-DAMES,0250005V,116,114,0,2,63,53,4 ème
DOUBS,BESANCON,0250011B,0,0,0,0,0,0,4 ème
DOUBS,BESANCON,0250012C,140,140,0,0,67,73,4 ème
DOUBS,BESANCON,0251208C,155,135,15,5,75,80,4 ème
DOUBS,FRASNE,0250018J,71,71,0,0,34,37,4 ème
DOUBS,HERIMONCOURT,0251375J,80,80,0,0,40,40,4 ème
DOUBS,LE RUSSEY,0251058P,24,24,0,0,10,14,4 ème
DOUBS,MAICHE,0251053J,108,108,0,0,54,54,4 ème
DOUBS,MONTBELIARD,0251395F,170,154,13,3,81,89,4 ème
DOUBS,MORTEAU,0251090Z,225,208,13,4,96,129,4 ème
DOUBS,PIREY,0251063V,92,92,0,0,46,46,4 ème
DOUBS,PONTARLIER,0251112Y,0,0,0,0,0,0,4 ème
DOUBS,SANCEY,0250055Z,30,30,0,0,12,18,4 ème
HAUTE-SAONE,HERICOURT,0700787A,170,153,16,1,64,106,4 ème
HAUTE-SAONE,LUXEUIL-LES-BAINS,0701192R,148,129,16,3,72,76,4 ème
HAUTE-SAONE,PESMES,0700027Z,101,101,0,0,54,47,4 ème
HAUTE-SAONE,VESOUL,0700038L,0,0,0,0,0,0,4 ème
HAUTE-SAONE,VESOUL,0700785Y,158,155,0,3,79,79,4 ème
JURA,CLAIRVAUX-LES-LACS,0390009Y,60,60,0,0,28,32,4 ème
JURA,DOLE,0390013C,0,0,0,0,0,0,4 ème
JURA,DOLE,0390800H,109,107,0,2,55,54,4 ème
JURA,DOLE,0390883Y,167,135,32,0,86,81,4 ème
JURA,LAVANS-LES-SAINT-CLAUDE,0391035N,58,58,0,0,27,31,4 ème
JURA,LONS-LE-SAUNIER,0390020K,0,0,0,0,0,0,4 ème
JURA,MOIRANS-EN-MONTAGNE,0390025R,47,42,0,5,25,22,4 ème
JURA,SAINT-CLAUDE,0390786T,0,0,0,0,0,0,4 ème
JURA,SALINS-LES-BAINS,0390962J,92,89,0,3,40,52,4 ème
JURA,TAVAUX,0390823H,75,75,0,0,35,40,4 ème
TERRITOIRE DE BELFORT,BELFORT,0900236T,0,0,0,0,0,0,4 ème
TERRITOIRE DE BELFORT,BELFORT,0900351T,97,81,16,0,47,50,4 ème
TERRITOIRE DE BELFORT,ROUGEMONT-LE-CHATEAU,0900013A,59,59,0,0,31,28,4 ème
COTE D'OR,BEAUNE,0210006T,0,0,0,0,0,0,4 ème
COTE D'OR,BEAUNE,0211626D,147,146,0,1,78,69,4 ème
COTE D'OR,CHATILLON-SUR-SEINE,0210014B,129,115,10,4,64,65,4 ème
COTE D'OR,DIJON,0210024M,129,127,0,2,57,72,4 ème
COTE D'OR,DIJON,0211089V,0,0,0,0,0,0,4 ème
COTE D'OR,DIJON,0211091X,0,0,0,0,0,0,4 ème
COTE D'OR,DIJON,0211357L,130,130,0,0,58,72,4 ème
COTE D'OR,DIJON,0211389W,197,197,0,0,94,103,4 ème
COTE D'OR,DIJON,0211525U,129,129,0,0,64,65,4 ème
COTE D'OR,DIJON,0211986V,0,0,0,0,0,0,4 ème
COTE D'OR,DIJON,0212119P,164,164,0,0,71,93,4 ème
COTE D'OR,ECHENON,0211358M,91,91,0,0,45,46,4 ème
COTE D'OR,LIERNAIS,0211524T,18,18,0,0,9,9,4 ème
COTE D'OR,MIREBEAU-SUR-BEZE,0210033X,106,102,0,4,58,48,4 ème
COTE D'OR,NUITS-SAINT-GEORGES,0210038C,153,149,0,4,69,84,4 ème
COTE D'OR,QUETIGNY,0211477S,158,143,15,0,73,85,4 ème
COTE D'OR,RECEY-SUR-OURCE,0210043H,25,25,0,0,13,12,4 ème
COTE D'OR,SEURRE,0210050R,81,81,0,0,38,43,4 ème
COTE D'OR,VENAREY-LES-LAUMES,0211184Y,76,76,0,0,36,40,4 ème
NIEVRE,CERCY-LA-TOUR,0580002M,29,29,0,0,17,12,4 ème
NIEVRE,CHATEAU-CHINON (VILLE),0580005R,43,34,7,2,21,22,4 ème
NIEVRE,FOURCHAMBAULT,0580020G,0,0,0,0,0,0,4 ème
NIEVRE,FOURCHAMBAULT,0580553L,152,133,17,2,68,84,4 ème
NIEVRE,LA CHARITE-SUR-LOIRE,0580610Y,92,74,15,3,43,49,4 ème
NIEVRE,MONTSAUCHE-LES-SETTONS,0580029S,24,24,0,0,13,11,4 ème
NIEVRE,NEVERS,0580034X,79,79,0,0,44,35,4 ème
NIEVRE,NEVERS,0580542Z,115,110,0,5,57,58,4 ème
NIEVRE,NEVERS,0580682B,81,81,0,0,43,38,4 ème
NIEVRE,PREMERY,0580036Z,30,30,0,0,12,18,4 ème
NIEVRE,SAINT-BENIN-D'AZY,0580038B,53,53,0,0,29,24,4 ème
NIEVRE,SAINT-SAULGE,0580040D,25,25,0,0,9,16,4 ème
SAONE-ET-LOIRE,BOURBON-LANCY,0710005V,81,81,0,0,41,40,4 ème
SAONE-ET-LOIRE,CHALON-SUR-SAONE,0710536X,102,85,14,3,45,57,4 ème
SAONE-ET-LOIRE,CHATENOY-LE-ROYAL,0711585M,77,76,0,1,40,37,4 ème
SAONE-ET-LOIRE,CHAUFFAILLES,0710121W,38,38,0,0,14,24,4 ème
SAONE-ET-LOIRE,GENELARD,0710039G,69,69,0,0,37,32,4 ème
SAONE-ET-LOIRE,LE CREUSOT,0710026T,0,0,0,0,0,0,4 ème
SAONE-ET-LOIRE,LE CREUSOT,0711324D,99,96,0,3,49,50,4 ème
SAONE-ET-LOIRE,MACON,0710048S,0,0,0,0,0,0,4 ème
SAONE-ET-LOIRE,MACON,0711249X,0,0,0,0,0,0,4 ème
SAONE-ET-LOIRE,MONTCHANIN,0710060E,123,120,0,3,60,63,4 ème
SAONE-ET-LOIRE,PARAY-LE-MONIAL,0710087J,0,0,0,0,0,0,4 ème
SAONE-ET-LOIRE,PIERRE-DE-BRESSE,0710063H,63,63,0,0,35,28,4 ème
SAONE-ET-LOIRE,SAINT-REMY,0711293V,159,142,17,0,89,70,4 ème
SAONE-ET-LOIRE,SANVIGNES-LES-MINES,0710069P,66,66,0,0,37,29,4 ème
YONNE,AUXERRE,0890005X,0,0,0,0,0,0,4 ème
YONNE,AUXERRE,0891054M,183,179,0,4,90,93,4 ème
YONNE,CHABLIS,0890013F,89,89,0,0,48,41,4 ème
YONNE,MIGENNES,0890977D,102,87,15,0,41,61,4 ème
YONNE,NOYERS,0890019M,40,40,0,0,17,23,4 ème
YONNE,PARON,0891235J,168,167,0,1,83,85,4 ème
YONNE,SAINT-FLORENTIN,0890024T,123,120,0,3,56,67,4 ème
YONNE,SENS,0890790A,184,168,16,0,92,92,4 ème
COTES D'ARMOR,BEGARD,0221518F,133,133,0,0,62,71,4 ème
COTES D'ARMOR,BELLE-ISLE-EN-TERRE,0221539D,38,38,0,0,21,17,4 ème
COTES D'ARMOR,BOURBRIAC,0220003J,35,35,0,0,17,18,4 ème
COTES D'ARMOR,CALLAC,0221540E,33,33,0,0,15,18,4 ème
COTES D'ARMOR,DINAN,0221743A,114,114,0,0,48,66,4 ème
COTES D'ARMOR,ERQUY,0220015X,41,41,0,0,20,21,4 ème
COTES D'ARMOR,GUINGAMP,0220019B,0,0,0,0,0,0,4 ème
COTES D'ARMOR,LANNION,0220104U,235,217,14,4,110,125,4 ème
COTES D'ARMOR,LANNION,0221931E,114,107,0,7,45,69,4 ème
COTES D'ARMOR,MERDRIGNAC,0220149T,27,27,0,0,11,16,4 ème
COTES D'ARMOR,PAIMPOL,0220151V,75,71,0,4,29,46,4 ème
COTES D'ARMOR,PLENEE-JUGON,0220154Y,24,24,0,0,14,10,4 ème
COTES D'ARMOR,PLENEUF-VAL-ANDRE,0221126E,74,74,0,0,39,35,4 ème
COTES D'ARMOR,PLEUMEUR-BODOU,0221819H,77,77,0,0,39,38,4 ème
COTES D'ARMOR,PLOUASNE,0220046F,56,56,0,0,23,33,4 ème
COTES D'ARMOR,PLOUBAZLANEC,0221866J,0,0,0,0,0,0,4 ème
COTES D'ARMOR,PLOUER-SUR-RANCE,0220047G,172,172,0,0,93,79,4 ème
COTES D'ARMOR,PONTRIEUX,0220166L,17,17,0,0,7,10,4 ème
COTES D'ARMOR,QUINTIN,0221028Y,115,113,0,2,58,57,4 ème
COTES D'ARMOR,QUINTIN,0221748F,185,174,11,0,87,98,4 ème
COTES D'ARMOR,ROSTRENEN,0221038J,50,50,0,0,28,22,4 ème
COTES D'ARMOR,SAINT-BRIEUC,0220185G,142,137,0,5,62,80,4 ème
COTES D'ARMOR,SAINT-BRIEUC,0221867K,0,0,0,0,0,0,4 ème
FINISTERE,BREST,0290131K,54,49,0,5,25,29,4 ème
FINISTERE,CROZON,0290256W,52,52,0,0,20,32,4 ème
FINISTERE,FOUESNANT,0291101P,201,201,0,0,103,98,4 ème
FINISTERE,GUILVINEC,0290674A,24,24,0,0,9,15,4 ème
FINISTERE,GUIPAVAS,0291968G,115,114,0,1,57,58,4 ème
FINISTERE,LE CONQUET,0290106H,49,49,0,0,21,28,4 ème
FINISTERE,LE RELECQ-KERHUON,0290151G,117,101,16,0,59,58,4 ème
FINISTERE,PLOUDALMEZEAU,0291638Y,68,68,0,0,31,37,4 ème
FINISTERE,PLOUESCAT,0290293L,43,43,0,0,17,26,4 ème
FINISTERE,PLOUZANE,0291656T,71,71,0,0,31,40,4 ème
FINISTERE,PLOUZANE,0291929P,117,117,0,0,64,53,4 ème
FINISTERE,PONT-DE-BUIS-LES-QUIMERCH,0290093U,70,70,0,0,33,37,4 ème
FINISTERE,POULDREUZIC,0290304Y,78,78,0,0,40,38,4 ème
FINISTERE,QUIMPER,0290306A,53,53,0,0,27,26,4 ème
FINISTERE,QUIMPER,0290347V,16,0,16,0,6,10,4 ème
FINISTERE,ROSPORDEN,0290310E,54,54,0,0,28,26,4 ème
ILLE-ET-VILAINE,ARGENTRE-DU-PLESSIS,0350849H,143,143,0,0,69,74,4 ème
ILLE-ET-VILAINE,BAIN-DE-BRETAGNE,0350851K,205,201,0,4,111,94,4 ème
ILLE-ET-VILAINE,BAIN-DE-BRETAGNE,0350970P,137,105,30,2,63,74,4 ème
ILLE-ET-VILAINE,BRUZ,0350002M,173,143,30,0,86,87,4 ème
ILLE-ET-VILAINE,BRUZ,0350852L,329,329,0,0,171,158,4 ème
ILLE-ET-VILAINE,CANCALE,0350003N,99,99,0,0,55,44,4 ème
ILLE-ET-VILAINE,CESSON-SEVIGNE,0350793X,0,0,0,0,0,0,4 ème
ILLE-ET-VILAINE,CHATEAUGIRON,0350855P,159,155,0,4,74,85,4 ème
ILLE-ET-VILAINE,COMBOURG,0350857S,95,95,0,0,52,43,4 ème
ILLE-ET-VILAINE,FOUGERES,0350761M,0,0,0,0,0,0,4 ème
ILLE-ET-VILAINE,GUIPRY-MESSAC,0352957Z,116,116,0,0,53,63,4 ème
ILLE-ET-VILAINE,JANZE,0350866B,141,141,0,0,72,69,4 ème
ILLE-ET-VILAINE,LA RICHARDAIS,0353036K,141,141,0,0,75,66,4 ème
ILLE-ET-VILAINE,LIFFRE,0351790F,189,189,0,0,87,102,4 ème
ILLE-ET-VILAINE,MAEN ROCH,0350040D,70,65,0,5,36,34,4 ème
ILLE-ET-VILAINE,MONTAUBAN-DE-BRETAGNE,0352247C,176,170,0,6,91,85,4 ème
ILLE-ET-VILAINE,MORDELLES,0350874K,170,168,0,2,75,95,4 ème
ILLE-ET-VILAINE,MORDELLES,0352030S,130,124,0,6,84,46,4 ème
ILLE-ET-VILAINE,NOYAL-SUR-VILAINE,0352167R,155,155,0,0,66,89,4 ème
ILLE-ET-VILAINE,PACE,0352274G,201,195,0,6,100,101,4 ème
ILLE-ET-VILAINE,RENNES,0350030T,0,0,0,0,0,0,4 ème
ILLE-ET-VILAINE,RENNES,0350032V,0,0,0,0,0,0,4 ème
ILLE-ET-VILAINE,RENNES,0350839X,137,137,0,0,73,64,4 ème
ILLE-ET-VILAINE,RENNES,0350913C,99,83,16,0,43,56,4 ème
ILLE-ET-VILAINE,RENNES,0350965J,146,143,0,3,66,80,4 ème
ILLE-ET-VILAINE,SAINT-AUBIN-DU-CORMIER,0350882U,60,60,0,0,39,21,4 ème
ILLE-ET-VILAINE,SAINT-MALO,0350062C,0,0,0,0,0,0,4 ème
ILLE-ET-VILAINE,SAINT-MALO,0350889B,64,64,0,0,31,33,4 ème
ILLE-ET-VILAINE,SAINT-MALO,0352072M,0,0,0,0,0,0,4 ème
ILLE-ET-VILAINE,TINTENIAC,0350891D,214,199,15,0,101,113,4 ème
ILLE-ET-VILAINE,VAL D'ANAST,0350869E,58,58,0,0,26,32,4 ème
MORBIHAN,BRECH,0560023W,180,180,0,0,83,97,4 ème
MORBIHAN,CAUDAN,0560128K,67,67,0,0,31,36,4 ème
MORBIHAN,ELVEN,0561965G,141,141,0,0,73,68,4 ème
MORBIHAN,ETEL,0560008E,0,0,0,0,0,0,4 ème
MORBIHAN,GUIDEL,0560136U,153,149,0,4,72,81,4 ème
MORBIHAN,HENNEBONT,0560018R,167,167,0,0,81,86,4 ème
MORBIHAN,HENNEBONT,0561401U,158,152,0,6,63,95,4 ème
MORBIHAN,JOSSELIN,0561378U,68,68,0,0,38,30,4 ème
MORBIHAN,LANGUIDIC,0560143B,85,85,0,0,40,45,4 ème
MORBIHAN,MALANSAC,0561410D,69,67,0,2,37,32,4 ème
MORBIHAN,MALESTROIT,0560058J,92,92,0,0,47,45,4 ème
MORBIHAN,MAURON,0560152L,43,43,0,0,19,24,4 ème
MORBIHAN,MUZILLAC,0560033G,111,111,0,0,59,52,4 ème
MORBIHAN,MUZILLAC,0560153M,95,95,0,0,43,52,4 ème
MORBIHAN,PLOEMEUR,0560104J,120,120,0,0,60,60,4 ème
MORBIHAN,PLOERMEL,0560226S,119,96,17,6,54,65,4 ème
MORBIHAN,PLOUAY,0560037L,102,102,0,0,54,48,4 ème
MORBIHAN,PONTIVY,0560110R,238,216,18,4,123,115,4 ème
MORBIHAN,PONTIVY,0560182U,0,0,0,0,0,0,4 ème
MORBIHAN,PORT-LOUIS,0561379V,133,133,0,0,63,70,4 ème
MORBIHAN,PRIZIAC,0560197K,0,0,0,0,0,0,4 ème
MORBIHAN,QUIBERON,0561329R,43,43,0,0,18,25,4 ème
MORBIHAN,ROHAN,0560047X,58,58,0,0,27,31,4 ème
MORBIHAN,VANNES,0560198L,0,0,0,0,0,0,4 ème
CHER,AUBIGNY-SUR-NERE,0180002E,144,135,9,0,67,77,4 ème
CHER,AVORD,0180004G,88,88,0,0,39,49,4 ème
CHER,BOURGES,0180010N,0,0,0,0,0,0,4 ème
CHER,BOURGES,0180591V,173,169,0,4,87,86,4 ème
CHER,SAINT-AMAND-MONTROND,0180646E,96,92,0,4,44,52,4 ème
CHER,SAINT-AMAND-MONTROND,0180769N,126,105,17,4,66,60,4 ème
CHER,SANCERRE,0180031L,75,71,3,1,39,36,4 ème
CHER,VIERZON,0180644C,137,135,0,2,69,68,4 ème
EURE-ET-LOIR,ANET,0281038B,138,136,0,2,68,70,4 ème
EURE-ET-LOIR,AUNEAU-BLEURY-SAINT-SYMPHORIEN,0280001Z,161,161,0,0,84,77,4 ème
EURE-ET-LOIR,BONNEVAL,0280866P,127,126,0,1,65,62,4 ème
EURE-ET-LOIR,BREZOLLES,0280005D,86,81,0,5,39,47,4 ème
EURE-ET-LOIR,CHARTRES,0280044W,0,0,0,0,0,0,4 ème
EURE-ET-LOIR,CHARTRES,0280751P,171,138,32,1,66,105,4 ème
EURE-ET-LOIR,CHARTRES,0280883H,117,116,0,1,51,66,4 ème
EURE-ET-LOIR,CHATEAUDUN,0280656L,69,65,0,4,37,32,4 ème
EURE-ET-LOIR,CHATEAUNEUF-EN-THYMERAIS,0280016R,97,94,0,3,50,47,4 ème
EURE-ET-LOIR,DREUX,0280865N,131,115,16,0,64,67,4 ème
EURE-ET-LOIR,EPERNON,0280889P,104,104,0,0,47,57,4 ème
EURE-ET-LOIR,MAINTENON,0280033J,132,128,0,4,61,71,4 ème
EURE-ET-LOIR,NOGENT-LE-ROTROU,0280924C,101,101,0,0,46,55,4 ème
EURE-ET-LOIR,SAINT-MAURICE-SAINT-GERMAIN,0280741D,67,55,12,0,17,50,4 ème
EURE-ET-LOIR,VERNOUILLET,0280024Z,99,94,0,5,50,49,4 ème
INDRE,CHATEAUROUX,0360016X,105,105,0,0,49,56,4 ème
INDRE,CHATEAUROUX,0360567W,105,104,0,1,55,50,4 ème
INDRE,EGUZON-CHANTOME,0360023E,46,46,0,0,24,22,4 ème
INDRE,ISSOUDUN,0360568X,47,47,0,0,21,26,4 ème
INDRE,SAINT-GAULTIER,0360546Y,51,51,0,0,24,27,4 ème
INDRE-ET-LOIRE,AMBOISE,0371248F,119,118,0,1,61,58,4 ème
INDRE-ET-LOIRE,BOURGUEIL,0370733W,18,18,0,0,10,8,4 ème
INDRE-ET-LOIRE,BOURGUEIL,0370995F,103,103,0,0,56,47,4 ème
INDRE-ET-LOIRE,CHAMBRAY-LES-TOURS,0370741E,85,85,0,0,37,48,4 ème
INDRE-ET-LOIRE,CHATEAU-LA-VALLIERE,0370006F,70,61,9,0,41,29,4 ème
INDRE-ET-LOIRE,DESCARTES,0371192V,44,42,0,2,19,25,4 ème
INDRE-ET-LOIRE,LIGUEIL,0370015R,86,82,0,4,37,49,4 ème
INDRE-ET-LOIRE,L'ILE-BOUCHARD,0370013N,47,47,0,0,24,23,4 ème
INDRE-ET-LOIRE,LOCHES,0371329U,72,72,0,0,30,42,4 ème
INDRE-ET-LOIRE,NEUILLE-PONT-PIERRE,0370022Y,155,152,0,3,77,78,4 ème
INDRE-ET-LOIRE,NOUATRE,0370024A,35,35,0,0,16,19,4 ème
INDRE-ET-LOIRE,PREUILLY-SUR-CLAISE,0370026C,58,58,0,0,33,25,4 ème
INDRE-ET-LOIRE,SAINT-AVERTIN,0370887N,139,139,0,0,62,77,4 ème
INDRE-ET-LOIRE,SAINT-CYR-SUR-LOIRE,0370792K,82,81,0,1,44,38,4 ème
INDRE-ET-LOIRE,SAINT-PIERRE-DES-CORPS,0370767H,102,82,16,4,48,54,4 ème
INDRE-ET-LOIRE,TOURS,0370729S,132,128,0,4,71,61,4 ème
INDRE-ET-LOIRE,TOURS,0370745J,121,121,0,0,50,71,4 ème
INDRE-ET-LOIRE,TOURS,0370769K,94,94,0,0,54,40,4 ème
INDRE-ET-LOIRE,TOURS,0370771M,0,0,0,0,0,0,4 ème
INDRE-ET-LOIRE,TOURS,0371099U,0,0,0,0,0,0,4 ème
LOIRET,BEAUGENCY,0450005L,184,179,0,5,97,87,4 ème
LOIRET,CHALETTE-SUR-LOING,0451148D,119,114,0,5,51,68,4 ème
LOIRET,FLEURY-LES-AUBRAIS,0451067R,0,0,0,0,0,0,4 ème
LOIRET,JARGEAU,0451069T,168,165,0,3,83,85,4 ème
LOIRET,MEUNG-SUR-LOIRE,0450038X,142,123,15,4,70,72,4 ème
LOIRET,ORLEANS,0450936Y,159,140,17,2,71,88,4 ème
LOIRET,ORLEANS,0451070U,143,122,16,5,71,72,4 ème
LOIRET,ORLEANS,0451334F,240,240,0,0,134,106,4 ème
LOIRET,ORLEANS,0451421A,144,144,0,0,72,72,4 ème
LOIRET,PUISEAUX,0450063Z,97,92,0,5,51,46,4 ème
LOIRET,SAINTE-GENEVIEVE-DES-BOIS,0450016Y,120,120,0,0,67,53,4 ème
LOIRET,SAINT-JEAN-DE-BRAYE,0450064A,0,0,0,0,0,0,4 ème
LOIRET,SAINT-JEAN-DE-LA-RUELLE,0451241E,84,67,17,0,36,48,4 ème
LOIRET,SAINT-JEAN-LE-BLANC,0451074Y,137,134,0,3,63,74,4 ème
LOIRET,SARAN,0451038J,134,125,0,9,72,62,4 ème
LOIRET,SULLY-SUR-LOIRE,0450790P,103,100,0,3,50,53,4 ème
LOIR-ET-CHER,BLOIS,0410001D,0,0,0,0,0,0,4 ème
LOIR-ET-CHER,BLOIS,0410593X,154,138,16,0,80,74,4 ème
LOIR-ET-CHER,MER,0410681T,46,45,0,1,15,31,4 ème
LOIR-ET-CHER,ROMORANTIN-LANTHENAY,0410019Y,198,180,16,2,117,81,4 ème
LOIR-ET-CHER,SAINT-AIGNAN,0410718H,0,0,0,0,0,0,4 ème
LOIR-ET-CHER,VENDOME,0410688A,66,66,0,0,34,32,4 ème
CORSE-DU-SUD,AJACCIO,6200185G,62,62,0,0,28,34,4 ème
HAUTE-CORSE,BASTIA,7200624R,130,127,0,3,59,71,4 ème
HAUTE-CORSE,CORTE,7200004S,92,89,2,1,37,55,4 ème
HAUTE-CORSE,LUCCIANA,7200053V,170,166,0,4,87,83,4 ème
HAUTE-CORSE,PENTA-DI-CASINCA,7200160L,119,115,4,0,57,62,4 ème
HAUTE-CORSE,SAINT-FLORENT,7200044K,45,45,0,0,23,22,4 ème
MEURTHE-ET-MOSELLE,ART-SUR-MEURTHE,0542449U,28,28,0,0,5,23,4 ème
MEURTHE-ET-MOSELLE,BAYON,0541852V,121,121,0,0,62,59,4 ème
MEURTHE-ET-MOSELLE,FLAVIGNY-SUR-MOSELLE,0541268K,46,23,0,23,14,32,4 ème
MEURTHE-ET-MOSELLE,FROUARD,0541326Y,67,67,0,0,31,36,4 ème
MEURTHE-ET-MOSELLE,HOMECOURT,0541471F,116,116,0,0,52,64,4 ème
MEURTHE-ET-MOSELLE,JARNY,0541331D,105,105,0,0,52,53,4 ème
MEURTHE-ET-MOSELLE,LONGLAVILLE,0541605B,0,0,0,0,0,0,4 ème
MEURTHE-ET-MOSELLE,LONGWY,0540030P,0,0,0,0,0,0,4 ème
MEURTHE-ET-MOSELLE,NANCY,0540081V,0,0,0,0,0,0,4 ème
MEURTHE-ET-MOSELLE,NANCY,0540110B,133,118,15,0,57,76,4 ème
MEURTHE-ET-MOSELLE,NANCY,0541327Z,84,84,0,0,42,42,4 ème
MEURTHE-ET-MOSELLE,NANCY,0541501N,78,78,0,0,36,42,4 ème
MEURTHE-ET-MOSELLE,NANCY,0541995A,189,189,0,0,105,84,4 ème
MEURTHE-ET-MOSELLE,NANCY,0542409A,44,40,0,4,18,26,4 ème
MEURTHE-ET-MOSELLE,NOMENY,0540054R,78,78,0,0,43,35,4 ème
MEURTHE-ET-MOSELLE,PAGNY-SUR-MOSELLE,0541567K,93,93,0,0,47,46,4 ème
MEURTHE-ET-MOSELLE,PIENNES,0541332E,76,76,0,0,39,37,4 ème
MEURTHE-ET-MOSELLE,PONT-A-MOUSSON,0540112D,145,145,0,0,68,77,4 ème
MEURTHE-ET-MOSELLE,TOMBLAINE,0540061Y,0,0,0,0,0,0,4 ème
MEURTHE-ET-MOSELLE,TOUL,0540067E,0,0,0,0,0,0,4 ème
MEURTHE-ET-MOSELLE,TUCQUEGNIEUX,0541333F,73,70,0,3,39,34,4 ème
MEURTHE-ET-MOSELLE,VAL DE BRIEY,0541985P,100,100,0,0,59,41,4 ème
MEURTHE-ET-MOSELLE,VILLERUPT,0542418K,178,160,16,2,82,96,4 ème
MEUSE,BAR-LE-DUC,0550701N,69,53,9,7,32,37,4 ème
MEUSE,REVIGNY-SUR-ORNAIN,0550018W,56,56,0,0,23,33,4 ème
MEUSE,VERDUN,0550024C,95,88,0,7,49,46,4 ème
MEUSE,VERDUN,0550758A,44,35,9,0,26,18,4 ème
MOSELLE,ALBESTROFF,0572691R,84,84,0,0,40,44,4 ème
MOSELLE,BEHREN-LES-FORBACH,0573268T,78,72,6,0,39,39,4 ème
MOSELLE,CATTENOM,0571994H,97,97,0,0,45,52,4 ème
MOSELLE,DIEUZE,0570279U,0,0,0,0,0,0,4 ème
MOSELLE,DIEUZE,0572814Z,99,95,0,4,48,51,4 ème
MOSELLE,FAMECK,0573269U,200,196,0,4,94,106,4 ème
MOSELLE,FLORANGE,0570317K,141,126,12,3,65,76,4 ème
MOSELLE,FONTOY,0572009Z,104,84,17,3,47,57,4 ème
MOSELLE,HETTANGE-GRANDE,0572025S,148,147,0,1,70,78,4 ème
MOSELLE,LE BAN-SAINT-MARTIN,0570128E,157,154,0,3,67,90,4 ème
MOSELLE,LEMBERG,0572020L,70,70,0,0,34,36,4 ème
MOSELLE,MAIZIERES-LES-METZ,0572164T,201,189,9,3,109,92,4 ème
MOSELLE,METZ,0570061G,0,0,0,0,0,0,4 ème
MOSELLE,METZ,0572348T,105,95,8,2,49,56,4 ème
MOSELLE,METZ,0572350V,125,103,12,10,50,75,4 ème
MOSELLE,MORHANGE,0570073V,110,88,13,9,55,55,4 ème
MOSELLE,PETITE-ROSSELLE,0572493A,66,66,0,0,41,25,4 ème
MOSELLE,PHALSBOURG,0572815A,136,131,0,5,71,65,4 ème
MOSELLE,SAINT-AVOLD,0570143W,107,103,0,4,49,58,4 ème
MOSELLE,SARREBOURG,0570097W,91,70,16,5,52,39,4 ème
MOSELLE,SARREGUEMINES,0572930A,113,113,0,0,54,59,4 ème
MOSELLE,STIRING-WENDEL,0570104D,123,116,0,7,52,71,4 ème
MOSELLE,WOIPPY,0572579U,112,110,0,2,57,55,4 ème
VOSGES,BRUYERES,0880005C,130,113,8,9,58,72,4 ème
VOSGES,BRUYERES,0880133S,0,0,0,0,0,0,4 ème
VOSGES,EPINAL,0880021V,0,0,0,0,0,0,4 ème
VOSGES,EPINAL,0880150K,166,166,0,0,89,77,4 ème
VOSGES,EPINAL,0881496Y,144,144,0,0,81,63,4 ème
VOSGES,FRAIZE,0881410E,89,88,0,1,38,51,4 ème
VOSGES,LA BRESSE,0880105L,39,39,0,0,15,24,4 ème
VOSGES,LE THOLY,0881148V,54,54,0,0,24,30,4 ème
VOSGES,MARTIGNY-LES-BAINS,0880108P,16,16,0,0,8,8,4 ème
VOSGES,RUPT-SUR-MOSELLE,0880054F,47,47,0,0,24,23,4 ème
VOSGES,SAINT-DIE-DES-VOSGES,0880057J,0,0,0,0,0,0,4 ème
VOSGES,SAINT-DIE-DES-VOSGES,0880100F,47,44,0,3,26,21,4 ème
VOSGES,XERTIGNY,0881369K,89,83,5,1,45,44,4 ème
ARDENNES,CHARLEVILLE-MEZIERES,0080028M,0,0,0,0,0,0,4 ème
ARDENNES,CHARLEVILLE-MEZIERES,0080079T,67,55,12,0,32,35,4 ème
ARDENNES,CHARLEVILLE-MEZIERES,0080925M,71,68,0,3,37,34,4 ème
ARDENNES,DOUZY,0080016Z,87,87,0,0,47,40,4 ème
ARDENNES,GIVET,0080948M,96,96,0,0,51,45,4 ème
ARDENNES,RETHEL,0080088C,44,44,0,0,22,22,4 ème
ARDENNES,REVIN,0080949N,68,64,0,4,31,37,4 ème
ARDENNES,ROCROI,0081098A,52,52,0,0,21,31,4 ème
ARDENNES,VOUZIERS,0081097Z,88,74,11,3,46,42,4 ème
AUBE,BAR-SUR-AUBE,0100902B,110,101,8,1,47,63,4 ème
AUBE,ROMILLY-SUR-SEINE,0100054E,81,81,0,0,46,35,4 ème
AUBE,SAINTE-SAVINE,0100055F,64,64,0,0,35,29,4 ème
AUBE,TROYES,0100081J,200,188,11,1,94,106,4 ème
AUBE,TROYES,0100945Y,0,0,0,0,0,0,4 ème
AUBE,TROYES,0100961R,98,98,0,0,55,43,4 ème
HAUTE-MARNE,LANGRES,0520040L,116,100,15,1,52,64,4 ème
MARNE,CHALONS-EN-CHAMPAGNE,0510010J,160,155,0,5,81,79,4 ème
MARNE,CHALONS-EN-CHAMPAGNE,0511129A,199,194,5,0,105,94,4 ème
MARNE,EPERNAY,0511327R,124,99,15,10,62,62,4 ème
MARNE,FISMES,0511188P,116,116,0,0,68,48,4 ème
MARNE,REIMS,0511145T,0,0,0,0,0,0,4 ème
MARNE,REIMS,0511178D,152,149,0,3,80,72,4 ème
MARNE,REIMS,0511179E,147,147,0,0,66,81,4 ème
MARNE,REIMS,0511180F,126,126,0,0,58,68,4 ème
MARNE,REIMS,0511214T,105,89,13,3,57,48,4 ème
MARNE,REIMS,0511470W,188,169,17,2,91,97,4 ème
MARNE,SAINT-THIERRY,0510051D,114,109,0,5,54,60,4 ème
MARNE,SUIPPES,0510056J,96,95,0,1,48,48,4 ème
MARNE,VERZY,0510060N,108,108,0,0,59,49,4 ème
BAS-RHIN,ACHENHEIM,0671686U,133,129,0,4,59,74,4 ème
BAS-RHIN,BENFELD,0670003P,167,164,0,3,71,96,4 ème
BAS-RHIN,DAMBACH-LA-VILLE,0670011Y,91,90,0,1,44,47,4 ème
BAS-RHIN,DRUSENHEIM,0672074R,116,116,0,0,63,53,4 ème
BAS-RHIN,DUTTLENHEIM,0672896J,107,104,0,3,49,58,4 ème
BAS-RHIN,HAGUENAU,0672136H,183,179,0,4,91,92,4 ème
BAS-RHIN,HAGUENAU,0672298J,125,125,0,0,57,68,4 ème
BAS-RHIN,HERRLISHEIM,0671911N,93,93,0,0,52,41,4 ème
BAS-RHIN,ILLKIRCH-GRAFFENSTADEN,0670087F,0,0,0,0,0,0,4 ème
BAS-RHIN,MERTZWILLER,0671912P,59,55,0,4,28,31,4 ème
BAS-RHIN,MOLSHEIM,0672131C,91,88,0,3,41,50,4 ème
BAS-RHIN,MUTZIG,0671828Y,165,158,0,7,72,93,4 ème
BAS-RHIN,OBERNAI,0672132D,93,90,0,3,43,50,4 ème
BAS-RHIN,OSTWALD,0672072N,152,147,0,5,68,84,4 ème
BAS-RHIN,ROSHEIM,0671913R,173,173,0,0,80,93,4 ème
BAS-RHIN,SARRE-UNION,0670056X,114,101,10,3,40,74,4 ème
BAS-RHIN,SAVERNE,0671986V,135,114,18,3,75,60,4 ème
BAS-RHIN,SCHILTIGHEIM,0670066H,200,175,16,9,88,112,4 ème
BAS-RHIN,SCHIRMECK,0670068K,84,81,0,3,41,43,4 ème
BAS-RHIN,SCHWEIGHOUSE-SUR-MODER,0671960S,107,101,0,6,56,51,4 ème
BAS-RHIN,SELESTAT,0672134F,90,86,0,4,39,51,4 ème
BAS-RHIN,STRASBOURG,0671590P,180,157,18,5,84,96,4 ème
BAS-RHIN,STRASBOURG,0671825V,153,153,0,0,79,74,4 ème
BAS-RHIN,STRASBOURG,0671909L,150,149,0,1,65,85,4 ème
BAS-RHIN,STRASBOURG,0671915T,210,210,0,0,116,94,4 ème
BAS-RHIN,STRASBOURG,0672301M,201,201,0,0,90,111,4 ème
BAS-RHIN,STRASBOURG,0672459J,105,87,16,2,56,49,4 ème
BAS-RHIN,STRASBOURG,0673079H,86,86,0,0,41,45,4 ème
BAS-RHIN,STRASBOURG,0673178R,0,0,0,0,0,0,4 ème
BAS-RHIN,SUNDHOUSE,0670106B,113,110,0,3,45,68,4 ème
BAS-RHIN,TRUCHTERSHEIM,0670107C,176,176,0,0,85,91,4 ème
BAS-RHIN,WOERTH,0671596W,110,104,0,6,53,57,4 ème
HAUT-RHIN,ALTKIRCH,0680001G,0,0,0,0,0,0,4 ème
HAUT-RHIN,CERNAY,0680006M,179,177,0,2,80,99,4 ème
HAUT-RHIN,COLMAR,0680010S,0,0,0,0,0,0,4 ème
HAUT-RHIN,COLMAR,0680088B,118,115,0,3,52,66,4 ème
HAUT-RHIN,COLMAR,0681123B,198,161,34,3,92,106,4 ème
HAUT-RHIN,COLMAR,0681659J,159,159,0,0,67,92,4 ème
HAUT-RHIN,ENSISHEIM,0680013V,165,144,17,4,74,91,4 ème
HAUT-RHIN,HEGENHEIM,0681268J,178,178,0,0,83,95,4 ème
HAUT-RHIN,INGERSHEIM,0681817F,0,0,0,0,0,0,4 ème
HAUT-RHIN,LANDSER,0681660K,148,148,0,0,73,75,4 ème
HAUT-RHIN,MULHOUSE,0680039Y,0,0,0,0,0,0,4 ème
HAUT-RHIN,MULHOUSE,0680111B,172,143,27,2,90,82,4 ème
HAUT-RHIN,MULHOUSE,0681127F,199,168,25,6,103,96,4 ème
HAUT-RHIN,PFASTATT,0681267H,109,108,0,1,59,50,4 ème
HAUT-RHIN,RIBEAUVILLE,0680101R,171,169,0,2,85,86,4 ème
HAUT-RHIN,RIEDISHEIM,0680136D,157,157,0,0,76,81,4 ème
HAUT-RHIN,ROUFFACH,0681366R,105,104,0,1,57,48,4 ème
HAUT-RHIN,THANN,0681368T,159,117,34,8,74,85,4 ème
HAUT-RHIN,WITTELSHEIM,0681888H,0,0,0,0,0,0,4 ème
GUADELOUPE,ANSE-BERTRAND,9710025A,46,46,0,0,22,24,4 ème
GUADELOUPE,BAIE-MAHAULT,9711086D,191,188,0,3,96,95,4 ème
GUADELOUPE,BAILLIF,9710041T,51,51,0,0,35,16,4 ème
GUADELOUPE,BASSE-TERRE,9710985U,128,128,0,0,63,65,4 ème
GUADELOUPE,CAPESTERRE-DE-MARIE-GALANTE,9710032H,18,18,0,0,5,13,4 ème
GUADELOUPE,LE MOULE,9710015P,162,139,16,7,72,90,4 ème
GUADELOUPE,PETIT-CANAL,9710028D,97,93,0,4,46,51,4 ème
GUADELOUPE,POINTE-A-PITRE,9710686U,79,57,14,8,29,50,4 ème
GUADELOUPE,POINTE-A-PITRE,9710722H,0,0,0,0,0,0,4 ème
GUADELOUPE,POINTE-NOIRE,9710029E,44,44,0,0,20,24,4 ème
GUADELOUPE,SAINT-CLAUDE,9710036M,137,137,0,0,68,69,4 ème
GUADELOUPE,SAINTE-ANNE,9710687V,85,84,0,1,49,36,4 ème
GUADELOUPE,SAINT-MARTIN,9710022X,220,199,16,5,98,122,4 ème
GUADELOUPE,TERRE-DE-HAUT,9711155D,23,23,0,0,13,10,4 ème
GUYANE,CAYENNE,9730091L,215,207,0,8,97,118,4 ème
GUYANE,IRACOUBO,9730219A,38,31,7,0,20,18,4 ème
GUYANE,REMIRE-MONTJOLY,9730370P,175,164,0,11,99,76,4 ème
GUYANE,ROURA,9730289B,27,27,0,0,10,17,4 ème
GUYANE,SAINT-LAURENT-DU-MARONI,9730329V,306,272,29,5,158,148,4 ème
AISNE,BELLEU,0021659T,130,130,0,0,68,62,4 ème
AISNE,BOHAIN-EN-VERMANDOIS,0022131F,39,39,0,0,19,20,4 ème
AISNE,CHATEAU-THIERRY,0021724N,151,147,0,4,77,74,4 ème
AISNE,CHAUNY,0022008X,0,0,0,0,0,0,4 ème
AISNE,LA CAPELLE,0021595Y,75,72,0,3,33,42,4 ème
AISNE,LA FERE,0022210S,6,6,0,0,1,5,4 ème
AISNE,LE NOUVION-EN-THIERACHE,0020039G,74,72,0,2,38,36,4 ème
AISNE,LIESSE-NOTRE-DAME,0020472C,26,26,0,0,15,11,4 ème
AISNE,SAINT-GOBAIN,0020046P,66,64,0,2,38,28,4 ème
AISNE,SAINT-MICHEL,0021663X,39,39,0,0,20,19,4 ème
AISNE,SAINT-QUENTIN,0020079A,0,0,0,0,0,0,4 ème
AISNE,SISSONNE,0021686X,126,121,0,5,62,64,4 ème
AISNE,SOISSONS,0021492L,123,103,20,0,65,58,4 ème
AISNE,SOISSONS,0021691C,135,130,0,5,63,72,4 ème
AISNE,SOISSONS,0022180J,13,13,0,0,4,9,4 ème
AISNE,VILLERS-COTTERETS,0021688Z,131,120,9,2,70,61,4 ème
AISNE,WASSIGNY,0020072T,55,53,0,2,27,28,4 ème
OISE,AGNETZ,0601155E,199,196,0,3,101,98,4 ème
OISE,BEAUVAIS,0600007G,146,144,0,2,64,82,4 ème
OISE,BEAUVAIS,0601162M,0,0,0,0,0,0,4 ème
OISE,BORNEL,0602077G,146,142,0,4,73,73,4 ème
OISE,BREUIL-LE-VERT,0601787S,0,0,0,0,0,0,4 ème
OISE,CAUFFRY,0601607W,138,122,14,2,62,76,4 ème
OISE,COMPIEGNE,0601524F,88,70,15,3,45,43,4 ème
OISE,COULOISY,0600028E,130,130,0,0,64,66,4 ème
OISE,CREIL,0600022Y,164,164,0,0,67,97,4 ème
OISE,CREIL,0601177D,196,177,14,5,90,106,4 ème
OISE,ESTREES-SAINT-DENIS,0601432F,207,203,0,4,97,110,4 ème
OISE,FORMERIE,0601469W,96,76,16,4,47,49,4 ème
OISE,GRANDVILLIERS,0600030G,111,103,0,8,48,63,4 ème
OISE,LA CHAPELLE-EN-SERVAL,0601766U,102,102,0,0,59,43,4 ème
OISE,LASSIGNY,0601970R,108,108,0,0,61,47,4 ème
OISE,MAIGNELAY-MONTIGNY,0601180G,95,94,0,1,56,39,4 ème
OISE,MARGNY-LES-COMPIEGNE,0601193W,159,138,16,5,82,77,4 ème
OISE,NOAILLES,0601443T,183,176,0,7,86,97,4 ème
OISE,NOYON,0600041U,0,0,0,0,0,0,4 ème
OISE,NOYON,0601158H,71,71,0,0,27,44,4 ème
OISE,NOYON,0601605U,172,169,0,3,80,92,4 ème
OISE,PONT-SAINTE-MAXENCE,0601296H,113,110,0,3,53,60,4 ème
OISE,SENLIS,0600050D,114,114,0,0,53,61,4 ème
OISE,SENLIS,0601367K,126,110,16,0,61,65,4 ème
SOMME,ABBEVILLE,0801368C,101,100,0,1,54,47,4 ème
SOMME,ABBEVILLE,0801512J,168,144,16,8,82,86,4 ème
SOMME,AILLY-LE-HAUT-CLOCHER,0801372G,74,70,0,4,32,42,4 ème
SOMME,ALBERT,0801375K,86,81,0,5,39,47,4 ème
SOMME,AMIENS,0800013E,0,0,0,0,0,0,4 ème
SOMME,AMIENS,0801263N,112,109,0,3,58,54,4 ème
SOMME,AMIENS,0801533G,141,139,0,2,63,78,4 ème
SOMME,AMIENS,0801628K,0,0,0,0,0,0,4 ème
SOMME,AMIENS,0801949J,0,0,0,0,0,0,4 ème
SOMME,HAM,0801252B,0,0,0,0,0,0,4 ème
SOMME,MONTDIDIER,0801853E,0,0,0,0,0,0,4 ème
SOMME,OISEMONT,0800045P,52,52,0,0,21,31,4 ème
SOMME,PERONNE,0801951L,0,0,0,0,0,0,4 ème
SOMME,ROSIERES-EN-SANTERRE,0800051W,86,80,0,6,39,47,4 ème
SOMME,RUE,0801489J,65,65,0,0,40,25,4 ème
NORD,ANICHE,0592610S,0,0,0,0,0,0,4 ème
NORD,ANZIN,0590006L,136,136,0,0,64,72,4 ème
NORD,ARLEUX,0594401N,209,198,9,2,110,99,4 ème
NORD,ARMENTIERES,0592946G,69,69,0,0,34,35,4 ème
NORD,AVESNES-SUR-HELPE,0595384G,59,59,0,0,25,34,4 ème
NORD,BAVAY,0593490Y,166,162,0,4,84,82,4 ème
NORD,BERGUES,0592933T,121,121,0,0,50,71,4 ème
NORD,BRUAY-SUR-L'ESCAUT,0590031N,148,127,14,7,76,72,4 ème
NORD,CAMBRAI,0593171B,234,232,0,2,120,114,4 ème
NORD,COUDEKERQUE-BRANCHE,0593120W,95,90,5,0,49,46,4 ème
NORD,CYSOING,0590057S,168,164,0,4,69,99,4 ème
NORD,CYSOING,0592960X,200,200,0,0,95,105,4 ème
NORD,DECHY,0590058T,99,99,0,0,51,48,4 ème
NORD,DOUAI,0594402P,126,111,15,0,66,60,4 ème
NORD,DOUAI,0595190W,67,56,11,0,30,37,4 ème
NORD,DUNKERQUE,0593058D,0,0,0,0,0,0,4 ème
NORD,DUNKERQUE,0593663L,125,109,16,0,54,71,4 ème
NORD,DUNKERQUE,0593664M,82,81,0,1,38,44,4 ème
NORD,DUNKERQUE,0593666P,129,114,12,3,60,69,4 ème
NORD,ESTAIRES,0593103C,64,55,9,0,30,34,4 ème
NORD,FLINES-LEZ-RACHES,0590082U,65,65,0,0,33,32,4 ème
NORD,FOURMIES,0595177G,43,43,0,0,24,19,4 ème
NORD,GRAVELINES,0593123Z,96,96,0,0,44,52,4 ème
NORD,HAZEBROUCK,0595170Z,140,140,0,0,66,74,4 ème
NORD,IWUY,0590107W,82,82,0,0,43,39,4 ème
NORD,JEUMONT,0590109Y,70,67,0,3,35,35,4 ème
NORD,LA BASSEE,0592950L,201,201,0,0,90,111,4 ème
NORD,LAMBERSART,0595163S,84,73,11,0,34,50,4 ème
NORD,LEERS,0595713P,135,135,0,0,61,74,4 ème
NORD,LILLE,0590111A,0,0,0,0,0,0,4 ème
NORD,LILLE,0593006X,0,0,0,0,0,0,4 ème
NORD,LILLE,0596957S,0,0,0,0,0,0,4 ème
NORD,LINSELLES,0596172N,85,83,0,2,44,41,4 ème
NORD,LOOS,0590133Z,0,0,0,0,0,0,4 ème
NORD,LOOS,0593233U,106,106,0,0,48,58,4 ème
NORD,LOOS,0594541R,9,9,0,0,5,4,4 ème
NORD,LOURCHES,0594533G,138,138,0,0,66,72,4 ème
NORD,LOUVROIL,0593686L,79,79,0,0,43,36,4 ème
NORD,MARCQ-EN-BAROEUL,0595398X,364,364,0,0,170,194,4 ème
NORD,MARCQ-EN-BAROEUL,0597115N,41,41,0,0,22,19,4 ème
NORD,MAUBEUGE,0590151U,78,76,0,2,37,41,4 ème
NORD,MAUBEUGE,0593254S,80,65,10,5,41,39,4 ème
NORD,MOUVAUX,0594527A,74,65,7,2,35,39,4 ème
NORD,NIEPPE,0596988A,108,105,0,3,54,54,4 ème
NORD,ONNAING,0590157A,121,121,0,0,53,68,4 ème
NORD,QUIEVRECHAIN,0594303G,138,138,0,0,71,67,4 ème
NORD,RONCHIN,0594865T,91,86,0,5,45,46,4 ème
NORD,ROUBAIX,0592886S,102,102,0,0,51,51,4 ème
NORD,ROUBAIX,0592963A,0,0,0,0,0,0,4 ème
NORD,ROUBAIX,0595167W,99,97,0,2,46,53,4 ème
NORD,ROUBAIX,0595302T,194,183,0,11,101,93,4 ème
NORD,SAINT-AMAND-LES-EAUX,0590192N,0,0,0,0,0,0,4 ème
NORD,SAINT-AMAND-LES-EAUX,0594411Z,180,162,13,5,66,114,4 ème
NORD,SECLIN,0592833J,0,0,0,0,0,0,4 ème
NORD,SECLIN,0593662K,124,107,17,0,60,64,4 ème
NORD,SOMAIN,0592976P,0,0,0,0,0,0,4 ème
NORD,TOURCOING,0590217R,0,0,0,0,0,0,4 ème
NORD,TOURCOING,0592965C,0,0,0,0,0,0,4 ème
NORD,TOURCOING,0592980U,0,0,0,0,0,0,4 ème
NORD,VALENCIENNES,0590224Y,126,126,0,0,61,65,4 ème
NORD,VIEUX-CONDE,0594412A,182,165,14,3,89,93,4 ème
NORD,VILLENEUVE-D'ASCQ,0595328W,143,128,15,0,73,70,4 ème
NORD,VILLENEUVE-D'ASCQ,0595404D,330,330,0,0,155,175,4 ème
NORD,WATTIGNIES,0595597N,118,118,0,0,60,58,4 ème
NORD,WATTRELOS,0593160P,337,337,0,0,172,165,4 ème
NORD,WATTRELOS,0594392D,56,56,0,0,23,33,4 ème
NORD,WATTRELOS,0595169Y,86,80,0,6,42,44,4 ème
NORD,WORMHOUT,0594643B,135,135,0,0,64,71,4 ème
PAS-DE-CALAIS,AIRE-SUR-LA-LYS,0622100W,192,192,0,0,92,100,4 ème
PAS-DE-CALAIS,ARRAS,0620011A,0,0,0,0,0,0,4 ème
PAS-DE-CALAIS,ARRAS,0622789V,90,78,9,3,48,42,4 ème
PAS-DE-CALAIS,ARRAS,0624343J,71,58,10,3,29,42,4 ème
PAS-DE-CALAIS,AUCHEL,0623313P,87,87,0,0,50,37,4 ème
PAS-DE-CALAIS,AUCHY-LES-HESDIN,0622097T,42,42,0,0,28,14,4 ème
PAS-DE-CALAIS,AUXI-LE-CHATEAU,0620025R,46,46,0,0,23,23,4 ème
PAS-DE-CALAIS,AVESNES-LE-COMTE,0620026S,120,107,12,1,66,54,4 ème
PAS-DE-CALAIS,AVION,0622420U,125,101,21,3,52,73,4 ème
PAS-DE-CALAIS,AVION,0622422W,138,138,0,0,60,78,4 ème
PAS-DE-CALAIS,BETHUNE,0622129C,118,118,0,0,59,59,4 ème
PAS-DE-CALAIS,BETHUNE,0622947S,185,169,16,0,101,84,4 ème
PAS-DE-CALAIS,BRUAY-LA-BUISSIERE,0623314R,83,83,0,0,48,35,4 ème
PAS-DE-CALAIS,CALAIS,0622211S,0,0,0,0,0,0,4 ème
PAS-DE-CALAIS,COULOGNE,0620073T,94,89,0,5,42,52,4 ème
PAS-DE-CALAIS,COURCELLES-LES-LENS,0622943M,122,103,17,2,65,57,4 ème
PAS-DE-CALAIS,DESVRES,0622135J,68,68,0,0,22,46,4 ème
PAS-DE-CALAIS,FRUGES,0620085F,66,66,0,0,23,43,4 ème
PAS-DE-CALAIS,HENIN-BEAUMONT,0623328F,0,0,0,0,0,0,4 ème
PAS-DE-CALAIS,HERSIN-COUPIGNY,0620097U,81,81,0,0,40,41,4 ème
PAS-DE-CALAIS,LAVENTIE,0622427B,156,156,0,0,78,78,4 ème
PAS-DE-CALAIS,LENS,0622115M,280,278,0,2,140,140,4 ème
PAS-DE-CALAIS,LE PORTEL,0622095R,126,101,25,0,59,67,4 ème
PAS-DE-CALAIS,LIEVIN,0623377J,0,0,0,0,0,0,4 ème
PAS-DE-CALAIS,MARCK,0622873L,144,144,0,0,70,74,4 ème
PAS-DE-CALAIS,MARLES-LES-MINES,0622272H,105,101,0,4,40,65,4 ème
PAS-DE-CALAIS,NORRENT-FONTES,0620195A,118,118,0,0,55,63,4 ème
PAS-DE-CALAIS,NOYELLES-SOUS-LENS,0623016S,90,88,0,2,42,48,4 ème
PAS-DE-CALAIS,OUTREAU,0620221D,0,0,0,0,0,0,4 ème
PAS-DE-CALAIS,PAS-EN-ARTOIS,0623112W,102,102,0,0,48,54,4 ème
PAS-DE-CALAIS,SAINT-OMER,0620165T,148,147,0,1,66,82,4 ème
PAS-DE-CALAIS,SAINT-OMER,0622119S,40,38,0,2,21,19,4 ème
PAS-DE-CALAIS,SAINT-POL-SUR-TERNOISE,0622790W,152,135,14,3,76,76,4 ème
PAS-DE-CALAIS,THEROUANNE,0620172A,177,173,0,4,91,86,4 ème
PAS-DE-CALAIS,VERMELLES,0623022Y,104,103,0,1,46,58,4 ème
SEINE-ET-MARNE,AVON,0771422C,124,104,16,4,58,66,4 ème
SEINE-ET-MARNE,CESSON,0771662N,115,109,0,6,57,58,4 ème
SEINE-ET-MARNE,CHAMPAGNE-SUR-SEINE,0771342R,170,153,16,1,77,93,4 ème
SEINE-ET-MARNE,CHELLES,0771766B,178,158,16,4,83,95,4 ème
SEINE-ET-MARNE,COULOMMIERS,0770924L,0,0,0,0,0,0,4 ème
SEINE-ET-MARNE,CRECY-LA-CHAPELLE,0771667U,164,163,0,1,74,90,4 ème
SEINE-ET-MARNE,CREGY-LES-MEAUX,0772248A,160,155,0,5,79,81,4 ème
SEINE-ET-MARNE,FONTAINEBLEAU,0771424E,113,113,0,0,54,59,4 ème
SEINE-ET-MARNE,JUILLY,0771917R,116,116,0,0,59,57,4 ème
SEINE-ET-MARNE,LA FERTE-GAUCHER,0771661M,180,165,14,1,97,83,4 ème
SEINE-ET-MARNE,LA FERTE-SOUS-JOUARRE,0771222K,123,123,0,0,63,60,4 ème
SEINE-ET-MARNE,LA FERTE-SOUS-JOUARRE,0771659K,118,103,15,0,47,71,4 ème
SEINE-ET-MARNE,LAGNY-SUR-MARNE,0771768D,139,124,15,0,72,67,4 ème
SEINE-ET-MARNE,LE MEE-SUR-SEINE,0772056S,130,128,0,2,61,69,4 ème
SEINE-ET-MARNE,LIEUSAINT,0772429X,84,79,0,5,42,42,4 ème
SEINE-ET-MARNE,LOGNES,0772125S,110,110,0,0,63,47,4 ème
SEINE-ET-MARNE,LORREZ-LE-BOCAGE-PREAUX,0770030P,119,119,0,0,64,55,4 ème
SEINE-ET-MARNE,MEAUX,0771029A,173,173,0,0,75,98,4 ème
SEINE-ET-MARNE,MEAUX,0771173G,157,157,0,0,80,77,4 ème
SEINE-ET-MARNE,MELUN,0770934X,0,0,0,0,0,0,4 ème
SEINE-ET-MARNE,MITRY-MORY,0771331D,152,136,16,0,75,77,4 ème
SEINE-ET-MARNE,MONTEREAU-FAULT-YONNE,0771174H,123,123,0,0,61,62,4 ème
SEINE-ET-MARNE,NOISIEL,0771940R,0,0,0,0,0,0,4 ème
SEINE-ET-MARNE,PERTHES,0772427V,140,140,0,0,69,71,4 ème
SEINE-ET-MARNE,ROISSY-EN-BRIE,0771563F,189,189,0,0,80,109,4 ème
SEINE-ET-MARNE,SAINT-GERMAIN-SUR-MORIN,0772714G,133,132,0,1,73,60,4 ème
SEINE-ET-MARNE,SAINT-THIBAULT-DES-VIGNES,0772154Y,140,137,0,3,64,76,4 ème
SEINE-ET-MARNE,TRILPORT,0772091E,128,124,0,4,55,73,4 ème
SEINE-ET-MARNE,VILLEPARISIS,0771878Y,166,151,14,1,76,90,4 ème
SEINE-SAINT-DENIS,AUBERVILLIERS,0930903B,103,103,0,0,56,47,4 ème
SEINE-SAINT-DENIS,AUBERVILLIERS,0932122B,0,0,0,0,0,0,4 ème
SEINE-SAINT-DENIS,AULNAY-SOUS-BOIS,0930846P,0,0,0,0,0,0,4 ème
SEINE-SAINT-DENIS,AULNAY-SOUS-BOIS,0931434D,148,142,0,6,85,63,4 ème
SEINE-SAINT-DENIS,AULNAY-SOUS-BOIS,0932652C,61,61,0,0,33,28,4 ème
SEINE-SAINT-DENIS,DRANCY,0930892P,151,151,0,0,69,82,4 ème
SEINE-SAINT-DENIS,DUGNY,0931376R,162,159,0,3,84,78,4 ème
SEINE-SAINT-DENIS,EPINAY-SUR-SEINE,0931145P,184,170,14,0,85,99,4 ème
SEINE-SAINT-DENIS,EPINAY-SUR-SEINE,0931207G,121,120,0,1,61,60,4 ème
SEINE-SAINT-DENIS,LA COURNEUVE,0931188L,191,189,0,2,94,97,4 ème
SEINE-SAINT-DENIS,LA COURNEUVE,0931738J,0,0,0,0,0,0,4 ème
SEINE-SAINT-DENIS,LE RAINCY,0930629D,179,179,0,0,81,98,4 ème
SEINE-SAINT-DENIS,LES PAVILLONS-SOUS-BOIS,0930089S,150,148,0,2,90,60,4 ème
SEINE-SAINT-DENIS,LES PAVILLONS-SOUS-BOIS,0930966V,67,67,0,0,35,32,4 ème
SEINE-SAINT-DENIS,MONTREUIL,0931210K,122,119,0,3,60,62,4 ème
SEINE-SAINT-DENIS,NEUILLY-PLAISANCE,0930623X,193,189,0,4,100,93,4 ème
SEINE-SAINT-DENIS,NEUILLY-SUR-MARNE,0930894S,197,177,16,4,93,104,4 ème
SEINE-SAINT-DENIS,NOISY-LE-GRAND,0931369H,0,0,0,0,0,0,4 ème
SEINE-SAINT-DENIS,NOISY-LE-SEC,0931710D,108,108,0,0,48,60,4 ème
SEINE-SAINT-DENIS,NOISY-LE-SEC,0931883S,73,70,0,3,32,41,4 ème
SEINE-SAINT-DENIS,PANTIN,0931217T,115,112,0,3,60,55,4 ème
SEINE-SAINT-DENIS,PANTIN,0931218U,144,144,0,0,74,70,4 ème
SEINE-SAINT-DENIS,PANTIN,0931764M,0,0,0,0,0,0,4 ème
SEINE-SAINT-DENIS,ROSNY-SOUS-BOIS,0930593P,187,174,13,0,94,93,4 ème
SEINE-SAINT-DENIS,ROSNY-SOUS-BOIS,0931723T,130,124,0,6,69,61,4 ème
SEINE-SAINT-DENIS,SAINT-DENIS,0930138V,0,0,0,0,0,0,4 ème
SEINE-SAINT-DENIS,SAINT-DENIS,0931232J,127,112,15,0,55,72,4 ème
SEINE-SAINT-DENIS,SAINT-DENIS,0932582B,115,115,0,0,50,65,4 ème
SEINE-SAINT-DENIS,SEVRAN,0931190N,158,142,16,0,77,81,4 ème
SEINE-SAINT-DENIS,SEVRAN,0932262D,160,160,0,0,74,86,4 ème
SEINE-SAINT-DENIS,TREMBLAY-EN-FRANCE,0931193S,0,0,0,0,0,0,4 ème
SEINE-SAINT-DENIS,VAUJOURS,0932301W,130,130,0,0,70,60,4 ème
SEINE-SAINT-DENIS,VILLEPINTE,0931192R,145,139,0,6,73,72,4 ème
VAL-DE-MARNE,BONNEUIL-SUR-MARNE,0940171A,7,0,7,0,2,5,4 ème
VAL-DE-MARNE,CHARENTON-LE-PONT,0941353K,163,163,0,0,83,80,4 ème
VAL-DE-MARNE,CHOISY-LE-ROI,0940141T,0,0,0,0,0,0,4 ème
VAL-DE-MARNE,CHOISY-LE-ROI,0941710Y,131,131,0,0,62,69,4 ème
VAL-DE-MARNE,CRETEIL,0940521F,128,128,0,0,62,66,4 ème
VAL-DE-MARNE,CRETEIL,0940884A,120,120,0,0,71,49,4 ème
VAL-DE-MARNE,CRETEIL,0942127B,116,112,0,4,59,57,4 ème
VAL-DE-MARNE,IVRY-SUR-SEINE,0941781A,145,145,0,0,68,77,4 ème
VAL-DE-MARNE,LE KREMLIN-BICETRE,0940809U,87,85,0,2,46,41,4 ème
VAL-DE-MARNE,LE KREMLIN-BICETRE,0941679P,81,81,0,0,43,38,4 ème
VAL-DE-MARNE,LIMEIL-BREVANNES,0941603G,157,140,15,2,67,90,4 ème
VAL-DE-MARNE,MAISONS-ALFORT,0941596Z,185,166,15,4,82,103,4 ème
VAL-DE-MARNE,ORMESSON-SUR-MARNE,0941017V,139,132,0,7,65,74,4 ème
VAL-DE-MARNE,SAINT-MANDE,0940024R,24,24,0,0,13,11,4 ème
VAL-DE-MARNE,SAINT-MAUR-DES-FOSSES,0940879V,112,112,0,0,52,60,4 ème
VAL-DE-MARNE,THIAIS,0940090M,175,175,0,0,83,92,4 ème
VAL-DE-MARNE,VILLEJUIF,0941039U,107,106,0,1,63,44,4 ème
VAL-DE-MARNE,VILLENEUVE-LE-ROI,0941602F,116,111,0,5,65,51,4 ème
VAL-DE-MARNE,VILLENEUVE-SAINT-GEORGES,0940791Z,161,146,15,0,75,86,4 ème
VAL-DE-MARNE,VILLENEUVE-SAINT-GEORGES,0941952L,0,0,0,0,0,0,4 ème
VAL-DE-MARNE,VILLIERS-SUR-MARNE,0941411Y,155,145,10,0,79,76,4 ème
VAL-DE-MARNE,VINCENNES,0940793B,170,170,0,0,78,92,4 ème
VAL-DE-MARNE,VITRY-SUR-SEINE,0940874P,95,95,0,0,55,40,4 ème
VAL-DE-MARNE,VITRY-SUR-SEINE,0941032L,110,110,0,0,67,43,4 ème
VAL-DE-MARNE,VITRY-SUR-SEINE,0941294W,0,0,0,0,0,0,4 ème
PARIS,PARIS,0750362L,104,104,0,0,51,53,4 ème
PARIS,PARIS,0750465Y,98,97,0,1,52,46,4 ème
PARIS,PARIS,0750558Z,0,0,0,0,0,0,4 ème
PARIS,PARIS,0752537A,114,110,0,4,49,65,4 ème
PARIS,PARIS,0752911G,119,115,0,4,51,68,4 ème
PARIS,PARIS,0752934G,261,258,0,3,136,125,4 ème
PARIS,PARIS,0753518S,136,129,0,7,64,72,4 ème
PARIS,PARIS,0753985Z,149,144,0,5,72,77,4 ème
PARIS,PARIS,0754861B,3,0,0,3,0,3,4 ème
PARIS,PARIS,0755000C,135,135,0,0,68,67,4 ème
PARIS,PARIS,0752544H,126,126,0,0,52,74,4 ème
PARIS,PARIS,0755840R,45,45,0,0,21,24,4 ème
PARIS,PARIS,0750436S,0,0,0,0,0,0,4 ème
PARIS,PARIS,0750793E,0,0,0,0,0,0,4 ème
PARIS,PARIS,0752192A,112,107,0,5,52,60,4 ème
PARIS,PARIS,0752317L,110,110,0,0,56,54,4 ème
PARIS,PARIS,0752870M,285,285,0,0,116,169,4 ème
PARIS,PARIS,0752897S,154,154,0,0,96,58,4 ème
PARIS,PARIS,0752918P,158,158,0,0,103,55,4 ème
PARIS,PARIS,0755779Z,124,111,13,0,62,62,4 ème
PARIS,PARIS,0752195D,90,90,0,0,46,44,4 ème
PARIS,PARIS,0750575T,93,90,0,3,47,46,4 ème
PARIS,PARIS,0751707Y,101,85,13,3,43,58,4 ème
PARIS,PARIS,0753938Y,115,115,0,0,62,53,4 ème
PARIS,PARIS,0754004V,120,120,0,0,55,65,4 ème
PARIS,PARIS,0750552T,123,117,0,6,74,49,4 ème
PARIS,PARIS,0752198G,123,109,12,2,61,62,4 ème
PARIS,PARIS,0753939Z,84,84,0,0,39,45,4 ème
PARIS,PARIS,0752525M,118,117,0,1,53,65,4 ème
PARIS,PARIS,0752920S,153,153,0,0,78,75,4 ème
PARIS,PARIS,0752186U,118,114,0,4,57,61,4 ème
PARIS,PARIS,0752531U,91,87,0,4,48,43,4 ème
PARIS,PARIS,0752925X,87,87,0,0,49,38,4 ème
PARIS,PARIS,0754008Z,20,18,0,2,4,16,4 ème
PARIS,PARIS,0754029X,0,0,0,0,0,0,4 ème
PARIS,PARIS,0753854G,20,20,0,0,20,0,4 ème
PARIS,PARIS,0751791P,209,209,0,0,93,116,4 ème
PARIS,PARIS,0752529S,120,112,0,8,58,62,4 ème
PARIS,PARIS,0752532V,140,136,0,4,61,79,4 ème
PARIS,PARIS,0752916M,18,8,0,10,3,15,4 ème
ESSONNE,BONDOUFLE,0911340M,173,170,0,3,81,92,4 ème
ESSONNE,BRETIGNY-SUR-ORGE,0911039K,206,200,0,6,102,104,4 ème
ESSONNE,CROSNE,0910979V,258,256,0,2,127,131,4 ème
ESSONNE,DOURDAN,0911491B,205,185,16,4,90,115,4 ème
ESSONNE,DRAVEIL,0910830H,98,98,0,0,55,43,4 ème
ESSONNE,DRAVEIL,0910973N,144,129,14,1,67,77,4 ème
ESSONNE,EPINAY-SOUS-SENART,0911397Z,171,166,0,5,92,79,4 ème
ESSONNE,ETAMPES,0910717K,141,141,0,0,70,71,4 ème
ESSONNE,ETAMPES,0911150F,137,134,0,3,72,65,4 ème
ESSONNE,ETAMPES,0911401D,0,0,0,0,0,0,4 ème
ESSONNE,GRIGNY,0911253T,146,138,0,8,81,65,4 ème
ESSONNE,IGNY,0911824N,41,41,0,0,20,21,4 ème
ESSONNE,LES ULIS,0911334F,149,132,16,1,77,72,4 ème
ESSONNE,LONGJUMEAU,0910718L,179,179,0,0,90,89,4 ème
ESSONNE,MASSY,0910624J,109,107,0,2,61,48,4 ème
ESSONNE,ORSAY,0910968H,121,116,0,5,58,63,4 ème
ESSONNE,PALAISEAU,0910045E,109,109,0,0,52,57,4 ème
ESSONNE,PALAISEAU,0912321D,0,0,0,0,0,0,4 ème
ESSONNE,PARAY-VIEILLE-POSTE,0911441X,119,119,0,0,61,58,4 ème
ESSONNE,SAINT-CHERON,0911256W,165,162,0,3,87,78,4 ème
ESSONNE,SAINT-MICHEL-SUR-ORGE,0910775Y,185,185,0,0,99,86,4 ème
ESSONNE,SAULX-LES-CHARTREUX,0911029Z,191,174,15,2,91,100,4 ème
ESSONNE,VERRIERES-LE-BUISSON,0910057T,137,137,0,0,76,61,4 ème
ESSONNE,VIGNEUX-SUR-SEINE,0910776Z,160,159,0,1,78,82,4 ème
ESSONNE,VIRY-CHATILLON,0910060W,127,127,0,0,61,66,4 ème
ESSONNE,YERRES,0910756C,0,0,0,0,0,0,4 ème
HAUTS-DE-SEINE,ANTONY,0921170X,142,139,0,3,65,77,4 ème
HAUTS-DE-SEINE,ASNIERES-SUR-SEINE,0921547G,131,129,0,2,67,64,4 ème
HAUTS-DE-SEINE,BAGNEUX,0921168V,132,116,9,7,71,61,4 ème
HAUTS-DE-SEINE,CHATENAY-MALABRY,0921179G,68,63,0,5,29,39,4 ème
HAUTS-DE-SEINE,CHATILLON,0921354X,126,126,0,0,65,61,4 ème
HAUTS-DE-SEINE,COURBEVOIE,0920999L,124,124,0,0,62,62,4 ème
HAUTS-DE-SEINE,FONTENAY-AUX-ROSES,0920963X,0,0,0,0,0,0,4 ème
HAUTS-DE-SEINE,GENNEVILLIERS,0921157H,250,244,0,6,129,121,4 ème
HAUTS-DE-SEINE,LA GARENNE-COLOMBES,0922645A,128,126,0,2,75,53,4 ème
HAUTS-DE-SEINE,LEVALLOIS-PERRET,0921393P,160,159,0,1,79,81,4 ème
HAUTS-DE-SEINE,MALAKOFF,0921165S,114,109,0,5,55,59,4 ème
HAUTS-DE-SEINE,MEUDON,0922450N,226,226,0,0,113,113,4 ème
HAUTS-DE-SEINE,MONTROUGE,0921504K,124,123,0,1,52,72,4 ème
HAUTS-DE-SEINE,NANTERRE,0921394R,124,107,16,1,55,69,4 ème
HAUTS-DE-SEINE,NANTERRE,0922579D,23,23,0,0,13,10,4 ème
HAUTS-DE-SEINE,NEUILLY-SUR-SEINE,0921780K,174,174,0,0,83,91,4 ème
HAUTS-DE-SEINE,NEUILLY-SUR-SEINE,0921913E,201,201,0,0,90,111,4 ème
HAUTS-DE-SEINE,NEUILLY-SUR-SEINE,0921914F,201,198,0,3,100,101,4 ème
HAUTS-DE-SEINE,RUEIL-MALMAISON,0921501G,149,143,0,6,72,77,4 ème
HAUTS-DE-SEINE,SAINT-CLOUD,0921591E,188,188,0,0,82,106,4 ème
HAUTS-DE-SEINE,SEVRES,0920936T,32,32,0,0,14,18,4 ème
HAUTS-DE-SEINE,SURESNES,0920885M,98,95,3,0,44,54,4 ème
HAUTS-DE-SEINE,SURESNES,0921178F,88,88,0,0,48,40,4 ème
HAUTS-DE-SEINE,VAUCRESSON,0921919L,29,29,0,0,12,17,4 ème
HAUTS-DE-SEINE,VILLENEUVE-LA-GARENNE,0921159K,136,134,0,2,61,75,4 ème
VAL-D'OISE,ARGENTEUIL,0950788R,123,121,0,2,66,57,4 ème
VAL-D'OISE,ARGENTEUIL,0950885W,123,120,0,3,59,64,4 ème
VAL-D'OISE,ARGENTEUIL,0950886X,138,122,12,4,73,65,4 ème
VAL-D'OISE,BESSANCOURT,0951400F,131,129,0,2,70,61,4 ème
VAL-D'OISE,CERGY,0951964U,135,134,0,1,71,64,4 ème
VAL-D'OISE,CORMEILLES-EN-PARISIS,0952236P,102,101,0,1,44,58,4 ème
VAL-D'OISE,EAUBONNE,0950892D,140,140,0,0,60,80,4 ème
VAL-D'OISE,ERAGNY,0951194G,141,138,0,3,72,69,4 ème
VAL-D'OISE,GONESSE,0950025L,176,174,0,2,81,95,4 ème
VAL-D'OISE,GONESSE,0951142A,153,133,16,4,80,73,4 ème
VAL-D'OISE,GOUSSAINVILLE,0951921X,155,155,0,0,74,81,4 ème
VAL-D'OISE,JOUY-LE-MOUTIER,0951801S,111,107,0,4,48,63,4 ème
VAL-D'OISE,LOUVRES,0952145R,118,118,0,0,67,51,4 ème
VAL-D'OISE,MAGNY-EN-VEXIN,0951102G,131,128,0,3,60,71,4 ème
VAL-D'OISE,MARLY-LA-VILLE,0951919V,119,119,0,0,46,73,4 ème
VAL-D'OISE,MONTMAGNY,0951141Z,156,154,0,2,67,89,4 ème
VAL-D'OISE,MONTMAGNY,0952010U,16,16,0,0,5,11,4 ème
VAL-D'OISE,MONTMORENCY,0950891C,115,101,11,3,61,54,4 ème
VAL-D'OISE,OSNY,0951403J,139,133,0,6,73,66,4 ème
VAL-D'OISE,PONTOISE,0950896H,162,142,17,3,76,86,4 ème
VAL-D'OISE,SAINT-BRICE-SOUS-FORET,0950931W,155,153,0,2,70,85,4 ème
VAL-D'OISE,SAINT-LEU-LA-FORET,0950748X,158,158,0,0,75,83,4 ème
VAL-D'OISE,SAINT-LEU-LA-FORET,0950763N,183,183,0,0,94,89,4 ème
VAL-D'OISE,TAVERNY,0950945L,158,145,13,0,64,94,4 ème
VAL-D'OISE,VIARMES,0951052C,149,149,0,0,69,80,4 ème
VAL-D'OISE,VILLIERS-LE-BEL,0950939E,138,119,14,5,60,78,4 ème
YVELINES,ACHERES,0783248G,160,143,16,1,84,76,4 ème
YVELINES,BOIS-D'ARCY,0780261K,192,188,0,4,90,102,4 ème
YVELINES,BONNIERES-SUR-SEINE,0783300N,59,59,0,0,27,32,4 ème
YVELINES,CARRIERES-SUR-SEINE,0780033M,175,175,0,0,91,84,4 ème
YVELINES,CONFLANS-SAINTE-HONORINE,0781985J,135,135,0,0,63,72,4 ème
YVELINES,JOUARS-PONTCHARTRAIN,0781632A,169,165,0,4,87,82,4 ème
YVELINES,LA CELLE-SAINT-CLOUD,0780504Z,114,114,0,0,52,62,4 ème
YVELINES,LE MESNIL-SAINT-DENIS,0783342J,101,101,0,0,55,46,4 ème
YVELINES,LE PECQ,0780263M,154,138,16,0,80,74,4 ème
YVELINES,LE PECQ,0783215W,82,75,0,7,41,41,4 ème
YVELINES,LES CLAYES-SOUS-BOIS,0780760C,110,106,0,4,50,60,4 ème
YVELINES,LE VESINET,0781594J,174,174,0,0,79,95,4 ème
YVELINES,MAISONS-LAFFITTE,0783156G,139,134,0,5,71,68,4 ème
YVELINES,MAULE,0780709X,214,214,0,0,108,106,4 ème
YVELINES,MONTESSON,0780578E,173,170,0,3,81,92,4 ème
YVELINES,POISSY,0781591F,141,141,0,0,78,63,4 ème
YVELINES,SAINT-ARNOULT-EN-YVELINES,0780712A,164,164,0,0,78,86,4 ème
YVELINES,SAINT-CYR-L'ECOLE,0782593V,0,0,0,0,0,0,4 ème
YVELINES,SARTROUVILLE,0780258G,208,193,15,0,110,98,4 ème
YVELINES,TRAPPES,0780514K,166,166,0,0,84,82,4 ème
YVELINES,TRAPPES,0780584L,0,0,0,0,0,0,4 ème
YVELINES,VERSAILLES,0780580G,150,150,0,0,83,67,4 ème
YVELINES,VERSAILLES,0780718G,103,102,0,1,44,59,4 ème
YVELINES,VERSAILLES,0781597M,384,381,0,3,175,209,4 ème
YVELINES,VERSAILLES,0783295H,245,245,0,0,105,140,4 ème
YVELINES,VOISINS-LE-BRETONNEUX,0781570H,108,108,0,0,51,57,4 ème
LA REUNION,LA POSSESSION,9741236A,184,181,0,3,89,95,4 ème
LA REUNION,LE PORT,9741313J,161,126,32,3,79,82,4 ème
LA REUNION,LE TAMPON,9740620F,230,224,0,6,100,130,4 ème
LA REUNION,LE TAMPON,9740652R,245,205,33,7,111,134,4 ème
LA REUNION,LE TAMPON,9741088P,96,93,0,3,47,49,4 ème
LA REUNION,LE TAMPON,9741262D,165,164,0,1,69,96,4 ème
LA REUNION,L'ETANG-SALE,9740813R,140,136,0,4,71,69,4 ème
LA REUNION,SAINT-ANDRE,9741261C,167,163,0,4,74,93,4 ème
LA REUNION,SAINT-BENOIT,9741366S,189,181,0,8,91,98,4 ème
LA REUNION,SAINT-BENOIT,9741546M,149,134,15,0,75,74,4 ème
LA REUNION,SAINT-DENIS,9740042C,188,178,7,3,98,90,4 ème
LA REUNION,SAINT-DENIS,9741208V,118,115,0,3,57,61,4 ème
LA REUNION,SAINTE-MARIE,9740022F,147,147,0,0,73,74,4 ème
LA REUNION,SAINTE-SUZANNE,9741237B,224,221,0,3,117,107,4 ème
LA REUNION,SAINT-JOSEPH,9740578K,222,221,0,1,115,107,4 ème
LA REUNION,SAINT-LOUIS,9740012V,164,160,0,4,86,78,4 ème
LA REUNION,SAINT-LOUIS,9740091F,195,186,0,9,101,94,4 ème
LA REUNION,SAINT-PIERRE,9741630D,64,64,0,0,46,18,4 ème
MARTINIQUE,GROS-MORNE,9720012F,85,69,14,2,39,46,4 ème
MARTINIQUE,LA TRINITE,9720025V,88,83,0,5,42,46,4 ème
MARTINIQUE,LA TRINITE,9720351Z,64,45,19,0,28,36,4 ème
MARTINIQUE,LE LORRAIN,9720726G,0,0,0,0,0,0,4 ème
MARTINIQUE,LE MARIN,9720468B,0,0,0,0,0,0,4 ème
MARTINIQUE,LE ROBERT,9720861D,120,96,18,6,55,65,4 ème
MARTINIQUE,LES ANSES-D'ARLET,9720565G,37,29,8,0,21,16,4 ème
MARTINIQUE,RIVIERE-SALEE,9720725F,0,0,0,0,0,0,4 ème
MARTINIQUE,SAINTE-LUCE,9720449F,76,75,0,1,36,40,4 ème
MARTINIQUE,SAINTE-LUCE,9720776L,99,99,0,0,53,46,4 ème
MARTINIQUE,SAINT-ESPRIT,9720020P,101,95,0,6,46,55,4 ème
MAYOTTE,MAMOUDZOU,9760009F,394,391,0,3,201,193,4 ème
MAYOTTE,MAMOUDZOU,9760368W,379,348,27,4,179,200,4 ème
MAYOTTE,OUANGANI,9760371Z,346,315,29,2,181,165,4 ème
MAYOTTE,PAMANDZI,9760183V,348,339,0,9,178,170,4 ème
MAYOTTE,SADA,9760180S,309,306,0,3,158,151,4 ème
CALVADOS,BLAINVILLE-SUR-ORNE,0141940H,81,78,0,3,40,41,4 ème
CALVADOS,CAEN,0140019V,0,0,0,0,0,0,4 ème
CALVADOS,CAEN,0141160K,216,216,0,0,123,93,4 ème
CALVADOS,CAEN,0141212S,117,113,0,4,57,60,4 ème
CALVADOS,CAEN,0141313B,92,90,0,2,37,55,4 ème
CALVADOS,DEAUVILLE,0141192V,0,0,0,0,0,0,4 ème
CALVADOS,DIVES-SUR-MER,0141270E,87,76,9,2,53,34,4 ème
CALVADOS,DOUVRES-LA-DELIVRANDE,0140049C,129,129,0,0,59,70,4 ème
CALVADOS,DOZULE,0140050D,93,87,0,6,47,46,4 ème
CALVADOS,FLEURY-SUR-ORNE,0141553M,127,122,0,5,74,53,4 ème
CALVADOS,HONFLEUR,0141168U,26,26,0,0,10,16,4 ème
CALVADOS,HONFLEUR,0141765T,126,126,0,0,73,53,4 ème
CALVADOS,LISIEUX,0141135H,172,157,15,0,88,84,4 ème
CALVADOS,LISIEUX,0141315D,72,71,0,1,35,37,4 ème
CALVADOS,LISIEUX,0141862Y,145,145,0,0,65,80,4 ème
CALVADOS,SAINT-PIERRE-EN-AUGE,0141226G,96,96,0,0,51,45,4 ème
CALVADOS,SAINT-PIERRE-EN-AUGE,0141272G,88,83,0,5,42,46,4 ème
CALVADOS,TILLY-SUR-SEULLES,0140081M,86,86,0,0,48,38,4 ème
CALVADOS,VIRE NORMANDIE,0141864A,54,54,0,0,31,23,4 ème
CALVADOS,VIRE NORMANDIE,0142145F,73,69,0,4,42,31,4 ème
CALVADOS,VIRE NORMANDIE,0142178S,0,0,0,0,0,0,4 ème
EURE,BEAUMONT-LE-ROGER,0271267F,129,127,0,2,58,71,4 ème
EURE,BERNAY,0271448C,62,62,0,0,28,34,4 ème
EURE,BERNAY,0271581X,0,0,0,0,0,0,4 ème
EURE,BRETEUIL,0270008M,89,89,0,0,50,39,4 ème
EURE,BRIONNE,0270010P,156,134,16,6,78,78,4 ème
EURE,CONCHES-EN-OUCHE,0271094T,150,144,0,6,76,74,4 ème
EURE,ETREPAGNY,0271106F,138,134,0,4,71,67,4 ème
EURE,EVREUX,0270020A,111,111,0,0,52,59,4 ème
EURE,EVREUX,0271070S,0,0,0,0,0,0,4 ème
EURE,GAILLON,0270025F,144,139,0,5,70,74,4 ème
EURE,GISORS,0271047S,76,76,0,0,39,37,4 ème
EURE,LOUVIERS,0271398Y,90,90,0,0,44,46,4 ème
EURE,MESNILS-SUR-ITON,0271060F,131,131,0,0,65,66,4 ème
EURE,NONANCOURT,0270033P,171,171,0,0,79,92,4 ème
EURE,THIBERVILLE,0271099Y,84,84,0,0,38,46,4 ème
EURE,VERNEUIL D'AVRE ET D'ITON,0270043A,139,118,16,5,69,70,4 ème
EURE,VERNON,0271289E,149,133,16,0,78,71,4 ème
EURE,VERNON,0271399Z,97,93,0,4,39,58,4 ème
MANCHE,AGNEAUX,0501701C,126,126,0,0,68,58,4 ème
MANCHE,CARENTAN-LES-MARAIS,0500012S,85,80,0,5,45,40,4 ème
MANCHE,CHERBOURG-EN-COTENTIN,0500034R,104,104,0,0,44,60,4 ème
MANCHE,CHERBOURG-EN-COTENTIN,0500062W,110,105,0,5,54,56,4 ème
MANCHE,CHERBOURG-EN-COTENTIN,0501788X,0,0,0,0,0,0,4 ème
MANCHE,MONTEBOURG,0501201J,26,26,0,0,14,12,4 ème
MANCHE,PORT-BAIL-SUR-MER,0501217B,37,37,0,0,18,19,4 ème
MANCHE,SAINT-CLAIR-SUR-L'ELLE,0500059T,65,63,0,2,30,35,4 ème
MANCHE,SAINT-LO,0500094F,104,98,0,6,44,60,4 ème
MANCHE,SAINT-LO,0500150S,78,72,0,6,34,44,4 ème
MANCHE,SAINT-LO,0501789Y,0,0,0,0,0,0,4 ème
MANCHE,SAINT-PIERRE-EGLISE,0500069D,74,74,0,0,37,37,4 ème
MANCHE,SAINT-SAUVEUR-LE-VICOMTE,0500072G,47,47,0,0,28,19,4 ème
MANCHE,SAINT-SAUVEUR-VILLAGES,0500071F,76,76,0,0,43,33,4 ème
MANCHE,VALOGNES,0500096H,123,118,0,5,63,60,4 ème
ORNE,ALENCON,0610002W,0,0,0,0,0,0,4 ème
ORNE,ATHIS-VAL DE ROUVRE,0610051Z,66,66,0,0,31,35,4 ème
ORNE,GACE,0610958K,77,77,0,0,33,44,4 ème
ORNE,GIEL-COURTEILLES,0610699D,18,18,0,0,2,16,4 ème
ORNE,LA FERRIERE-AUX-ETANGS,0610017M,73,73,0,0,33,40,4 ème
ORNE,L'AIGLE,0610026X,0,0,0,0,0,0,4 ème
ORNE,VAL-AU-PERCHE,0610959L,52,52,0,0,33,19,4 ème
SEINE MARITIME,BOLBEC,0760013B,0,0,0,0,0,0,4 ème
SEINE MARITIME,BUCHY,0761952J,149,146,0,3,67,82,4 ème
SEINE MARITIME,DARNETAL,0760021K,112,112,0,0,48,64,4 ème
SEINE MARITIME,DIEPPE,0761703N,84,65,15,4,45,39,4 ème
SEINE MARITIME,DIEPPE,0761786D,115,114,0,1,56,59,4 ème
SEINE MARITIME,EPOUVILLE,0762598L,138,138,0,0,71,67,4 ème
SEINE MARITIME,GODERVILLE,0761741E,163,138,18,7,78,85,4 ème
SEINE MARITIME,ISNEAUVILLE,0763368Y,143,143,0,0,72,71,4 ème
SEINE MARITIME,LE HAVRE,0762127Z,68,68,0,0,36,32,4 ème
SEINE MARITIME,LE HAVRE,0762173Z,78,69,9,0,40,38,4 ème
SEINE MARITIME,LE PETIT-QUEVILLY,0760087G,0,0,0,0,0,0,4 ème
SEINE MARITIME,LE PETIT-QUEVILLY,0761949F,120,113,0,7,56,64,4 ème
SEINE MARITIME,LE TREPORT,0760114L,0,0,0,0,0,0,4 ème
SEINE MARITIME,MAROMME,0760075U,162,144,16,2,84,78,4 ème
SEINE MARITIME,MONTIVILLIERS,0762227H,177,162,15,0,93,84,4 ème
SEINE MARITIME,ROUEN,0760172Z,148,146,0,2,69,79,4 ème
SEINE MARITIME,ROUEN,0762290B,87,87,0,0,46,41,4 ème
SEINE MARITIME,SAINTE-ADRESSE,0761735Y,0,0,0,0,0,0,4 ème
SEINE MARITIME,SOTTEVILLE-LES-ROUEN,0760173A,98,95,0,3,47,51,4 ème
DORDOGNE,BERGERAC,0241136E,166,166,0,0,87,79,4 ème
DORDOGNE,LANOUAILLE,0240015L,43,43,0,0,24,19,4 ème
DORDOGNE,LE BUGUE,0240011G,66,65,0,1,32,34,4 ème
DORDOGNE,PERIGUEUX,0240052B,105,101,0,4,49,56,4 ème
DORDOGNE,RIBERAC,0240050Z,0,0,0,0,0,0,4 ème
DORDOGNE,SIGOULES-ET-FLAUGEAC,0240924Z,73,63,10,0,31,42,4 ème
DORDOGNE,THIVIERS,0240040N,81,67,10,4,41,40,4 ème
DORDOGNE,TRELISSAC,0240112S,8,0,8,0,2,6,4 ème
GIRONDE,BEGLES,0331882S,0,0,0,0,0,0,4 ème
GIRONDE,BLANQUEFORT,0330018R,0,0,0,0,0,0,4 ème
GIRONDE,BLANQUEFORT,0331548D,0,0,0,0,0,0,4 ème
GIRONDE,BORDEAUX,0330066T,154,150,0,4,66,88,4 ème
GIRONDE,BORDEAUX,0330142A,0,0,0,0,0,0,4 ème
GIRONDE,BORDEAUX,0331513R,87,87,0,0,32,55,4 ème
GIRONDE,BORDEAUX,0332492E,176,176,0,0,94,82,4 ème
GIRONDE,BORDEAUX,0332497K,0,0,0,0,0,0,4 ème
GIRONDE,BRANNE,0330058J,137,134,0,3,67,70,4 ème
GIRONDE,CESTAS,0332342S,233,233,0,0,126,107,4 ème
GIRONDE,EYSINES,0331739L,8,0,8,0,5,3,4 ème
GIRONDE,FLOIRAC,0331419N,151,147,0,4,69,82,4 ème
GIRONDE,GRADIGNAN,0332190B,137,116,16,5,63,74,4 ème
GIRONDE,GUJAN-MESTRAS,0331759H,220,198,17,5,117,103,4 ème
GIRONDE,LANGON,0330084M,201,174,26,1,102,99,4 ème
GIRONDE,LANGON,0331527F,47,47,0,0,26,21,4 ème
GIRONDE,LE PIAN-SUR-GARONNE,0332934K,125,123,0,2,65,60,4 ème
GIRONDE,LESPARRE-MEDOC,0331891B,165,159,0,6,78,87,4 ème
GIRONDE,LIBOURNE,0330091V,201,184,14,3,91,110,4 ème
GIRONDE,LIBOURNE,0331507J,207,207,0,0,110,97,4 ème
GIRONDE,LUSSAC,0330093X,89,88,0,1,40,49,4 ème
GIRONDE,MARCHEPRIME,0333121N,159,159,0,0,84,75,4 ème
GIRONDE,MARSAS,0333484H,175,175,0,0,94,81,4 ème
GIRONDE,PAUILLAC,0330103H,216,198,17,1,110,106,4 ème
GIRONDE,PESSAC,0330106L,118,116,0,2,52,66,4 ème
GIRONDE,SAINTE-FOY-LA-GRANDE,0331531K,51,51,0,0,22,29,4 ème
GIRONDE,SAINT-MEDARD-DE-GUIZIERES,0331532L,91,91,0,0,50,41,4 ème
GIRONDE,SAINT-SELVE,0333528F,111,111,0,0,56,55,4 ème
GIRONDE,SOULAC-SUR-MER,0330125G,93,93,0,0,45,48,4 ème
GIRONDE,TALENCE,0332195G,208,204,0,4,80,128,4 ème
GIRONDE,VILLENAVE-D'ORNON,0330132P,150,143,0,7,80,70,4 ème
LANDES,AIRE-SUR-L'ADOUR,0400047J,0,0,0,0,0,0,4 ème
LANDES,AIRE-SUR-L'ADOUR,0400090F,98,92,0,6,55,43,4 ème
LANDES,AMOU,0400003L,69,69,0,0,30,39,4 ème
LANDES,ANGRESSE,0401091U,157,152,0,5,73,84,4 ème
LANDES,BISCARROSSE,0401048X,95,95,0,0,56,39,4 ème
LANDES,DAX,0400740M,143,139,0,4,63,80,4 ème
LANDES,HAGETMAU,0400727Y,110,84,13,13,57,53,4 ème
LANDES,LABENNE,0401014K,164,162,0,2,94,70,4 ème
LANDES,MONT-DE-MARSAN,0400019D,0,0,0,0,0,0,4 ème
LANDES,MONT-DE-MARSAN,0400774Z,114,109,0,5,48,66,4 ème
LANDES,MONT-DE-MARSAN,0400779E,111,108,0,3,49,62,4 ème
LANDES,MONT-DE-MARSAN,0400858R,124,121,0,3,64,60,4 ème
LANDES,MORCENX-LA-NOUVELLE,0400097N,0,0,0,0,0,0,4 ème
LANDES,MUGRON,0400025K,62,59,0,3,35,27,4 ème
LANDES,POUILLON,0400032T,133,130,0,3,55,78,4 ème
LOT-ET-GARONNE,AGEN,0470061L,145,140,0,5,75,70,4 ème
LOT-ET-GARONNE,FOULAYRONNES,0470782V,0,0,0,0,0,0,4 ème
LOT-ET-GARONNE,LAVARDAC,0470775M,72,51,18,3,35,37,4 ème
LOT-ET-GARONNE,MARMANDE,0470069V,95,95,0,0,51,44,4 ème
LOT-ET-GARONNE,VILLENEUVE-SUR-LOT,0470049Y,140,137,0,3,65,75,4 ème
LOT-ET-GARONNE,VILLENEUVE-SUR-LOT,0470753N,10,0,10,0,3,7,4 ème
PYRENEES-ATLANTIQUES,ANGLET,0640003F,209,206,0,3,97,112,4 ème
PYRENEES-ATLANTIQUES,ARTHEZ-DE-BEARN,0640005H,41,41,0,0,22,19,4 ème
PYRENEES-ATLANTIQUES,BAYONNE,0640013S,0,0,0,0,0,0,4 ème
PYRENEES-ATLANTIQUES,BAYONNE,0640141F,59,59,0,0,28,31,4 ème
PYRENEES-ATLANTIQUES,BEDOUS,0640016V,30,30,0,0,13,17,4 ème
PYRENEES-ATLANTIQUES,BILLERE,0640606L,162,159,0,3,73,89,4 ème
PYRENEES-ATLANTIQUES,CAMBO-LES-BAINS,0641702C,77,74,0,3,46,31,4 ème
PYRENEES-ATLANTIQUES,HASPARREN,0641393S,103,99,0,4,53,50,4 ème
PYRENEES-ATLANTIQUES,HENDAYE,0640228A,147,144,0,3,77,70,4 ème
PYRENEES-ATLANTIQUES,LARCEVEAU-ARROS-CIBITS,0642006H,70,63,0,7,38,32,4 ème
PYRENEES-ATLANTIQUES,MONEIN,0640041X,87,87,0,0,47,40,4 ème
PYRENEES-ATLANTIQUES,OLORON-SAINTE-MARIE,0640211G,122,103,16,3,73,49,4 ème
PYRENEES-ATLANTIQUES,ORTHEZ,0640053K,0,0,0,0,0,0,4 ème
PYRENEES-ATLANTIQUES,ORTHEZ,0640214K,101,82,16,3,44,57,4 ème
PYRENEES-ATLANTIQUES,ORTHEZ,0641560Y,117,117,0,0,55,62,4 ème
PYRENEES-ATLANTIQUES,PAU,0641660G,130,130,0,0,73,57,4 ème
PYRENEES-ATLANTIQUES,PAU,0642010M,20,20,0,0,7,13,4 ème
PYRENEES-ATLANTIQUES,PAU,0642011N,15,15,0,0,7,8,4 ème
PYRENEES-ATLANTIQUES,PONTACQ,0640062V,70,66,0,4,42,28,4 ème
PYRENEES-ATLANTIQUES,SAINT-JEAN-DE-LUZ,0640163E,114,113,0,1,57,57,4 ème
PYRENEES-ATLANTIQUES,SAINT-JEAN-DE-LUZ,0641661H,150,148,0,2,83,67,4 ème
PYRENEES-ATLANTIQUES,SAINT-PALAIS,0640168K,49,49,0,0,20,29,4 ème
PYRENEES-ATLANTIQUES,SAINT-PALAIS,0641232S,74,73,0,1,30,44,4 ème
PYRENEES-ATLANTIQUES,SALIES-DE-BEARN,0640071E,84,82,0,2,41,43,4 ème
PYRENEES-ATLANTIQUES,SAUVETERRE-DE-BEARN,0640073G,46,46,0,0,25,21,4 ème
PYRENEES-ATLANTIQUES,SERRES-CASTET,0641780M,192,184,0,8,87,105,4 ème
CORREZE,ALLASSAC,0190001Y,141,141,0,0,69,72,4 ème
CORREZE,BEAULIEU-SUR-DORDOGNE,0190004B,40,40,0,0,11,29,4 ème
CORREZE,BEYNAT,0190006D,55,51,0,4,30,25,4 ème
CORREZE,BRIVE-LA-GAILLARDE,0190065T,48,46,0,2,24,24,4 ème
CORREZE,BRIVE-LA-GAILLARDE,0190671B,91,87,0,4,43,48,4 ème
CORREZE,BRIVE-LA-GAILLARDE,0190701J,0,0,0,0,0,0,4 ème
CORREZE,BRIVE-LA-GAILLARDE,0190723H,139,139,0,0,65,74,4 ème
CORREZE,BRIVE-LA-GAILLARDE,0190780V,124,120,4,0,52,72,4 ème
CORREZE,MEYSSAC,0190026A,49,49,0,0,24,25,4 ème
CORREZE,SEILHAC,0190030E,96,96,0,0,50,46,4 ème
CREUSE,AHUN,0230001B,38,38,0,0,20,18,4 ème
CREUSE,AUZANCES,0230004E,25,25,0,0,12,13,4 ème
CREUSE,BOUSSAC,0230009K,45,45,0,0,25,20,4 ème
HAUTE-VIENNE,BELLAC,0870004G,0,0,0,0,0,0,4 ème
HAUTE-VIENNE,CHALUS,0870007K,76,76,0,0,39,37,4 ème
HAUTE-VIENNE,LIMOGES,0870117E,162,145,16,1,77,85,4 ème
HAUTE-VIENNE,LIMOGES,0870909R,107,107,0,0,47,60,4 ème
HAUTE-VIENNE,LIMOGES,0875023M,0,0,0,0,0,0,4 ème
HAUTE-VIENNE,PIERRE-BUFFIERE,0870036S,92,92,0,0,53,39,4 ème
HAUTE-VIENNE,SAINT-JUNIEN,0870734A,111,111,0,0,56,55,4 ème
CHARENTE,ANGOULEME,0160047P,0,0,0,0,0,0,4 ème
CHARENTE,ANGOULEME,0160050T,111,111,0,0,60,51,4 ème
CHARENTE,BARBEZIEUX-SAINT-HILAIRE,0161049D,48,48,0,0,14,34,4 ème
CHARENTE,CHALAIS,0160015E,46,46,0,0,22,24,4 ème
CHARENTE,CHASSENEUIL-SUR-BONNIEURE,0160048R,0,0,0,0,0,0,4 ème
CHARENTE,COGNAC,0160117R,108,90,17,1,54,54,4 ème
CHARENTE,GOND-PONTOUVRE,0160106D,124,107,16,1,57,67,4 ème
CHARENTE,JARNAC,0160027T,110,105,0,5,50,60,4 ème
CHARENTE,MONTEMBOEUF,0160031X,37,37,0,0,27,10,4 ème
CHARENTE,MONTMOREAU,0160032Y,47,45,0,2,24,23,4 ème
CHARENTE,ROUILLAC,0160034A,92,91,0,1,38,54,4 ème
CHARENTE,RUELLE-SUR-TOUVRE,0160036C,0,0,0,0,0,0,4 ème
CHARENTE,SEGONZAC,0160042J,83,83,0,0,52,31,4 ème
CHARENTE,SOYAUX,0160100X,85,55,30,0,43,42,4 ème
CHARENTE,SOYAUX,0160862A,0,0,0,0,0,0,4 ème
CHARENTE,VILLEFAGNAN,0160115N,37,37,0,0,19,18,4 ème
CHARENTE-MARITIME,AIGREFEUILLE-D'AUNIS,0170110C,24,17,0,7,11,13,4 ème
CHARENTE-MARITIME,AIGREFEUILLE-D'AUNIS,0171129K,194,192,0,2,89,105,4 ème
CHARENTE-MARITIME,DOMPIERRE-SUR-MER,0171210Y,180,180,0,0,86,94,4 ème
CHARENTE-MARITIME,GEMOZAC,0170009T,113,113,0,0,40,73,4 ème
CHARENTE-MARITIME,LA JARRIE,0170010U,147,147,0,0,63,84,4 ème
CHARENTE-MARITIME,LA ROCHELLE,0170088D,147,145,0,2,60,87,4 ème
CHARENTE-MARITIME,MARANS,0170112E,54,54,0,0,34,20,4 ème
CHARENTE-MARITIME,PONS,0170020E,0,0,0,0,0,0,4 ème
CHARENTE-MARITIME,SAINT-AIGULIN,0170048K,60,60,0,0,29,31,4 ème
CHARENTE-MARITIME,SAINT-JEAN-D'ANGELY,0170051N,0,0,0,0,0,0,4 ème
CHARENTE-MARITIME,SAINT-JEAN-D'ANGELY,0170118L,51,51,0,0,29,22,4 ème
CHARENTE-MARITIME,TONNAY-CHARENTE,0170072L,163,163,0,0,90,73,4 ème
DEUX-SEVRES,AIRVAULT,0790059K,18,18,0,0,9,9,4 ème
DEUX-SEVRES,AIRVAULT,0790704L,42,42,0,0,21,21,4 ème
DEUX-SEVRES,BRESSUIRE,0790080H,0,0,0,0,0,0,4 ème
DEUX-SEVRES,BRESSUIRE,0791014Y,140,140,0,0,77,63,4 ème
DEUX-SEVRES,CERIZAY,0790945Y,105,86,16,3,52,53,4 ème
DEUX-SEVRES,CHEF-BOUTONNE,0790014L,52,52,0,0,31,21,4 ème
DEUX-SEVRES,COULONGES-SUR-L'AUTIZE,0790016N,119,119,0,0,56,63,4 ème
DEUX-SEVRES,LORETZ-D'ARGENTON,0790004A,35,35,0,0,17,18,4 ème
DEUX-SEVRES,MAULEON,0790065S,99,99,0,0,57,42,4 ème
DEUX-SEVRES,MENIGOUTE,0790020T,39,39,0,0,21,18,4 ème
DEUX-SEVRES,NIORT,0790043T,0,0,0,0,0,0,4 ème
DEUX-SEVRES,SAINT-MAIXENT-L'ECOLE,0790978J,149,129,17,3,70,79,4 ème
DEUX-SEVRES,SECONDIGNY,0790034H,54,54,0,0,25,29,4 ème
DEUX-SEVRES,THENEZAY,0790035J,37,37,0,0,12,25,4 ème
DEUX-SEVRES,THOUARS,0790038M,0,0,0,0,0,0,4 ème
DEUX-SEVRES,THOUARS,0790708R,99,96,0,3,56,43,4 ème
VIENNE,CHATELLERAULT,0860006P,0,0,0,0,0,0,4 ème
VIENNE,CHAUVIGNY,0860792U,224,209,12,3,105,119,4 ème
VIENNE,GENCAY,0860016A,108,106,0,2,51,57,4 ème
VIENNE,LATILLE,0860019D,107,107,0,0,52,55,4 ème
VIENNE,L'ISLE-JOURDAIN,0860017B,42,42,0,0,19,23,4 ème
VIENNE,NEUVILLE-DE-POITOU,0860032T,149,149,0,0,80,69,4 ème
VIENNE,POITIERS,0860076R,212,195,17,0,98,114,4 ème
VIENNE,POITIERS,0860823C,0,0,0,0,0,0,4 ème
VIENNE,VALENCE-EN-POITOU,0860762L,47,47,0,0,28,19,4 ème
AUDE,BRAM,0110676A,159,156,0,3,84,75,4 ème
AUDE,CARCASSONNE,0110665N,200,200,0,0,90,110,4 ème
AUDE,CASTELNAUDARY,0110011C,86,86,0,0,42,44,4 ème
AUDE,COUIZA,0110015G,66,66,0,0,33,33,4 ème
AUDE,LIMOUX,0110019L,0,0,0,0,0,0,4 ème
AUDE,LIMOUX,0110052X,33,33,0,0,16,17,4 ème
AUDE,NARBONNE,0110788X,143,116,16,11,68,75,4 ème
GARD,BAGNOLS-SUR-CEZE,0300088H,105,105,0,0,46,59,4 ème
GARD,BESSEGES,0300013B,42,40,0,2,19,23,4 ème
GARD,BOUILLARGUES,0301209B,191,191,0,0,86,105,4 ème
GARD,BRIGNON,0301246S,180,180,0,0,91,89,4 ème
GARD,GALLARGUES-LE-MONTUEUX,0301816L,167,167,0,0,93,74,4 ème
GARD,GENOLHAC,0300016E,24,24,0,0,10,14,4 ème
GARD,LA GRAND-COMBE,0300091L,25,25,0,0,9,16,4 ème
GARD,LEDIGNAN,0301747L,114,114,0,0,62,52,4 ème
GARD,LE MARTINET,0300020J,20,20,0,0,5,15,4 ème
GARD,MARGUERITTES,0301245R,185,165,17,3,95,90,4 ème
GARD,NIMES,0300057Z,0,0,0,0,0,0,4 ème
GARD,NIMES,0300059B,118,114,0,4,54,64,4 ème
GARD,NIMES,0300141R,165,139,23,3,74,91,4 ème
GARD,NIMES,0300996V,14,9,0,5,7,7,4 ème
GARD,NIMES,0301270T,0,0,0,0,0,0,4 ème
GARD,ROCHEFORT-DU-GARD,0301656M,175,171,0,4,98,77,4 ème
GARD,SAINT-AMBROIX,0300099V,54,40,14,0,24,30,4 ème
GARD,VESTRIC-ET-CANDIAC,0301653J,165,165,0,0,80,85,4 ème
HERAULT,AGDE,0341893Y,138,120,15,3,62,76,4 ème
HERAULT,BAILLARGUES,0341577E,141,140,0,1,71,70,4 ème
HERAULT,BEDARIEUX,0340006X,0,0,0,0,0,0,4 ème
HERAULT,BEDARIEUX,0340888F,17,17,0,0,8,9,4 ème
HERAULT,BESSAN,0340008Z,140,136,0,4,65,75,4 ème
HERAULT,BEZIERS,0340011C,0,0,0,0,0,0,4 ème
HERAULT,BEZIERS,0340118U,123,123,0,0,58,65,4 ème
HERAULT,BEZIERS,0340836Z,163,140,15,8,77,86,4 ème
HERAULT,BEZIERS,0341066Z,199,181,15,3,94,105,4 ème
HERAULT,BEZIERS,0342132H,162,143,16,3,75,87,4 ème
HERAULT,CASTELNAU-LE-LEZ,0340086J,205,200,0,5,109,96,4 ème
HERAULT,FABREGUES,0342077Y,140,135,0,5,70,70,4 ème
HERAULT,GANGES,0341424N,173,169,0,4,93,80,4 ème
HERAULT,GIGNAC,0342436N,0,0,0,0,0,0,4 ème
HERAULT,JACOU,0342036D,224,224,0,0,107,117,4 ème
HERAULT,LE CRES,0341363X,203,185,16,2,101,102,4 ème
HERAULT,LUNEL,0340030Y,0,0,0,0,0,0,4 ème
HERAULT,LUNEL,0341825Z,194,176,16,2,87,107,4 ème
HERAULT,LUNEL,0342090M,0,0,0,0,0,0,4 ème
HERAULT,MEZE,0340973Y,111,109,0,2,63,48,4 ème
HERAULT,MONTPELLIER,0340043M,0,0,0,0,0,0,4 ème
HERAULT,MONTPELLIER,0340048T,149,149,0,0,77,72,4 ème
HERAULT,MONTPELLIER,0340051W,131,124,0,7,57,74,4 ème
HERAULT,MONTPELLIER,0340053Y,213,191,16,6,101,112,4 ème
HERAULT,MONTPELLIER,0340111L,109,109,0,0,49,60,4 ème
HERAULT,MONTPELLIER,0340899T,128,128,0,0,70,58,4 ème
HERAULT,MONTPELLIER,0341277D,171,152,17,2,93,78,4 ème
HERAULT,MONTPELLIER,0341421K,255,253,0,2,122,133,4 ème
HERAULT,MONTPELLIER,0341726S,7,0,7,0,4,3,4 ème
HERAULT,MONTPELLIER,0342488V,0,0,0,0,0,0,4 ème
HERAULT,MURVIEL-LES-BEZIERS,0340054Z,135,133,0,2,55,80,4 ème
HERAULT,QUARANTE,0340063J,80,77,0,3,39,41,4 ème
HERAULT,SAINT-ANDRE-DE-SANGONIS,0342186S,171,155,16,0,81,90,4 ème
HERAULT,SAINT-GEORGES-D'ORQUES,0340908C,97,97,0,0,48,49,4 ème
LOZERE,MARVEJOLS,0480005V,90,71,14,5,41,49,4 ème
LOZERE,MENDE,0480025S,0,0,0,0,0,0,4 ème
PYRENEES-ORIENTALES,ESPIRA-DE-L'AGLY,0660065M,93,78,15,0,46,47,4 ème
PYRENEES-ORIENTALES,FONT-ROMEU-ODEILLO-VIA,0660634F,89,89,0,0,40,49,4 ème
PYRENEES-ORIENTALES,PERPIGNAN,0660062J,128,128,0,0,71,57,4 ème
PYRENEES-ORIENTALES,PRADES,0660022R,160,142,16,2,85,75,4 ème
PYRENEES-ORIENTALES,SAINT-ANDRE,0660865G,164,164,0,0,78,86,4 ème
PYRENEES-ORIENTALES,SAINT-LAURENT-DE-LA-SALANQUE,0660028X,222,220,0,2,114,108,4 ème
PYRENEES-ORIENTALES,VILLELONGUE-DELS-MONTS,0660026V,0,0,0,0,0,0,4 ème
ARIEGE,AX-LES-THERMES,0090001C,48,48,0,0,17,31,4 ème
ARIEGE,FOIX,0090478W,221,218,0,3,109,112,4 ème
ARIEGE,LAVELANET,0090007J,76,76,0,0,37,39,4 ème
ARIEGE,MAZERES,0090012P,89,87,0,2,47,42,4 ème
ARIEGE,MIREPOIX,0090573Z,128,106,19,3,55,73,4 ème
ARIEGE,SAINT-GIRONS,0090019X,0,0,0,0,0,0,4 ème
AVEYRON,LAISSAC-SEVERAC L'EGLISE,0120078V,35,35,0,0,15,20,4 ème
AVEYRON,MILLAU,0120014A,0,0,0,0,0,0,4 ème
AVEYRON,MILLAU,0120878P,245,232,9,4,125,120,4 ème
AVEYRON,ONET-LE-CHATEAU,0121273U,121,119,0,2,54,67,4 ème
AVEYRON,PONT-DE-SALARS,0120018E,87,83,0,4,45,42,4 ème
AVEYRON,RIEUPEYROUX,0120020G,34,31,0,3,14,20,4 ème
AVEYRON,RIGNAC,0120021H,97,97,0,0,40,57,4 ème
AVEYRON,VILLEFRANCHE-DE-ROUERGUE,0121255Z,83,81,0,2,39,44,4 ème
GERS,EAUZE,0320052H,28,28,0,0,10,18,4 ème
GERS,FLEURANCE,0320012P,99,95,0,4,50,49,4 ème
GERS,LECTOURE,0320017V,84,71,9,4,43,41,4 ème
GERS,MARCIAC,0320019X,49,49,0,0,29,20,4 ème
GERS,MAUVEZIN,0320021Z,107,105,0,2,59,48,4 ème
GERS,NOGARO,0320027F,84,71,10,3,36,48,4 ème
GERS,SAMATAN,0320030J,0,0,0,0,0,0,4 ème
GERS,SAMATAN,0320031K,114,114,0,0,53,61,4 ème
HAUTE-GARONNE,AUTERIVE,0310084Y,187,167,15,5,105,82,4 ème
HAUTE-GARONNE,AYGUESVIVES,0311573S,190,186,0,4,86,104,4 ème
HAUTE-GARONNE,BOULOGNE-SUR-GESSE,0310007P,42,42,0,0,20,22,4 ème
HAUTE-GARONNE,CASTELGINEST,0311720B,153,148,0,5,79,74,4 ème
HAUTE-GARONNE,ESCALQUENS,0313010D,160,160,0,0,84,76,4 ème
HAUTE-GARONNE,FONTENILLES,0312743N,177,170,0,7,86,91,4 ème
HAUTE-GARONNE,FROUZINS,0311915N,129,117,0,12,61,68,4 ème
HAUTE-GARONNE,GOURDAN-POLIGNAN,0310017A,0,0,0,0,0,0,4 ème
HAUTE-GARONNE,LABARTHE-SUR-LEZE,0312843X,159,151,0,8,79,80,4 ème
HAUTE-GARONNE,LAUNAGUET,0312139G,122,119,0,3,67,55,4 ème
HAUTE-GARONNE,MONTREJEAU,0310023G,76,68,0,8,34,42,4 ème
HAUTE-GARONNE,MURET,0311130K,160,160,0,0,70,90,4 ème
HAUTE-GARONNE,QUINT-FONSEGRIVES,0312762J,150,150,0,0,68,82,4 ème
HAUTE-GARONNE,SAINT-GAUDENS,0311851U,116,114,0,2,68,48,4 ème
HAUTE-GARONNE,SAINT-GAUDENS,0311968W,88,84,0,4,32,56,4 ème
HAUTE-GARONNE,SAINT-LYS,0311772H,139,137,0,2,71,68,4 ème
HAUTE-GARONNE,SAINT-ORENS-DE-GAMEVILLE,0311850T,175,171,0,4,78,97,4 ème
HAUTE-GARONNE,SAINT-PIERRE-DE-LAGES,0312609T,142,138,0,4,68,74,4 ème
HAUTE-GARONNE,TOULOUSE,0310040A,0,0,0,0,0,0,4 ème
HAUTE-GARONNE,TOULOUSE,0310044E,0,0,0,0,0,0,4 ème
HAUTE-GARONNE,TOULOUSE,0310046G,0,0,0,0,0,0,4 ème
HAUTE-GARONNE,TOULOUSE,0310053P,0,0,0,0,0,0,4 ème
HAUTE-GARONNE,TOULOUSE,0310091F,0,0,0,0,0,0,4 ème
HAUTE-GARONNE,TOULOUSE,0311168B,57,57,0,0,37,20,4 ème
HAUTE-GARONNE,TOULOUSE,0311232W,77,77,0,0,33,44,4 ème
HAUTE-GARONNE,TOULOUSE,0311328A,144,143,0,1,78,66,4 ème
HAUTE-GARONNE,TOULOUSE,0311333F,144,125,15,4,61,83,4 ème
HAUTE-GARONNE,TOULOUSE,0312065B,0,0,0,0,0,0,4 ème
HAUTE-GARONNE,TOULOUSE,0313079D,115,113,0,2,55,60,4 ème
HAUTE-GARONNE,TOURNEFEUILLE,0311688S,209,205,0,4,98,111,4 ème
HAUTE-GARONNE,TOURNEFEUILLE,0312307P,165,162,0,3,83,82,4 ème
HAUTES-PYRENEES,ARREAU,0650003A,61,61,0,0,36,25,4 ème
HAUTES-PYRENEES,BAGNERES-DE-BIGORRE,0650005C,0,0,0,0,0,0,4 ème
HAUTES-PYRENEES,BAGNERES-DE-BIGORRE,0650738Z,23,23,0,0,9,14,4 ème
HAUTES-PYRENEES,LANNEMEZAN,0650084N,136,112,13,11,66,70,4 ème
HAUTES-PYRENEES,LOURDES,0650014M,0,0,0,0,0,0,4 ème
HAUTES-PYRENEES,MONLEON-MAGNOAC,0650878B,103,101,0,2,38,65,4 ème
HAUTES-PYRENEES,SAINT-LAURENT-DE-NESTE,0650022W,59,59,0,0,27,32,4 ème
HAUTES-PYRENEES,TARBES,0650033H,55,49,0,6,28,27,4 ème
HAUTES-PYRENEES,TARBES,0650050B,143,137,0,6,72,71,4 ème
HAUTES-PYRENEES,TARBES,0650067V,0,0,0,0,0,0,4 ème
HAUTES-PYRENEES,TARBES,0651004N,140,140,0,0,66,74,4 ème
HAUTES-PYRENEES,VIC-EN-BIGORRE,0650838H,147,124,18,5,68,79,4 ème
LOT,CAHORS,0460050E,0,0,0,0,0,0,4 ème
LOT,CAHORS,0460051F,0,0,0,0,0,0,4 ème
LOT,CAHORS,0460620Z,78,78,0,0,51,27,4 ème
LOT,GOURDON,0460592U,114,102,10,2,63,51,4 ème
LOT,LALBENQUE,0460734Y,40,40,0,0,15,25,4 ème
LOT,SOUILLAC,0460028F,0,0,0,0,0,0,4 ème
TARN,ALBAN,0810002M,59,59,0,0,27,32,4 ème
TARN,ALBI,0811030E,233,196,31,6,108,125,4 ème
TARN,ALBI,0811062P,112,112,0,0,49,63,4 ème
TARN,ALBI,0811197L,190,170,17,3,110,80,4 ème
TARN,BLAYE-LES-MINES,0810788S,134,113,16,5,72,62,4 ème
TARN,BRASSAC,0810008U,71,71,0,0,31,40,4 ème
TARN,CASTRES,0810061B,129,96,29,4,70,59,4 ème
TARN,CASTRES,0810105Z,0,0,0,0,0,0,4 ème
TARN,CASTRES,0810113H,0,0,0,0,0,0,4 ème
TARN,CASTRES,0810959C,0,0,0,0,0,0,4 ème
TARN,CORDES-SUR-CIEL,0810019F,70,70,0,0,35,35,4 ème
TARN,DOURGNE,0810020G,87,87,0,0,41,46,4 ème
TARN,MAZAMET,0811067V,105,105,0,0,49,56,4 ème
TARN,PUYLAURENS,0810036Z,125,125,0,0,54,71,4 ème
TARN,REALMONT,0810038B,119,116,0,3,57,62,4 ème
TARN-ET-GARONNE,CAUSSADE,0820007M,201,174,17,10,89,112,4 ème
TARN-ET-GARONNE,LABASTIDE-SAINT-PIERRE,0820823Z,137,132,0,5,78,59,4 ème
TARN-ET-GARONNE,MONTAUBAN,0820022D,200,195,0,5,103,97,4 ème
TARN-ET-GARONNE,MONTAUBAN,0820052L,111,111,0,0,54,57,4 ème
TARN-ET-GARONNE,MONTAUBAN,0820061W,0,0,0,0,0,0,4 ème
TARN-ET-GARONNE,MONTAUBAN,0820588U,314,291,17,6,164,150,4 ème
TARN-ET-GARONNE,MONTAUBAN,0820896D,135,117,16,2,57,78,4 ème
LOIRE-ATLANTIQUE,AIGREFEUILLE-SUR-MAINE,0442542Z,149,147,0,2,73,76,4 ème
LOIRE-ATLANTIQUE,BOUAYE,0440184L,121,121,0,0,59,62,4 ème
LOIRE-ATLANTIQUE,BOUGUENAIS,0441656L,0,0,0,0,0,0,4 ème
LOIRE-ATLANTIQUE,CLISSON,0440188R,174,174,0,0,76,98,4 ème
LOIRE-ATLANTIQUE,LA BAULE-ESCOUBLAC,0441822S,148,144,0,4,78,70,4 ème
LOIRE-ATLANTIQUE,LA MONTAGNE,0440198B,81,81,0,0,37,44,4 ème
LOIRE-ATLANTIQUE,LE LOROUX-BOTTEREAU,0441686U,148,146,0,2,72,76,4 ème
LOIRE-ATLANTIQUE,LE POULIGUEN,0440061C,54,52,0,2,23,31,4 ème
LOIRE-ATLANTIQUE,MISSILLAC,0441917V,69,69,0,0,37,32,4 ème
LOIRE-ATLANTIQUE,NANTES,0440028S,132,128,0,4,72,60,4 ème
LOIRE-ATLANTIQUE,NANTES,0440030U,0,0,0,0,0,0,4 ème
LOIRE-ATLANTIQUE,NANTES,0440045K,162,161,0,1,84,78,4 ème
LOIRE-ATLANTIQUE,NANTES,0440536U,68,68,0,0,37,31,4 ème
LOIRE-ATLANTIQUE,NANTES,0441934N,134,134,0,0,72,62,4 ème
LOIRE-ATLANTIQUE,NORT-SUR-ERDRE,0440221B,141,141,0,0,71,70,4 ème
LOIRE-ATLANTIQUE,NOZAY,0440292D,160,156,0,4,72,88,4 ème
LOIRE-ATLANTIQUE,REZE,0440231M,48,48,0,0,23,25,4 ème
LOIRE-ATLANTIQUE,SAINTE-LUCE-SUR-LOIRE,0441724K,159,141,16,2,82,77,4 ème
LOIRE-ATLANTIQUE,SAINT-HERBLAIN,0441940V,200,200,0,0,90,110,4 ème
LOIRE-ATLANTIQUE,SAINT-NAZAIRE,0440307V,0,0,0,0,0,0,4 ème
LOIRE-ATLANTIQUE,SAINT-NAZAIRE,0440315D,0,0,0,0,0,0,4 ème
LOIRE-ATLANTIQUE,SAINT-NAZAIRE,0440350S,139,134,0,5,65,74,4 ème
LOIRE-ATLANTIQUE,SAINT-PHILBERT-DE-GRAND-LIEU,0440239W,197,195,0,2,97,100,4 ème
LOIRE-ATLANTIQUE,SAINT-PHILBERT-DE-GRAND-LIEU,0442782K,123,118,0,5,61,62,4 ème
LOIRE-ATLANTIQUE,SAINT-SEBASTIEN-SUR-LOIRE,0440279P,0,0,0,0,0,0,4 ème
LOIRE-ATLANTIQUE,SAINT-SEBASTIEN-SUR-LOIRE,0440537V,0,0,0,0,0,0,4 ème
LOIRE-ATLANTIQUE,VERTOU,0440244B,264,264,0,0,114,150,4 ème
MAINE-ET-LOIRE,ANGERS,0490060Z,61,61,0,0,35,26,4 ème
MAINE-ET-LOIRE,ANGERS,0490845C,70,70,0,0,29,41,4 ème
MAINE-ET-LOIRE,ANGERS,0490953V,90,72,16,2,36,54,4 ème
MAINE-ET-LOIRE,ANGERS,0491764B,124,105,16,3,62,62,4 ème
MAINE-ET-LOIRE,AVRILLE,0490801E,0,0,0,0,0,0,4 ème
MAINE-ET-LOIRE,BEAUPREAU-EN-MAUGES,0490903R,0,0,0,0,0,0,4 ème
MAINE-ET-LOIRE,CHOLET,0491025Y,134,134,0,0,63,71,4 ème
MAINE-ET-LOIRE,CHOLET,0491026Z,113,110,0,3,53,60,4 ème
MAINE-ET-LOIRE,LYS-HAUT-LAYON,0491707P,66,66,0,0,36,30,4 ème
MAINE-ET-LOIRE,MAULEVRIER,0490868C,121,121,0,0,60,61,4 ème
MAINE-ET-LOIRE,MONTREUIL-JUIGNE,0490032U,183,179,0,4,93,90,4 ème
MAINE-ET-LOIRE,MONTREVAULT-SUR-EVRE,0490034W,98,94,0,4,58,40,4 ème
MAINE-ET-LOIRE,SAUMUR,0490042E,69,66,0,3,36,33,4 ème
MAINE-ET-LOIRE,SAUMUR,0490960C,93,91,0,2,49,44,4 ème
MAINE-ET-LOIRE,SAUMUR,0491930G,188,174,14,0,89,99,4 ème
MAINE-ET-LOIRE,SEGRE-EN-ANJOU BLEU,0490962E,157,137,16,4,77,80,4 ème
MAYENNE,ANDOUILLE,0530002P,92,92,0,0,46,46,4 ème
MAYENNE,CHATEAU-GONTIER-SUR-MAYENNE,0530874M,126,125,0,1,62,64,4 ème
MAYENNE,EVRON,0530059B,124,124,0,0,61,63,4 ème
MAYENNE,GORRON,0530793Z,34,34,0,0,18,16,4 ème
MAYENNE,LASSAY-LES-CHATEAUX,0530803K,65,65,0,0,30,35,4 ème
MAYENNE,LAVAL,0530061D,177,161,16,0,81,96,4 ème
MAYENNE,LAVAL,0530875N,205,201,0,4,97,108,4 ème
MAYENNE,MAYENNE,0530826K,71,70,0,1,34,37,4 ème
MAYENNE,MESLAY-DU-MAINE,0530791X,62,62,0,0,29,33,4 ème
MAYENNE,MONTSURS,0530064G,28,28,0,0,11,17,4 ème
MAYENNE,MONTSURS,0530792Y,63,63,0,0,36,27,4 ème
MAYENNE,RENAZE,0530584X,37,37,0,0,17,20,4 ème
MAYENNE,VILLAINES-LA-JUHEL,0530025P,42,40,0,2,21,21,4 ème
SARTHE,ALLONNES,0721224P,67,64,0,3,36,31,4 ème
SARTHE,CERANS-FOULLETOURTE,0721483W,76,76,0,0,32,44,4 ème
SARTHE,CHANGE,0720920J,16,0,16,0,3,13,4 ème
SARTHE,LA CHARTRE-SUR-LE-LOIR,0720011W,45,45,0,0,25,20,4 ème
SARTHE,LA FLECHE,0720021G,0,0,0,0,0,0,4 ème
SARTHE,LA FLECHE,0721405L,110,110,0,0,56,54,4 ème
SARTHE,MONTVAL-SUR-LOIR,0720804H,46,46,0,0,26,20,4 ème
SARTHE,PARIGNE-L'EVEQUE,0720847E,123,104,15,4,56,67,4 ème
SARTHE,PRUILLE-LE-CHETIF,0720811R,123,117,6,0,63,60,4 ème
SARTHE,PRUILLE-LE-CHETIF,0721478R,0,0,0,0,0,0,4 ème
SARTHE,SABLE-SUR-SARTHE,0720048L,0,0,0,0,0,0,4 ème
SARTHE,SAINTE-JAMME-SUR-SARTHE,0721042S,152,152,0,0,73,79,4 ème
SARTHE,SILLE-LE-GUILLAUME,0721365T,55,55,0,0,27,28,4 ème
VENDEE,BENET,0850092N,84,84,0,0,47,37,4 ème
VENDEE,BENET,0851145H,52,52,0,0,25,27,4 ème
VENDEE,CHANTONNAY,0850145W,155,133,17,5,60,95,4 ème
VENDEE,ESSARTS EN BOCAGE,0851647D,129,124,0,5,64,65,4 ème
VENDEE,LA ROCHE-SUR-YON,0850130E,0,0,0,0,0,0,4 ème
VENDEE,LA ROCHE-SUR-YON,0850604V,150,131,15,4,76,74,4 ème
VENDEE,LES ACHARDS,0850106D,138,138,0,0,67,71,4 ème
VENDEE,LES HERBIERS,0851193K,161,133,23,5,76,85,4 ème
VENDEE,MONTAIGU-VENDEE,0850136L,0,0,0,0,0,0,4 ème
VENDEE,MONTAIGU-VENDEE,0850639H,183,169,14,0,104,79,4 ème
VENDEE,MONTAIGU-VENDEE,0851704R,0,0,0,0,0,0,4 ème
VENDEE,NOIRMOUTIER-EN-L'ILE,0851144G,51,51,0,0,28,23,4 ème
VENDEE,SAINT-HILAIRE-DES-LOGES,0851195M,65,65,0,0,29,36,4 ème
VENDEE,SAINT-JEAN-DE-MONTS,0850039F,133,133,0,0,70,63,4 ème
VENDEE,SAINT-LAURENT-SUR-SEVRE,0851293U,172,172,0,0,77,95,4 ème
ALPES-DE-HTE-PROVENCE,MANOSQUE,0040013T,73,71,0,2,38,35,4 ème
ALPES-DE-HTE-PROVENCE,MANOSQUE,0040587S,62,62,0,0,32,30,4 ème
ALPES-DE-HTE-PROVENCE,SAINTE-TULLE,0040524Y,135,130,0,5,58,77,4 ème
ALPES-DE-HTE-PROVENCE,SEYNE,0040021B,29,27,0,2,8,21,4 ème
BOUCHES-DU-RHONE,AIX-EN-PROVENCE,0131711P,159,153,0,6,71,88,4 ème
BOUCHES-DU-RHONE,AIX-EN-PROVENCE,0132917A,248,247,0,1,127,121,4 ème
BOUCHES-DU-RHONE,AIX-EN-PROVENCE,0133397X,109,109,0,0,62,47,4 ème
BOUCHES-DU-RHONE,AIX-EN-PROVENCE,0134094E,181,181,0,0,90,91,4 ème
BOUCHES-DU-RHONE,AIX-EN-PROVENCE,0134342Z,88,88,0,0,45,43,4 ème
BOUCHES-DU-RHONE,ARLES,0131609D,156,154,0,2,80,76,4 ème
BOUCHES-DU-RHONE,ARLES,0131746C,180,159,21,0,81,99,4 ème
BOUCHES-DU-RHONE,AUBAGNE,0131364M,91,91,0,0,40,51,4 ème
BOUCHES-DU-RHONE,AUBAGNE,0132412B,193,164,24,5,93,100,4 ème
BOUCHES-DU-RHONE,CABRIES,0133115R,148,148,0,0,86,62,4 ème
BOUCHES-DU-RHONE,EYGUIERES,0133790Z,141,141,0,0,74,67,4 ème
BOUCHES-DU-RHONE,FOS-SUR-MER,0132634T,224,220,0,4,97,127,4 ème
BOUCHES-DU-RHONE,GREASQUE,0130028K,223,223,0,0,112,111,4 ème
BOUCHES-DU-RHONE,ISTRES,0131888G,142,142,0,0,80,62,4 ème
BOUCHES-DU-RHONE,ISTRES,0132276D,0,0,0,0,0,0,4 ème
BOUCHES-DU-RHONE,LA CIOTAT,0131883B,116,116,0,0,48,68,4 ème
BOUCHES-DU-RHONE,LA CIOTAT,0132786H,185,165,17,3,88,97,4 ème
BOUCHES-DU-RHONE,LAMBESC,0131259Y,98,98,0,0,48,50,4 ème
BOUCHES-DU-RHONE,LANCON-PROVENCE,0134431W,0,0,0,0,0,0,4 ème
BOUCHES-DU-RHONE,LE PUY-SAINTE-REPARADE,0133992U,125,125,0,0,64,61,4 ème
BOUCHES-DU-RHONE,MARIGNANE,0131607B,179,178,0,1,88,91,4 ème
BOUCHES-DU-RHONE,MARIGNANE,0131608C,209,178,29,2,101,108,4 ème
BOUCHES-DU-RHONE,MARSEILLE,0133544G,39,39,0,0,11,28,4 ème
BOUCHES-DU-RHONE,MARSEILLE,0130057S,0,0,0,0,0,0,4 ème
BOUCHES-DU-RHONE,MARSEILLE,0131968U,149,133,14,2,81,68,4 ème
BOUCHES-DU-RHONE,MARSEILLE,0130050J,0,0,0,0,0,0,4 ème
BOUCHES-DU-RHONE,MARSEILLE,0132790M,0,0,0,0,0,0,4 ème
BOUCHES-DU-RHONE,MARSEILLE,0131703F,137,113,24,0,68,69,4 ème
BOUCHES-DU-RHONE,MARSEILLE,0132408X,108,108,0,0,51,57,4 ème
BOUCHES-DU-RHONE,MARSEILLE,0133986M,81,81,0,0,35,46,4 ème
BOUCHES-DU-RHONE,MARSEILLE,0134101M,0,0,0,0,0,0,4 ème
BOUCHES-DU-RHONE,MARSEILLE,0131932E,219,219,0,0,110,109,4 ème
BOUCHES-DU-RHONE,MARSEILLE,0132950L,66,50,16,0,25,41,4 ème
BOUCHES-DU-RHONE,MARSEILLE,0133278T,41,41,0,0,25,16,4 ème
BOUCHES-DU-RHONE,MARSEILLE,0133788X,144,139,0,5,76,68,4 ème
BOUCHES-DU-RHONE,MARSEILLE,0131264D,110,110,0,0,62,48,4 ème
BOUCHES-DU-RHONE,MARSEILLE,0130079R,118,118,0,0,63,55,4 ème
BOUCHES-DU-RHONE,MARSEILLE,0131441W,0,0,0,0,0,0,4 ème
BOUCHES-DU-RHONE,MARSEILLE,0132911U,98,98,0,0,66,32,4 ème
BOUCHES-DU-RHONE,MARSEILLE,0130054N,0,0,0,0,0,0,4 ème
BOUCHES-DU-RHONE,MARSEILLE,0131603X,106,106,0,0,54,52,4 ème
BOUCHES-DU-RHONE,MARSEILLE,0131927Z,203,203,0,0,105,98,4 ème
BOUCHES-DU-RHONE,MARSEILLE,0130084W,101,99,0,2,44,57,4 ème
BOUCHES-DU-RHONE,MARSEILLE,0130139F,110,108,0,2,50,60,4 ème
BOUCHES-DU-RHONE,PEYROLLES-EN-PROVENCE,0131723C,155,155,0,0,88,67,4 ème
BOUCHES-DU-RHONE,ROGNES,0133287C,143,137,0,6,59,84,4 ème
BOUCHES-DU-RHONE,ROQUEVAIRE,0130156Z,210,210,0,0,93,117,4 ème
BOUCHES-DU-RHONE,ROUSSET,0133451F,139,136,0,3,63,76,4 ème
BOUCHES-DU-RHONE,SAINT-CHAMAS,0130158B,122,122,0,0,66,56,4 ème
BOUCHES-DU-RHONE,SAINT-MITRE-LES-REMPARTS,0131367R,66,66,0,0,35,31,4 ème
BOUCHES-DU-RHONE,SALON-DE-PROVENCE,0132789L,150,150,0,0,70,80,4 ème
BOUCHES-DU-RHONE,SALON-DE-PROVENCE,0133492A,172,165,0,7,77,95,4 ème
BOUCHES-DU-RHONE,TARASCON,0131611F,204,180,23,1,98,106,4 ème
BOUCHES-DU-RHONE,VITROLLES,0132214L,143,143,0,0,69,74,4 ème
BOUCHES-DU-RHONE,VITROLLES,0132411A,183,166,17,0,94,89,4 ème
BOUCHES-DU-RHONE,VITROLLES,0133352Y,103,103,0,0,46,57,4 ème
HAUTES-ALPES,LARAGNE-MONTEGLIN,0050452P,76,74,0,2,43,33,4 ème
VAUCLUSE,APT,0840001V,0,0,0,0,0,0,4 ème
VAUCLUSE,APT,0840759U,258,240,15,3,127,131,4 ème
VAUCLUSE,AVIGNON,0840007B,167,167,0,0,74,93,4 ème
VAUCLUSE,AVIGNON,0840042P,0,0,0,0,0,0,4 ème
VAUCLUSE,AVIGNON,0840940R,0,0,0,0,0,0,4 ème
VAUCLUSE,BOLLENE,0840437U,169,153,16,0,72,97,4 ème
VAUCLUSE,CARPENTRAS,0840852V,96,96,0,0,0,96,4 ème
VAUCLUSE,CAVAILLON,0840079E,127,127,0,0,59,68,4 ème
VAUCLUSE,LA TOUR-D'AIGUES,0841027K,176,174,0,2,86,90,4 ème
VAUCLUSE,L'ISLE-SUR-LA-SORGUE,0840021S,0,0,0,0,0,0,4 ème
VAUCLUSE,ORANGE,0840764Z,212,211,0,1,103,109,4 ème
VAUCLUSE,SAINTE-CECILE-LES-VIGNES,0841099N,154,153,0,1,74,80,4 ème
VAUCLUSE,SORGUES,0840033E,101,98,0,3,43,58,4 ème
VAUCLUSE,VALREAS,0840714V,58,58,0,0,24,34,4 ème
VAUCLUSE,VALREAS,0840716X,143,133,10,0,75,68,4 ème
VAUCLUSE,VEDENE,0840039L,0,0,0,0,0,0,4 ème
ALPES-MARITIMES,ANTIBES,0060083H,117,113,0,4,56,61,4 ème
ALPES-MARITIMES,ANTIBES,0061456A,99,99,0,0,55,44,4 ème
ALPES-MARITIMES,CARROS,0061130W,207,184,16,7,95,112,4 ème
ALPES-MARITIMES,GRASSE,0061244V,174,144,28,2,76,98,4 ème
ALPES-MARITIMES,GRASSE,0061668F,151,122,16,13,65,86,4 ème
ALPES-MARITIMES,LA COLLE-SUR-LOUP,0061376N,201,199,0,2,105,96,4 ème
ALPES-MARITIMES,MENTON,0061238N,179,179,0,0,98,81,4 ème
ALPES-MARITIMES,NICE,0060084J,162,156,0,6,93,69,4 ème
ALPES-MARITIMES,NICE,0060086L,176,168,0,8,82,94,4 ème
ALPES-MARITIMES,NICE,0060676C,83,83,0,0,51,32,4 ème
ALPES-MARITIMES,NICE,0061001F,163,145,14,4,72,91,4 ème
ALPES-MARITIMES,NICE,0061003H,102,98,0,4,48,54,4 ème
ALPES-MARITIMES,NICE,0061339Y,207,200,0,7,96,111,4 ème
ALPES-MARITIMES,NICE,0061460E,189,189,0,0,109,80,4 ème
ALPES-MARITIMES,SAINT-JEANNET,0061666D,195,195,0,0,96,99,4 ème
ALPES-MARITIMES,VALBONNE,0062011D,190,190,0,0,104,86,4 ème
ALPES-MARITIMES,VALLAURIS,0061211J,210,186,16,8,108,102,4 ème
VAR,BARJOLS,0830928H,139,120,16,3,65,74,4 ème
VAR,BRIGNOLES,0830833E,193,193,0,0,89,104,4 ème
VAR,FREJUS,0830823U,203,159,31,13,96,107,4 ème
VAR,FREJUS,0830960T,0,0,0,0,0,0,4 ème
VAR,HYERES,0830028E,167,167,0,0,78,89,4 ème
VAR,HYERES,0830832D,106,103,0,3,49,57,4 ème
VAR,HYERES,0831186N,194,192,0,2,106,88,4 ème
VAR,LA CRAU,0830147J,49,49,0,0,15,34,4 ème
VAR,LA GARDE,0830179U,213,213,0,0,103,110,4 ème
VAR,LA SEYNE-SUR-MER,0830830B,131,131,0,0,63,68,4 ème
VAR,LA SEYNE-SUR-MER,0830923C,0,0,0,0,0,0,4 ème
VAR,LE BEAUSSET,0831056X,166,166,0,0,77,89,4 ème
VAR,LES ARCS,0830001A,171,171,0,0,79,92,4 ème
VAR,ROQUEBRUNE-SUR-ARGENS,0831474B,200,200,0,0,98,102,4 ème
VAR,SAINT-CYR-SUR-MER,0830038R,126,126,0,0,48,78,4 ème
VAR,SAINT-MAXIMIN-LA-SAINTE-BAUME,0830959S,167,167,0,0,80,87,4 ème
VAR,SAINT-RAPHAEL,0831116M,197,197,0,0,105,92,4 ème
VAR,TOULON,0830058M,0,0,0,0,0,0,4 ème
VAR,TOULON,0830059N,0,0,0,0,0,0,4 ème
VAR,TOULON,0830110U,164,164,0,0,84,80,4 ème
VAR,TOULON,0830111V,84,82,0,2,45,39,4 ème
VAR,TOULON,0830162A,121,119,0,2,50,71,4 ème
VAR,TOULON,0830926F,185,185,0,0,74,111,4 ème
VAR,TOULON,0831115L,80,79,0,1,50,30,4 ème
VAR,VIDAUBAN,0831379Y,171,171,0,0,84,87,4 ème
ALLIER,BELLENAVES,0030001K,68,68,0,0,34,34,4 ème
ALLIER,BELLERIVE-SUR-ALLIER,0030002L,109,109,0,0,46,63,4 ème
ALLIER,COMMENTRY,0030890B,121,102,15,4,65,56,4 ème
ALLIER,COMMENTRY,0031044U,0,0,0,0,0,0,4 ème
ALLIER,CUSSET,0030979Y,138,138,0,0,68,70,4 ème
ALLIER,DOYET,0030015A,32,32,0,0,18,14,4 ème
ALLIER,MONTLUCON,0030030S,70,68,0,2,40,30,4 ème
ALLIER,MONTLUCON,0030091H,140,134,0,6,63,77,4 ème
ALLIER,MONTMARAULT,0030035X,45,44,0,1,16,29,4 ème
ALLIER,MOULINS,0030039B,144,142,0,2,66,78,4 ème
ALLIER,SAINT-GERMAIN-DES-FOSSES,0030043F,72,69,0,3,29,43,4 ème
ALLIER,SAINT-POURCAIN-SUR-SIOULE,0030104X,29,29,0,0,19,10,4 ème
ALLIER,SAINT-POURCAIN-SUR-SIOULE,0030892D,103,103,0,0,59,44,4 ème
ALLIER,VARENNES-SUR-ALLIER,0030048L,89,69,16,4,42,47,4 ème
ALLIER,VICHY,0030049M,82,80,0,2,49,33,4 ème
CANTAL,ALLANCHE,0150001V,22,22,0,0,10,12,4 ème
CANTAL,CONDAT,0150011F,16,16,0,0,7,9,4 ème
CANTAL,MONTSALVY,0150020R,44,44,0,0,23,21,4 ème
CANTAL,RIOM-ES-MONTAGNES,0150027Y,41,41,0,0,17,24,4 ème
CANTAL,SAINT-FLOUR,0150053B,42,40,0,2,12,30,4 ème
CANTAL,YDES,0150034F,47,47,0,0,24,23,4 ème
HAUTE-LOIRE,BRIOUDE,0430854V,120,117,0,3,56,64,4 ème
HAUTE-LOIRE,BRIOUDE,0430898T,93,90,0,3,46,47,4 ème
HAUTE-LOIRE,LE PUY-EN-VELAY,0430902X,113,113,0,0,69,44,4 ème
HAUTE-LOIRE,MONISTROL-SUR-LOIRE,0430663M,159,149,0,10,73,86,4 ème
HAUTE-LOIRE,RETOURNAC,0430026V,73,73,0,0,38,35,4 ème
HAUTE-LOIRE,SAINT-JULIEN-CHAPTEUIL,0430086K,43,43,0,0,22,21,4 ème
HAUTE-LOIRE,SAUGUES,0430032B,20,20,0,0,12,8,4 ème
HAUTE-LOIRE,YSSINGEAUX,0430909E,95,91,0,4,44,51,4 ème
PUY-DE-DOME,AUBIERE,0631081H,56,51,0,5,24,32,4 ème
PUY-DE-DOME,BESSE-ET-SAINT-ANASTAISE,0630008S,66,66,0,0,36,30,4 ème
PUY-DE-DOME,BILLOM,0630009T,203,203,0,0,109,94,4 ème
PUY-DE-DOME,CLERMONT-FERRAND,0630024J,0,0,0,0,0,0,4 ème
PUY-DE-DOME,CLERMONT-FERRAND,0631085M,171,171,0,0,90,81,4 ème
PUY-DE-DOME,CLERMONT-FERRAND,0631086N,150,150,0,0,73,77,4 ème
PUY-DE-DOME,CLERMONT-FERRAND,0631502R,112,108,0,4,51,61,4 ème
PUY-DE-DOME,CLERMONT-FERRAND,0631731P,140,140,0,0,68,72,4 ème
PUY-DE-DOME,CLERMONT-FERRAND,0631773K,135,133,0,2,59,76,4 ème
PUY-DE-DOME,COURPIERE,0631523N,83,79,0,4,44,39,4 ème
PUY-DE-DOME,COURPIERE,0631733S,46,46,0,0,19,27,4 ème
PUY-DE-DOME,ISSOIRE,0630041C,0,0,0,0,0,0,4 ème
PUY-DE-DOME,RIOM,0631763Z,188,151,31,6,93,95,4 ème
PUY-DE-DOME,SAINT-ELOY-LES-MINES,0630060Y,76,68,0,8,39,37,4 ème
ARDECHE,ANNONAY,0070100W,0,0,0,0,0,0,4 ème
ARDECHE,ANNONAY,0071156U,222,197,20,5,100,122,4 ème
ARDECHE,GUILHERAND-GRANGES,0070011Z,180,175,0,5,84,96,4 ème
ARDECHE,JOYEUSE,0070012A,65,62,0,3,34,31,4 ème
ARDECHE,LAMASTRE,0071168G,26,26,0,0,11,15,4 ème
ARDECHE,LARGENTIERE,0070017F,48,48,0,0,22,26,4 ème
ARDECHE,SAINT-PERAY,0071320X,150,129,15,6,82,68,4 ème
ARDECHE,SATILLIEU,0070086F,55,55,0,0,22,33,4 ème
ARDECHE,TOURNON-SUR-RHONE,0071192H,136,136,0,0,71,65,4 ème
DROME,BOURG-DE-PEAGE,0260001K,229,226,0,3,119,110,4 ème
DROME,CLEON-D'ANDRAN,0260005P,136,136,0,0,71,65,4 ème
DROME,DIEULEFIT,0260009U,91,91,0,0,46,45,4 ème
DROME,MONTELIMAR,0260045H,165,161,0,4,78,87,4 ème
DROME,MONTELIMAR,0261086P,169,161,0,8,74,95,4 ème
DROME,PORTES-LES-VALENCE,0260021G,165,156,0,9,81,84,4 ème
DROME,ROMANS-SUR-ISERE,0261091V,48,44,0,4,27,21,4 ème
DROME,SAINT-DONAT-SUR-L'HERBASSE,0260026M,95,94,0,1,46,49,4 ème
DROME,SAINT-RAMBERT-D'ALBON,0260101U,84,82,0,2,40,44,4 ème
DROME,SUZE-LA-ROUSSE,0260033V,70,70,0,0,39,31,4 ème
DROME,VALENCE,0261100E,0,0,0,0,0,0,4 ème
HAUTE SAVOIE,ANNECY,0740065U,142,138,0,4,77,65,4 ème
HAUTE SAVOIE,ANNECY,0740106N,118,118,0,0,62,56,4 ème
HAUTE SAVOIE,ANNECY,0740930J,173,172,0,1,84,89,4 ème
HAUTE SAVOIE,ANNECY,0741278M,186,185,0,1,88,98,4 ème
HAUTE SAVOIE,ANNEMASSE,0741476C,0,0,0,0,0,0,4 ème
HAUTE SAVOIE,BONNEVILLE,0740157U,169,166,0,3,78,91,4 ème
HAUTE SAVOIE,CHAMONIX-MONT-BLANC,0740110T,58,58,0,0,35,23,4 ème
HAUTE SAVOIE,CLUSES,0740143D,0,0,0,0,0,0,4 ème
HAUTE SAVOIE,COLLONGES-SOUS-SALEVE,0740114X,58,58,0,0,32,26,4 ème
HAUTE SAVOIE,FRANGY,0740024Z,133,133,0,0,67,66,4 ème
HAUTE SAVOIE,GAILLARD,0741097R,173,167,0,6,83,90,4 ème
HAUTE SAVOIE,LA ROCHE-SUR-FORON,0740931K,193,177,16,0,100,93,4 ème
HAUTE SAVOIE,LA ROCHE-SUR-FORON,0741286W,0,0,0,0,0,0,4 ème
HAUTE SAVOIE,MARGENCEL,0741666J,143,114,26,3,66,77,4 ème
HAUTE SAVOIE,MEGEVE,0740026B,64,64,0,0,26,38,4 ème
HAUTE SAVOIE,POISY,0741699V,138,135,0,3,72,66,4 ème
HAUTE SAVOIE,RUMILLY,0740032H,177,159,16,2,95,82,4 ème
HAUTE SAVOIE,SAINT-GERVAIS-LES-BAINS,0740095B,33,33,0,0,14,19,4 ème
HAUTE SAVOIE,SAINT-JEOIRE,0740035L,178,174,0,4,75,103,4 ème
HAUTE SAVOIE,SAINT-JEOIRE,0740152N,0,0,0,0,0,0,4 ème
HAUTE SAVOIE,SAINT-JULIEN-EN-GENEVOIS,0740038P,213,201,12,0,98,115,4 ème
HAUTE SAVOIE,SALLANCHES,0741281R,115,109,0,6,65,50,4 ème
HAUTE SAVOIE,TANINGES,0740043V,122,122,0,0,55,67,4 ème
HAUTE SAVOIE,THONON-LES-BAINS,0740102J,158,158,0,0,73,85,4 ème
HAUTE SAVOIE,THONON-LES-BAINS,0741227G,223,218,0,5,115,108,4 ème
HAUTE SAVOIE,THONON-LES-BAINS,0741341F,228,208,16,4,103,125,4 ème
HAUTE SAVOIE,VILLE-LA-GRAND,0740910M,296,256,31,9,155,141,4 ème
ISERE,BEAUREPAIRE,0381685A,57,57,0,0,32,25,4 ème
ISERE,BOURGOIN-JALLIEU,0381658W,139,139,0,0,63,76,4 ème
ISERE,BOURGOIN-JALLIEU,0382174G,207,171,31,5,109,98,4 ème
ISERE,CHARVIEU-CHAVAGNEUX,0380011F,137,134,0,3,78,59,4 ème
ISERE,ECHIROLLES,0381903M,112,92,16,4,57,55,4 ème
ISERE,FONTAINE,0381810L,112,95,14,3,62,50,4 ème
ISERE,GIERES,0380025W,146,142,0,4,72,74,4 ème
ISERE,GRENOBLE,0380032D,0,0,0,0,0,0,4 ème
ISERE,GRENOBLE,0381758E,0,0,0,0,0,0,4 ème
ISERE,GRENOBLE,0381780D,110,110,0,0,49,61,4 ème
ISERE,GRENOBLE,0382114S,147,144,0,3,72,75,4 ème
ISERE,GRENOBLE,0383437E,41,29,12,0,15,26,4 ème
ISERE,LA COTE-SAINT-ANDRE,0382893N,0,0,0,0,0,0,4 ème
ISERE,LA MURE,0382426F,140,130,8,2,62,78,4 ème
ISERE,LA TRONCHE,0381630R,3,3,0,0,2,1,4 ème
ISERE,LE PONT-DE-BEAUVOISIN,0382427G,125,123,0,2,57,68,4 ème
ISERE,LE PONT-DE-CLAIX,0380013H,115,115,0,0,54,61,4 ème
ISERE,LES AVENIERES VEYRINS-THUELLIN,0380004Y,134,134,0,0,58,76,4 ème
ISERE,MONTALIEU-VERCIEU,0380045T,141,141,0,0,71,70,4 ème
ISERE,SAINT-ETIENNE-DE-SAINT-GEOIRS,0380059H,117,117,0,0,53,64,4 ème
ISERE,SAINT-MARTIN-D'HERES,0380357G,95,76,14,5,40,55,4 ème
ISERE,SAINT-MARTIN-LE-VINOUX,0382036G,139,124,8,7,60,79,4 ème
ISERE,SALAISE-SUR-SANNE,0383253E,170,170,0,0,89,81,4 ème
ISERE,VARCES-ALLIERES-ET-RISSET,0383260M,120,120,0,0,57,63,4 ème
ISERE,VIENNE,0382430K,165,165,0,0,84,81,4 ème
ISERE,VINAY,0380087N,128,123,0,5,61,67,4 ème
ISERE,VOIRON,0381809K,0,0,0,0,0,0,4 ème
SAVOIE,AIME-LA-PLAGNE,0730002F,113,113,0,0,61,52,4 ème
SAVOIE,AIX-LES-BAINS,0730791N,112,112,0,0,51,61,4 ème
SAVOIE,AIX-LES-BAINS,0731204M,122,122,0,0,54,68,4 ème
SAVOIE,ALBERTVILLE,0730760E,0,0,0,0,0,0,4 ème
SAVOIE,BARBERAZ,0730772T,0,0,0,0,0,0,4 ème
SAVOIE,BEAUFORT,0730007L,53,53,0,0,24,29,4 ème
SAVOIE,CHAMBERY,0730811K,25,0,25,0,10,15,4 ème
SAVOIE,MONTMELIAN,0731044N,207,191,16,0,103,104,4 ème
AIN,ARTEMARE,0010794H,92,88,0,4,45,47,4 ème
AIN,BAGE-DOMMARTIN,0010005A,154,152,0,2,75,79,4 ème
AIN,BELLEY,0011150V,99,95,0,4,50,49,4 ème
AIN,DAGNEUX,0011142L,131,131,0,0,57,74,4 ème
AIN,GEX,0010024W,183,166,15,2,88,95,4 ème
AIN,PERONNAS,0010938P,153,118,31,4,79,74,4 ème
AIN,PONCIN,0010036J,86,85,0,1,44,42,4 ème
AIN,TREVOUX,0010097A,166,166,0,0,88,78,4 ème
LOIRE,BOURG-ARGENTAL,0420003A,53,53,0,0,18,35,4 ème
LOIRE,CHAZELLES-SUR-LYON,0420011J,85,85,0,0,51,34,4 ème
LOIRE,LA PACAUDIERE,0421456E,66,66,0,0,29,37,4 ème
LOIRE,LE COTEAU,0421084A,138,119,15,4,67,71,4 ème
LOIRE,MONTBRISON,0421454C,327,292,31,4,167,160,4 ème
LOIRE,NOIRETABLE,0420022W,47,47,0,0,26,21,4 ème
LOIRE,RIVE-DE-GIER,0421172W,173,158,15,0,83,90,4 ème
LOIRE,ROANNE,0420987V,0,0,0,0,0,0,4 ème
LOIRE,SAINT-CHAMOND,0421486M,104,99,0,5,50,54,4 ème
LOIRE,SAINT-ETIENNE,0420049A,0,0,0,0,0,0,4 ème
LOIRE,SAINT-ETIENNE,0421176A,121,100,16,5,54,67,4 ème
LOIRE,SAINT-ETIENNE,0421686E,112,92,17,3,53,59,4 ème
LOIRE,SAINT-ETIENNE,0421804H,192,187,0,5,99,93,4 ème
LOIRE,SAINT-JUST-EN-CHEVALET,0420062P,24,24,0,0,14,10,4 ème
LOIRE,SAINT-JUST-EN-CHEVALET,0421061A,20,20,0,0,14,6,4 ème
RHONE,BRIGNAIS,0692582G,108,102,0,6,57,51,4 ème
RHONE,CALUIRE-ET-CUIRE,0691728D,159,145,13,1,68,91,4 ème
RHONE,CALUIRE-ET-CUIRE,0692968B,0,0,0,0,0,0,4 ème
RHONE,CHAPONNAY,0693243A,189,189,0,0,101,88,4 ème
RHONE,CHATILLON,0693975W,188,182,0,6,87,101,4 ème
RHONE,CIVRIEUX-D'AZERGUES,0690584K,96,91,0,5,47,49,4 ème
RHONE,CONDRIEU,0690587N,78,78,0,0,31,47,4 ème
RHONE,CORBAS,0692898A,122,122,0,0,58,64,4 ème
RHONE,COURS,0690016T,59,59,0,0,32,27,4 ème
RHONE,COURS,0690590S,15,15,0,0,9,6,4 ème
RHONE,DECINES-CHARPIEU,0694185Z,60,60,0,0,36,24,4 ème
RHONE,DEUX-GROSNES,0690070B,40,40,0,0,17,23,4 ème
RHONE,FRANCHEVILLE,0694151M,177,174,0,3,92,85,4 ème
RHONE,GENAS,0691650U,182,176,0,6,103,79,4 ème
RHONE,IRIGNY,0691824H,164,161,0,3,82,82,4 ème
RHONE,L'ARBRESLE,0690578D,117,117,0,0,59,58,4 ème
RHONE,LYON,0692929J,225,225,0,0,99,126,4 ème
RHONE,LYON,0694191F,194,194,0,0,97,97,4 ème
RHONE,LYON,0690641X,0,0,0,0,0,0,4 ème
RHONE,LYON,0690698J,0,0,0,0,0,0,4 ème
RHONE,LYON,0692505Y,180,176,0,4,88,92,4 ème
RHONE,LYON,0691798E,107,101,0,6,49,58,4 ème
RHONE,LYON,0692920Z,156,156,0,0,83,73,4 ème
RHONE,LYON,0692339T,168,150,16,2,73,95,4 ème
RHONE,LYON,0692922B,126,126,0,0,59,67,4 ème
RHONE,LYON,0693479G,185,185,0,0,105,80,4 ème
RHONE,LYON,0692340U,167,148,16,3,72,95,4 ème
RHONE,LYON,0692940W,204,204,0,0,106,98,4 ème
RHONE,LYON,0692698H,222,219,0,3,124,98,4 ème
RHONE,NEUVILLE-SUR-SAONE,0692941X,274,274,0,0,140,134,4 ème
RHONE,OULLINS,0691673U,88,81,0,7,25,63,4 ème
RHONE,RILLIEUX-LA-PAPE,0691498D,150,146,0,4,66,84,4 ème
RHONE,RILLIEUX-LA-PAPE,0692159X,167,151,16,0,77,90,4 ème
RHONE,SAINT-DIDIER-AU-MONT-D'OR,0690546U,158,153,0,5,77,81,4 ème
RHONE,SAINT-LAURENT-DE-MURE,0692865P,181,180,0,1,103,78,4 ème
RHONE,SAINT-PRIEST,0694312M,58,58,0,0,32,26,4 ème
RHONE,TASSIN-LA-DEMI-LUNE,0692163B,185,183,0,2,96,89,4 ème
RHONE,VAL D'OINGT,0690580F,77,77,0,0,41,36,4 ème
RHONE,VAUGNERAY,0690621A,149,145,0,4,84,65,4 ème
RHONE,VAULX-EN-VELIN,0692336P,171,154,16,1,85,86,4 ème
RHONE,VENISSIEUX,0690551Z,171,171,0,0,89,82,4 ème
RHONE,VILLEFRANCHE-SUR-SAONE,0690099H,127,111,16,0,68,59,4 ème
RHONE,VILLEFRANCHE-SUR-SAONE,0693375U,0,0,0,0,0,0,4 ème
RHONE,VILLEURBANNE,0690047B,0,0,0,0,0,0,4 ème
RHONE,VILLEURBANNE,0690107S,0,0,0,0,0,0,4 ème
RHONE,VILLEURBANNE,0690626F,142,128,11,3,72,70,4 ème
RHONE,VILLEURBANNE,0692337R,129,125,0,4,62,67,4 ème
RHONE,VILLEURBANNE,0693093M,111,105,0,6,52,59,4 ème
RHONE,VILLEURBANNE,0694296V,97,96,0,1,47,50,4 ème
DOUBS,AMANCEY,0251048D,16,16,0,0,5,11,4 ème
DOUBS,AUDINCOURT,0250001R,0,0,0,0,0,0,4 ème
DOUBS,BESANCON,0250013D,0,0,0,0,0,0,4 ème
DOUBS,BESANCON,0251079M,0,0,0,0,0,0,4 ème
DOUBS,BESANCON,0251080N,150,131,16,3,78,72,4 ème
DOUBS,BESANCON,0251127P,163,160,0,3,84,79,4 ème
DOUBS,LEVIER,0251069B,52,52,0,0,27,25,4 ème
DOUBS,MOUTHE,0250040H,135,135,0,0,60,75,4 ème
DOUBS,ORNANS,0251129S,121,120,0,1,60,61,4 ème
DOUBS,ROULANS,0250051V,87,87,0,0,48,39,4 ème
DOUBS,SAINT-VIT,0251394E,200,184,16,0,102,98,4 ème
DOUBS,VERCEL-VILLEDIEU-LE-CAMP,0251062U,50,50,0,0,24,26,4 ème
HAUTE-SAONE,DAMPIERRE-SUR-SALON,0700004Z,82,82,0,0,44,38,4 ème
HAUTE-SAONE,FOUGEROLLES-SAINT-VALBERT,0700007C,63,60,0,3,21,42,4 ème
HAUTE-SAONE,GRAY,0700011G,0,0,0,0,0,0,4 ème
HAUTE-SAONE,LURE,0700018P,0,0,0,0,0,0,4 ème
HAUTE-SAONE,LURE,0700076C,0,0,0,0,0,0,4 ème
HAUTE-SAONE,MARNAY,0700026Y,134,134,0,0,66,68,4 ème
HAUTE-SAONE,RIOZ,0700029B,190,187,0,3,101,89,4 ème
HAUTE-SAONE,SAINT-LOUP-SUR-SEMOUSE,0700788B,103,103,0,0,48,55,4 ème
HAUTE-SAONE,VESOUL,0700786Z,141,111,28,2,65,76,4 ème
HAUTE-SAONE,VILLERSEXEL,0700077D,9,0,9,0,4,5,4 ème
JURA,ARBOIS,0390960G,41,41,0,0,23,18,4 ème
JURA,CHAMPAGNOLE,0390961H,148,148,0,0,66,82,4 ème
JURA,DAMPARIS,0390010Z,75,75,0,0,42,33,4 ème
JURA,DOLE,0390797E,122,120,0,2,76,46,4 ème
JURA,DOLE,0391002C,204,183,17,4,87,117,4 ème
JURA,FRAISANS,0390016F,93,93,0,0,42,51,4 ème
JURA,LONS-LE-SAUNIER,0390907Z,171,134,32,5,84,87,4 ème
JURA,ORGELET,0390031X,48,44,0,4,24,24,4 ème
JURA,SAINT-AMOUR,0390914G,0,0,0,0,0,0,4 ème
JURA,SAINT-CLAUDE,0390071R,67,67,0,0,37,30,4 ème
JURA,VOITEUR,0390073T,54,54,0,0,19,35,4 ème
TERRITOIRE DE BELFORT,BAVILLIERS,0900355X,0,0,0,0,0,0,4 ème
TERRITOIRE DE BELFORT,BEAUCOURT,0900275K,115,111,0,4,53,62,4 ème
TERRITOIRE DE BELFORT,DANJOUTIN,0900237U,136,133,0,3,75,61,4 ème
TERRITOIRE DE BELFORT,DELLE,0900007U,120,104,16,0,59,61,4 ème
TERRITOIRE DE BELFORT,DELLE,0900019G,0,0,0,0,0,0,4 ème
COTE D'OR,ARNAY-LE-DUC,0210001M,50,50,0,0,20,30,4 ème
COTE D'OR,BROCHON,0211140A,148,148,0,0,72,76,4 ème
COTE D'OR,CHENOVE,0211225T,54,36,16,2,22,32,4 ème
COTE D'OR,CHEVIGNY-SAINT-SAUVEUR,0211137X,194,193,0,1,97,97,4 ème
COTE D'OR,DIJON,0210019G,0,0,0,0,0,0,4 ème
COTE D'OR,DIJON,0210025N,102,95,0,7,46,56,4 ème
COTE D'OR,DIJON,0211070Z,289,269,16,4,118,171,4 ème
COTE D'OR,MARSANNAY-LA-COTE,0211391Y,100,96,0,4,52,48,4 ème
COTE D'OR,MONTBARD,0210034Y,76,73,0,3,41,35,4 ème
COTE D'OR,NOLAY,0210037B,50,50,0,0,23,27,4 ème
COTE D'OR,PONTAILLER-SUR-SAONE,0210040E,87,87,0,0,48,39,4 ème
COTE D'OR,SEMUR-EN-AUXOIS,0210047M,0,0,0,0,0,0,4 ème
COTE D'OR,TALANT,0211523S,80,77,0,3,45,35,4 ème
NIEVRE,DORNES,0580019F,29,29,0,0,18,11,4 ème
NIEVRE,IMPHY,0580618G,55,53,0,2,29,26,4 ème
NIEVRE,LUZY,0580619H,36,36,0,0,16,20,4 ème
NIEVRE,MOULINS-ENGILBERT,0580030T,43,43,0,0,21,22,4 ème
NIEVRE,VARENNES-VAUZELLES,0580620J,123,103,16,4,51,72,4 ème
SAONE-ET-LOIRE,CHAGNY,0710009Z,171,169,0,2,78,93,4 ème
SAONE-ET-LOIRE,CHALON-SUR-SAONE,0710012C,0,0,0,0,0,0,4 ème
SAONE-ET-LOIRE,CHAUFFAILLES,0710021M,71,71,0,0,37,34,4 ème
SAONE-ET-LOIRE,DIGOIN,0711136Z,99,97,0,2,48,51,4 ème
SAONE-ET-LOIRE,LUGNY,0710044M,137,133,0,4,81,56,4 ème
SAONE-ET-LOIRE,MACON,0711054K,203,189,14,0,92,111,4 ème
SAONE-ET-LOIRE,MATOUR,0710053X,71,71,0,0,29,42,4 ème
SAONE-ET-LOIRE,MONTCEAU-LES-MINES,0711135Y,104,103,0,1,55,49,4 ème
SAONE-ET-LOIRE,PARAY-LE-MONIAL,0711314T,108,108,0,0,51,57,4 ème
SAONE-ET-LOIRE,SAINT-GENGOUX-LE-NATIONAL,0710064J,71,71,0,0,35,36,4 ème
SAONE-ET-LOIRE,TOURNUS,0710535W,117,114,0,3,52,65,4 ème
YONNE,ANCY-LE-FRANC,0890979F,41,41,0,0,20,21,4 ème
YONNE,BRIENON-SUR-ARMANCON,0891057R,60,60,0,0,29,31,4 ème
YONNE,PONT-SUR-YONNE,0890823L,144,130,14,0,63,81,4 ème
YONNE,SENS,0890030Z,127,123,0,4,60,67,4 ème
YONNE,VERMENTON,0890037G,63,63,0,0,39,24,4 ème
COTES D'ARMOR,BROONS,0220136D,49,49,0,0,29,20,4 ème
COTES D'ARMOR,CORLAY,0220009R,20,20,0,0,7,13,4 ème
COTES D'ARMOR,DINAN,0221744B,113,107,0,6,58,55,4 ème
COTES D'ARMOR,GOUAREC,0221745C,15,15,0,0,6,9,4 ème
COTES D'ARMOR,GUERLEDAN,0220150U,31,31,0,0,10,21,4 ème
COTES D'ARMOR,LAMBALLE-ARMOR,0220142K,217,215,0,2,100,117,4 ème
COTES D'ARMOR,LAMBALLE-ARMOR,0220196U,0,0,0,0,0,0,4 ème
COTES D'ARMOR,LE MENE,0220008P,62,62,0,0,32,30,4 ème
COTES D'ARMOR,PLERIN,0220134B,85,85,0,0,44,41,4 ème
COTES D'ARMOR,PLOUER-SUR-RANCE,0220161F,59,59,0,0,25,34,4 ème
COTES D'ARMOR,SAINT-BRIEUC,0220071H,0,0,0,0,0,0,4 ème
COTES D'ARMOR,SAINT-BRIEUC,0220184F,109,93,16,0,52,57,4 ème
COTES D'ARMOR,SAINT-NICOLAS-DU-PELEM,0220061X,15,15,0,0,8,7,4 ème
COTES D'ARMOR,SAINT-QUAY-PORTRIEUX,0220063Z,97,97,0,0,41,56,4 ème
COTES D'ARMOR,SAINT-QUAY-PORTRIEUX,0220176X,42,42,0,0,25,17,4 ème
FINISTERE,BREST,0290012F,0,0,0,0,0,0,4 ème
FINISTERE,BREST,0290236Z,45,45,0,0,22,23,4 ème
FINISTERE,BREST,0291661Y,87,72,15,0,43,44,4 ème
FINISTERE,BREST,0291869Z,193,193,0,0,89,104,4 ème
FINISTERE,CARHAIX-PLOUGUER,0290247L,56,56,0,0,31,25,4 ème
FINISTERE,CONCARNEAU,0290031B,86,82,0,4,41,45,4 ème
FINISTERE,CROZON,0290032C,116,116,0,0,62,54,4 ème
FINISTERE,DOUARNENEZ,0290260A,59,59,0,0,21,38,4 ème
FINISTERE,GUERLESQUIN,0290039K,51,51,0,0,28,23,4 ème
FINISTERE,GUILERS,0291713E,54,54,0,0,23,31,4 ème
FINISTERE,GUIPAVAS,0291655S,127,124,0,3,61,66,4 ème
FINISTERE,HUELGOAT,0290148D,40,40,0,0,29,11,4 ème
FINISTERE,LANDERNEAU,0290045S,223,207,16,0,108,115,4 ème
FINISTERE,LE RELECQ-KERHUON,0292055B,77,77,0,0,41,36,4 ème
FINISTERE,MOELAN-SUR-MER,0291717J,93,93,0,0,48,45,4 ème
FINISTERE,MORLAIX,0291104T,66,60,0,6,30,36,4 ème
FINISTERE,PLABENNEC,0290286D,124,121,0,3,55,69,4 ème
FINISTERE,PLOUDALMEZEAU,0290065N,107,107,0,0,48,59,4 ème
FINISTERE,PLOUGASTEL-DAOULAS,0291928N,126,125,0,1,63,63,4 ème
FINISTERE,PLOUHINEC,0290330B,70,70,0,0,38,32,4 ème
FINISTERE,PLOUNEOUR-MENEZ,0290058F,59,59,0,0,36,23,4 ème
FINISTERE,PLOUZANE,0291753Y,87,87,0,0,50,37,4 ème
FINISTERE,PONT-AVEN,0290301V,38,38,0,0,19,19,4 ème
FINISTERE,PONT-L'ABBE,0290168A,0,0,0,0,0,0,4 ème
FINISTERE,QUIMPER,0290071V,0,0,0,0,0,0,4 ème
FINISTERE,QUIMPER,0290320R,93,93,0,0,36,57,4 ème
FINISTERE,QUIMPERLE,0290107J,94,93,0,1,53,41,4 ème
FINISTERE,SAINT-MARTIN-DES-CHAMPS,0290083H,44,42,0,2,20,24,4 ème
ILLE-ET-VILAINE,BREAL-SOUS-MONTFORT,0352958A,146,146,0,0,76,70,4 ème
ILLE-ET-VILAINE,CANCALE,0350853M,63,63,0,0,32,31,4 ème
ILLE-ET-VILAINE,CESSON-SEVIGNE,0353006C,0,0,0,0,0,0,4 ème
ILLE-ET-VILAINE,CHATEAUBOURG,0352448W,178,178,0,0,71,107,4 ème
ILLE-ET-VILAINE,COMBOURG,0350707D,148,146,0,2,77,71,4 ème
ILLE-ET-VILAINE,CREVIN,0352860U,143,143,0,0,80,63,4 ème
ILLE-ET-VILAINE,DINARD,0351795L,131,131,0,0,72,59,4 ème
ILLE-ET-VILAINE,FOUGERES,0350770X,249,249,0,0,127,122,4 ème
ILLE-ET-VILAINE,FOUGERES,0350967L,126,90,32,4,61,65,4 ème
ILLE-ET-VILAINE,GUICHEN,0351881E,184,181,0,3,95,89,4 ème
ILLE-ET-VILAINE,LA GUERCHE-DE-BRETAGNE,0350863Y,137,137,0,0,68,69,4 ème
ILLE-ET-VILAINE,MARTIGNE-FERCHAUD,0350868D,79,79,0,0,41,38,4 ème
ILLE-ET-VILAINE,MELESSE,0352183H,118,118,0,0,67,51,4 ème
ILLE-ET-VILAINE,MONTFORT-SUR-MEU,0350872H,169,167,0,2,85,84,4 ème
ILLE-ET-VILAINE,MONTFORT-SUR-MEU,0351791G,207,177,30,0,105,102,4 ème
ILLE-ET-VILAINE,PIPRIAC,0350875L,87,83,0,4,46,41,4 ème
ILLE-ET-VILAINE,PLEINE-FOUGERES,0350021H,63,63,0,0,31,32,4 ème
ILLE-ET-VILAINE,PLEINE-FOUGERES,0350877N,43,43,0,0,22,21,4 ème
ILLE-ET-VILAINE,PLELAN-LE-GRAND,0350878P,68,68,0,0,40,28,4 ème
ILLE-ET-VILAINE,REDON,0350102W,0,0,0,0,0,0,4 ème
ILLE-ET-VILAINE,RENNES,0350031U,0,0,0,0,0,0,4 ème
ILLE-ET-VILAINE,RENNES,0350760L,111,102,0,9,48,63,4 ème
ILLE-ET-VILAINE,RENNES,0350776D,0,0,0,0,0,0,4 ème
ILLE-ET-VILAINE,RENNES,0350835T,105,103,0,2,54,51,4 ème
ILLE-ET-VILAINE,RENNES,0351054F,0,0,0,0,0,0,4 ème
ILLE-ET-VILAINE,RENNES,0352071L,47,47,0,0,23,24,4 ème
ILLE-ET-VILAINE,SAINT-MALO,0350785N,106,106,0,0,53,53,4 ème
ILLE-ET-VILAINE,TINTENIAC,0350050P,0,0,0,0,0,0,4 ème
ILLE-ET-VILAINE,VAL D'ANAST,0350017D,95,94,0,1,58,37,4 ème
ILLE-ET-VILAINE,VITRE,0350808N,0,0,0,0,0,0,4 ème
ILLE-ET-VILAINE,VITRE,0352008T,99,99,0,0,52,47,4 ème
MORBIHAN,BAUD,0561386C,102,102,0,0,49,53,4 ème
MORBIHAN,BAUD,0561399S,70,70,0,0,31,39,4 ème
MORBIHAN,ETEL,0560009F,85,85,0,0,50,35,4 ème
MORBIHAN,GOURIN,0561383Z,55,54,0,1,25,30,4 ème
MORBIHAN,GROIX,0561352R,5,5,0,0,2,3,4 ème
MORBIHAN,GUER,0560061M,96,96,0,0,37,59,4 ème
MORBIHAN,LA GACILLY,0561400T,124,124,0,0,56,68,4 ème
MORBIHAN,LE PALAIS,0560034H,33,33,0,0,17,16,4 ème
MORBIHAN,LORIENT,0560149H,120,119,0,1,67,53,4 ème
MORBIHAN,PLESCOP,0561931V,116,111,0,5,61,55,4 ème
MORBIHAN,PLOERMEL,0560108N,239,219,17,3,125,114,4 ème
MORBIHAN,PLUVIGNER,0561356V,158,158,0,0,67,91,4 ème
MORBIHAN,QUESTEMBERT,0561641E,0,0,0,0,0,0,4 ème
MORBIHAN,QUEVEN,0561384A,179,154,16,9,78,101,4 ème
MORBIHAN,VANNES,0560118Z,226,212,14,0,130,96,4 ème
CHER,BOURGES,0180593X,173,153,17,3,84,89,4 ème
CHER,BOURGES,0180766K,68,65,0,3,30,38,4 ème
CHER,BOURGES,0180796T,220,220,0,0,115,105,4 ème
CHER,BOURGES,0180823X,0,0,0,0,0,0,4 ème
CHER,CHATEAUMEILLANT,0180013S,65,57,8,0,32,33,4 ème
CHER,LA GUERCHE-SUR-L'AUBOIS,0180710Z,82,69,8,5,35,47,4 ème
CHER,MEHUN-SUR-YEVRE,0180586P,121,120,0,1,54,67,4 ème
CHER,SAINT-GERMAIN-DU-PUY,0180732Y,118,106,9,3,60,58,4 ème
CHER,SANCOINS,0180033N,52,52,0,0,31,21,4 ème
CHER,VIERZON,0180036S,0,0,0,0,0,0,4 ème
CHER,VIERZON,0180572Z,0,0,0,0,0,0,4 ème
EURE-ET-LOIR,AUTHON-DU-PERCHE,0280002A,46,46,0,0,23,23,4 ème
EURE-ET-LOIR,BU,0281095N,106,105,0,1,57,49,4 ème
EURE-ET-LOIR,CHARTRES,0280691Z,0,0,0,0,0,0,4 ème
EURE-ET-LOIR,CHARTRES,0280993C,155,155,0,0,91,64,4 ème
EURE-ET-LOIR,CHATEAUDUN,0280918W,87,64,23,0,44,43,4 ème
EURE-ET-LOIR,ILLIERS-COMBRAY,0280702L,129,126,0,3,66,63,4 ème
EURE-ET-LOIR,LES VILLAGES VOVEENS,0280040S,111,109,0,2,58,53,4 ème
EURE-ET-LOIR,LUCE,0280657M,108,73,32,3,47,61,4 ème
EURE-ET-LOIR,LUISANT,0281043G,155,152,0,3,83,72,4 ème
EURE-ET-LOIR,NOGENT-LE-ROI,0280035L,185,179,0,6,100,85,4 ème
EURE-ET-LOIR,SAINT-MAURICE-SAINT-GERMAIN,0280684S,0,0,0,0,0,0,4 ème
EURE-ET-LOIR,SAINT-PREST,0281055V,178,177,0,1,94,84,4 ème
EURE-ET-LOIR,SENONCHES,0280887M,62,62,0,0,30,32,4 ème
INDRE,AIGURANDE,0360001F,33,33,0,0,20,13,4 ème
INDRE,ARGENTON-SUR-CREUSE,0360003H,0,0,0,0,0,0,4 ème
INDRE,BUZANCAIS,0360511K,38,38,0,0,20,18,4 ème
INDRE,ISSOUDUN,0360024F,0,0,0,0,0,0,4 ème
INDRE,LE BLANC,0360005K,0,0,0,0,0,0,4 ème
INDRE,LE BLANC,0360719L,106,89,14,3,55,51,4 ème
INDRE,LEVROUX,0360028K,65,65,0,0,35,30,4 ème
INDRE,NEUVY-SAINT-SEPULCHRE,0360030M,68,67,0,1,28,40,4 ème
INDRE,VALENCAY,0360525A,61,58,0,3,30,31,4 ème
INDRE-ET-LOIRE,AMBOISE,0371325P,79,79,0,0,37,42,4 ème
INDRE-ET-LOIRE,FONDETTES,0371397T,122,122,0,0,61,61,4 ème
INDRE-ET-LOIRE,LOCHES,0370016S,0,0,0,0,0,0,4 ème
INDRE-ET-LOIRE,SAINTE-MAURE-DE-TOURAINE,0371101W,110,91,14,5,57,53,4 ème
INDRE-ET-LOIRE,SAINT-PIERRE-DES-CORPS,0371391L,95,95,0,0,40,55,4 ème
INDRE-ET-LOIRE,TOURS,0370040T,0,0,0,0,0,0,4 ème
INDRE-ET-LOIRE,TOURS,0370045Y,144,144,0,0,67,77,4 ème
INDRE-ET-LOIRE,TOURS,0370732V,88,88,0,0,41,47,4 ème
INDRE-ET-LOIRE,TOURS,0370757X,0,0,0,0,0,0,4 ème
INDRE-ET-LOIRE,TOURS,0370884K,155,155,0,0,64,91,4 ème
INDRE-ET-LOIRE,TOURS,0370991B,130,103,24,3,48,82,4 ème
INDRE-ET-LOIRE,TOURS,0371158H,58,58,0,0,23,35,4 ème
LOIRET,AMILLY,0450937Z,185,168,16,1,93,92,4 ème
LOIRET,BEAUNE-LA-ROLANDE,0450006M,139,137,0,2,68,71,4 ème
LOIRET,BELLEGARDE,0450007N,122,102,17,3,64,58,4 ème
LOIRET,COURTENAY,0451173F,119,114,0,5,62,57,4 ème
LOIRET,FERRIERES-EN-GATINAIS,0450022E,166,164,0,2,75,91,4 ème
LOIRET,GIEN,0451245J,102,97,0,5,42,60,4 ème
LOIRET,LA CHAPELLE-SAINT-MESMIN,0451035F,133,126,0,7,68,65,4 ème
LOIRET,LES BORDES,0451608D,114,110,0,4,58,56,4 ème
LOIRET,MONTARGIS,0450041A,96,92,0,4,55,41,4 ème
LOIRET,OLIVET,0450047G,178,178,0,0,83,95,4 ème
LOIRET,ORLEANS,0450786K,0,0,0,0,0,0,4 ème
LOIRET,ORLEANS,0450939B,142,140,0,2,66,76,4 ème
LOIRET,ORLEANS,0451316L,115,104,7,4,46,69,4 ème
LOIRET,ORLEANS,0451590J,0,0,0,0,0,0,4 ème
LOIRET,PATAY,0450061X,99,98,0,1,54,45,4 ème
LOIRET,PITHIVIERS,0450750W,0,0,0,0,0,0,4 ème
LOIRET,PITHIVIERS,0451788Z,155,136,13,6,78,77,4 ème
LOIRET,SAINT-DENIS-EN-VAL,0451660K,135,131,0,4,63,72,4 ème
LOIRET,TIGY,0451449F,118,115,0,3,57,61,4 ème
LOIR-ET-CHER,BLOIS,0410003F,162,141,15,6,78,84,4 ème
LOIR-ET-CHER,BLOIS,0410918A,160,160,0,0,87,73,4 ème
LOIR-ET-CHER,MONTOIRE-SUR-LE-LOIR,0410566T,105,87,14,4,52,53,4 ème
LOIR-ET-CHER,NEUNG-SUR-BEUVRON,0410035R,64,58,0,6,41,23,4 ème
LOIR-ET-CHER,OUCQUES LA NOUVELLE,0410015U,59,56,0,3,25,34,4 ème
LOIR-ET-CHER,SAINT-LAURENT-NOUAN,0410914W,113,98,13,2,48,65,4 ème
LOIR-ET-CHER,SALBRIS,0410686Y,33,33,0,0,15,18,4 ème
LOIR-ET-CHER,SALBRIS,0410717G,108,104,0,4,59,49,4 ème
LOIR-ET-CHER,VENDOME,0410768M,180,155,22,3,93,87,4 ème
CORSE-DU-SUD,AJACCIO,6200011T,204,204,0,0,101,103,4 ème
CORSE-DU-SUD,AJACCIO,6200084X,198,198,0,0,92,106,4 ème
CORSE-DU-SUD,AJACCIO,6200636X,0,0,0,0,0,0,4 ème
CORSE-DU-SUD,PORTO-VECCHIO,6200697N,135,117,16,2,69,66,4 ème
CORSE-DU-SUD,VICO,6200048H,33,33,0,0,16,17,4 ème
HAUTE-CORSE,CERVIONE,7200020J,71,64,7,0,34,37,4 ème
HAUTE-CORSE,L'ILE-ROUSSE,7200025P,127,116,6,5,60,67,4 ème
MEURTHE-ET-MOSELLE,ART-SUR-MEURTHE,0541344T,0,0,0,0,0,0,4 ème
MEURTHE-ET-MOSELLE,BENAMENIL,0540004L,74,72,0,2,29,45,4 ème
MEURTHE-ET-MOSELLE,DOMMARTEMONT,0541706L,101,84,16,1,41,60,4 ème
MEURTHE-ET-MOSELLE,JARNY,0540076P,0,0,0,0,0,0,4 ème
MEURTHE-ET-MOSELLE,JARVILLE-LA-MALGRANGE,0541306B,242,242,0,0,115,127,4 ème
MEURTHE-ET-MOSELLE,JARVILLE-LA-MALGRANGE,0541817G,111,92,17,2,56,55,4 ème
MEURTHE-ET-MOSELLE,LAXOU,0542262R,0,0,0,0,0,0,4 ème
MEURTHE-ET-MOSELLE,LIVERDUN,0541284C,117,117,0,0,58,59,4 ème
MEURTHE-ET-MOSELLE,LONGUYON,0542349K,132,132,0,0,60,72,4 ème
MEURTHE-ET-MOSELLE,LONGWY,0541288G,110,108,0,2,51,59,4 ème
MEURTHE-ET-MOSELLE,LUDRES,0542189L,135,134,0,1,75,60,4 ème
MEURTHE-ET-MOSELLE,NANCY,0540082W,0,0,0,0,0,0,4 ème
MEURTHE-ET-MOSELLE,NANCY,0540106X,144,142,0,2,82,62,4 ème
MEURTHE-ET-MOSELLE,REHON,0541336J,103,103,0,0,47,56,4 ème
MEURTHE-ET-MOSELLE,SAINT-NICOLAS-DE-PORT,0541572R,99,97,0,2,50,49,4 ème
MEURTHE-ET-MOSELLE,TOUL,0541210X,126,121,0,5,67,59,4 ème
MEURTHE-ET-MOSELLE,VAL DE BRIEY,0540115G,145,143,0,2,84,61,4 ème
MEURTHE-ET-MOSELLE,VEZELISE,0540071J,100,100,0,0,51,49,4 ème
MEUSE,BAR-LE-DUC,0550003E,0,0,0,0,0,0,4 ème
MEUSE,BAR-LE-DUC,0550004F,0,0,0,0,0,0,4 ème
MEUSE,STENAY,0550020Y,89,72,14,3,41,48,4 ème
MEUSE,VERDUN,0550026E,0,0,0,0,0,0,4 ème
MEUSE,VERDUN,0550055L,44,44,0,0,21,23,4 ème
MOSELLE,ALGRANGE,0570241C,0,0,0,0,0,0,4 ème
MOSELLE,AUMETZ,0572583Y,81,81,0,0,43,38,4 ème
MOSELLE,BOUZONVILLE,0570012D,121,120,0,1,55,66,4 ème
MOSELLE,DELME,0570020M,95,91,0,4,45,50,4 ème
MOSELLE,FAREBERSVILLER,0572023P,143,131,9,3,80,63,4 ème
MOSELLE,FOLSCHVILLER,0572187T,123,119,0,4,60,63,4 ème
MOSELLE,FORBACH,0572180K,146,123,15,8,79,67,4 ème
MOSELLE,FREYMING-MERLEBACH,0573491K,0,0,0,0,0,0,4 ème
MOSELLE,GROSBLIEDERSTROFF,0572363J,110,107,0,3,57,53,4 ème
MOSELLE,LONGEVILLE-LES-SAINT-AVOLD,0572360F,90,87,0,3,43,47,4 ème
MOSELLE,LORQUIN,0570328X,80,80,0,0,43,37,4 ème
MOSELLE,MARLY,0573211F,0,0,0,0,0,0,4 ème
MOSELLE,METZ,0570283Y,0,0,0,0,0,0,4 ème
MOSELLE,METZ,0572168X,83,79,0,4,41,42,4 ème
MOSELLE,SAINT-AVOLD,0572488V,138,124,13,1,55,83,4 ème
MOSELLE,SARREBOURG,0570213X,44,44,0,0,23,21,4 ème
MOSELLE,THIONVILLE,0572811W,136,136,0,0,61,75,4 ème
MOSELLE,VERNY,0573754W,135,132,0,3,61,74,4 ème
MOSELLE,WOIPPY,0572582X,110,106,0,4,51,59,4 ème
VOSGES,CAPAVENIR VOSGES,0881147U,145,131,12,2,61,84,4 ème
VOSGES,CHARMES,0881145S,118,103,13,2,54,64,4 ème
VOSGES,CHATEL-SUR-MOSELLE,0880418B,99,96,0,3,51,48,4 ème
VOSGES,EPINAL,0880149J,101,94,0,7,56,45,4 ème
VOSGES,LE THILLOT,0880065T,90,83,4,3,46,44,4 ème
VOSGES,RAMBERVILLERS,0880045W,149,141,0,8,83,66,4 ème
VOSGES,RAON-L'ETAPE,0881120P,130,112,13,5,59,71,4 ème
VOSGES,REMIREMONT,0881140L,0,0,0,0,0,0,4 ème
VOSGES,SAINT-DIE-DES-VOSGES,0880151L,158,139,16,3,79,79,4 ème
VOSGES,SAINT-DIE-DES-VOSGES,0881447V,54,53,0,1,30,24,4 ème
VOSGES,SENONES,0881101U,77,77,0,0,37,40,4 ème
VOSGES,VITTEL,0880156S,95,87,0,8,48,47,4 ème
ARDENNES,CARIGNAN,0081099B,87,81,6,0,48,39,4 ème
ARDENNES,CHARLEVILLE-MEZIERES,0080010T,0,0,0,0,0,0,4 ème
ARDENNES,CHARLEVILLE-MEZIERES,0080035V,94,89,0,5,47,47,4 ème
ARDENNES,CHARLEVILLE-MEZIERES,0080068F,49,44,0,5,22,27,4 ème
ARDENNES,JUNIVILLE,0080021E,66,66,0,0,35,31,4 ème
ARDENNES,NOUZONVILLE,0080036W,85,74,11,0,42,43,4 ème
ARDENNES,SEDAN,0080048J,0,0,0,0,0,0,4 ème
ARDENNES,VIREUX-WALLERAND,0080052N,43,43,0,0,25,18,4 ème
ARDENNES,VRIGNE AUX BOIS,0080839U,98,81,17,0,48,50,4 ème
AUBE,BAR-SUR-SEINE,0100005B,137,126,8,3,75,62,4 ème
AUBE,BOUILLY,0100765C,162,159,3,0,84,78,4 ème
AUBE,LUSIGNY-SUR-BARSE,0100033G,128,128,0,0,68,60,4 ème
AUBE,PONT-SAINTE-MARIE,0101031S,145,129,11,5,74,71,4 ème
AUBE,ROMILLY-SUR-SEINE,0100016N,0,0,0,0,0,0,4 ème
AUBE,ROMILLY-SUR-SEINE,0100787B,150,149,0,1,78,72,4 ème
AUBE,ROMILLY-SUR-SEINE,0100905E,148,135,13,0,75,73,4 ème
AUBE,SAINTE-SAVINE,0100664T,145,145,0,0,73,72,4 ème
HAUTE-MARNE,CHATEAUVILLAIN,0520006Z,42,42,0,0,22,20,4 ème
HAUTE-MARNE,CHAUMONT,0520966T,75,75,0,0,34,41,4 ème
HAUTE-MARNE,DOULAINCOURT-SAUCOURT,0520014H,64,64,0,0,24,40,4 ème
HAUTE-MARNE,FRONCLES,0520018M,24,24,0,0,10,14,4 ème
HAUTE-MARNE,LANGRES,0520021R,0,0,0,0,0,0,4 ème
HAUTE-MARNE,LA PORTE DU DER,0520022S,65,65,0,0,36,29,4 ème
HAUTE-MARNE,SAINT-DIZIER,0520692V,0,0,0,0,0,0,4 ème
HAUTE-MARNE,SAINT-DIZIER,0520968V,117,117,0,0,51,66,4 ème
HAUTE-MARNE,WASSY,0520032C,0,0,0,0,0,0,4 ème
MARNE,ANGLURE,0510001Z,68,68,0,0,31,37,4 ème
MARNE,CHALONS-EN-CHAMPAGNE,0511106A,12,0,12,0,4,8,4 ème
MARNE,CHALONS-EN-CHAMPAGNE,0511147V,0,0,0,0,0,0,4 ème
MARNE,FAGNIERES,0511472Y,130,111,12,7,63,67,4 ème
MARNE,GUEUX,0511564Y,153,153,0,0,76,77,4 ème
MARNE,MONTMIRAIL,0511177C,41,41,0,0,19,22,4 ème
MARNE,REIMS,0511801F,196,196,0,0,94,102,4 ème
MARNE,SAINT-MEMMIE,0511216V,173,157,13,3,84,89,4 ème
MARNE,VITRY-LE-FRANCOIS,0511144S,78,78,0,0,38,40,4 ème
MARNE,WITRY-LES-REIMS,0512014M,124,123,0,1,63,61,4 ème
BAS-RHIN,CHATENOIS,0671962U,111,111,0,0,61,50,4 ème
BAS-RHIN,DRULINGEN,0670014B,85,80,0,5,42,43,4 ème
BAS-RHIN,ERSTEIN,0670017E,191,170,19,2,82,109,4 ème
BAS-RHIN,GERSTHEIM,0672135G,86,86,0,0,37,49,4 ème
BAS-RHIN,HOERDT,0672012Y,88,88,0,0,48,40,4 ème
BAS-RHIN,ILLKIRCH-GRAFFENSTADEN,0672194W,172,156,11,5,87,85,4 ème
BAS-RHIN,LAUTERBOURG,0671688W,77,77,0,0,35,42,4 ème
BAS-RHIN,LINGOLSHEIM,0671690Y,124,108,14,2,66,58,4 ème
BAS-RHIN,MARMOUTIER,0671985U,87,86,0,1,47,40,4 ème
BAS-RHIN,MATZENHEIM,0671604E,98,98,0,0,44,54,4 ème
BAS-RHIN,MOLSHEIM,0672606U,156,132,21,3,73,83,4 ème
BAS-RHIN,NIEDERBRONN-LES-BAINS,0671738A,86,84,0,2,43,43,4 ème
BAS-RHIN,REICHSHOFFEN,0671595V,113,97,13,3,55,58,4 ème
BAS-RHIN,SAVERNE,0671987W,117,113,0,4,57,60,4 ème
BAS-RHIN,SCHILTIGHEIM,0670089H,0,0,0,0,0,0,4 ème
BAS-RHIN,SELESTAT,0671830A,159,143,13,3,89,70,4 ème
BAS-RHIN,SOUFFELWEYERSHEIM,0672254L,137,133,0,4,58,79,4 ème
BAS-RHIN,STRASBOURG,0670085D,0,0,0,0,0,0,4 ème
BAS-RHIN,STRASBOURG,0671508A,154,154,0,0,70,84,4 ème
BAS-RHIN,STRASBOURG,0671594U,142,140,0,2,67,75,4 ème
BAS-RHIN,STRASBOURG,0671620X,124,124,0,0,65,59,4 ème
BAS-RHIN,STRASBOURG,0671636P,0,0,0,0,0,0,4 ème
BAS-RHIN,STRASBOURG,0672128Z,116,116,0,0,55,61,4 ème
BAS-RHIN,STRASBOURG,0672304R,53,53,0,0,25,28,4 ème
BAS-RHIN,VAL-DE-MODER,0671598Y,98,95,0,3,50,48,4 ème
BAS-RHIN,VENDENHEIM,0672658A,76,76,0,0,42,34,4 ème
BAS-RHIN,VILLE,0671601B,116,116,0,0,63,53,4 ème
BAS-RHIN,WISSEMBOURG,0671984T,179,165,8,6,95,84,4 ème
HAUT-RHIN,ALTKIRCH,0681373Y,200,160,32,8,99,101,4 ème
HAUT-RHIN,FERRETTE,0680014W,122,122,0,0,61,61,4 ème
HAUT-RHIN,FORTSCHWIHR,0681190Z,185,185,0,0,84,101,4 ème
HAUT-RHIN,HUNINGUE,0680020C,152,137,15,0,78,74,4 ème
HAUT-RHIN,MULHOUSE,0680105V,147,142,0,5,76,71,4 ème
HAUT-RHIN,MULHOUSE,0680135C,204,204,0,0,103,101,4 ème
HAUT-RHIN,MULHOUSE,0681768C,0,0,0,0,0,0,4 ème
HAUT-RHIN,MULHOUSE,0681961M,121,112,0,9,57,64,4 ème
HAUT-RHIN,SAINT-AMARIN,0680064A,100,100,0,0,47,53,4 ème
HAUT-RHIN,SAINT-LOUIS,0680066C,0,0,0,0,0,0,4 ème
HAUT-RHIN,SIERENTZ,0681269K,114,113,0,1,57,57,4 ème
HAUT-RHIN,SOULTZ-HAUT-RHIN,0680128V,120,116,0,4,56,64,4 ème
HAUT-RHIN,VOLGELSHEIM,0681125D,152,120,29,3,78,74,4 ème
HAUT-RHIN,WITTELSHEIM,0681322T,86,85,0,1,41,45,4 ème
HAUT-RHIN,WITTENHEIM,0680161F,45,29,16,0,24,21,4 ème
GUADELOUPE,BASSE-TERRE,9710482X,93,74,15,4,38,55,4 ème
GUADELOUPE,CAPESTERRE-BELLE-EAU,9710406P,124,85,27,12,60,64,4 ème
GUADELOUPE,CAPESTERRE-BELLE-EAU,9710418C,0,0,0,0,0,0,4 ème
GUADELOUPE,LAMENTIN,9710086S,204,177,14,13,107,97,4 ème
GUADELOUPE,LAMENTIN,9710090W,0,0,0,0,0,0,4 ème
GUADELOUPE,LE GOSIER,9710039R,284,258,16,10,139,145,4 ème
GUADELOUPE,LES ABYMES,9710826W,168,167,0,1,99,69,4 ème
GUADELOUPE,LES ABYMES,9710938T,154,154,0,0,60,94,4 ème
GUADELOUPE,MORNE-A-L'EAU,9710403L,189,167,17,5,98,91,4 ème
GUADELOUPE,POINTE-A-PITRE,9710073C,107,106,0,1,41,66,4 ème
GUADELOUPE,SAINTE-ROSE,9710023Y,143,133,9,1,72,71,4 ème
GUADELOUPE,SAINTE-ROSE,9711181G,126,126,0,0,57,69,4 ème
GUADELOUPE,SAINT-LOUIS,9710037N,34,23,8,3,14,20,4 ème
GUADELOUPE,VIEUX-HABITANTS,9710045X,76,72,0,4,39,37,4 ème
GUYANE,CAYENNE,9730020J,281,236,31,14,134,147,4 ème
GUYANE,CAYENNE,9730083C,312,275,33,4,148,164,4 ème
GUYANE,CAYENNE,9730247F,196,192,0,4,100,96,4 ème
GUYANE,CAYENNE,9730479H,45,45,0,0,23,22,4 ème
GUYANE,GRAND-SANTI,9730380A,141,131,7,3,69,72,4 ème
GUYANE,KOUROU,9730483M,98,92,0,6,56,42,4 ème
GUYANE,MACOURIA,9730206L,210,208,0,2,110,100,4 ème
GUYANE,MANA,9730373T,149,142,0,7,68,81,4 ème
GUYANE,MATOURY,9730307W,267,209,50,8,137,130,4 ème
GUYANE,PAPAICHTON,9730381B,53,34,15,4,22,31,4 ème
GUYANE,REMIRE-MONTJOLY,9730179G,213,191,19,3,101,112,4 ème
GUYANE,SAINT-GEORGES,9730173A,163,137,25,1,83,80,4 ème
GUYANE,SAINT-LAURENT-DU-MARONI,9730110G,260,219,33,8,114,146,4 ème
GUYANE,SAINT-LAURENT-DU-MARONI,9730348R,225,217,0,8,106,119,4 ème
AISNE,CHARMES,0020467X,13,13,0,0,7,6,4 ème
AISNE,CHATEAU-THIERRY,0021939X,0,0,0,0,0,0,4 ème
AISNE,CORBENY,0020017H,101,101,0,0,53,48,4 ème
AISNE,FLAVY-LE-MARTEL,0021593W,108,108,0,0,57,51,4 ème
AISNE,HARLY,0021534G,111,106,0,5,57,54,4 ème
AISNE,HIRSON,0020075W,124,104,16,4,62,62,4 ème
AISNE,HIRSON,0020089L,0,0,0,0,0,0,4 ème
AISNE,RIBEMONT,0021689A,78,77,0,1,42,36,4 ème
AISNE,SAINT-QUENTIN,0020056A,91,73,15,3,43,48,4 ème
AISNE,SAINT-QUENTIN,0020473D,202,202,0,0,103,99,4 ème
AISNE,SAINT-QUENTIN,0022042J,0,0,0,0,0,0,4 ème
AISNE,SOISSONS,0020492Z,0,0,0,0,0,0,4 ème
AISNE,SOISSONS,0022044L,0,0,0,0,0,0,4 ème
AISNE,TERGNIER,0020063H,161,140,14,7,82,79,4 ème
AISNE,VERVINS,0020067M,116,88,20,8,46,70,4 ème
AISNE,VILLENEUVE-SUR-AISNE,0020029W,83,83,0,0,44,39,4 ème
AISNE,VILLERS-COTTERETS,0021989B,99,99,0,0,52,47,4 ème
OISE,BEAUVAIS,0600002B,0,0,0,0,0,0,4 ème
OISE,BEAUVAIS,0601189S,103,99,0,4,48,55,4 ème
OISE,BRENOUILLE,0601786R,96,93,0,3,44,52,4 ème
OISE,BRESLES,0601424X,133,127,0,6,65,68,4 ème
OISE,BRETEUIL,0601153C,25,20,5,0,9,16,4 ème
OISE,CHAMBLY,0600060P,137,137,0,0,61,76,4 ème
OISE,COMPIEGNE,0601295G,97,97,0,0,54,43,4 ème
OISE,COMPIEGNE,0601366J,147,144,0,3,67,80,4 ème
OISE,CREPY-EN-VALOIS,0601294F,178,174,0,4,93,85,4 ème
OISE,CREVECOEUR-LE-GRAND,0600027D,126,111,13,2,69,57,4 ème
OISE,LAMORLAYE,0601872J,134,134,0,0,64,70,4 ème
OISE,MOUY,0601293E,151,149,0,2,88,63,4 ème
OISE,PONT-SAINTE-MAXENCE,0601147W,156,156,0,0,90,66,4 ème
OISE,RIBECOURT-DRESLINCOURT,0601822E,0,0,0,0,0,0,4 ème
OISE,SAINT-AUBIN-EN-BRAY,0601292D,158,153,0,5,90,68,4 ème
OISE,SAINT-JUST-EN-CHAUSSEE,0601445V,161,142,16,3,69,92,4 ème
OISE,SAINT-LEU-D'ESSERENT,0601409F,160,158,0,2,87,73,4 ème
SOMME,ALBERT,0801218P,66,62,0,4,30,36,4 ème
SOMME,AMIENS,0800019L,102,81,16,5,44,58,4 ème
SOMME,AMIENS,0800020M,141,136,0,5,66,75,4 ème
SOMME,AMIENS,0801194N,0,0,0,0,0,0,4 ème
SOMME,AMIENS,0801219R,186,186,0,0,87,99,4 ème
SOMME,AMIENS,0801946F,0,0,0,0,0,0,4 ème
SOMME,BRAY-SUR-SOMME,0800023R,43,43,0,0,22,21,4 ème
SOMME,CHAULNES,0801536K,97,95,0,2,50,47,4 ème
SOMME,CONTY,0800025T,98,95,0,3,47,51,4 ème
SOMME,CORBIE,0801478X,76,76,0,0,38,38,4 ème
SOMME,CRECY-EN-PONTHIEU,0800027V,65,59,0,6,29,36,4 ème
SOMME,FLIXECOURT,0801487G,62,61,0,1,31,31,4 ème
SOMME,HAM,0800036E,128,100,16,12,73,55,4 ème
SOMME,LONGPRE-LES-CORPS-SAINTS,0800037F,75,72,0,3,32,43,4 ème
SOMME,MONTDIDIER,0801225X,93,90,0,3,45,48,4 ème
NORD,ARMENTIERES,0590257J,0,0,0,0,0,0,4 ème
NORD,ARMENTIERES,0594397J,117,114,0,3,60,57,4 ème
NORD,AVESNELLES,0595176F,166,147,13,6,92,74,4 ème
NORD,BAILLEUL,0593063J,0,0,0,0,0,0,4 ème
NORD,BAILLEUL,0594636U,212,198,12,2,108,104,4 ème
NORD,BAVAY,0592924H,23,23,0,0,13,10,4 ème
NORD,BERGUES,0593479L,78,78,0,0,38,40,4 ème
NORD,BERLAIMONT,0594415D,67,67,0,0,28,39,4 ème
NORD,BEUVRAGES,0594301E,125,117,5,3,59,66,4 ème
NORD,CAMBRAI,0593487V,121,119,0,2,60,61,4 ème
NORD,CAMBRAI,0593488W,129,108,16,5,55,74,4 ème
NORD,CAMBRAI,0595175E,143,141,0,2,74,69,4 ème
NORD,CAPPELLE-EN-PEVELE,0596873A,158,158,0,0,78,80,4 ème
NORD,CAUDRY,0590044C,0,0,0,0,0,0,4 ème
NORD,COUDEKERQUE-BRANCHE,0590263R,0,0,0,0,0,0,4 ème
NORD,COUDEKERQUE-BRANCHE,0594295Y,40,37,0,3,19,21,4 ème
NORD,CROIX,0593239A,143,142,0,1,73,70,4 ème
NORD,DENAIN,0592962Z,85,80,0,5,39,46,4 ème
NORD,DOUAI,0590068D,153,149,0,4,64,89,4 ème
NORD,DOUAI,0592941B,135,128,0,7,54,81,4 ème
NORD,DOUAI,0595387K,195,192,0,3,98,97,4 ème
NORD,DUNKERQUE,0590164H,77,73,0,4,40,37,4 ème
NORD,DUNKERQUE,0593101A,115,115,0,0,62,53,4 ème
NORD,FACHES-THUMESNIL,0593476H,112,112,0,0,46,66,4 ème
NORD,FOURMIES,0590083V,0,0,0,0,0,0,4 ème
NORD,FOURMIES,0593252P,100,81,15,4,48,52,4 ème
NORD,GRANDE-SYNTHE,0595782P,79,74,0,5,41,38,4 ème
NORD,HALLUIN,0590091D,137,125,7,5,70,67,4 ème
NORD,HAUBOURDIN,0593127D,70,66,0,4,30,40,4 ème
NORD,HAUTMONT,0590098L,0,0,0,0,0,0,4 ème
NORD,HAZEBROUCK,0593077Z,0,0,0,0,0,0,4 ème
NORD,HEM,0595630Z,112,112,0,0,55,57,4 ème
NORD,JEUMONT,0592712C,0,0,0,0,0,0,4 ème
NORD,LA MADELEINE,0593658F,119,104,11,4,57,62,4 ème
NORD,LESQUIN,0592889V,174,174,0,0,92,82,4 ème
NORD,LILLE,0590115E,146,141,0,5,73,73,4 ème
NORD,LILLE,0590131X,122,118,0,4,71,51,4 ème
NORD,LILLE,0590266U,0,0,0,0,0,0,4 ème
NORD,LILLE,0593027V,0,0,0,0,0,0,4 ème
NORD,LILLE,0594288R,104,104,0,0,44,60,4 ème
NORD,LILLE,0594523W,112,106,0,6,68,44,4 ème
NORD,LILLE,0596177U,80,80,0,0,32,48,4 ème
NORD,LILLE,0597004T,111,111,0,0,61,50,4 ème
NORD,LINSELLES,0592895B,150,150,0,0,84,66,4 ème
NORD,LOOS,0593660H,64,64,0,0,38,26,4 ème
NORD,MARCQ-EN-BAROEUL,0593227M,138,138,0,0,76,62,4 ème
NORD,MASNIERES,0593683H,88,88,0,0,39,49,4 ème
NORD,MASNY,0593483R,114,108,0,6,47,67,4 ème
NORD,MAUBEUGE,0594362W,116,106,8,2,58,58,4 ème
NORD,MAUBEUGE,0595399Y,145,145,0,0,60,85,4 ème
NORD,MONS-EN-BAROEUL,0593178J,117,105,12,0,60,57,4 ème
NORD,MONS-EN-BAROEUL,0593218C,115,115,0,0,59,56,4 ème
NORD,PERENCHIES,0594628K,107,104,0,3,54,53,4 ème
NORD,RAISMES,0594408W,116,101,11,4,51,65,4 ème
NORD,RONCQ,0593668S,72,72,0,0,35,37,4 ème
NORD,ROOST-WARENDIN,0593251N,134,126,5,3,74,60,4 ème
NORD,ROUBAIX,0590189K,0,0,0,0,0,0,4 ème
NORD,ROUBAIX,0592905M,107,88,19,0,51,56,4 ème
NORD,ROUBAIX,0593667R,173,152,16,5,94,79,4 ème
NORD,ROUBAIX,0594634S,103,84,15,4,42,61,4 ème
NORD,SAINT-AMAND-LES-EAUX,0595400Z,219,219,0,0,116,103,4 ème
NORD,SAINT-ANDRE-LEZ-LILLE,0592911U,74,74,0,0,34,40,4 ème
NORD,SIN-LE-NOBLE,0593185S,178,163,15,0,77,101,4 ème
NORD,SOMAIN,0597055Y,223,223,0,0,122,101,4 ème
NORD,THUMERIES,0590211J,122,122,0,0,64,58,4 ème
NORD,TOURCOING,0592714E,104,88,11,5,53,51,4 ème
NORD,TOURCOING,0592966D,0,0,0,0,0,0,4 ème
NORD,TOURCOING,0593149C,115,109,0,6,55,60,4 ème
NORD,TOURCOING,0593150D,93,93,0,0,48,45,4 ème
NORD,TOURCOING,0593152F,45,45,0,0,15,30,4 ème
NORD,VALENCIENNES,0592967E,0,0,0,0,0,0,4 ème
NORD,VALENCIENNES,0592969G,0,0,0,0,0,0,4 ème
NORD,VALENCIENNES,0593155J,217,213,2,2,108,109,4 ème
NORD,VALENCIENNES,0595173C,86,86,0,0,38,48,4 ème
NORD,VILLENEUVE-D'ASCQ,0595656C,76,72,0,4,31,45,4 ème
NORD,WATTEN,0593159N,61,59,0,2,32,29,4 ème
NORD,WATTRELOS,0593242D,154,135,16,3,81,73,4 ème
NORD,WORMHOUT,0595856V,0,0,0,0,0,0,4 ème
PAS-DE-CALAIS,AIRE-SUR-LA-LYS,0622094P,181,163,15,3,88,93,4 ème
PAS-DE-CALAIS,ARDRES,0620004T,127,127,0,0,73,54,4 ème
PAS-DE-CALAIS,ARDRES,0622123W,120,114,0,6,53,67,4 ème
PAS-DE-CALAIS,AUBIGNY-EN-ARTOIS,0620016F,143,143,0,0,84,59,4 ème
PAS-DE-CALAIS,BERCK,0620229M,13,13,0,0,4,9,4 ème
PAS-DE-CALAIS,BETHUNE,0622089J,0,0,0,0,0,0,4 ème
PAS-DE-CALAIS,BOULOGNE-SUR-MER,0620199E,105,102,0,3,52,53,4 ème
PAS-DE-CALAIS,BOULOGNE-SUR-MER,0622131E,57,57,0,0,22,35,4 ème
PAS-DE-CALAIS,BOULOGNE-SUR-MER,0623571V,126,126,0,0,71,55,4 ème
PAS-DE-CALAIS,BOUVIGNY-BOYEFFLES,0622108E,127,127,0,0,82,45,4 ème
PAS-DE-CALAIS,BRUAY-LA-BUISSIERE,0620198D,91,91,0,0,45,46,4 ème
PAS-DE-CALAIS,CALAIS,0620188T,0,0,0,0,0,0,4 ème
PAS-DE-CALAIS,CALAIS,0622099V,16,0,16,0,6,10,4 ème
PAS-DE-CALAIS,DIVION,0620079Z,97,94,0,3,50,47,4 ème
PAS-DE-CALAIS,ETAPLES,0620187S,0,0,0,0,0,0,4 ème
PAS-DE-CALAIS,ETAPLES,0622192W,0,0,0,0,0,0,4 ème
PAS-DE-CALAIS,FREVENT,0622261W,98,83,15,0,51,47,4 ème
PAS-DE-CALAIS,GUINES,0622150A,0,0,0,0,0,0,4 ème
PAS-DE-CALAIS,HARNES,0622791X,130,111,16,3,64,66,4 ème
PAS-DE-CALAIS,HESDIN,0620099W,106,90,16,0,48,58,4 ème
PAS-DE-CALAIS,ISBERGUES,0620136L,99,99,0,0,53,46,4 ème
PAS-DE-CALAIS,LENS,0622418S,198,179,19,0,97,101,4 ème
PAS-DE-CALAIS,LENS,0623864N,0,0,0,0,0,0,4 ème
PAS-DE-CALAIS,LIEVIN,0620190V,0,0,0,0,0,0,4 ème
PAS-DE-CALAIS,LIEVIN,0620219B,94,74,17,3,43,51,4 ème
PAS-DE-CALAIS,LIEVIN,0622086F,187,185,0,2,87,100,4 ème
PAS-DE-CALAIS,MARQUISE,0620131F,0,0,0,0,0,0,4 ème
PAS-DE-CALAIS,MARQUISE,0622143T,94,94,0,0,49,45,4 ème
PAS-DE-CALAIS,MAZINGARBE,0622087G,116,114,0,2,58,58,4 ème
PAS-DE-CALAIS,MERICOURT,0622262X,157,138,17,2,81,76,4 ème
PAS-DE-CALAIS,MONTIGNY-EN-GOHELLE,0622423X,76,76,0,0,42,34,4 ème
PAS-DE-CALAIS,NOEUX-LES-MINES,0624440P,0,0,0,0,0,0,4 ème
PAS-DE-CALAIS,OUTREAU,0620154F,158,158,0,0,72,86,4 ème
PAS-DE-CALAIS,ROUVROY,0620158K,148,148,0,0,73,75,4 ème
PAS-DE-CALAIS,SAINT-MARTIN-BOULOGNE,0622198C,0,0,0,0,0,0,4 ème
PAS-DE-CALAIS,SAINT-NICOLAS,0623014P,181,160,16,5,83,98,4 ème
PAS-DE-CALAIS,SAINT-OMER,0622907Y,77,58,16,3,38,39,4 ème
PAS-DE-CALAIS,SAINT-POL-SUR-TERNOISE,0622121U,44,44,0,0,16,28,4 ème
PAS-DE-CALAIS,VITRY-EN-ARTOIS,0622084D,142,126,15,1,68,74,4 ème
PAS-DE-CALAIS,WIMILLE,0622299M,104,92,12,0,54,50,4 ème
PAS-DE-CALAIS,WINGLES,0620180J,142,121,16,5,72,70,4 ème
SEINE-ET-MARNE,BRIE-COMTE-ROBERT,0771363N,196,176,16,4,96,100,4 ème
SEINE-ET-MARNE,BRIE-COMTE-ROBERT,0771993Y,104,104,0,0,53,51,4 ème
SEINE-ET-MARNE,BUSSY-SAINT-GEORGES,0772413E,145,145,0,0,76,69,4 ème
SEINE-ET-MARNE,BUSSY-SAINT-GEORGES,0772588V,149,146,0,3,81,68,4 ème
SEINE-ET-MARNE,CHAMPS-SUR-MARNE,0772330P,135,135,0,0,64,71,4 ème
SEINE-ET-MARNE,CHATEAU-LANDON,0770010T,71,71,0,0,35,36,4 ème
SEINE-ET-MARNE,CHELLES,0770013W,156,156,0,0,81,75,4 ème
SEINE-ET-MARNE,COMBS-LA-VILLE,0771475K,176,160,10,6,92,84,4 ème
SEINE-ET-MARNE,COULOMMIERS,0771513B,173,157,16,0,81,92,4 ème
SEINE-ET-MARNE,COURTRY,0772396L,132,129,0,3,68,64,4 ème
SEINE-ET-MARNE,DAMMARIE-LES-LYS,0770019C,171,143,24,4,81,90,4 ème
SEINE-ET-MARNE,FONTAINEBLEAU,0771925Z,197,197,0,0,75,122,4 ème
SEINE-ET-MARNE,GRETZ-ARMAINVILLIERS,0772189L,147,143,0,4,75,72,4 ème
SEINE-ET-MARNE,LA CHAPELLE-LA-REINE,0770009S,143,138,0,5,59,84,4 ème
SEINE-ET-MARNE,LA FERTE-SOUS-JOUARRE,0770024H,205,203,0,2,104,101,4 ème
SEINE-ET-MARNE,LE MEE-SUR-SEINE,0771337K,164,164,0,0,75,89,4 ème
SEINE-ET-MARNE,LIEUSAINT,0772128V,96,92,0,4,52,44,4 ème
SEINE-ET-MARNE,MELUN,0771238C,19,19,0,0,5,14,4 ème
SEINE-ET-MARNE,MELUN,0771762X,156,153,0,3,78,78,4 ème
SEINE-ET-MARNE,MONTEREAU-FAULT-YONNE,0770938B,0,0,0,0,0,0,4 ème
SEINE-ET-MARNE,MONTEREAU-FAULT-YONNE,0771567K,190,158,29,3,98,92,4 ème
SEINE-ET-MARNE,MOUROUX,0772247Z,111,110,0,1,50,61,4 ème
SEINE-ET-MARNE,NANTEUIL-LES-MEAUX,0772499Y,192,186,0,6,95,97,4 ème
SEINE-ET-MARNE,NEMOURS,0771621U,108,108,0,0,60,48,4 ème
SEINE-ET-MARNE,PONTAULT-COMBAULT,0771419Z,163,163,0,0,74,89,4 ème
SEINE-ET-MARNE,PROVINS,0771336J,0,0,0,0,0,0,4 ème
SEINE-ET-MARNE,PROVINS,0771515D,148,145,0,3,73,75,4 ème
SEINE-ET-MARNE,SAINT-PIERRE-LES-NEMOURS,0772574E,88,86,0,2,39,49,4 ème
SEINE-ET-MARNE,SAVIGNY-LE-TEMPLE,0771960M,160,133,23,4,76,84,4 ème
SEINE-ET-MARNE,SOURDUN,0772737G,50,50,0,0,25,25,4 ème
SEINE-ET-MARNE,THORIGNY-SUR-MARNE,0770944H,0,0,0,0,0,0,4 ème
SEINE-ET-MARNE,THORIGNY-SUR-MARNE,0771472G,160,160,0,0,82,78,4 ème
SEINE-ET-MARNE,TORCY,0772482E,102,102,0,0,44,58,4 ème
SEINE-ET-MARNE,VARENNES-SUR-SEINE,0770053P,139,136,0,3,70,69,4 ème
SEINE-ET-MARNE,VILLIERS-SAINT-GEORGES,0770059W,99,98,0,1,53,46,4 ème
SEINE-SAINT-DENIS,AUBERVILLIERS,0931184G,161,146,15,0,75,86,4 ème
SEINE-SAINT-DENIS,AUBERVILLIERS,0931186J,138,138,0,0,69,69,4 ème
SEINE-SAINT-DENIS,AUBERVILLIERS,0932272P,104,88,16,0,50,54,4 ème
SEINE-SAINT-DENIS,BAGNOLET,0930936M,0,0,0,0,0,0,4 ème
SEINE-SAINT-DENIS,BOBIGNY,0931198X,0,0,0,0,0,0,4 ème
SEINE-SAINT-DENIS,BONDY,0931005M,133,130,0,3,70,63,4 ème
SEINE-SAINT-DENIS,BONDY,0931612X,147,131,16,0,62,85,4 ème
SEINE-SAINT-DENIS,BONDY,0932282A,0,0,0,0,0,0,4 ème
SEINE-SAINT-DENIS,DRANCY,0931201A,168,164,0,4,82,86,4 ème
SEINE-SAINT-DENIS,DRANCY,0932229T,0,0,0,0,0,0,4 ème
SEINE-SAINT-DENIS,DUGNY,0932126F,0,0,0,0,0,0,4 ème
SEINE-SAINT-DENIS,EPINAY-SUR-SEINE,0931428X,164,164,0,0,79,85,4 ème
SEINE-SAINT-DENIS,GAGNY,0930898W,128,125,0,3,58,70,4 ème
SEINE-SAINT-DENIS,GOURNAY-SUR-MARNE,0931382X,87,87,0,0,44,43,4 ème
SEINE-SAINT-DENIS,LE PRE-SAINT-GERVAIS,0931219V,125,125,0,0,64,61,4 ème
SEINE-SAINT-DENIS,LE RAINCY,0930969Y,164,164,0,0,72,92,4 ème
SEINE-SAINT-DENIS,LE RAINCY,0932302X,21,21,0,0,21,0,4 ème
SEINE-SAINT-DENIS,LIVRY-GARGAN,0930619T,216,212,0,4,100,116,4 ème
SEINE-SAINT-DENIS,LIVRY-GARGAN,0932454M,169,169,0,0,88,81,4 ème
SEINE-SAINT-DENIS,MONTREUIL,0931213N,95,90,0,5,41,54,4 ème
SEINE-SAINT-DENIS,MONTREUIL,0932579Y,142,141,0,1,69,73,4 ème
SEINE-SAINT-DENIS,NOISY-LE-GRAND,0931705Y,174,174,0,0,86,88,4 ème
SEINE-SAINT-DENIS,NOISY-LE-GRAND,0932333F,127,125,0,2,60,67,4 ème
SEINE-SAINT-DENIS,NOISY-LE-GRAND,0932581A,102,101,0,1,54,48,4 ème
SEINE-SAINT-DENIS,PIERREFITTE-SUR-SEINE,0931224A,168,168,0,0,93,75,4 ème
SEINE-SAINT-DENIS,ROMAINVILLE,0931222Y,116,108,0,8,63,53,4 ème
SEINE-SAINT-DENIS,ROSNY-SOUS-BOIS,0931739K,0,0,0,0,0,0,4 ème
SEINE-SAINT-DENIS,SAINT-DENIS,0930865K,135,129,0,6,50,85,4 ème
SEINE-SAINT-DENIS,SAINT-DENIS,0931229F,165,151,14,0,94,71,4 ème
SEINE-SAINT-DENIS,SAINT-DENIS,0931230G,139,139,0,0,65,74,4 ème
SEINE-SAINT-DENIS,SAINT-OUEN,0932261C,135,134,0,1,63,72,4 ème
SEINE-SAINT-DENIS,TREMBLAY-EN-FRANCE,0931149U,214,213,0,1,109,105,4 ème
SEINE-SAINT-DENIS,VAUJOURS,0930921W,197,197,0,0,95,102,4 ème
SEINE-SAINT-DENIS,VILLEMOMBLE,0931227D,159,156,0,3,88,71,4 ème
SEINE-SAINT-DENIS,VILLEPINTE,0932038K,137,137,0,0,67,70,4 ème
VAL-DE-MARNE,ALFORTVILLE,0941022A,176,160,16,0,87,89,4 ème
VAL-DE-MARNE,ARCUEIL,0941971G,203,186,13,4,101,102,4 ème
VAL-DE-MARNE,BOISSY-SAINT-LEGER,0940612E,104,102,0,2,52,52,4 ème
VAL-DE-MARNE,CHAMPIGNY-SUR-MARNE,0941015T,135,120,15,0,75,60,4 ème
VAL-DE-MARNE,CHENNEVIERES-SUR-MARNE,0941348E,134,119,10,5,71,63,4 ème
VAL-DE-MARNE,CRETEIL,0940006W,151,131,16,4,61,90,4 ème
VAL-DE-MARNE,CRETEIL,0940031Y,114,114,0,0,55,59,4 ème
VAL-DE-MARNE,CRETEIL,0940100Y,111,111,0,0,55,56,4 ème
VAL-DE-MARNE,CRETEIL,0941102M,122,120,0,2,57,65,4 ème
VAL-DE-MARNE,CRETEIL,0941614U,56,56,0,0,56,0,4 ème
VAL-DE-MARNE,GENTILLY,0940134K,0,0,0,0,0,0,4 ème
VAL-DE-MARNE,IVRY-SUR-SEINE,0941025D,159,144,15,0,72,87,4 ème
VAL-DE-MARNE,IVRY-SUR-SEINE,0941601E,157,154,0,3,79,78,4 ème
VAL-DE-MARNE,JOINVILLE-LE-PONT,0940012C,123,123,0,0,69,54,4 ème
VAL-DE-MARNE,LE PERREUX-SUR-MARNE,0940788W,159,155,0,4,72,87,4 ème
VAL-DE-MARNE,LE PLESSIS-TREVISE,0941221S,190,190,0,0,101,89,4 ème
VAL-DE-MARNE,L'HAY-LES-ROSES,0940583Y,179,167,12,0,83,96,4 ème
VAL-DE-MARNE,MAISONS-ALFORT,0941024C,69,69,0,0,30,39,4 ème
VAL-DE-MARNE,MAISONS-ALFORT,0941355M,0,0,0,0,0,0,4 ème
VAL-DE-MARNE,NOGENT-SUR-MARNE,0941714C,234,234,0,0,122,112,4 ème
VAL-DE-MARNE,RUNGIS,0940072T,72,72,0,0,33,39,4 ème
VAL-DE-MARNE,SAINT-MAUR-DES-FOSSES,0940140S,0,0,0,0,0,0,4 ème
VAL-DE-MARNE,SAINT-MAUR-DES-FOSSES,0940552P,197,197,0,0,94,103,4 ème
VAL-DE-MARNE,SAINT-MAUR-DES-FOSSES,0940569H,172,172,0,0,102,70,4 ème
VAL-DE-MARNE,SAINT-MAUR-DES-FOSSES,0941600D,177,177,0,0,84,93,4 ème
VAL-DE-MARNE,VALENTON,0941052H,104,104,0,0,42,62,4 ème
VAL-DE-MARNE,VILLEJUIF,0941038T,111,111,0,0,65,46,4 ème
VAL-DE-MARNE,VILLENEUVE-SAINT-GEORGES,0940749D,135,130,0,5,70,65,4 ème
VAL-DE-MARNE,VILLENEUVE-SAINT-GEORGES,0940792A,114,111,0,3,58,56,4 ème
VAL-DE-MARNE,VITRY-SUR-SEINE,0941033M,155,139,16,0,80,75,4 ème
VAL-DE-MARNE,VITRY-SUR-SEINE,0941224V,110,96,14,0,56,54,4 ème
PARIS,PARIS,0750776L,0,0,0,0,0,0,4 ème
PARIS,PARIS,0752829T,82,78,0,4,35,47,4 ème
PARIS,PARIS,0755778Y,72,70,0,2,40,32,4 ème
PARIS,PARIS,0750607C,131,128,0,3,63,68,4 ème
PARIS,PARIS,0750778N,0,0,0,0,0,0,4 ème
PARIS,PARIS,0752536Z,107,107,0,0,42,65,4 ème
PARIS,PARIS,0753896C,249,241,0,8,119,130,4 ème
PARIS,PARIS,0754853T,100,100,0,0,42,58,4 ème
PARIS,PARIS,0752316K,109,104,0,5,50,59,4 ème
PARIS,PARIS,0753982W,136,136,0,0,70,66,4 ème
PARIS,PARIS,0754924V,0,0,0,0,0,0,4 ème
PARIS,PARIS,0750445B,155,139,16,0,69,86,4 ème
PARIS,PARIS,0750463W,0,0,0,0,0,0,4 ème
PARIS,PARIS,0752543G,86,86,0,0,45,41,4 ème
PARIS,PARIS,0752846L,0,0,0,0,0,0,4 ème
PARIS,PARIS,0751708Z,0,0,0,0,0,0,4 ème
PARIS,PARIS,0752318M,141,136,0,5,68,73,4 ème
PARIS,PARIS,0752545J,174,170,0,4,92,82,4 ème
PARIS,PARIS,0752546K,171,170,0,1,92,79,4 ème
PARIS,PARIS,0753992G,57,57,0,0,32,25,4 ème
PARIS,PARIS,0754475G,0,0,0,0,0,0,4 ème
PARIS,PARIS,0752919R,61,61,0,0,30,31,4 ème
PARIS,PARIS,0752936J,141,141,0,0,74,67,4 ème
PARIS,PARIS,0752554U,189,189,0,0,92,97,4 ème
PARIS,PARIS,0753350J,0,0,0,0,0,0,4 ème
PARIS,PARIS,0750429J,107,101,0,6,47,60,4 ème
PARIS,PARIS,0752196E,111,95,16,0,58,53,4 ème
PARIS,PARIS,0750650Z,0,0,0,0,0,0,4 ème
PARIS,PARIS,0751706X,112,107,0,5,55,57,4 ème
PARIS,PARIS,0755052J,37,37,0,0,16,21,4 ème
PARIS,PARIS,0753046D,130,130,0,0,59,71,4 ème
PARIS,PARIS,0754005W,127,127,0,0,61,66,4 ème
PARIS,PARIS,0755029J,24,24,0,0,0,24,4 ème
PARIS,PARIS,0752693V,114,113,0,1,59,55,4 ème
PARIS,PARIS,0753965C,60,60,0,0,21,39,4 ème
PARIS,PARIS,0750407K,55,53,0,2,33,22,4 ème
PARIS,PARIS,0753967E,111,111,0,0,62,49,4 ème
PARIS,PARIS,0752527P,158,157,0,1,84,74,4 ème
PARIS,PARIS,0752528R,123,117,0,6,65,58,4 ème
PARIS,PARIS,0752882A,119,119,0,0,56,63,4 ème
PARIS,PARIS,0752912H,89,89,0,0,47,42,4 ème
PARIS,PARIS,0752961L,0,0,0,0,0,0,4 ème
PARIS,PARIS,0752533W,110,108,0,2,44,66,4 ème
ESSONNE,ATHIS-MONS,0911027X,169,151,16,2,75,94,4 ème
ESSONNE,BALLANCOURT-SUR-ESSONNE,0910773W,180,176,0,4,85,95,4 ème
ESSONNE,CORBEIL-ESSONNES,0911570M,114,98,16,0,59,55,4 ème
ESSONNE,DOURDAN,0911940P,105,99,0,6,55,50,4 ème
ESSONNE,ETAMPES,0911402E,176,157,16,3,90,86,4 ème
ESSONNE,EVRY-COURCOURONNES,0910021D,164,148,16,0,69,95,4 ème
ESSONNE,EVRY-COURCOURONNES,0911748F,216,216,0,0,113,103,4 ème
ESSONNE,GRIGNY,0911036G,150,130,16,4,74,76,4 ème
ESSONNE,LA FERTE-ALAIS,0910977T,113,111,0,2,55,58,4 ème
ESSONNE,LE MEREVILLOIS,0911403F,175,170,0,5,72,103,4 ème
ESSONNE,MASSY,0910859P,183,165,15,3,92,91,4 ème
ESSONNE,MASSY,0911031B,171,171,0,0,83,88,4 ème
ESSONNE,MONTGERON,0910677S,149,145,0,4,74,75,4 ème
ESSONNE,MONTLHERY,0910980W,42,42,0,0,17,25,4 ème
ESSONNE,MORSANG-SUR-ORGE,0910042B,186,169,16,1,89,97,4 ème
ESSONNE,SAINTE-GENEVIEVE-DES-BOIS,0910860R,201,199,0,2,90,111,4 ème
ESSONNE,SAINT-GERMAIN-LES-CORBEIL,0911341N,199,194,0,5,95,104,4 ème
ESSONNE,SAINT-PIERRE-DU-PERRAY,0911948Y,152,144,0,8,83,69,4 ème
ESSONNE,SAVIGNY-SUR-ORGE,0910836P,56,56,0,0,22,34,4 ème
ESSONNE,VERRIERES-LE-BUISSON,0911601W,25,25,0,0,13,12,4 ème
HAUTS-DE-SEINE,ANTONY,0921786S,181,178,0,3,87,94,4 ème
HAUTS-DE-SEINE,ASNIERES-SUR-SEINE,0920890T,150,150,0,0,88,62,4 ème
HAUTS-DE-SEINE,ASNIERES-SUR-SEINE,0922256C,51,51,0,0,27,24,4 ème
HAUTS-DE-SEINE,ASNIERES-SUR-SEINE,0922565N,174,173,0,1,81,93,4 ème
HAUTS-DE-SEINE,BAGNEUX,0921631Y,122,122,0,0,64,58,4 ème
HAUTS-DE-SEINE,BOULOGNE-BILLANCOURT,0920902F,176,176,0,0,95,81,4 ème
HAUTS-DE-SEINE,BOULOGNE-BILLANCOURT,0921238W,142,142,0,0,68,74,4 ème
HAUTS-DE-SEINE,BOULOGNE-BILLANCOURT,0921904V,103,103,0,0,64,39,4 ème
HAUTS-DE-SEINE,BOURG-LA-REINE,0921242A,188,172,15,1,97,91,4 ème
HAUTS-DE-SEINE,BOURG-LA-REINE,0921905W,232,232,0,0,114,118,4 ème
HAUTS-DE-SEINE,CHATENAY-MALABRY,0921180H,68,68,0,0,36,32,4 ème
HAUTS-DE-SEINE,CHAVILLE,0920689Z,153,153,0,0,84,69,4 ème
HAUTS-DE-SEINE,CHAVILLE,0921907Y,160,156,0,4,89,71,4 ème
HAUTS-DE-SEINE,CLAMART,0920653K,175,174,0,1,92,83,4 ème
HAUTS-DE-SEINE,COLOMBES,0920626F,105,105,0,0,40,65,4 ème
HAUTS-DE-SEINE,COLOMBES,0921160L,171,171,0,0,74,97,4 ème
HAUTS-DE-SEINE,COURBEVOIE,0922578C,121,121,0,0,54,67,4 ème
HAUTS-DE-SEINE,LE PLESSIS-ROBINSON,0920624D,143,126,16,1,63,80,4 ème
HAUTS-DE-SEINE,LEVALLOIS-PERRET,0921391M,99,99,0,0,47,52,4 ème
HAUTS-DE-SEINE,MALAKOFF,0921012A,112,108,0,4,44,68,4 ème
HAUTS-DE-SEINE,NEUILLY-SUR-SEINE,0920985W,0,0,0,0,0,0,4 ème
HAUTS-DE-SEINE,PUTEAUX,0921219A,151,151,0,0,72,79,4 ème
HAUTS-DE-SEINE,PUTEAUX,0922731U,113,113,0,0,63,50,4 ème
HAUTS-DE-SEINE,RUEIL-MALMAISON,0921018G,151,151,0,0,115,36,4 ème
HAUTS-DE-SEINE,RUEIL-MALMAISON,0921590D,154,146,8,0,83,71,4 ème
HAUTS-DE-SEINE,RUEIL-MALMAISON,0921916H,183,183,0,0,183,0,4 ème
VAL-D'OISE,BEAUMONT-SUR-OISE,0950751A,55,55,0,0,27,28,4 ème
VAL-D'OISE,BEAUMONT-SUR-OISE,0951748J,0,0,0,0,0,0,4 ème
VAL-D'OISE,BRAY-ET-LU,0952079U,86,86,0,0,40,46,4 ème
VAL-D'OISE,CERGY,0950937C,209,192,14,3,106,103,4 ème
VAL-D'OISE,CERGY,0951697D,166,146,16,4,77,89,4 ème
VAL-D'OISE,CHARS,0951282C,0,0,0,0,0,0,4 ème
VAL-D'OISE,CORMEILLES-EN-PARISIS,0950656X,0,0,0,0,0,0,4 ème
VAL-D'OISE,CORMEILLES-EN-PARISIS,0950790T,87,87,0,0,38,49,4 ème
VAL-D'OISE,CORMEILLES-EN-PARISIS,0951099D,145,142,0,3,69,76,4 ème
VAL-D'OISE,CORMEILLES-EN-PARISIS,0952045G,115,110,0,5,58,57,4 ème
VAL-D'OISE,DOMONT,0951220K,26,26,0,0,1,25,4 ème
VAL-D'OISE,EAUBONNE,0950893E,157,152,0,5,75,82,4 ème
VAL-D'OISE,ECOUEN,0950941G,135,115,16,4,64,71,4 ème
VAL-D'OISE,ERAGNY,0951672B,106,97,0,9,48,58,4 ème
VAL-D'OISE,ERMONT,0950019E,163,158,0,5,76,87,4 ème
VAL-D'OISE,FOSSES,0950926R,196,188,8,0,104,92,4 ème
VAL-D'OISE,L'ISLE-ADAM,0950898K,209,194,10,5,100,109,4 ème
VAL-D'OISE,MENUCOURT,0951233Z,130,130,0,0,66,64,4 ème
VAL-D'OISE,MONTSOULT,0951051B,126,126,0,0,62,64,4 ème
VAL-D'OISE,OSNY,0950760K,136,136,0,0,71,65,4 ème
VAL-D'OISE,PONTOISE,0951943W,57,57,0,0,33,24,4 ème
VAL-D'OISE,SAINT-GRATIEN,0951190C,171,150,16,5,72,99,4 ème
VAL-D'OISE,SAINT-OUEN-L'AUMONE,0950039B,126,126,0,0,65,61,4 ème
VAL-D'OISE,SANNOIS,0950805J,0,0,0,0,0,0,4 ème
VAL-D'OISE,SANNOIS,0951754R,116,111,0,5,57,59,4 ème
VAL-D'OISE,SARCELLES,0950723V,198,194,0,4,89,109,4 ème
VAL-D'OISE,SARCELLES,0951509Z,189,189,0,0,100,89,4 ème
VAL-D'OISE,SOISY-SOUS-MONTMORENCY,0951352D,163,146,15,2,75,88,4 ème
VAL-D'OISE,VAUREAL,0951705M,146,143,0,3,61,85,4 ème
VAL-D'OISE,VIGNY,0952080V,114,114,0,0,65,49,4 ème
YVELINES,ANDRESY,0780002D,200,200,0,0,102,98,4 ème
YVELINES,BOUGIVAL,0783301P,94,94,0,0,45,49,4 ème
YVELINES,CHANTELOUP-LES-VIGNES,0781986K,55,55,0,0,25,30,4 ème
YVELINES,CHATOU,0780507C,163,142,17,4,88,75,4 ème
YVELINES,COIGNIERES,0781511U,116,113,0,3,58,58,4 ème
YVELINES,CONFLANS-SAINTE-HONORINE,0780050F,190,189,0,1,99,91,4 ème
YVELINES,CONFLANS-SAINTE-HONORINE,0783447Y,0,0,0,0,0,0,4 ème
YVELINES,EPONE,0780656P,163,158,0,5,80,83,4 ème
YVELINES,FEUCHEROLLES,0781863B,152,152,0,0,78,74,4 ème
YVELINES,GUYANCOURT,0781695U,97,82,15,0,60,37,4 ème
YVELINES,ISSOU,0781885A,164,164,0,0,82,82,4 ème
YVELINES,LES CLAYES-SOUS-BOIS,0783251K,109,109,0,0,52,57,4 ème
YVELINES,MAGNY-LES-HAMEAUX,0781171Z,107,107,0,0,53,54,4 ème
YVELINES,MANTES-LA-VILLE,0780116C,196,196,0,0,104,92,4 ème
YVELINES,MONTESSON,0783339F,158,158,0,0,68,90,4 ème
YVELINES,MONTIGNY-LE-BRETONNEUX,0781818C,106,106,0,0,51,55,4 ème
YVELINES,NOISY-LE-ROI,0780179W,163,141,17,5,83,80,4 ème
YVELINES,PLAISIR,0780761D,169,166,0,3,84,85,4 ème
YVELINES,POISSY,0780264N,134,117,13,4,53,81,4 ème
YVELINES,SAINT-CYR-L'ECOLE,0780186D,144,140,0,4,72,72,4 ème
YVELINES,SAINT-GERMAIN-EN-LAYE,0781589D,192,192,0,0,91,101,4 ème
YVELINES,SAINT-GERMAIN-EN-LAYE,0783307W,128,128,0,0,70,58,4 ème
YVELINES,SAINT-GERMAIN-EN-LAYE,0783547G,152,152,0,0,74,78,4 ème
YVELINES,TRAPPES,0780273Y,0,0,0,0,0,0,4 ème
YVELINES,TRIEL-SUR-SEINE,0780573Z,178,174,0,4,85,93,4 ème
YVELINES,VERNOUILLET,0780845V,97,97,0,0,43,54,4 ème
YVELINES,VERSAILLES,0781107E,225,225,0,0,128,97,4 ème
YVELINES,VIROFLAY,0780184B,174,174,0,0,84,90,4 ème
LA REUNION,BRAS-PANON,9740046G,196,190,0,6,98,98,4 ème
LA REUNION,LE TAMPON,9740036W,192,165,27,0,87,105,4 ème
LA REUNION,SAINT-ANDRE,9740599H,151,145,0,6,83,68,4 ème
LA REUNION,SAINT-ANDRE,9741386N,184,183,0,1,82,102,4 ème
LA REUNION,SAINT-DENIS,9740081V,195,195,0,0,96,99,4 ème
LA REUNION,SAINT-DENIS,9740572D,246,211,31,4,106,140,4 ème
LA REUNION,SAINT-DENIS,9740618D,137,117,15,5,75,62,4 ème
LA REUNION,SAINT-DENIS,9740734E,98,81,17,0,41,57,4 ème
LA REUNION,SAINT-DENIS,9741654E,23,23,0,0,16,7,4 ème
LA REUNION,SAINTE-ROSE,9740044E,115,111,0,4,54,61,4 ème
LA REUNION,SAINT-JOSEPH,9741047V,175,171,0,4,88,87,4 ème
LA REUNION,SAINT-LEU,9741048W,192,162,29,1,103,89,4 ème
LA REUNION,SAINT-LOUIS,9740011U,236,221,15,0,120,116,4 ème
LA REUNION,SAINT-PAUL,9740093H,253,219,32,2,109,144,4 ème
LA REUNION,SAINT-PAUL,9741190A,149,145,0,4,82,67,4 ème
LA REUNION,SAINT-PHILIPPE,9740468R,61,59,0,2,26,35,4 ème
MARTINIQUE,DUCOS,9720469C,214,194,19,1,106,108,4 ème
MARTINIQUE,FORT-DE-FRANCE,9720052Z,76,69,0,7,37,39,4 ème
MARTINIQUE,FORT-DE-FRANCE,9720084J,85,61,18,6,34,51,4 ème
MARTINIQUE,FORT-DE-FRANCE,9720429J,0,0,0,0,0,0,4 ème
MARTINIQUE,FORT-DE-FRANCE,9720501M,0,0,0,0,0,0,4 ème
MARTINIQUE,LE CARBET,9720008B,80,80,0,0,40,40,4 ème
MARTINIQUE,LE FRANCOIS,9720771F,0,0,0,0,0,0,4 ème
MARTINIQUE,RIVIERE-PILOTE,9720017L,141,119,14,8,84,57,4 ème
MARTINIQUE,RIVIERE-SALEE,9720448E,116,93,16,7,61,55,4 ème
MARTINIQUE,SAINTE-MARIE,9720842H,37,37,0,0,16,21,4 ème
MARTINIQUE,SAINT-JOSEPH,9720021R,157,139,17,1,72,85,4 ème
MARTINIQUE,SAINT-PIERRE,9720446C,35,25,8,2,17,18,4 ème
MAYOTTE,BOUENI,9760379H,197,163,29,5,103,94,4 ème
MAYOTTE,CHICONI,9760119A,230,225,0,5,107,123,4 ème
MAYOTTE,DEMBENI,9760245M,447,445,0,2,243,204,4 ème
MAYOTTE,KOUNGOU,9760369X,466,434,28,4,222,244,4 ème
MAYOTTE,MAMOUDZOU,9760308F,422,412,0,10,203,219,4 ème
CALVADOS,ARGENCES,0140072C,112,112,0,0,67,45,3 ème
CALVADOS,BAYEUX,0141860W,163,163,0,0,72,91,3 ème
CALVADOS,CABOURG,0141812U,44,44,0,0,20,24,3 ème
CALVADOS,CAEN,0140015R,118,117,0,1,63,55,3 ème
CALVADOS,CAEN,0140024A,115,110,0,5,58,57,3 ème
CALVADOS,CAEN,0141596J,137,135,0,2,58,79,3 ème
CALVADOS,CAEN,0141816Y,150,126,20,4,70,80,3 ème
CALVADOS,COURSEULLES-SUR-MER,0140041U,104,101,0,3,58,46,3 ème
CALVADOS,CREULLY SUR SEULLES,0140042V,95,90,0,5,33,62,3 ème
CALVADOS,DOUVRES-LA-DELIVRANDE,0141216W,170,154,16,0,65,105,3 ème
CALVADOS,EVRECY,0140051E,152,146,0,6,85,67,3 ème
CALVADOS,HEROUVILLE-SAINT-CLAIR,0141166S,38,38,0,0,24,14,3 ème
CALVADOS,LISIEUX,0141766U,153,146,0,7,79,74,3 ème
CALVADOS,ORBEC,0140073D,66,66,0,0,26,40,3 ème
CALVADOS,PONT-L'EVEQUE,0140075F,111,111,0,0,54,57,3 ème
CALVADOS,SAINT-MARTIN-DE-FONTENAY,0140068Y,157,157,0,0,77,80,3 ème
CALVADOS,VERSON,0140087U,190,188,0,2,88,102,3 ème
EURE,BERNAY,0271096V,97,94,0,3,43,54,3 ème
EURE,BERNAY,0271316J,65,52,13,0,26,39,3 ème
EURE,BROGLIE,0271122Y,42,42,0,0,20,22,3 ème
EURE,BUEIL,0271744Z,118,118,0,0,54,64,3 ème
EURE,EVREUX,0271449D,87,87,0,0,45,42,3 ème
EURE,GASNY,0271442W,129,127,0,2,71,58,3 ème
EURE,GISORS,0270026G,24,24,0,0,8,16,3 ème
EURE,LES ANDELYS,0270001E,107,104,0,3,50,57,3 ème
EURE,LE VAL D'HAZEY,0271482P,104,88,16,0,59,45,3 ème
EURE,LOUVIERS,0270029K,24,24,0,0,13,11,3 ème
EURE,LOUVIERS,0271336F,144,127,15,2,69,75,3 ème
EURE,LOUVIERS,0271634E,25,25,0,0,9,16,3 ème
EURE,MESNILS-SUR-ITON,0270014U,103,96,0,7,45,58,3 ème
EURE,PONT-AUDEMER,0271081D,17,17,0,0,7,10,3 ème
EURE,PONT-AUDEMER,0271450E,90,90,0,0,49,41,3 ème
EURE,ROMILLY-SUR-ANDELLE,0271533V,116,116,0,0,70,46,3 ème
EURE,VERNEUIL D'AVRE ET D'ITON,0271676A,20,20,0,0,8,12,3 ème
EURE,VERNON,0270052K,24,24,0,0,13,11,3 ème
EURE,VERNON,0271068P,72,72,0,0,35,37,3 ème
MANCHE,AGON-COUTAINVILLE,0500001E,77,77,0,0,31,46,3 ème
MANCHE,AVRANCHES,0500003G,102,98,0,4,51,51,3 ème
MANCHE,BRICQUEBEC-EN-COTENTIN,0500010P,146,130,15,1,73,73,3 ème
MANCHE,CARENTAN-LES-MARAIS,0500139E,95,94,0,1,51,44,3 ème
MANCHE,CERISY-LA-SALLE,0500014U,43,43,0,0,25,18,3 ème
MANCHE,CHERBOURG-EN-COTENTIN,0501205N,79,65,14,0,46,33,3 ème
MANCHE,CHERBOURG-EN-COTENTIN,0501216A,103,100,0,3,55,48,3 ème
MANCHE,CHERBOURG-EN-COTENTIN,0501482P,106,88,15,3,47,59,3 ème
MANCHE,CHERBOURG-EN-COTENTIN,0502008L,103,97,0,6,52,51,3 ème
MANCHE,GAVRAY-SUR-SIENNE,0500035S,45,41,0,4,24,21,3 ème
MANCHE,ISIGNY-LE-BUAT,0501830T,31,31,0,0,12,19,3 ème
MANCHE,LA HAYE,0501218C,68,62,0,6,39,29,3 ème
MANCHE,SAINT-HILAIRE-DU-HARCOUET,0500148P,41,41,0,0,16,25,3 ème
MANCHE,SAINT-JEAN-DE-DAYE,0501301T,41,41,0,0,17,24,3 ème
MANCHE,SAINT-LO,0501219D,24,24,0,0,12,12,3 ème
MANCHE,SAINT-PIERRE-EGLISE,0500122L,41,41,0,0,24,17,3 ème
MANCHE,SAINT-VAAST-LA-HOUGUE,0501300S,31,31,0,0,22,9,3 ème
MANCHE,TORIGNY-LES-VILLES,0500079P,106,105,0,1,48,58,3 ème
ORNE,ALENCON,0610056E,74,72,0,2,33,41,3 ème
ORNE,ARGENTAN,0611022E,86,69,14,3,45,41,3 ème
ORNE,ARGENTAN,0611023F,78,76,0,2,45,33,3 ème
ORNE,ARGENTAN,0611099N,60,60,0,0,27,33,3 ème
ORNE,DOMFRONT EN POIRAIE,0610696A,39,39,0,0,21,18,3 ème
ORNE,DOMFRONT EN POIRAIE,0610970Y,70,52,13,5,31,39,3 ème
ORNE,ECOUCHE-LES-VALLEES,0610016L,52,52,0,0,30,22,3 ème
ORNE,FLERS,0610698C,17,17,0,0,9,8,3 ème
ORNE,GIEL-COURTEILLES,0610724F,13,13,0,0,0,13,3 ème
ORNE,LA FERTE MACE,0610709P,61,61,0,0,27,34,3 ème
ORNE,L'AIGLE,0610691V,73,73,0,0,31,42,3 ème
ORNE,LE MELE-SUR-SARTHE,0610031C,63,60,0,3,31,32,3 ème
ORNE,LONGNY LES VILLAGES,0610739X,29,29,0,0,15,14,3 ème
ORNE,PUTANGES-LE-LAC,0610037J,53,53,0,0,25,28,3 ème
ORNE,SEES,0611095J,59,59,0,0,31,28,3 ème
SEINE MARITIME,AUMALE,0762107C,52,52,0,0,25,27,3 ème
SEINE MARITIME,BACQUEVILLE-EN-CAUX,0760004S,77,71,0,6,36,41,3 ème
SEINE MARITIME,BARENTIN,0760007V,24,24,0,0,13,11,3 ème
SEINE MARITIME,BARENTIN,0762286X,113,113,0,0,63,50,3 ème
SEINE MARITIME,BARENTIN,0762764S,129,110,16,3,70,59,3 ème
SEINE MARITIME,BOLBEC,0761701L,135,117,17,1,59,76,3 ème
SEINE MARITIME,BOLBEC,0761725M,87,87,0,0,47,40,3 ème
SEINE MARITIME,DIEPPE,0760024N,24,24,0,0,1,23,3 ème
SEINE MARITIME,DIEPPE,0762225F,135,131,0,4,71,64,3 ème
SEINE MARITIME,EU,0762170W,144,131,13,0,71,73,3 ème
SEINE MARITIME,FORGES-LES-EAUX,0762600N,24,24,0,0,9,15,3 ème
SEINE MARITIME,GRAND-COURONNE,0762836V,24,24,0,0,7,17,3 ème
SEINE MARITIME,LA FEUILLIE,0762177D,55,55,0,0,32,23,3 ème
SEINE MARITIME,LE GRAND-QUEVILLY,0760049R,93,92,0,1,52,41,3 ème
SEINE MARITIME,LE GRAND-QUEVILLY,0762093M,118,97,16,5,54,64,3 ème
SEINE MARITIME,LE HAVRE,0760062E,24,24,0,0,17,7,3 ème
SEINE MARITIME,LE HAVRE,0761328F,106,106,0,0,59,47,3 ème
SEINE MARITIME,LE HAVRE,0761699J,121,115,0,6,59,62,3 ème
SEINE MARITIME,LE HAVRE,0761781Y,87,70,14,3,41,46,3 ème
SEINE MARITIME,LE HAVRE,0762564Z,280,280,0,0,127,153,3 ème
SEINE MARITIME,LE HAVRE,0763500S,20,20,0,0,11,9,3 ème
SEINE MARITIME,LE HOULME,0761746K,124,124,0,0,54,70,3 ème
SEINE MARITIME,LE MESNIL-ESNARD,0762565A,146,146,0,0,76,70,3 ème
SEINE MARITIME,LILLEBONNE,0762289A,147,131,15,1,65,82,3 ème
SEINE MARITIME,RIVES-EN-SEINE,0762084C,128,125,0,3,67,61,3 ème
SEINE MARITIME,ROUEN,0761717D,76,76,0,0,30,46,3 ème
SEINE MARITIME,ROUEN,0762178E,141,141,0,0,74,67,3 ème
SEINE MARITIME,SAINT-ETIENNE-DU-ROUVRAY,0761647C,96,83,13,0,40,56,3 ème
SEINE MARITIME,SAINT-ETIENNE-DU-ROUVRAY,0762132E,66,66,0,0,29,37,3 ème
SEINE MARITIME,SOTTEVILLE-LES-ROUEN,0761691A,187,166,16,5,94,93,3 ème
SEINE MARITIME,TERRES-DE-CAUX,0760034Z,100,94,0,6,43,57,3 ème
SEINE MARITIME,YVETOT,0762880T,24,24,0,0,13,11,3 ème
DORDOGNE,ANNESSE-ET-BEAULIEU,0240997D,82,82,0,0,40,42,3 ème
DORDOGNE,BEAUMONTOIS EN PERIGORD,0240001W,54,54,0,0,18,36,3 ème
DORDOGNE,BERGERAC,0240094X,30,30,0,0,10,20,3 ème
DORDOGNE,BERGERAC,0240996C,114,114,0,0,67,47,3 ème
DORDOGNE,COULAURES,0240012H,16,16,0,0,0,16,3 ème
DORDOGNE,LA FORCE,0240053C,132,110,16,6,63,69,3 ème
DORDOGNE,LALINDE,0240158S,88,88,0,0,46,42,3 ème
DORDOGNE,MONTIGNAC,0240927C,85,85,0,0,49,36,3 ème
DORDOGNE,MUSSIDAN,0240961P,88,86,0,2,47,41,3 ème
DORDOGNE,NEUVIC,0240044T,71,63,0,8,35,36,3 ème
DORDOGNE,PERIGUEUX,0241043D,112,112,0,0,57,55,3 ème
DORDOGNE,SAINT-CYPRIEN,0240065R,57,57,0,0,32,25,3 ème
DORDOGNE,SARLAT-LA-CANEDA,0240121B,205,189,13,3,95,110,3 ème
DORDOGNE,TERRASSON-LAVILLEDIEU,0240037K,132,117,12,3,74,58,3 ème
DORDOGNE,THENON,0240066S,80,80,0,0,40,40,3 ème
GIRONDE,ARCACHON,0330167C,79,79,0,0,38,41,3 ème
GIRONDE,BEGLES,0331752A,146,146,0,0,69,77,3 ème
GIRONDE,BIGANOS,0330017P,141,138,0,3,68,73,3 ème
GIRONDE,BLAYE,0331511N,59,58,0,1,36,23,3 ème
GIRONDE,BLAYE,0332347X,184,151,21,12,81,103,3 ème
GIRONDE,BORDEAUX,0331462K,99,99,0,0,56,43,3 ème
GIRONDE,BORDEAUX,0331662C,210,208,0,2,101,109,3 ème
GIRONDE,BORDEAUX,0331663D,140,122,11,7,76,64,3 ème
GIRONDE,BORDEAUX,0332082J,132,132,0,0,61,71,3 ème
GIRONDE,BORDEAUX,0332491D,68,68,0,0,35,33,3 ème
GIRONDE,BORDEAUX,0332496J,8,8,0,0,2,6,3 ème
GIRONDE,BORDEAUX,0333531J,0,0,0,0,0,0,3 ème
GIRONDE,BOURG,0332341R,127,123,0,4,65,62,3 ème
GIRONDE,CARBON-BLANC,0333132A,166,161,0,5,70,96,3 ème
GIRONDE,CASTILLON-LA-BATAILLE,0330064R,103,98,0,5,65,38,3 ème
GIRONDE,CUDOS,0332327A,43,43,0,0,22,21,3 ème
GIRONDE,HOURTIN,0330081J,122,122,0,0,64,58,3 ème
GIRONDE,LANGON,0330082K,13,13,0,0,3,10,3 ème
GIRONDE,LANGON,0330083L,147,145,0,2,69,78,3 ème
GIRONDE,LIBOURNE,0330162X,107,102,0,5,49,58,3 ème
GIRONDE,MERIGNAC,0330145D,138,136,0,2,62,76,3 ème
GIRONDE,MERIGNAC,0331668J,22,22,0,0,10,12,3 ème
GIRONDE,MONSEGUR,0330100E,68,68,0,0,38,30,3 ème
GIRONDE,PAREMPUYRE,0332569N,195,195,0,0,97,98,3 ème
GIRONDE,PAUILLAC,0331644H,79,79,0,0,37,42,3 ème
GIRONDE,PESSAC,0331758G,174,169,0,5,84,90,3 ème
GIRONDE,PODENSAC,0330108N,167,156,11,0,84,83,3 ème
GIRONDE,SAINT-ANDRE-DE-CUBZAC,0331530J,152,152,0,0,70,82,3 ème
GIRONDE,SAINT-LOUBES,0332340P,238,238,0,0,117,121,3 ème
GIRONDE,SAINT-MEDARD-EN-JALLES,0330119A,17,17,0,0,7,10,3 ème
GIRONDE,TALENCE,0330128K,116,116,0,0,59,57,3 ème
LANDES,CAPBRETON,0400005N,149,137,12,0,75,74,3 ème
LANDES,DAX,0400729A,171,162,0,9,96,75,3 ème
LANDES,DAX,0401022U,148,147,0,1,71,77,3 ème
LANDES,GEAUNE,0400011V,70,70,0,0,38,32,3 ème
LANDES,MONT-DE-MARSAN,0400020E,24,24,0,0,13,11,3 ème
LANDES,MONT-DE-MARSAN,0400648M,150,147,0,3,66,84,3 ème
LANDES,MONTFORT-EN-CHALOSSE,0400023H,123,123,0,0,68,55,3 ème
LANDES,PARENTIS-EN-BORN,0400026L,185,154,31,0,97,88,3 ème
LANDES,RION-DES-LANDES,0400033U,61,61,0,0,26,35,3 ème
LANDES,SAINT-PAUL-LES-DAX,0401066S,120,118,0,2,67,53,3 ème
LANDES,SAINT-VINCENT-DE-TYROSSE,0400039A,116,116,0,0,51,65,3 ème
LANDES,SOUSTONS,0400728Z,138,135,0,3,70,68,3 ème
LANDES,TARNOS,0400091G,119,119,0,0,61,58,3 ème
LOT-ET-GARONNE,AGEN,0470777P,179,176,0,3,79,100,3 ème
LOT-ET-GARONNE,CASSENEUIL,0470011G,54,54,0,0,22,32,3 ème
LOT-ET-GARONNE,CLAIRAC,0470015L,24,23,0,1,3,21,3 ème
LOT-ET-GARONNE,LE MAS-D'AGENAIS,0470043S,95,95,0,0,48,47,3 ème
LOT-ET-GARONNE,LE PASSAGE,0470105J,208,187,19,2,112,96,3 ème
LOT-ET-GARONNE,MARMANDE,0470733S,172,169,0,3,88,84,3 ème
LOT-ET-GARONNE,NERAC,0470776N,111,111,0,0,55,56,3 ème
LOT-ET-GARONNE,NERAC,0471038Y,27,27,0,0,14,13,3 ème
LOT-ET-GARONNE,VILLENEUVE-SUR-LOT,0470038L,24,24,0,0,5,19,3 ème
PYRENEES-ATLANTIQUES,ANGLET,0640110X,96,96,0,0,49,47,3 ème
PYRENEES-ATLANTIQUES,BAYONNE,0640212H,216,197,16,3,96,120,3 ème
PYRENEES-ATLANTIQUES,BIARRITZ,0641414P,157,142,10,5,74,83,3 ème
PYRENEES-ATLANTIQUES,BIZANOS,0641413N,118,116,0,2,54,64,3 ème
PYRENEES-ATLANTIQUES,CAMBO-LES-BAINS,0641392R,103,93,8,2,54,49,3 ème
PYRENEES-ATLANTIQUES,GELOS,0640026F,22,22,0,0,3,19,3 ème
PYRENEES-ATLANTIQUES,LASSEUBE,0640036S,56,55,0,1,27,29,3 ème
PYRENEES-ATLANTIQUES,LESCAR,0640121J,51,49,0,2,19,32,3 ème
PYRENEES-ATLANTIQUES,LESTELLE-BETHARRAM,0641655B,59,44,15,0,31,28,3 ème
PYRENEES-ATLANTIQUES,MAULEON-LICHARRE,0641656C,33,33,0,0,16,17,3 ème
PYRENEES-ATLANTIQUES,MOURENX,0641561Z,89,76,11,2,42,47,3 ème
PYRENEES-ATLANTIQUES,ORTHEZ,0641659F,48,48,0,0,24,24,3 ème
PYRENEES-ATLANTIQUES,PAU,0640058R,24,24,0,0,15,9,3 ème
PYRENEES-ATLANTIQUES,PAU,0640189H,25,25,0,0,16,9,3 ème
PYRENEES-ATLANTIQUES,PAU,0640227Z,230,207,21,2,102,128,3 ème
PYRENEES-ATLANTIQUES,PAU,0640607M,226,223,0,3,109,117,3 ème
PYRENEES-ATLANTIQUES,PAU,0640608N,169,138,26,5,70,99,3 ème
PYRENEES-ATLANTIQUES,SAINT-JEAN-DE-LUZ,0640066Z,24,23,0,1,8,16,3 ème
PYRENEES-ATLANTIQUES,SAINT-JEAN-DE-LUZ,0640229B,92,82,9,1,43,49,3 ème
CORREZE,BRIVE-LA-GAILLARDE,0190059L,116,116,0,0,60,56,3 ème
CORREZE,BRIVE-LA-GAILLARDE,0190635M,119,98,17,4,57,62,3 ème
CORREZE,EGLETONS,0190019T,80,79,0,1,43,37,3 ème
CORREZE,MERLINES,0190023X,22,22,0,0,10,12,3 ème
CORREZE,MEYMAC,0190025Z,50,50,0,0,25,25,3 ème
CORREZE,OBJAT,0190717B,121,117,0,4,74,47,3 ème
CORREZE,TREIGNAC,0190632J,46,46,0,0,12,34,3 ème
CORREZE,TULLE,0190614P,143,138,0,5,77,66,3 ème
CORREZE,USSEL,0190782X,34,34,0,0,19,15,3 ème
CREUSE,AUBUSSON,0230506A,94,85,6,3,52,42,3 ème
CREUSE,BENEVENT-L'ABBAYE,0230005F,34,34,0,0,21,13,3 ème
CREUSE,BONNAT,0230006G,33,33,0,0,15,18,3 ème
CREUSE,FELLETIN,0230017U,39,39,0,0,16,23,3 ème
CREUSE,SAINT-VAURY,0230028F,65,65,0,0,28,37,3 ème
HAUTE-VIENNE,AMBAZAC,0870684W,168,168,0,0,79,89,3 ème
HAUTE-VIENNE,EYMOUTIERS,0870014T,28,28,0,0,10,18,3 ème
HAUTE-VIENNE,LIMOGES,0870022B,103,79,16,8,46,57,3 ème
HAUTE-VIENNE,LIMOGES,0870771R,177,160,17,0,85,92,3 ème
HAUTE-VIENNE,LIMOGES,0870816P,195,195,0,0,108,87,3 ème
HAUTE-VIENNE,LIMOGES,0870817R,145,141,0,4,69,76,3 ème
HAUTE-VIENNE,LIMOGES,0870865T,140,138,0,2,76,64,3 ème
HAUTE-VIENNE,NEXON,0870032M,65,65,0,0,26,39,3 ème
HAUTE-VIENNE,ROCHECHOUART,0870037T,74,74,0,0,36,38,3 ème
HAUTE-VIENNE,SAINT-MATHIEU,0870047D,39,39,0,0,20,19,3 ème
CHARENTE,AIGRE,0160001P,42,42,0,0,20,22,3 ème
CHARENTE,ANGOULEME,0160061E,165,165,0,0,85,80,3 ème
CHARENTE,ANGOULEME,0160113L,58,58,0,0,29,29,3 ème
CHARENTE,CHAMPAGNE-MOUTON,0160016F,43,43,0,0,26,17,3 ème
CHARENTE,JARNAC,0160075V,27,27,0,0,9,18,3 ème
CHARENTE,RUFFEC,0160077X,45,45,0,0,24,21,3 ème
CHARENTE,RUFFEC,0161003D,18,18,0,0,2,16,3 ème
CHARENTE-MARITIME,AYTRE,0171339N,82,78,0,4,45,37,3 ème
CHARENTE-MARITIME,COURCON,0170007R,211,208,0,3,114,97,3 ème
CHARENTE-MARITIME,LAGORD,0170970M,237,237,0,0,106,131,3 ème
CHARENTE-MARITIME,LA ROCHELLE,0171184V,235,231,0,4,115,120,3 ème
CHARENTE-MARITIME,LA ROCHELLE,0171238D,24,24,0,0,4,20,3 ème
CHARENTE-MARITIME,LA TREMBLADE,0170388E,113,113,0,0,54,59,3 ème
CHARENTE-MARITIME,LE CHATEAU-D'OLERON,0170005N,83,83,0,0,51,32,3 ème
CHARENTE-MARITIME,MONTLIEU-LA-GARDE,0170076R,52,52,0,0,24,28,3 ème
CHARENTE-MARITIME,ROCHEFORT,0170081W,108,81,24,3,46,62,3 ème
CHARENTE-MARITIME,ROYAN,0170384A,65,64,0,1,28,37,3 ème
DEUX-SEVRES,BRESSUIRE,0790091V,178,175,0,3,90,88,3 ème
DEUX-SEVRES,BRESSUIRE,0791029P,23,23,0,0,5,18,3 ème
DEUX-SEVRES,CELLES-SUR-BELLE,0790011H,134,134,0,0,66,68,3 ème
DEUX-SEVRES,CERIZAY,0790063P,79,79,0,0,34,45,3 ème
DEUX-SEVRES,MAUZE-SUR-LE-MIGNON,0790929F,96,96,0,0,42,54,3 ème
DEUX-SEVRES,MELLE,0790943W,99,78,16,5,47,52,3 ème
DEUX-SEVRES,MONCOUTANT-SUR-SEVRE,0790067U,77,77,0,0,37,40,3 ème
DEUX-SEVRES,NIORT,0791016A,129,127,0,2,71,58,3 ème
DEUX-SEVRES,PARTHENAY,0790030D,86,84,0,2,50,36,3 ème
DEUX-SEVRES,PARTHENAY,0791042D,91,88,0,3,42,49,3 ème
DEUX-SEVRES,SAINT-MAIXENT-L'ECOLE,0790031E,24,24,0,0,2,22,3 ème
VIENNE,CHATELLERAULT,0860752A,18,16,0,2,7,11,3 ème
VIENNE,CIVRAY,0860761K,42,42,0,0,22,20,3 ème
VIENNE,DANGE-SAINT-ROMAIN,0860763M,48,48,0,0,28,20,3 ème
VIENNE,JAUNAY-MARIGNY,0861038L,180,175,0,5,85,95,3 ème
VIENNE,LOUDUN,0860022G,21,21,0,0,10,11,3 ème
VIENNE,LUSIGNAN,0861053C,108,108,0,0,55,53,3 ème
VIENNE,MIGNALOUX-BEAUVOIR,0860793V,27,0,27,0,13,14,3 ème
VIENNE,POITIERS,0860037Y,19,19,0,0,6,13,3 ème
VIENNE,POITIERS,0860040B,143,143,0,0,65,78,3 ème
VIENNE,POITIERS,0860759H,101,101,0,0,54,47,3 ème
VIENNE,POITIERS,0861092V,117,114,0,3,60,57,3 ème
VIENNE,SAINT-BENOIT,0861073Z,187,171,15,1,82,105,3 ème
VIENNE,SAINT-JEAN-DE-SAUVES,0860045G,57,57,0,0,35,22,3 ème
VIENNE,VALENCE-EN-POITOU,0860014Y,65,65,0,0,36,29,3 ème
VIENNE,VIVONNE,0860047J,128,123,0,5,64,64,3 ème
AUDE,CARCASSONNE,0110007Y,46,46,0,0,19,27,3 ème
AUDE,CASTELNAUDARY,0110012D,24,24,0,0,7,17,3 ème
AUDE,CASTELNAUDARY,0110896P,24,24,0,0,12,12,3 ème
AUDE,LEZIGNAN-CORBIERES,0111034P,45,45,0,0,21,24,3 ème
AUDE,LEZIGNAN-CORBIERES,0111051H,138,122,16,0,77,61,3 ème
AUDE,NARBONNE,0110021N,199,173,16,10,94,105,3 ème
AUDE,NARBONNE,0110023R,47,47,0,0,20,27,3 ème
AUDE,NARBONNE,0110026U,187,169,18,0,90,97,3 ème
AUDE,RIEUX-MINERVOIS,0110667R,82,82,0,0,39,43,3 ème
AUDE,TREBES,0110674Y,94,92,0,2,43,51,3 ème
GARD,ARAMON,0301325C,120,116,0,4,58,62,3 ème
GARD,BAGNOLS-SUR-CEZE,0300055X,181,181,0,0,99,82,3 ème
GARD,BAGNOLS-SUR-CEZE,0300106C,48,48,0,0,19,29,3 ème
GARD,BAGNOLS-SUR-CEZE,0301327E,132,125,0,7,77,55,3 ème
GARD,BEAUCAIRE,0300089J,48,45,0,3,24,24,3 ème
GARD,BEAUCAIRE,0301208A,131,128,0,3,71,60,3 ème
GARD,NIMES,0300946R,109,109,0,0,53,56,3 ème
GARD,NIMES,0301010K,136,115,17,4,68,68,3 ème
GARD,NIMES,0301098F,149,126,17,6,75,74,3 ème
GARD,NIMES,0301210C,48,48,0,0,37,11,3 ème
GARD,QUISSAC,0300032X,103,103,0,0,48,55,3 ème
GARD,SAINT-AMBROIX,0300036B,88,84,0,4,35,53,3 ème
GARD,SAINT-GENIES-DE-MALGOIRES,0301670C,152,139,13,0,79,73,3 ème
GARD,SOMMIERES,0301232B,232,230,0,2,107,125,3 ème
GARD,UZES,0300047N,22,22,0,0,4,18,3 ème
GARD,VERGEZE,0300050S,165,146,16,3,84,81,3 ème
HERAULT,AGDE,0342080B,87,87,0,0,41,46,3 ème
HERAULT,BEDARIEUX,0340119V,186,174,4,8,86,100,3 ème
HERAULT,CAZOULS-LES-BEZIERS,0340021N,152,134,15,3,76,76,3 ème
HERAULT,CLERMONT-L'HERAULT,0340893L,93,93,0,0,45,48,3 ème
HERAULT,GIGNAC,0341386X,195,191,0,4,90,105,3 ème
HERAULT,MONTAGNAC,0340037F,79,77,0,2,36,43,3 ème
HERAULT,MONTPELLIER,0340042L,24,24,0,0,9,15,3 ème
HERAULT,MONTPELLIER,0340109J,145,141,0,4,70,75,3 ème
HERAULT,MONTPELLIER,0340833W,14,0,14,0,6,8,3 ème
HERAULT,MONTPELLIER,0340880X,120,120,0,0,68,52,3 ème
HERAULT,MONTPELLIER,0341278E,211,187,16,8,102,109,3 ème
HERAULT,MONTPELLIER,0342266D,77,74,0,3,39,38,3 ème
HERAULT,PEZENAS,0340837A,173,152,16,5,81,92,3 ème
HERAULT,SAINT-JEAN-DE-VEDAS,0341276C,174,174,0,0,87,87,3 ème
HERAULT,SAINT-PONS-DE-THOMIERES,0340069R,17,17,0,0,2,15,3 ème
HERAULT,SAINT-PONS-DE-THOMIERES,0340070S,56,51,5,0,24,32,3 ème
HERAULT,SERIGNAN,0341388Z,224,202,16,6,101,123,3 ème
HERAULT,SETE,0340115R,129,129,0,0,73,56,3 ème
LOZERE,FLORAC TROIS RIVIERES,0480003T,58,54,0,4,29,29,3 ème
LOZERE,LA CANOURGUE,0480006W,47,47,0,0,21,26,3 ème
LOZERE,LE COLLET-DE-DEZE,0480002S,20,20,0,0,11,9,3 ème
LOZERE,MENDE,0480607Z,184,163,11,10,85,99,3 ème
LOZERE,MEYRUEIS,0480011B,26,26,0,0,13,13,3 ème
LOZERE,MEYRUEIS,0480034B,19,19,0,0,6,13,3 ème
LOZERE,MONT LOZERE ET GOULET,0480001R,30,30,0,0,10,20,3 ème
PYRENEES-ORIENTALES,BOURG-MADAME,0660600U,63,57,5,1,39,24,3 ème
PYRENEES-ORIENTALES,CABESTANY,0660521H,241,225,15,1,111,130,3 ème
PYRENEES-ORIENTALES,CANET-EN-ROUSSILLON,0660648W,237,233,0,4,126,111,3 ème
PYRENEES-ORIENTALES,CERET,0660601V,217,194,16,7,117,100,3 ème
PYRENEES-ORIENTALES,LE SOLER,0660872P,45,45,0,0,21,24,3 ème
PYRENEES-ORIENTALES,PRADES,0660021P,24,24,0,0,10,14,3 ème
PYRENEES-ORIENTALES,RIVESALTES,0660037G,213,194,16,3,87,126,3 ème
PYRENEES-ORIENTALES,SAINT-CYPRIEN,0660846L,94,94,0,0,37,57,3 ème
ARIEGE,LAVELANET,0090006H,17,17,0,0,5,12,3 ème
ARIEGE,LAVELANET,0090490J,61,55,0,6,23,38,3 ème
ARIEGE,PAMIERS,0090037S,83,80,0,3,34,49,3 ème
ARIEGE,PAMIERS,0090481Z,12,0,12,0,2,10,3 ème
AVEYRON,AUBIN,0120096P,15,15,0,0,5,10,3 ème
AVEYRON,DECAZEVILLE,0120006S,13,13,0,0,7,6,3 ème
AVEYRON,RIGNAC,0120070L,32,32,0,0,25,7,3 ème
AVEYRON,RODEZ,0121133S,103,86,14,3,51,52,3 ème
AVEYRON,VILLEFRANCHE-DE-ROUERGUE,0121213D,176,168,0,8,86,90,3 ème
AVEYRON,VILLEFRANCHE-DE-ROUERGUE,0121260E,13,11,0,2,0,13,3 ème
GERS,AUCH,0320562M,119,105,14,0,56,63,3 ème
GERS,FLEURANCE,0320686X,24,24,0,0,14,10,3 ème
GERS,MASSEUBE,0320608M,68,68,0,0,36,32,3 ème
GERS,MIRANDE,0320035P,84,79,0,5,39,45,3 ème
GERS,NOGARO,0320025D,22,22,0,0,7,15,3 ème
GERS,RISCLE,0320029H,48,48,0,0,23,25,3 ème
GERS,VIC-FEZENSAC,0320033M,59,56,0,3,33,26,3 ème
HAUTE-GARONNE,AUCAMVILLE,0311632F,179,175,0,4,84,95,3 ème
HAUTE-GARONNE,AURIGNAC,0310003K,43,42,0,1,23,20,3 ème
HAUTE-GARONNE,BALMA,0311330C,206,186,16,4,108,98,3 ème
HAUTE-GARONNE,BEAUZELLE,0313078C,0,0,0,0,0,0,3 ème
HAUTE-GARONNE,CARAMAN,0311690U,102,86,16,0,51,51,3 ème
HAUTE-GARONNE,CASTANET-TOLOSAN,0311266H,169,169,0,0,92,77,3 ème
HAUTE-GARONNE,CAZERES,0310012V,137,132,0,5,72,65,3 ème
HAUTE-GARONNE,COLOMIERS,0311238C,138,131,0,7,61,77,3 ème
HAUTE-GARONNE,COLOMIERS,0311687R,137,135,0,2,63,74,3 ème
HAUTE-GARONNE,FONSORBES,0312338Y,136,131,0,5,74,62,3 ème
HAUTE-GARONNE,LEGUEVIN,0312337X,163,161,0,2,80,83,3 ème
HAUTE-GARONNE,MURET,0311240E,16,0,16,0,4,12,3 ème
HAUTE-GARONNE,NAILLOUX,0312699R,143,139,0,4,76,67,3 ème
HAUTE-GARONNE,NOE,0312868Z,191,189,0,2,98,93,3 ème
HAUTE-GARONNE,SAINT-GAUDENS,0310083X,112,83,23,6,57,55,3 ème
HAUTE-GARONNE,TOULOUSE,0310057U,23,23,0,0,21,2,3 ème
HAUTE-GARONNE,TOULOUSE,0310092G,206,199,0,7,95,111,3 ème
HAUTE-GARONNE,TOULOUSE,0311231V,77,71,0,6,37,40,3 ème
HAUTE-GARONNE,TOULOUSE,0311236A,227,227,0,0,128,99,3 ème
HAUTE-GARONNE,TOULOUSE,0311264F,114,112,0,2,51,63,3 ème
HAUTE-GARONNE,TOULOUSE,0311570N,33,33,0,0,15,18,3 ème
HAUTE-GARONNE,TOULOUSE,0311631E,188,188,0,0,100,88,3 ème
HAUTE-GARONNE,TOULOUSE,0311962P,226,226,0,0,123,103,3 ème
HAUTE-GARONNE,TOULOUSE,0312284P,21,21,0,0,8,13,3 ème
HAUTE-GARONNE,VERFEIL,0311335H,105,105,0,0,56,49,3 ème
HAUTES-PYRENEES,ARGELES-GAZOST,0650836F,113,113,0,0,64,49,3 ème
HAUTES-PYRENEES,AUREILHAN,0650028C,23,23,0,0,2,21,3 ème
HAUTES-PYRENEES,LOURDES,0650015N,117,96,17,4,61,56,3 ème
HAUTES-PYRENEES,LOURDES,0650877A,142,139,0,3,61,81,3 ème
HAUTES-PYRENEES,LOURES-BAROUSSE,0650017R,49,49,0,0,28,21,3 ème
HAUTES-PYRENEES,MAUBOURGUET,0650019T,52,50,0,2,30,22,3 ème
HAUTES-PYRENEES,TARBES,0650031F,125,122,0,3,71,54,3 ème
HAUTES-PYRENEES,TARBES,0650034J,125,109,16,0,70,55,3 ème
HAUTES-PYRENEES,TARBES,0650886K,20,20,0,0,8,12,3 ème
HAUTES-PYRENEES,TOURNAY,0650036L,73,70,0,3,36,37,3 ème
HAUTES-PYRENEES,VIC-EN-BIGORRE,0650035K,16,16,0,0,7,9,3 ème
LOT,BRETENOUX,0460573Y,79,79,0,0,41,38,3 ème
LOT,FIGEAC,0460032K,14,14,0,0,8,6,3 ème
LOT,FIGEAC,0460054J,174,156,16,2,88,86,3 ème
LOT,GRAMAT,0460046A,19,18,0,1,8,11,3 ème
LOT,LATRONQUIERE,0460018V,39,39,0,0,24,15,3 ème
LOT,SOUILLAC,0460594W,62,60,0,2,33,29,3 ème
TARN,ALBI,0811061N,100,98,0,2,56,44,3 ème
TARN,CASTRES,0810016C,47,47,0,0,12,35,3 ème
TARN,CASTRES,0810088F,30,30,0,0,17,13,3 ème
TARN,GRAULHET,0810125W,176,157,16,3,85,91,3 ème
TARN,LABRUGUIERE,0810089G,50,50,0,0,24,26,3 ème
TARN,LAUTREC,0810028R,54,54,0,0,23,31,3 ème
TARN,LAVAUR,0811032G,267,252,10,5,143,124,3 ème
TARN,MAZAMET,0810126X,99,81,16,2,46,53,3 ème
TARN,SAINT-SULPICE-LA-POINTE,0810041E,191,188,0,3,99,92,3 ème
TARN-ET-GARONNE,DIEUPENTALE,0820678S,19,16,0,3,9,10,3 ème
TARN-ET-GARONNE,MOISSAC,0820017Y,185,166,12,7,86,99,3 ème
TARN-ET-GARONNE,MONTAUBAN,0820754Z,166,160,6,0,82,84,3 ème
TARN-ET-GARONNE,MONTEILS,0820883P,21,21,0,0,3,18,3 ème
LOIRE-ATLANTIQUE,BASSE-GOULAINE,0442277L,150,150,0,0,64,86,3 ème
LOIRE-ATLANTIQUE,BOUGUENAIS,0440316E,190,169,16,5,100,90,3 ème
LOIRE-ATLANTIQUE,GORGES,0440107C,38,38,0,0,9,29,3 ème
LOIRE-ATLANTIQUE,GUERANDE,0442368K,105,100,0,5,65,40,3 ème
LOIRE-ATLANTIQUE,HERBIGNAC,0440015C,102,102,0,0,53,49,3 ème
LOIRE-ATLANTIQUE,HERBIGNAC,0440195Y,120,120,0,0,67,53,3 ème
LOIRE-ATLANTIQUE,LE LOROUX-BOTTEREAU,0440200D,189,187,0,2,104,85,3 ème
LOIRE-ATLANTIQUE,LE PELLERIN,0441658N,114,114,0,0,54,60,3 ème
LOIRE-ATLANTIQUE,LIGNE,0440199C,92,92,0,0,41,51,3 ème
LOIRE-ATLANTIQUE,MONTOIR-DE-BRETAGNE,0440539X,79,79,0,0,41,38,3 ème
LOIRE-ATLANTIQUE,NANTES,0440033X,24,24,0,0,5,19,3 ème
LOIRE-ATLANTIQUE,NANTES,0440049P,120,117,0,3,58,62,3 ème
LOIRE-ATLANTIQUE,NANTES,0440210P,74,74,0,0,43,31,3 ème
LOIRE-ATLANTIQUE,NANTES,0440219Z,32,32,0,0,18,14,3 ème
LOIRE-ATLANTIQUE,NANTES,0440246D,16,16,0,0,6,10,3 ème
LOIRE-ATLANTIQUE,NANTES,0440309X,82,82,0,0,45,37,3 ème
LOIRE-ATLANTIQUE,NANTES,0441545R,177,161,16,0,75,102,3 ème
LOIRE-ATLANTIQUE,NANTES,0441608J,84,64,16,4,46,38,3 ème
LOIRE-ATLANTIQUE,NANTES,0441938T,185,185,0,0,76,109,3 ème
LOIRE-ATLANTIQUE,NANTES,0442725Y,22,22,0,0,14,8,3 ème
LOIRE-ATLANTIQUE,NOZAY,0440223D,143,143,0,0,76,67,3 ème
LOIRE-ATLANTIQUE,ORVAULT,0440055W,143,143,0,0,82,61,3 ème
LOIRE-ATLANTIQUE,PAIMBOEUF,0441862K,88,73,15,0,39,49,3 ème
LOIRE-ATLANTIQUE,REZE,0440064F,167,167,0,0,78,89,3 ème
LOIRE-ATLANTIQUE,REZE,0440065G,170,170,0,0,87,83,3 ème
LOIRE-ATLANTIQUE,SAINT-BREVIN-LES-PINS,0440233P,100,97,0,3,49,51,3 ème
LOIRE-ATLANTIQUE,SAINT-PERE-EN-RETZ,0440238V,110,110,0,0,57,53,3 ème
LOIRE-ATLANTIQUE,THOUARE-SUR-LOIRE,0442417N,147,143,0,4,68,79,3 ème
LOIRE-ATLANTIQUE,TREILLIERES,0440209N,108,108,0,0,54,54,3 ème
LOIRE-ATLANTIQUE,TREILLIERES,0442418P,144,144,0,0,68,76,3 ème
LOIRE-ATLANTIQUE,VERTOU,0440080Y,129,126,0,3,64,65,3 ème
MAINE-ET-LOIRE,ANGERS,0490784L,24,24,0,0,7,17,3 ème
MAINE-ET-LOIRE,ANGERS,0490921K,147,147,0,0,57,90,3 ème
MAINE-ET-LOIRE,ANGERS,0491028B,100,100,0,0,53,47,3 ème
MAINE-ET-LOIRE,ANGERS,0491083L,178,178,0,0,90,88,3 ème
MAINE-ET-LOIRE,ANGERS,0491641T,86,86,0,0,41,45,3 ème
MAINE-ET-LOIRE,ANGERS,0492004M,217,197,14,6,112,105,3 ème
MAINE-ET-LOIRE,ANGERS,0492081W,149,148,0,1,72,77,3 ème
MAINE-ET-LOIRE,BEAUPREAU-EN-MAUGES,0490851J,182,182,0,0,92,90,3 ème
MAINE-ET-LOIRE,BELLEVIGNE-EN-LAYON,0490879P,93,93,0,0,49,44,3 ème
MAINE-ET-LOIRE,CHALONNES-SUR-LOIRE,0490955X,122,119,0,3,67,55,3 ème
MAINE-ET-LOIRE,CHEMILLE-EN-ANJOU,0490858S,133,130,0,3,62,71,3 ème
MAINE-ET-LOIRE,CHOLET,0491675E,109,93,16,0,51,58,3 ème
MAINE-ET-LOIRE,DOUE-EN-ANJOU,0490863X,89,89,0,0,50,39,3 ème
MAINE-ET-LOIRE,GENNES-VAL-DE-LOIRE,0491261E,119,119,0,0,64,55,3 ème
MAINE-ET-LOIRE,INGRANDES-LE FRESNE SUR LOIRE,0490026M,72,72,0,0,49,23,3 ème
MAINE-ET-LOIRE,LE LION-D'ANGERS,0490866A,77,74,0,3,39,38,3 ème
MAINE-ET-LOIRE,LES HAUTS-D'ANJOU,0490857R,101,101,0,0,48,53,3 ème
MAINE-ET-LOIRE,LES PONTS-DE-CE,0491923Z,94,94,0,0,58,36,3 ème
MAINE-ET-LOIRE,LYS-HAUT-LAYON,0490881S,82,82,0,0,42,40,3 ème
MAINE-ET-LOIRE,MAUGES-SUR-LOIRE,0490873H,70,70,0,0,32,38,3 ème
MAINE-ET-LOIRE,NOYANT-VILLAGES,0491766D,47,47,0,0,23,24,3 ème
MAINE-ET-LOIRE,OMBREE D'ANJOU,0490037Z,51,51,0,0,23,28,3 ème
MAINE-ET-LOIRE,OMBREE D'ANJOU,0490871F,45,45,0,0,22,23,3 ème
MAINE-ET-LOIRE,SAUMUR,0490055U,24,24,0,0,12,12,3 ème
MAINE-ET-LOIRE,SAUMUR,0490836T,55,54,0,1,32,23,3 ème
MAINE-ET-LOIRE,SAUMUR,0490839W,83,83,0,0,42,41,3 ème
MAINE-ET-LOIRE,SEVREMOINE,0490874J,56,56,0,0,31,25,3 ème
MAINE-ET-LOIRE,TRELAZE,0490048L,124,108,16,0,64,60,3 ème
MAINE-ET-LOIRE,VAL D'ERDRE-AUXENCE,0490029R,88,88,0,0,46,42,3 ème
MAINE-ET-LOIRE,VERRIERES-EN-ANJOU,0492140K,123,123,0,0,73,50,3 ème
MAYENNE,AMBRIERES-LES-VALLEES,0530001N,56,56,0,0,35,21,3 ème
MAYENNE,CHATEAU-GONTIER-SUR-MAYENNE,0530040F,16,16,0,0,5,11,3 ème
MAYENNE,ERNEE,0530770Z,112,107,0,5,50,62,3 ème
MAYENNE,GORRON,0530060C,26,26,0,0,11,15,3 ème
MAYENNE,LAVAL,0530484N,114,94,17,3,43,71,3 ème
SARTHE,ALLONNES,0720001K,135,116,16,3,67,68,3 ème
SARTHE,CHANGE,0721477P,86,81,0,5,43,43,3 ème
SARTHE,CONLIE,0720014Z,92,70,14,8,35,57,3 ème
SARTHE,CONNERRE,0720015A,139,139,0,0,77,62,3 ème
SARTHE,ECOMMOY,0721043T,127,127,0,0,62,65,3 ème
SARTHE,LA FLECHE,0720023J,114,99,15,0,56,58,3 ème
SARTHE,LE MANS,0720033V,48,48,0,0,12,36,3 ème
SARTHE,LE MANS,0720034W,46,46,0,0,14,32,3 ème
SARTHE,LE MANS,0720038A,83,83,0,0,41,42,3 ème
SARTHE,LE MANS,0720812S,176,176,0,0,90,86,3 ème
SARTHE,LE MANS,0720902P,108,87,16,5,46,62,3 ème
SARTHE,LE MANS,0720986F,127,109,15,3,66,61,3 ème
SARTHE,LE MANS,0721608G,21,21,0,0,4,17,3 ème
SARTHE,MAROLLES-LES-BRAULTS,0720043F,52,52,0,0,21,31,3 ème
SARTHE,SILLE-LE-GUILLAUME,0720817X,60,60,0,0,33,27,3 ème
SARTHE,TELOCHE,0721261E,164,161,0,3,77,87,3 ème
SARTHE,YVRE-L'EVEQUE,0721225R,90,88,0,2,38,52,3 ème
VENDEE,CHALLANS,0850142T,24,24,0,0,7,17,3 ème
VENDEE,CHALLANS,0850147Y,241,221,16,4,114,127,3 ème
VENDEE,CHALLANS,0851158X,310,291,15,4,157,153,3 ème
VENDEE,CHALLANS,0851698J,32,30,0,2,14,18,3 ème
VENDEE,FONTENAY-LE-COMTE,0850066K,136,136,0,0,64,72,3 ème
VENDEE,LA CHATAIGNERAIE,0850097U,106,106,0,0,58,48,3 ème
VENDEE,LA ROCHE-SUR-YON,0850027T,47,47,0,0,7,40,3 ème
VENDEE,LA ROCHE-SUR-YON,0851274Y,155,155,0,0,84,71,3 ème
VENDEE,LES ACHARDS,0851655M,103,103,0,0,59,44,3 ème
VENDEE,LES HERBIERS,0851400K,24,24,0,0,4,20,3 ème
VENDEE,LES SABLES-D'OLONNE,0850033Z,24,24,0,0,2,22,3 ème
VENDEE,LES SABLES-D'OLONNE,0850117R,171,160,8,3,88,83,3 ème
VENDEE,LUCON,0851290R,162,160,0,2,93,69,3 ème
VENDEE,MONTAIGU-VENDEE,0850104B,272,254,15,3,132,140,3 ème
VENDEE,MOUTIERS-LES-MAUXFAITS,0850107E,138,138,0,0,71,67,3 ème
VENDEE,MOUTIERS-LES-MAUXFAITS,0850641K,112,112,0,0,63,49,3 ème
VENDEE,NOIRMOUTIER-EN-L'ILE,0850109G,34,34,0,0,19,15,3 ème
VENDEE,PALLUAU,0850108F,117,117,0,0,49,68,3 ème
VENDEE,SAINT-JEAN-DE-MONTS,0850123X,64,64,0,0,36,28,3 ème
VENDEE,SAINT-MICHEL-EN-L'HERM,0851132U,65,65,0,0,37,28,3 ème
ALPES-DE-HTE-PROVENCE,ANNOT,0040001E,25,25,0,0,14,11,3 ème
ALPES-DE-HTE-PROVENCE,BANON,0040002F,25,25,0,0,10,15,3 ème
ALPES-DE-HTE-PROVENCE,CHATEAU-ARNOUX-SAINT-AUBAN,0040052K,161,152,0,9,87,74,3 ème
ALPES-DE-HTE-PROVENCE,DIGNE-LES-BAINS,0040007L,50,50,0,0,24,26,3 ème
ALPES-DE-HTE-PROVENCE,FORCALQUIER,0040382U,113,113,0,0,53,60,3 ème
ALPES-DE-HTE-PROVENCE,MANOSQUE,0040011R,37,37,0,0,10,27,3 ème
ALPES-DE-HTE-PROVENCE,MANOSQUE,0040462F,104,103,0,1,54,50,3 ème
ALPES-DE-HTE-PROVENCE,RIEZ,0040017X,66,66,0,0,44,22,3 ème
ALPES-DE-HTE-PROVENCE,SAINT-ANDRE-LES-ALPES,0040019Z,43,43,0,0,17,26,3 ème
BOUCHES-DU-RHONE,AIX-EN-PROVENCE,0132325G,135,130,0,5,62,73,3 ème
BOUCHES-DU-RHONE,AIX-EN-PROVENCE,0133395V,41,37,0,4,19,22,3 ème
BOUCHES-DU-RHONE,ARLES,0131322S,122,122,0,0,66,56,3 ème
BOUCHES-DU-RHONE,ARLES,0131610E,179,174,0,5,78,101,3 ème
BOUCHES-DU-RHONE,ARLES,0132572A,168,164,0,4,81,87,3 ème
BOUCHES-DU-RHONE,FUVEAU,0133243E,242,242,0,0,125,117,3 ème
BOUCHES-DU-RHONE,MARIGNANE,0130033R,48,48,0,0,16,32,3 ème
BOUCHES-DU-RHONE,MARSEILLE,0132204A,131,126,0,5,54,77,3 ème
BOUCHES-DU-RHONE,MARSEILLE,0130068D,24,24,0,0,18,6,3 ème
BOUCHES-DU-RHONE,MARSEILLE,0131379D,89,87,0,2,48,41,3 ème
BOUCHES-DU-RHONE,MARSEILLE,0131385K,93,93,0,0,46,47,3 ème
BOUCHES-DU-RHONE,MARSEILLE,0132401P,128,115,13,0,67,61,3 ème
BOUCHES-DU-RHONE,MARSEILLE,0132402R,206,206,0,0,99,107,3 ème
BOUCHES-DU-RHONE,MARSEILLE,0131756N,181,152,24,5,80,101,3 ème
BOUCHES-DU-RHONE,MARSEILLE,0133494C,29,29,0,0,13,16,3 ème
BOUCHES-DU-RHONE,MARSEILLE,0132312T,199,195,0,4,100,99,3 ème
BOUCHES-DU-RHONE,MARSEILLE,0133827P,8,8,0,0,4,4,3 ème
BOUCHES-DU-RHONE,MARSEILLE,0131604Y,140,133,0,7,68,72,3 ème
BOUCHES-DU-RHONE,MARSEILLE,0132114C,82,82,0,0,48,34,3 ème
BOUCHES-DU-RHONE,MARSEILLE,0132491M,183,148,31,4,78,105,3 ème
BOUCHES-DU-RHONE,MARSEILLE,0132956T,88,88,0,0,45,43,3 ème
BOUCHES-DU-RHONE,MARSEILLE,0133775H,69,62,0,7,28,41,3 ème
BOUCHES-DU-RHONE,MARSEILLE,0131372W,88,88,0,0,46,42,3 ème
BOUCHES-DU-RHONE,MARSEILLE,0131885D,151,146,0,5,78,73,3 ème
BOUCHES-DU-RHONE,MARSEILLE,0132785G,128,122,0,6,59,69,3 ème
BOUCHES-DU-RHONE,MARSEILLE,0131605Z,170,154,16,0,69,101,3 ème
BOUCHES-DU-RHONE,MARSEILLE,0131370U,45,45,0,0,23,22,3 ème
BOUCHES-DU-RHONE,MARSEILLE,0130055P,23,23,0,0,5,18,3 ème
BOUCHES-DU-RHONE,MARSEILLE,0132949K,128,128,0,0,66,62,3 ème
BOUCHES-DU-RHONE,MARSEILLE,0133445Z,12,12,0,0,2,10,3 ème
BOUCHES-DU-RHONE,MARSEILLE,0131943S,205,202,0,3,102,103,3 ème
BOUCHES-DU-RHONE,MARSEILLE,0132193N,23,23,0,0,20,3,3 ème
BOUCHES-DU-RHONE,MARSEILLE,0130062X,37,37,0,0,4,33,3 ème
BOUCHES-DU-RHONE,MARSEILLE,0132913W,186,186,0,0,98,88,3 ème
BOUCHES-DU-RHONE,MARSEILLE,0132914X,191,188,0,3,95,96,3 ème
BOUCHES-DU-RHONE,MARSEILLE,0132311S,130,127,0,3,65,65,3 ème
BOUCHES-DU-RHONE,MARTIGUES,0131707K,113,110,0,3,53,60,3 ème
BOUCHES-DU-RHONE,PLAN-DE-CUQUES,0133665N,171,171,0,0,82,89,3 ème
BOUCHES-DU-RHONE,PORT-DE-BOUC,0132322D,121,121,0,0,57,64,3 ème
BOUCHES-DU-RHONE,SAINT-ANDIOL,0133621R,107,106,0,1,58,49,3 ème
BOUCHES-DU-RHONE,SAINT-REMY-DE-PROVENCE,0132573B,164,147,17,0,70,94,3 ème
BOUCHES-DU-RHONE,SALON-DE-PROVENCE,0130163G,242,216,26,0,107,135,3 ème
BOUCHES-DU-RHONE,SALON-DE-PROVENCE,0131349W,132,132,0,0,72,60,3 ème
BOUCHES-DU-RHONE,VELAUX,0133353Z,192,192,0,0,99,93,3 ème
BOUCHES-DU-RHONE,VITROLLES,0133196D,144,144,0,0,74,70,3 ème
HAUTES-ALPES,GAP,0050008G,34,34,0,0,8,26,3 ème
HAUTES-ALPES,GAP,0050480V,166,153,11,2,95,71,3 ème
HAUTES-ALPES,L'ARGENTIERE-LA-BESSEE,0050409T,62,61,0,1,31,31,3 ème
HAUTES-ALPES,SERRES,0050520N,25,25,0,0,11,14,3 ème
HAUTES-ALPES,TALLARD,0050638S,98,98,0,0,45,53,3 ème
HAUTES-ALPES,VEYNES,0050022X,67,67,0,0,26,41,3 ème
VAUCLUSE,CARPENTRAS,0840761W,134,131,0,3,65,69,3 ème
VAUCLUSE,CARPENTRAS,0840851U,109,109,0,0,108,1,3 ème
VAUCLUSE,CAVAILLON,0840018N,132,110,21,1,61,71,3 ème
VAUCLUSE,CAVAILLON,0841086Z,96,96,0,0,50,46,3 ème
VAUCLUSE,LE PONTET,0840664R,174,157,15,2,86,88,3 ème
VAUCLUSE,L'ISLE-SUR-LA-SORGUE,0840585E,119,117,0,2,51,68,3 ème
VAUCLUSE,L'ISLE-SUR-LA-SORGUE,0841118J,134,134,0,0,66,68,3 ème
VAUCLUSE,MAZAN,0841043C,181,181,0,0,91,90,3 ème
VAUCLUSE,MONTEUX,0840698C,187,183,0,4,91,96,3 ème
VAUCLUSE,PERTUIS,0840069U,71,71,0,0,38,33,3 ème
VAUCLUSE,PERTUIS,0840926A,119,114,0,5,62,57,3 ème
VAUCLUSE,SORGUES,0840583C,196,183,13,0,101,95,3 ème
VAUCLUSE,SORGUES,0841078R,19,19,0,0,7,12,3 ème
VAUCLUSE,VEDENE,0840803S,187,187,0,0,96,91,3 ème
ALPES-MARITIMES,ANTIBES,0060795G,102,102,0,0,49,53,3 ème
ALPES-MARITIMES,BEAUSOLEIL,0061278G,113,113,0,0,49,64,3 ème
ALPES-MARITIMES,CANNES,0061174U,132,128,0,4,57,75,3 ème
ALPES-MARITIMES,CANNES,0061394H,23,23,0,0,20,3,3 ème
ALPES-MARITIMES,CANNES,0061457B,257,257,0,0,113,144,3 ème
ALPES-MARITIMES,CANNES,0061561P,24,24,0,0,2,22,3 ème
ALPES-MARITIMES,LA TRINITE,0060910G,144,142,0,2,73,71,3 ème
ALPES-MARITIMES,MANDELIEU-LA-NAPOULE,0061175V,163,163,0,0,91,72,3 ème
ALPES-MARITIMES,MANDELIEU-LA-NAPOULE,0061924J,117,112,0,5,52,65,3 ème
ALPES-MARITIMES,NICE,0060043P,24,24,0,0,15,9,3 ème
ALPES-MARITIMES,NICE,0060085K,146,146,0,0,66,80,3 ème
ALPES-MARITIMES,NICE,0060679F,119,119,0,0,59,60,3 ème
ALPES-MARITIMES,NICE,0060681H,68,68,0,0,43,25,3 ème
ALPES-MARITIMES,NICE,0060745C,88,84,0,4,54,34,3 ème
ALPES-MARITIMES,NICE,0060840F,207,185,14,8,103,104,3 ème
ALPES-MARITIMES,NICE,0061462G,96,96,0,0,15,81,3 ème
ALPES-MARITIMES,PEGOMAS,0062181N,135,135,0,0,67,68,3 ème
ALPES-MARITIMES,ROQUEBILLIERE,0061237M,51,49,2,0,22,29,3 ème
ALPES-MARITIMES,ROQUEFORT-LES-PINS,0062056C,193,193,0,0,101,92,3 ème
VAR,AUPS,0830002B,136,131,0,5,66,70,3 ème
VAR,BANDOL,0830003C,79,59,14,6,39,40,3 ème
VAR,BESSE-SUR-ISSOLE,0831630W,206,206,0,0,103,103,3 ème
VAR,BRIGNOLES,0830103L,188,184,0,4,88,100,3 ème
VAR,BRIGNOLES,0830734X,195,172,15,8,89,106,3 ème
VAR,CUERS,0831482K,46,46,0,0,17,29,3 ème
VAR,DRAGUIGNAN,0830929J,203,199,0,4,94,109,3 ème
VAR,DRAGUIGNAN,0830956N,228,204,16,8,106,122,3 ème
VAR,DRAGUIGNAN,0831306U,82,82,0,0,36,46,3 ème
VAR,GAREOULT,0831391L,168,168,0,0,84,84,3 ème
VAR,HYERES,0830145G,188,157,29,2,82,106,3 ème
VAR,LA SEYNE-SUR-MER,0831052T,111,111,0,0,50,61,3 ème
VAR,LA SEYNE-SUR-MER,0831196Z,160,150,10,0,98,62,3 ème
VAR,LORGUES,0830076G,158,158,0,0,69,89,3 ème
VAR,OLLIOULES,0831188R,186,185,0,1,92,94,3 ème
VAR,ROCBARON,0831645M,153,153,0,0,84,69,3 ème
VAR,SAINT-MANDRIER-SUR-MER,0830071B,38,38,0,0,14,24,3 ème
VAR,SAINT-ZACHARIE,0831657A,159,159,0,0,77,82,3 ème
VAR,SANARY-SUR-MER,0830178T,125,125,0,0,62,63,3 ème
VAR,TOULON,0830953K,163,162,0,1,83,80,3 ème
VAR,TOULON,0831197A,124,123,0,1,64,60,3 ème
VAR,TOULON,0831198B,126,126,0,0,63,63,3 ème
VAR,VINON-SUR-VERDON,0831552L,155,155,0,0,61,94,3 ème
ALLIER,BOURBON-L'ARCHAMBAULT,0030004N,64,60,0,4,40,24,3 ème
ALLIER,CERILLY,0030005P,25,25,0,0,12,13,3 ème
ALLIER,CUSSET,0030061A,23,23,0,0,8,15,3 ème
ALLIER,GANNAT,0030017C,116,114,0,2,63,53,3 ème
ALLIER,MONTLUCON,0030981A,61,61,0,0,36,25,3 ème
ALLIER,MOULINS,0030081X,51,51,0,0,26,25,3 ème
ALLIER,YZEURE,0030837U,140,137,0,3,67,73,3 ème
CANTAL,AURILLAC,0150008C,24,24,0,0,14,10,3 ème
CANTAL,AURILLAC,0150639N,86,85,0,1,54,32,3 ème
CANTAL,MAURIAC,0150061K,19,19,0,0,9,10,3 ème
CANTAL,PIERREFORT,0150024V,14,14,0,0,8,6,3 ème
CANTAL,RIOM-ES-MONTAGNES,0150062L,15,15,0,0,7,8,3 ème
CANTAL,VIC-SUR-CERE,0150033E,39,39,0,0,18,21,3 ème
HAUTE-LOIRE,BRIVES-CHARENSAC,0430917N,71,51,16,4,42,29,3 ème
HAUTE-LOIRE,ESPALY-SAINT-MARCEL,0430023S,24,24,0,0,1,23,3 ème
HAUTE-LOIRE,LANGEAC,0430013F,59,56,0,3,21,38,3 ème
HAUTE-LOIRE,LANGEAC,0430072V,26,26,0,0,11,15,3 ème
HAUTE-LOIRE,LE PUY-EN-VELAY,0430903Y,61,61,0,0,31,30,3 ème
HAUTE-LOIRE,MONISTROL-SUR-LOIRE,0430906B,135,123,12,0,65,70,3 ème
HAUTE-LOIRE,SAINTE-FLORINE,0430029Y,44,43,0,1,19,25,3 ème
HAUTE-LOIRE,SAINTE-FLORINE,0430085J,22,22,0,0,11,11,3 ème
HAUTE-LOIRE,YSSINGEAUX,0430953C,24,24,0,0,9,15,3 ème
PUY-DE-DOME,BEAUMONT,0630007R,138,138,0,0,64,74,3 ème
PUY-DE-DOME,CEYRAT,0630063B,134,126,0,8,64,70,3 ème
PUY-DE-DOME,CHATEL-GUYON,0630017B,138,138,0,0,73,65,3 ème
PUY-DE-DOME,CLERMONT-FERRAND,0631073Z,125,125,0,0,64,61,3 ème
PUY-DE-DOME,CLERMONT-FERRAND,0631120A,120,99,16,5,52,68,3 ème
PUY-DE-DOME,CLERMONT-FERRAND,0631126G,151,131,17,3,65,86,3 ème
PUY-DE-DOME,CLERMONT-FERRAND,0631522M,135,115,16,4,75,60,3 ème
PUY-DE-DOME,CLERMONT-FERRAND,0632091F,24,24,0,0,18,6,3 ème
PUY-DE-DOME,COURNON-D'AUVERGNE,0631688T,190,168,17,5,95,95,3 ème
PUY-DE-DOME,CUNLHAT,0630031S,18,18,0,0,6,12,3 ème
PUY-DE-DOME,GERZAT,0631161V,202,180,16,6,105,97,3 ème
PUY-DE-DOME,ISSOIRE,0631734T,135,135,0,0,83,52,3 ème
PUY-DE-DOME,LA TOUR-D'AUVERGNE,0630036X,31,31,0,0,16,15,3 ème
PUY-DE-DOME,LEMPDES,0631412T,142,124,16,2,72,70,3 ème
PUY-DE-DOME,LEZOUX,0631481T,149,146,0,3,80,69,3 ème
PUY-DE-DOME,MANZAT,0630038Z,46,46,0,0,26,20,3 ème
PUY-DE-DOME,OLLIERGUES,0630045G,19,19,0,0,10,9,3 ème
PUY-DE-DOME,ORCINES,0631100D,17,17,0,0,8,9,3 ème
PUY-DE-DOME,PONT-DU-CHATEAU,0630916D,146,146,0,0,76,70,3 ème
PUY-DE-DOME,PONT-DU-CHATEAU,0631480S,24,24,0,0,5,19,3 ème
PUY-DE-DOME,PUY-GUILLAUME,0630050M,78,78,0,0,38,40,3 ème
PUY-DE-DOME,RIOM,0631580A,134,133,0,1,77,57,3 ème
PUY-DE-DOME,ROMAGNAT,0630665F,41,16,7,18,6,35,3 ème
PUY-DE-DOME,SAINT-ELOY-LES-MINES,0630061Z,24,24,0,0,12,12,3 ème
PUY-DE-DOME,SAINT-ELOY-LES-MINES,0631109N,14,14,0,0,8,6,3 ème
PUY-DE-DOME,SAINT-SATURNIN,0631111R,55,53,0,2,19,36,3 ème
ARDECHE,BOURG-SAINT-ANDEOL,0070006U,155,134,15,6,74,81,3 ème
ARDECHE,LE POUZIN,0070019H,91,89,0,2,47,44,3 ème
ARDECHE,LE TEIL,0070864B,47,47,0,0,21,26,3 ème
ARDECHE,TOURNON-SUR-RHONE,0070848J,244,223,16,5,120,124,3 ème
DROME,BOURG-DE-PEAGE,0260090G,168,168,0,0,84,84,3 ème
DROME,CREST,0261092W,111,110,0,1,64,47,3 ème
DROME,DIE,0261093X,107,103,0,4,50,57,3 ème
DROME,MONTELIMAR,0260789S,200,163,27,10,108,92,3 ème
DROME,MONTELIMAR,0261088S,142,142,0,0,71,71,3 ème
DROME,ROMANS-SUR-ISERE,0260115J,163,138,16,9,85,78,3 ème
DROME,SAINT-VALLIER,0260032U,177,156,11,10,95,82,3 ème
DROME,SAINT-VALLIER,0261397C,12,12,0,0,5,7,3 ème
DROME,VALENCE,0260049M,146,140,0,6,62,84,3 ème
DROME,VALENCE,0260070K,120,120,0,0,61,59,3 ème
DROME,VALENCE,0260082Y,22,22,0,0,11,11,3 ème
DROME,VALENCE,0260978X,159,143,16,0,84,75,3 ème
HAUTE SAVOIE,ANNECY,0740062R,24,24,0,0,3,21,3 ème
HAUTE SAVOIE,ANNECY,0741096P,161,153,0,8,68,93,3 ème
HAUTE SAVOIE,BONS-EN-CHABLAIS,0740015P,138,135,0,3,68,70,3 ème
HAUTE SAVOIE,CLUSES,0740017S,24,24,0,0,8,16,3 ème
HAUTE SAVOIE,COLLONGES-SOUS-SALEVE,0741596H,24,24,0,0,13,11,3 ème
HAUTE SAVOIE,CRANVES-SALES,0741514U,227,225,0,2,117,110,3 ème
HAUTE SAVOIE,EVIAN-LES-BAINS,0740117A,51,51,0,0,26,25,3 ème
HAUTE SAVOIE,GROISY,0740025A,201,196,0,5,108,93,3 ème
HAUTE SAVOIE,LA ROCHE-SUR-FORON,0741279N,174,174,0,0,87,87,3 ème
HAUTE SAVOIE,MEGEVE,0740119C,59,59,0,0,23,36,3 ème
HAUTE SAVOIE,REIGNIER-ESERY,0740029E,195,194,0,1,107,88,3 ème
HAUTE SAVOIE,SAINT-JULIEN-EN-GENEVOIS,0741282S,145,144,0,1,86,59,3 ème
HAUTE SAVOIE,SAINT-JULIEN-EN-GENEVOIS,0741419R,147,142,0,5,71,76,3 ème
HAUTE SAVOIE,SAINT-PIERRE-EN-FAUCIGNY,0741665H,148,130,15,3,73,75,3 ème
HAUTE SAVOIE,SALLANCHES,0740039R,146,140,0,6,76,70,3 ème
HAUTE SAVOIE,SCIONZIER,0741139L,205,181,19,5,109,96,3 ème
ISERE,ALLEVARD,0380002W,99,99,0,0,41,58,3 ème
ISERE,ALLEVARD,0381741L,36,36,0,0,12,24,3 ème
ISERE,BOURGOIN-JALLIEU,0381687C,115,115,0,0,56,59,3 ème
ISERE,CHATTE,0383345E,105,105,0,0,57,48,3 ème
ISERE,CLAIX,0382107J,15,0,15,0,5,10,3 ème
ISERE,CLAIX,0382865H,116,114,0,2,58,58,3 ème
ISERE,CREMIEU,0382103E,194,189,0,5,93,101,3 ème
ISERE,ECHIROLLES,0382044R,112,105,0,7,51,61,3 ème
ISERE,GRENOBLE,0380036H,15,15,0,0,7,8,3 ème
ISERE,GRENOBLE,0381667F,144,144,0,0,67,77,3 ème
ISERE,GRENOBLE,0381776Z,148,148,0,0,72,76,3 ème
ISERE,GRENOBLE,0383243U,160,160,0,0,94,66,3 ème
ISERE,HEYRIEUX,0380038K,137,137,0,0,61,76,3 ème
ISERE,LA COTE-SAINT-ANDRE,0380014J,24,24,0,0,8,16,3 ème
ISERE,LA MOTTE-D'AVEILLANS,0380047V,56,56,0,0,30,26,3 ème
ISERE,LA TOUR-DU-PIN,0380073Y,23,23,0,0,5,18,3 ème
ISERE,LA VERPILLIERE,0382176J,131,131,0,0,67,64,3 ème
ISERE,LE GRAND-LEMPS,0380026X,126,126,0,0,59,67,3 ème
ISERE,LE PEAGE-DE-ROUSSILLON,0381733C,24,24,0,0,15,9,3 ème
ISERE,LE PEAGE-DE-ROUSSILLON,0382582A,114,114,0,0,56,58,3 ème
ISERE,LES ABRETS EN DAUPHINE,0380001V,160,156,0,4,87,73,3 ème
ISERE,L'ISLE-D'ABEAU,0383056R,119,117,0,2,59,60,3 ème
ISERE,MEYLAN,0382492C,74,74,0,0,27,47,3 ème
ISERE,PONTCHARRA,0381905P,191,179,12,0,87,104,3 ème
ISERE,PONT-EVEQUE,0382504R,102,99,0,3,63,39,3 ème
ISERE,ROUSSILLON,0381599G,31,31,0,0,13,18,3 ème
ISERE,SAINT-EGREVE,0380058G,171,171,0,0,88,83,3 ème
ISERE,SAINT-ISMIER,0382100B,178,178,0,0,79,99,3 ème
ISERE,SASSENAGE,0382098Z,193,188,0,5,97,96,3 ème
ISERE,SEYSSINET-PARISET,0380072X,110,105,0,5,53,57,3 ème
ISERE,SEYSSUEL,0382115T,182,161,15,6,83,99,3 ème
ISERE,VIENNE,0382583B,236,232,0,4,119,117,3 ème
ISERE,VILLARD-DE-LANS,0382429J,164,164,0,0,73,91,3 ème
ISERE,VOIRON,0382042N,132,129,0,3,60,72,3 ème
SAVOIE,AIX-LES-BAINS,0730853F,132,111,20,1,61,71,3 ème
SAVOIE,ALBERTVILLE,0731272L,77,75,0,2,43,34,3 ème
SAVOIE,CHAMBERY,0730776X,18,17,0,1,7,11,3 ème
SAVOIE,CHAMBERY,0730902J,170,165,0,5,95,75,3 ème
SAVOIE,LES ECHELLES,0730022C,102,99,0,3,51,51,3 ème
SAVOIE,MOUTIERS,0730796U,33,33,0,0,14,19,3 ème
SAVOIE,SAINT-ALBAN-LEYSSE,0730810J,140,122,15,3,80,60,3 ème
SAVOIE,UGINE,0730044B,96,96,0,0,56,40,3 ème
SAVOIE,VALGELON-LA ROCHETTE,0731114P,137,137,0,0,78,59,3 ème
SAVOIE,YENNE,0730045C,80,80,0,0,34,46,3 ème
AIN,BELLEY,0011010T,24,24,0,0,11,13,3 ème
AIN,BOURG-EN-BRESSE,0010018P,146,146,0,0,76,70,3 ème
AIN,BOURG-EN-BRESSE,0010080G,82,82,0,0,36,46,3 ème
AIN,BOURG-EN-BRESSE,0010974D,163,133,29,1,79,84,3 ème
AIN,BOURG-EN-BRESSE,0011118K,39,39,0,0,6,33,3 ème
AIN,BOURG-EN-BRESSE,0011275F,119,116,0,3,61,58,3 ème
AIN,CHATILLON-SUR-CHALARONNE,0010821M,137,133,0,4,66,71,3 ème
AIN,FEILLENS,0010086N,108,108,0,0,51,57,3 ème
AIN,LAGNIEU,0010026Y,181,179,0,2,97,84,3 ème
AIN,LEYMENT,0011300H,151,148,0,3,85,66,3 ème
AIN,MEXIMIEUX,0010041P,249,222,23,4,105,144,3 ème
AIN,MONTLUEL,0010796K,140,137,0,3,79,61,3 ème
AIN,PLATEAU D'HAUTEVILLE,0010025X,60,60,0,0,34,26,3 ème
AIN,REYRIEUX,0011338Z,169,169,0,0,81,88,3 ème
AIN,SAINT-ANDRE-DE-CORCY,0011257L,149,145,0,4,73,76,3 ème
AIN,TREVOUX,0010066S,154,152,0,2,85,69,3 ème
AIN,VALSERHONE,0010006B,24,24,0,0,4,20,3 ème
AIN,VONNAS,0010046V,86,83,0,3,41,45,3 ème
LOIRE,ANDREZIEUX-BOUTHEON,0421691K,26,26,0,0,9,17,3 ème
LOIRE,CHAZELLES-SUR-LYON,0420998G,25,25,0,0,6,19,3 ème
LOIRE,FEURS,0420012K,201,201,0,0,103,98,3 ème
LOIRE,FIRMINY,0421570D,77,59,17,1,31,46,3 ème
LOIRE,FIRMINY,0421659A,59,57,0,2,25,34,3 ème
LOIRE,FIRMINY,0421681Z,90,87,0,3,41,49,3 ème
LOIRE,LE CHAMBON-FEUGEROLLES,0421044G,45,45,0,0,28,17,3 ème
LOIRE,LE CHAMBON-FEUGEROLLES,0421919H,141,126,15,0,63,78,3 ème
LOIRE,PELUSSIN,0420024Y,101,101,0,0,56,45,3 ème
LOIRE,SAINT-CHAMOND,0421688G,101,100,0,1,43,58,3 ème
LOIRE,SAINT-ETIENNE,0421038A,69,69,0,0,34,35,3 ème
LOIRE,SAINT-ETIENNE,0421569C,111,108,0,3,53,58,3 ème
LOIRE,SAINT-ETIENNE,0421741P,99,95,0,4,43,56,3 ème
LOIRE,SAINT-ETIENNE,0421742R,25,25,0,0,8,17,3 ème
LOIRE,SURY-LE-COMTAL,0420985T,23,23,0,0,0,23,3 ème
RHONE,BELLEVILLE-EN-BEAUJOLAIS,0693734J,24,24,0,0,12,12,3 ème
RHONE,BELLEVILLE-EN-BEAUJOLAIS,0694279B,105,105,0,0,53,52,3 ème
RHONE,BRON,0691479H,125,122,0,3,60,65,3 ème
RHONE,CHAPONOST,0693365H,153,147,0,6,72,81,3 ème
RHONE,CHAZAY-D'AZERGUES,0692448L,135,131,0,4,75,60,3 ème
RHONE,CRAPONNE,0692422H,160,155,0,5,73,87,3 ème
RHONE,LAMURE-SUR-AZERGUES,0690022Z,91,85,0,6,36,55,3 ème
RHONE,LYON,0692334M,131,126,0,5,68,63,3 ème
RHONE,LYON,0694007F,121,119,0,2,63,58,3 ème
RHONE,LYON,0692937T,176,176,0,0,81,95,3 ème
RHONE,LYON,0691663H,152,149,0,3,63,89,3 ème
RHONE,LYON,0693137K,137,137,0,0,63,74,3 ème
RHONE,LYON,0694453R,0,0,0,0,0,0,3 ème
RHONE,LYON,0690060R,65,63,0,2,22,43,3 ème
RHONE,LYON,0691669P,149,147,0,2,86,63,3 ème
RHONE,LYON,0693406C,16,16,0,0,6,10,3 ème
RHONE,LYON,0694295U,125,124,0,1,54,71,3 ème
RHONE,LYON,0692703N,97,92,0,5,36,61,3 ème
RHONE,OULLINS,0690541N,134,134,0,0,68,66,3 ème
RHONE,OULLINS,0692924D,347,347,0,0,179,168,3 ème
RHONE,SAINTE-FOY-LES-LYON,0691484N,119,103,16,0,50,69,3 ème
RHONE,SAINT-MARTIN-EN-HAUT,0694092Y,91,91,0,0,49,42,3 ème
RHONE,SAINT-PRIEST,0692417C,144,139,0,5,76,68,3 ème
RHONE,SAINT-PRIEST,0694406P,122,106,16,0,63,59,3 ème
RHONE,TASSIN-LA-DEMI-LUNE,0692943Z,204,202,0,2,104,100,3 ème
RHONE,THIZY-LES-BOURGS,0690581G,39,39,0,0,20,19,3 ème
RHONE,VAL D'OINGT,0691674V,128,125,0,3,64,64,3 ème
RHONE,VAULX-EN-VELIN,0691666L,133,118,15,0,60,73,3 ème
RHONE,VENISSIEUX,0690093B,21,21,0,0,10,11,3 ème
RHONE,VENISSIEUX,0691799F,159,138,15,6,67,92,3 ème
RHONE,VENISSIEUX,0692418D,24,24,0,0,4,20,3 ème
RHONE,VILLEFRANCHE-SUR-SAONE,0690097F,24,24,0,0,11,13,3 ème
RHONE,VILLEFRANCHE-SUR-SAONE,0691645N,122,118,0,4,58,64,3 ème
RHONE,VILLEFRANCHE-SUR-SAONE,0692944A,279,277,0,2,149,130,3 ème
RHONE,VILLEURBANNE,0690599B,68,68,0,0,26,42,3 ème
RHONE,VILLEURBANNE,0692945B,191,191,0,0,101,90,3 ème
RHONE,VOURLES,0690624D,167,167,0,0,87,80,3 ème
DOUBS,BAUME-LES-DAMES,0250063H,24,24,0,0,11,13,3 ème
DOUBS,BESANCON,0250009Z,140,140,0,0,76,64,3 ème
DOUBS,BESANCON,0251371E,16,0,16,0,8,8,3 ème
DOUBS,BESANCON,0251587P,104,104,0,0,45,59,3 ème
DOUBS,BLAMONT,0250015F,51,51,0,0,24,27,3 ème
DOUBS,ETUPES,0251211F,167,165,0,2,90,77,3 ème
DOUBS,L'ISLE-SUR-LE-DOUBS,0250024R,82,81,0,1,41,41,3 ème
DOUBS,ORCHAMPS-VENNES,0251054K,54,54,0,0,31,23,3 ème
DOUBS,ORNANS,0251055L,53,53,0,0,29,24,3 ème
DOUBS,PIERREFONTAINE-LES-VARANS,0251315U,42,42,0,0,15,27,3 ème
DOUBS,PONT-DE-ROIDE-VERMONDANS,0250047R,98,96,0,2,56,42,3 ème
DOUBS,QUINGEY,0250049T,88,87,0,1,38,50,3 ème
DOUBS,SELONCOURT,0251397H,80,80,0,0,32,48,3 ème
HAUTE-SAONE,CHAMPAGNEY,0700895T,103,103,0,0,52,51,3 ème
HAUTE-SAONE,FAUCOGNEY-ET-LA-MER,0700005A,35,35,0,0,22,13,3 ème
HAUTE-SAONE,GRAY,0700060K,37,37,0,0,21,16,3 ème
HAUTE-SAONE,GRAY,0700904C,90,73,15,2,41,49,3 ème
HAUTE-SAONE,GY,0700061L,39,39,0,0,25,14,3 ème
HAUTE-SAONE,JUSSEY,0700016M,49,49,0,0,24,25,3 ème
HAUTE-SAONE,LURE,0700045U,182,166,15,1,99,83,3 ème
HAUTE-SAONE,LUXEUIL-LES-BAINS,0700056F,67,67,0,0,35,32,3 ème
HAUTE-SAONE,VAUVILLERS,0700035H,35,33,0,2,19,16,3 ème
JURA,ARBOIS,0390074U,15,15,0,0,8,7,3 ème
JURA,ARINTHOD,0390783P,57,57,0,0,27,30,3 ème
JURA,CHAUSSIN,0390922R,88,88,0,0,46,42,3 ème
JURA,LONS-LE-SAUNIER,0390022M,110,108,0,2,54,56,3 ème
JURA,NOZEROY,0390784R,45,45,0,0,27,18,3 ème
JURA,SAINT-AMOUR,0390785S,46,46,0,0,28,18,3 ème
JURA,SAINT-CLAUDE,0390924T,111,92,14,5,72,39,3 ème
TERRITOIRE DE BELFORT,BELFORT,0900017E,79,75,0,4,42,37,3 ème
TERRITOIRE DE BELFORT,CHEVREMONT,0900032W,45,45,0,0,19,26,3 ème
TERRITOIRE DE BELFORT,VALDOIE,0900014B,111,107,0,4,54,57,3 ème
COTE D'OR,AUXONNE,0210003P,23,23,0,0,3,20,3 ème
COTE D'OR,BEAUNE,0211229X,173,173,0,0,90,83,3 ème
COTE D'OR,BEAUNE,0211428N,24,0,24,0,13,11,3 ème
COTE D'OR,BLIGNY-SUR-OUCHE,0210011Y,26,26,0,0,14,12,3 ème
COTE D'OR,CHATILLON-SUR-SEINE,0210013A,17,17,0,0,5,12,3 ème
COTE D'OR,CHATILLON-SUR-SEINE,0211079J,30,30,0,0,12,18,3 ème
COTE D'OR,DIJON,0210018F,29,29,0,0,4,25,3 ème
COTE D'OR,DIJON,0211034K,182,181,0,1,91,91,3 ème
COTE D'OR,DIJON,0211071A,101,101,0,0,58,43,3 ème
COTE D'OR,DIJON,0211081L,115,115,0,0,57,58,3 ème
COTE D'OR,DIJON,0211136W,123,105,16,2,60,63,3 ème
COTE D'OR,DIJON,0211150L,140,126,14,0,65,75,3 ème
COTE D'OR,DIJON,0211162Z,65,48,16,1,26,39,3 ème
COTE D'OR,GENLIS,0211164B,133,133,0,0,66,67,3 ème
COTE D'OR,SAULIEU,0210046L,31,30,0,1,16,15,3 ème
COTE D'OR,SOMBERNON,0210051S,98,98,0,0,50,48,3 ème
COTE D'OR,VITTEAUX,0210053U,20,20,0,0,11,9,3 ème
NIEVRE,CORBIGNY,0580012Y,32,32,0,0,16,16,3 ème
NIEVRE,COSNE-COURS-SUR-LOIRE,0580669M,98,78,15,5,55,43,3 ème
NIEVRE,COSNE-COURS-SUR-LOIRE,0580746W,98,98,0,0,53,45,3 ème
NIEVRE,NEVERS,0580050P,24,24,0,0,15,9,3 ème
NIEVRE,NEVERS,0580599L,97,91,0,6,57,40,3 ème
NIEVRE,VARZY,0580042F,13,13,0,0,1,12,3 ème
SAONE-ET-LOIRE,AUTUN,0710115P,66,66,0,0,38,28,3 ème
SAONE-ET-LOIRE,CHALON-SUR-SAONE,0711348E,150,150,0,0,71,79,3 ème
SAONE-ET-LOIRE,CLUNY,0710024R,121,115,0,6,59,62,3 ème
SAONE-ET-LOIRE,CUISEAUX,0710033A,75,75,0,0,36,39,3 ème
SAONE-ET-LOIRE,EPINAC,0710037E,40,40,0,0,21,19,3 ème
SAONE-ET-LOIRE,LA CHAPELLE-DE-GUINCHAY,0711321A,116,116,0,0,60,56,3 ème
SAONE-ET-LOIRE,LE CREUSOT,0711069B,131,119,12,0,59,72,3 ème
SAONE-ET-LOIRE,MACON,0710080B,30,30,0,0,18,12,3 ème
SAONE-ET-LOIRE,MACON,0710534V,112,100,12,0,43,69,3 ème
SAONE-ET-LOIRE,MARCIGNY,0711071D,88,88,0,0,49,39,3 ème
SAONE-ET-LOIRE,MONTCEAU-LES-MINES,0710056A,98,78,16,4,44,54,3 ème
SAONE-ET-LOIRE,MONTCEAU-LES-MINES,0711777W,94,94,0,0,47,47,3 ème
SAONE-ET-LOIRE,MONTCENIS,0711323C,65,64,0,1,33,32,3 ème
SAONE-ET-LOIRE,PARAY-LE-MONIAL,0711755X,49,49,0,0,19,30,3 ème
SAONE-ET-LOIRE,SAINT-GERMAIN-DU-BOIS,0711146K,85,85,0,0,41,44,3 ème
SAONE-ET-LOIRE,SAINT-MARCEL,0711490J,130,115,15,0,60,70,3 ème
YONNE,AUXERRE,0890789Z,167,152,15,0,70,97,3 ème
YONNE,AUXERRE,0890819G,24,24,0,0,12,12,3 ème
YONNE,AVALLON,0890008A,15,15,0,0,5,10,3 ème
YONNE,COURSON-LES-CARRIERES,0890015H,67,67,0,0,40,27,3 ème
YONNE,JOIGNY,0890065M,116,116,0,0,57,59,3 ème
YONNE,JOIGNY,0890937K,127,125,0,2,61,66,3 ème
YONNE,JOIGNY,0891199V,24,24,0,0,4,20,3 ème
YONNE,MONTHOLON,0890788Y,120,120,0,0,64,56,3 ème
YONNE,SAINT-VALERIEN,0890028X,137,135,0,2,71,66,3 ème
YONNE,SENS,0891055N,132,132,0,0,73,59,3 ème
YONNE,SENS,0891093E,110,109,0,1,48,62,3 ème
YONNE,VILLENEUVE-LA-GUYARD,0891186F,138,138,0,0,64,74,3 ème
YONNE,VILLENEUVE-L'ARCHEVEQUE,0890038H,106,106,0,0,46,60,3 ème
COTES D'ARMOR,CREHEN,0221619R,79,79,0,0,41,38,3 ème
COTES D'ARMOR,EVRAN,0220140H,43,43,0,0,20,23,3 ème
COTES D'ARMOR,GUINGAMP,0220197V,99,99,0,0,49,50,3 ème
COTES D'ARMOR,GUINGAMP,0221698B,94,74,20,0,43,51,3 ème
COTES D'ARMOR,HILLION,0222030M,113,110,0,3,62,51,3 ème
COTES D'ARMOR,LAMBALLE-ARMOR,0221537B,220,191,28,1,105,115,3 ème
COTES D'ARMOR,MONCONTOUR,0221594N,88,88,0,0,47,41,3 ème
COTES D'ARMOR,PAIMPOL,0221991V,104,92,12,0,60,44,3 ème
COTES D'ARMOR,PERROS-GUIREC,0220167M,47,47,0,0,16,31,3 ème
COTES D'ARMOR,PERROS-GUIREC,0221029Z,85,85,0,0,49,36,3 ème
COTES D'ARMOR,PLEMET,0220153X,26,26,0,0,13,13,3 ème
COTES D'ARMOR,PLESIDY,0221877W,40,40,0,0,18,22,3 ème
COTES D'ARMOR,PLOUFRAGAN,0221621T,187,163,24,0,90,97,3 ème
COTES D'ARMOR,PLOUGUENAST-LANGAST,0220162G,38,38,0,0,21,17,3 ème
COTES D'ARMOR,SAINT-BRIEUC,0220054P,131,125,0,6,49,82,3 ème
COTES D'ARMOR,SAINT-BRIEUC,0220058U,15,15,0,0,2,13,3 ème
COTES D'ARMOR,SAINT-BRIEUC,0221513A,157,140,16,1,72,85,3 ème
COTES D'ARMOR,SAINT-BRIEUC,0221751J,143,143,0,0,92,51,3 ème
COTES D'ARMOR,TREGUIER,0220072J,15,15,0,0,8,7,3 ème
COTES D'ARMOR,TREGUIER,0220177Y,33,33,0,0,16,17,3 ème
FINISTERE,BREST,0290335G,36,36,0,0,12,24,3 ème
FINISTERE,BREST,0291824A,129,127,0,2,67,62,3 ème
FINISTERE,BREST,0291867X,169,151,14,4,77,92,3 ème
FINISTERE,CARANTEC,0290021R,71,71,0,0,32,39,3 ème
FINISTERE,CARHAIX-PLOUGUER,0291102R,99,92,6,1,52,47,3 ème
FINISTERE,CLEDER,0290253T,22,22,0,0,11,11,3 ème
FINISTERE,CONCARNEAU,0290030A,17,17,0,0,4,13,3 ème
FINISTERE,CONCARNEAU,0290132L,78,65,13,0,36,42,3 ème
FINISTERE,CONCARNEAU,0291873D,136,136,0,0,58,78,3 ème
FINISTERE,DAOULAS,0290033D,138,133,0,5,60,78,3 ème
FINISTERE,DOUARNENEZ,0291591X,158,146,12,0,77,81,3 ème
FINISTERE,FOUESNANT,0290262C,81,81,0,0,36,45,3 ème
FINISTERE,LANDERNEAU,0290184T,53,53,0,0,7,46,3 ème
FINISTERE,LANMEUR,0290047U,92,92,0,0,38,54,3 ème
FINISTERE,LANNILIS,0291639Z,71,71,0,0,39,32,3 ème
FINISTERE,LE RELECQ-KERHUON,0290308C,55,55,0,0,37,18,3 ème
FINISTERE,MORLAIX,0291085X,88,73,15,0,46,42,3 ème
FINISTERE,QUIMPER,0290068S,151,149,0,2,81,70,3 ème
FINISTERE,QUIMPER,0291087Z,140,120,16,4,69,71,3 ème
FINISTERE,QUIMPER,0291592Y,175,172,0,3,91,84,3 ème
FINISTERE,QUIMPER,0292204N,39,39,0,0,23,16,3 ème
FINISTERE,SAINT-POL-DE-LEON,0290207T,20,20,0,0,7,13,3 ème
FINISTERE,SAINT-RENAN,0290086L,107,107,0,0,49,58,3 ème
ILLE-ET-VILAINE,CESSON-SEVIGNE,0351906G,192,187,0,5,87,105,3 ème
ILLE-ET-VILAINE,CHATEAUBOURG,0350854N,130,127,0,3,78,52,3 ème
ILLE-ET-VILAINE,CHATEAUGIRON,0352248D,143,143,0,0,77,66,3 ème
ILLE-ET-VILAINE,DOL-DE-BRETAGNE,0350708E,148,121,23,4,68,80,3 ème
ILLE-ET-VILAINE,FOUGERES,0351997F,117,117,0,0,53,64,3 ème
ILLE-ET-VILAINE,LA GUERCHE-DE-BRETAGNE,0351799R,57,53,0,4,25,32,3 ème
ILLE-ET-VILAINE,MAEN ROCH,0350883V,98,96,0,2,52,46,3 ème
ILLE-ET-VILAINE,MONTAUBAN-DE-BRETAGNE,0350870F,70,70,0,0,34,36,3 ème
ILLE-ET-VILAINE,PACE,0352319F,242,242,0,0,122,120,3 ème
ILLE-ET-VILAINE,REDON,0351969A,125,122,0,3,57,68,3 ème
ILLE-ET-VILAINE,RENNES,0350759K,141,141,0,0,70,71,3 ème
ILLE-ET-VILAINE,RENNES,0350781J,106,104,0,2,61,45,3 ème
ILLE-ET-VILAINE,RENNES,0351878B,24,24,0,0,15,9,3 ème
ILLE-ET-VILAINE,RETIERS,0351882F,97,97,0,0,55,42,3 ème
ILLE-ET-VILAINE,VERN-SUR-SEICHE,0352541X,157,150,0,7,71,86,3 ème
ILLE-ET-VILAINE,VITRE,0350709F,28,28,0,0,6,22,3 ème
MORBIHAN,ALLAIRE,0561376S,111,111,0,0,53,58,3 ème
MORBIHAN,GOURIN,0561546B,61,53,8,0,31,30,3 ème
MORBIHAN,GUER,0560135T,52,52,0,0,34,18,3 ème
MORBIHAN,HENNEBONT,0560070X,24,24,0,0,5,19,3 ème
MORBIHAN,JOSSELIN,0560020T,51,43,8,0,29,22,3 ème
MORBIHAN,LANESTER,0560142A,80,80,0,0,34,46,3 ème
MORBIHAN,LE PALAIS,0560154N,18,18,0,0,11,7,3 ème
MORBIHAN,LORIENT,0560029C,146,146,0,0,77,69,3 ème
MORBIHAN,LORIENT,0560102G,153,140,13,0,72,81,3 ème
MORBIHAN,LORIENT,0562028A,148,146,0,2,75,73,3 ème
MORBIHAN,MAURON,0560032F,46,46,0,0,21,25,3 ème
MORBIHAN,PLOEMEUR,0560802T,125,123,0,2,63,62,3 ème
MORBIHAN,PONTIVY,0561332U,123,95,25,3,49,74,3 ème
MORBIHAN,PONTIVY,0561474Y,100,100,0,0,40,60,3 ème
MORBIHAN,PORT-LOUIS,0560042S,12,12,0,0,3,9,3 ème
MORBIHAN,QUESTEMBERT,0560044U,87,64,21,2,28,59,3 ème
MORBIHAN,RIANTEC,0561409C,149,148,0,1,68,81,3 ème
MORBIHAN,SAINT-AVE,0561840W,109,109,0,0,58,51,3 ème
MORBIHAN,SAINTE-ANNE-D'AURAY,0560119A,48,27,0,21,32,16,3 ème
MORBIHAN,SAINTE-ANNE-D'AURAY,0561545A,131,129,0,2,75,56,3 ème
MORBIHAN,SARZEAU,0560173J,27,27,0,0,18,9,3 ème
MORBIHAN,SENE,0561622J,114,111,0,3,61,53,3 ème
MORBIHAN,VANNES,0560050A,186,186,0,0,74,112,3 ème
CHER,BOURGES,0180008L,24,24,0,0,10,14,3 ème
CHER,BOURGES,0180009M,43,38,0,5,6,37,3 ème
CHER,BOURGES,0180673J,134,122,9,3,71,63,3 ème
CHER,NERONDES,0180023C,58,58,0,0,32,26,3 ème
CHER,NERONDES,0180567U,18,18,0,0,8,10,3 ème
CHER,SAINT-FLORENT-SUR-CHER,0180028H,166,159,7,0,75,91,3 ème
CHER,VIERZON,0180570X,47,40,7,0,17,30,3 ème
CHER,VIERZON,0180592W,152,136,14,2,75,77,3 ème
EURE-ET-LOIR,AUNEAU-BLEURY-SAINT-SYMPHORIEN,0280671C,65,65,0,0,27,38,3 ème
EURE-ET-LOIR,BROU,0280006E,66,63,0,3,34,32,3 ème
EURE-ET-LOIR,BROU,0280674F,45,45,0,0,24,21,3 ème
EURE-ET-LOIR,CHARTRES,0280663U,180,180,0,0,99,81,3 ème
EURE-ET-LOIR,CHARTRES,0280755U,178,175,0,3,87,91,3 ème
EURE-ET-LOIR,DREUX,0280687V,13,13,0,0,5,8,3 ème
EURE-ET-LOIR,DREUX,0280716B,102,87,15,0,46,56,3 ème
EURE-ET-LOIR,DREUX,0280994D,206,201,5,0,116,90,3 ème
EURE-ET-LOIR,DREUX,0281060A,146,141,0,5,64,82,3 ème
EURE-ET-LOIR,VERNOUILLET,0280753S,150,148,0,2,74,76,3 ème
INDRE,ARGENTON-SUR-CREUSE,0360718K,149,127,17,5,79,70,3 ème
INDRE,CHABRIS,0360044C,44,44,0,0,22,22,3 ème
INDRE,CHATEAUROUX,0360011S,15,15,0,0,9,6,3 ème
INDRE,CHATEAUROUX,0360048G,120,119,0,1,48,72,3 ème
INDRE,CHATEAUROUX,0360496U,134,131,0,3,65,69,3 ème
INDRE,CHATEAUROUX,0360541T,103,86,17,0,48,55,3 ème
INDRE,CHATILLON-SUR-INDRE,0360018Z,34,34,0,0,21,13,3 ème
INDRE,DEOLS,0360658V,129,114,15,0,53,76,3 ème
INDRE,ECUEILLE,0360022D,12,12,0,0,8,4,3 ème
INDRE,ISSOUDUN,0360721N,106,89,14,3,42,64,3 ème
INDRE,LA CHATRE,0360019A,15,15,0,0,8,7,3 ème
INDRE,LE BLANC,0360510J,47,47,0,0,20,27,3 ème
INDRE-ET-LOIRE,AMBOISE,0371122U,222,205,15,2,111,111,3 ème
INDRE-ET-LOIRE,AZAY-LE-RIDEAU,0371210P,150,136,13,1,68,82,3 ème
INDRE-ET-LOIRE,CHATEAU-RENAULT,0371211R,15,15,0,0,4,11,3 ème
INDRE-ET-LOIRE,CHINON,0371208M,28,28,0,0,14,14,3 ème
INDRE-ET-LOIRE,JOUE-LES-TOURS,0370071B,88,71,17,0,41,47,3 ème
INDRE-ET-LOIRE,LANGEAIS,0370885L,169,166,0,3,93,76,3 ème
INDRE-ET-LOIRE,NEUVY-LE-ROI,0370023Z,81,81,0,0,41,40,3 ème
INDRE-ET-LOIRE,RICHELIEU,0371191U,57,57,0,0,29,28,3 ème
INDRE-ET-LOIRE,SAINT-CYR-SUR-LOIRE,0371126Y,116,113,0,3,59,57,3 ème
INDRE-ET-LOIRE,SAINT-PIERRE-DES-CORPS,0370766G,75,75,0,0,33,42,3 ème
INDRE-ET-LOIRE,TOURS,0370044X,114,109,0,5,65,49,3 ème
INDRE-ET-LOIRE,TOURS,0370730T,56,56,0,0,30,26,3 ème
INDRE-ET-LOIRE,TOURS,0370764E,108,108,0,0,59,49,3 ème
INDRE-ET-LOIRE,TOURS,0370765F,108,105,0,3,46,62,3 ème
INDRE-ET-LOIRE,TOURS,0371209N,144,140,0,4,76,68,3 ème
INDRE-ET-LOIRE,TOURS,0371330V,114,114,0,0,42,72,3 ème
INDRE-ET-LOIRE,VOUVRAY,0370746K,28,28,0,0,15,13,3 ème
LOIRET,AMILLY,0451104F,17,0,17,0,6,11,3 ème
LOIRET,ARTENAY,0450003J,98,98,0,0,47,51,3 ème
LOIRET,BAZOCHES-LES-GALLERANDES,0450004K,81,80,0,1,39,42,3 ème
LOIRET,BEAUGENCY,0450479B,37,37,0,0,22,15,3 ème
LOIRET,CHATEAUNEUF-SUR-LOIRE,0450783G,185,180,0,5,101,84,3 ème
LOIRET,CHATILLON-SUR-LOIRE,0450017Z,78,78,0,0,48,30,3 ème
LOIRET,DADONVILLE,0451787Y,157,139,15,3,78,79,3 ème
LOIRET,GIEN,0451450G,69,69,0,0,32,37,3 ème
LOIRET,LA FERTE-SAINT-AUBIN,0450023F,140,138,0,2,76,64,3 ème
LOIRET,LE MALESHERBOIS,0450787L,156,155,0,1,64,92,3 ème
LOIRET,LORRIS,0450034T,114,112,0,2,52,62,3 ème
LOIRET,MONTARGIS,0451330B,47,47,0,0,20,27,3 ème
LOIRET,NEUVILLE-AUX-BOIS,0450045E,180,164,12,4,91,89,3 ème
LOIRET,OLIVET,0451304Y,24,24,0,0,12,12,3 ème
LOIRET,ORLEANS,0450049J,13,13,0,0,2,11,3 ème
LOIRET,ORLEANS,0450053N,143,140,0,3,70,73,3 ème
LOIRET,ORLEANS,0450055R,153,135,15,3,73,80,3 ème
LOIRET,ORLEANS,0450782F,10,10,0,0,2,8,3 ème
LOIRET,ORLEANS,0450785J,192,186,0,6,94,98,3 ème
LOIRET,ORLEANS,0451329A,152,152,0,0,73,79,3 ème
LOIRET,SAINT-AY,0451719Z,98,97,0,1,55,43,3 ème
LOIRET,SAINT-BENOIT-SUR-LOIRE,0450123P,48,48,0,0,24,24,3 ème
LOIRET,SAINT-JEAN-DE-BRAYE,0450839T,153,149,0,4,78,75,3 ème
LOIRET,TRAINOU,0451443Z,186,181,0,5,95,91,3 ème
LOIRET,VILLEMANDEUR,0451665R,161,157,0,4,69,92,3 ème
LOIR-ET-CHER,BLOIS,0410621C,26,26,0,0,12,14,3 ème
LOIR-ET-CHER,BLOIS,0410678P,58,45,13,0,27,31,3 ème
LOIR-ET-CHER,LAMOTTE-BEUVRON,0410008L,145,123,16,6,86,59,3 ème
LOIR-ET-CHER,MONTOIRE-SUR-LE-LOIR,0410682U,20,20,0,0,13,7,3 ème
LOIR-ET-CHER,SAINT-AIGNAN,0410714D,119,102,12,5,56,63,3 ème
LOIR-ET-CHER,VENDOME,0410792N,130,127,0,3,60,70,3 ème
CORSE-DU-SUD,AJACCIO,6200006M,168,160,0,8,77,91,3 ème
CORSE-DU-SUD,GROSSETO-PRUGNA,6200080T,100,100,0,0,49,51,3 ème
CORSE-DU-SUD,LEVIE,6200026J,9,9,0,0,6,3,3 ème
HAUTE-CORSE,BASTIA,7200012A,79,78,0,1,37,42,3 ème
HAUTE-CORSE,BASTIA,7200612C,155,145,8,2,75,80,3 ème
HAUTE-CORSE,CALVI,7200017F,118,118,0,0,59,59,3 ème
MEURTHE-ET-MOSELLE,COLOMBEY-LES-BELLES,0540012V,112,108,0,4,60,52,3 ème
MEURTHE-ET-MOSELLE,CUSTINES,0540078S,94,94,0,0,55,39,3 ème
MEURTHE-ET-MOSELLE,GERBEVILLER,0540022F,73,73,0,0,41,32,3 ème
MEURTHE-ET-MOSELLE,LANDRES,0540086A,24,24,0,0,7,17,3 ème
MEURTHE-ET-MOSELLE,LEXY,0541579Y,169,144,24,1,75,94,3 ème
MEURTHE-ET-MOSELLE,LUNEVILLE,0541328A,139,135,0,4,68,71,3 ème
MEURTHE-ET-MOSELLE,LUNEVILLE,0541990V,83,83,0,0,38,45,3 ème
MEURTHE-ET-MOSELLE,MONT-SAINT-MARTIN,0541357G,19,19,0,0,10,9,3 ème
MEURTHE-ET-MOSELLE,NANCY,0541340N,39,39,0,0,14,25,3 ème
MEURTHE-ET-MOSELLE,NANCY,0541370W,18,18,0,0,12,6,3 ème
MEURTHE-ET-MOSELLE,NANCY,0541998D,13,13,0,0,1,12,3 ème
MEURTHE-ET-MOSELLE,NEUVES-MAISONS,0540052N,104,104,0,0,49,55,3 ème
MEURTHE-ET-MOSELLE,PONT-A-MOUSSON,0541270M,40,40,0,0,18,22,3 ème
MEURTHE-ET-MOSELLE,TOUL,0541377D,22,22,0,0,5,17,3 ème
MEURTHE-ET-MOSELLE,TOUL,0541999E,98,97,0,1,54,44,3 ème
MEURTHE-ET-MOSELLE,VANDOEUVRE-LES-NANCY,0540111C,117,114,0,3,53,64,3 ème
MEURTHE-ET-MOSELLE,VANDOEUVRE-LES-NANCY,0541515D,122,106,16,0,52,70,3 ème
MEUSE,BAR-LE-DUC,0550703R,70,68,0,2,30,40,3 ème
MEUSE,CLERMONT-EN-ARGONNE,0550007J,58,58,0,0,28,30,3 ème
MEUSE,COMMERCY,0550008K,15,15,0,0,5,10,3 ème
MEUSE,COMMERCY,0550840P,190,170,16,4,97,93,3 ème
MEUSE,COMMERCY,0550920B,24,24,0,0,11,13,3 ème
MEUSE,MONTMEDY,0550016U,66,66,0,0,33,33,3 ème
MEUSE,SAINT-MIHIEL,0550804A,100,95,0,5,59,41,3 ème
MEUSE,STENAY,0550072E,16,16,0,0,6,10,3 ème
MEUSE,THIERVILLE-SUR-MEUSE,0550759B,112,109,0,3,64,48,3 ème
MEUSE,VERDUN,0550050F,71,71,0,0,37,34,3 ème
MOSELLE,AUDUN-LE-TICHE,0572170Z,65,65,0,0,32,33,3 ème
MOSELLE,BITCHE,0573326F,16,16,0,0,6,10,3 ème
MOSELLE,DIEUZE,0570021N,22,22,0,0,12,10,3 ème
MOSELLE,FAMECK,0572075W,23,23,0,0,7,16,3 ème
MOSELLE,FAULQUEMONT,0572176F,86,63,17,6,43,43,3 ème
MOSELLE,FORBACH,0570030Y,23,23,0,0,6,17,3 ème
MOSELLE,FORBACH,0572922S,190,190,0,0,100,90,3 ème
MOSELLE,FREYMING-MERLEBACH,0570326V,126,105,9,12,68,58,3 ème
MOSELLE,GUENANGE,0573244S,160,137,17,6,81,79,3 ème
MOSELLE,HAGONDANGE,0572172B,135,135,0,0,62,73,3 ème
MOSELLE,METZ,0570069R,121,117,0,4,58,63,3 ème
MOSELLE,METZ,0572088K,107,82,15,10,54,53,3 ème
MOSELLE,METZ,0572166V,185,163,16,6,98,87,3 ème
MOSELLE,METZ,0572352X,104,104,0,0,53,51,3 ème
MOSELLE,MOULINS-LES-METZ,0572186S,77,75,0,2,43,34,3 ème
MOSELLE,OTTANGE,0572101Z,19,19,0,0,7,12,3 ème
MOSELLE,ROMBAS,0572585A,110,103,0,7,63,47,3 ème
MOSELLE,SARREGUEMINES,0572184P,129,124,0,5,67,62,3 ème
MOSELLE,SARREGUEMINES,0572587C,144,126,14,4,59,85,3 ème
MOSELLE,THIONVILLE,0570108H,62,62,0,0,17,45,3 ème
MOSELLE,THIONVILLE,0572951Y,14,14,0,0,7,7,3 ème
MOSELLE,VITRY-SUR-ORNE,0572019K,130,130,0,0,61,69,3 ème
VOSGES,CAPAVENIR VOSGES,0880064S,21,21,0,0,14,7,3 ème
VOSGES,CONTREXEVILLE,0881102V,84,75,5,4,41,43,3 ème
VOSGES,DOMPAIRE,0880017R,85,85,0,0,44,41,3 ème
VOSGES,GERARDMER,0880031F,19,19,0,0,7,12,3 ème
VOSGES,LA VOGE-LES-BAINS,0880002Z,30,30,0,0,18,12,3 ème
VOSGES,LE VAL-D'AJOL,0880068W,58,58,0,0,36,22,3 ème
VOSGES,REMIREMONT,0880154P,101,81,16,4,39,62,3 ème
VOSGES,SAINT-DIE-DES-VOSGES,0880152M,23,23,0,0,3,20,3 ème
ARDENNES,ASFELD,0081102E,112,112,0,0,49,63,3 ème
ARDENNES,BOGNY-SUR-MEUSE,0080105W,48,46,0,2,23,25,3 ème
ARDENNES,CHARLEVILLE-MEZIERES,0080084Y,168,168,0,0,81,87,3 ème
ARDENNES,GRANDPRE,0081096Y,31,31,0,0,15,16,3 ème
ARDENNES,RIMOGNE,0080042C,85,72,13,0,56,29,3 ème
ARDENNES,SAULT-LES-RETHEL,0080909V,85,75,8,2,38,47,3 ème
ARDENNES,SEDAN,0080910W,84,80,0,4,51,33,3 ème
AUBE,AIX-VILLEMAUR-PALIS,0100806X,120,120,0,0,66,54,3 ème
AUBE,BAR-SUR-SEINE,0100004A,22,22,0,0,8,14,3 ème
AUBE,BAR-SUR-SEINE,0100745F,40,40,0,0,22,18,3 ème
AUBE,LA CHAPELLE-SAINT-LUC,0100009F,144,144,0,0,62,82,3 ème
AUBE,MARIGNY-LE-CHATEL,0100011H,82,82,0,0,43,39,3 ème
AUBE,MERY-SUR-SEINE,0100785Z,108,108,0,0,56,52,3 ème
AUBE,SAINT-ANDRE-LES-VERGERS,0100019S,143,132,9,2,57,86,3 ème
AUBE,TROYES,0100031E,162,157,0,5,87,75,3 ème
AUBE,TROYES,0100057H,97,92,5,0,45,52,3 ème
AUBE,TROYES,0100058J,60,57,0,3,30,30,3 ème
AUBE,TROYES,0100947A,148,143,0,5,67,81,3 ème
AUBE,TROYES,0101015Z,46,46,0,0,19,27,3 ème
HAUTE-MARNE,CHAUMONT,0520008B,24,24,0,0,3,21,3 ème
HAUTE-MARNE,CHAUMONT,0520039K,106,87,19,0,55,51,3 ème
HAUTE-MARNE,CHEVILLON,0520842H,80,80,0,0,44,36,3 ème
HAUTE-MARNE,JOINVILLE,0520822L,90,86,0,4,46,44,3 ème
HAUTE-MARNE,SAINT-DIZIER,0520050X,116,116,0,0,60,56,3 ème
HAUTE-MARNE,SAINT-DIZIER,0520051Y,81,78,0,3,43,38,3 ème
MARNE,BAZANCOURT,0511326P,131,125,6,0,78,53,3 ème
MARNE,CHALONS-EN-CHAMPAGNE,0510011K,137,133,0,4,67,70,3 ème
MARNE,CHALONS-EN-CHAMPAGNE,0511083A,110,107,0,3,55,55,3 ème
MARNE,CHALONS-EN-CHAMPAGNE,0511951U,24,24,0,0,10,14,3 ème
MARNE,DORMANS,0511258R,96,89,4,3,44,52,3 ème
MARNE,ESTERNAY,0511567B,47,47,0,0,24,23,3 ème
MARNE,MONTMIRAIL,0510026B,79,75,0,4,43,36,3 ème
MARNE,MONTMORT-LUCY,0510027C,41,41,0,0,22,19,3 ème
MARNE,REIMS,0510036M,46,46,0,0,16,30,3 ème
MARNE,REIMS,0511084B,137,135,0,2,64,73,3 ème
MARNE,REIMS,0511153B,16,16,0,0,3,13,3 ème
MARNE,REIMS,0511251H,115,99,16,0,59,56,3 ème
MARNE,REIMS,0511254L,166,162,0,4,71,95,3 ème
MARNE,RILLY-LA-MONTAGNE,0510048A,76,76,0,0,32,44,3 ème
MARNE,VITRY-LE-FRANCOIS,0510062R,24,24,0,0,10,14,3 ème
BAS-RHIN,BISCHHEIM,0670004R,197,181,14,2,96,101,3 ème
BAS-RHIN,BISCHWILLER,0670006T,24,24,0,0,7,17,3 ème
BAS-RHIN,ESCHAU,0671687V,177,174,0,3,90,87,3 ème
BAS-RHIN,GEISPOLSHEIM,0671824U,149,146,0,3,66,83,3 ème
BAS-RHIN,HAGUENAU,0671603D,150,150,0,0,74,76,3 ème
BAS-RHIN,HAGUENAU,0671734W,154,135,13,6,80,74,3 ème
BAS-RHIN,HOCHFELDEN,0671961T,174,172,0,2,96,78,3 ème
BAS-RHIN,ILLKIRCH-GRAFFENSTADEN,0671455T,22,0,22,0,7,15,3 ème
BAS-RHIN,ILLKIRCH-GRAFFENSTADEN,0671956M,96,94,0,2,50,46,3 ème
BAS-RHIN,ILLKIRCH-GRAFFENSTADEN,0672198A,24,24,0,0,3,21,3 ème
BAS-RHIN,LA BROQUE,0671697F,111,96,13,2,56,55,3 ème
BAS-RHIN,MARLENHEIM,0671989Y,133,133,0,0,83,50,3 ème
BAS-RHIN,MOLSHEIM,0670043H,24,24,0,0,15,9,3 ème
BAS-RHIN,MOLSHEIM,0672615D,24,24,0,0,3,21,3 ème
BAS-RHIN,RHINAU,0671963V,52,52,0,0,28,24,3 ème
BAS-RHIN,SOUFFLENHEIM,0670076U,127,123,0,4,53,74,3 ème
BAS-RHIN,SOULTZ-SOUS-FORETS,0671827X,149,146,0,3,82,67,3 ème
BAS-RHIN,STRASBOURG,0670133F,180,174,0,6,102,78,3 ème
BAS-RHIN,STRASBOURG,0671593T,183,176,0,7,98,85,3 ème
BAS-RHIN,STRASBOURG,0671607H,176,171,0,5,75,101,3 ème
BAS-RHIN,STRASBOURG,0671742E,208,184,18,6,88,120,3 ème
BAS-RHIN,STRASBOURG,0672899M,96,96,0,0,49,47,3 ème
BAS-RHIN,WALBOURG,0672302N,110,110,0,0,33,77,3 ème
BAS-RHIN,WASSELONNE,0671740C,120,117,0,3,62,58,3 ème
BAS-RHIN,WINGEN-SUR-MODER,0671739B,47,47,0,0,19,28,3 ème
HAUT-RHIN,BLOTZHEIM,0680131Y,122,122,0,0,56,66,3 ème
HAUT-RHIN,BRUNSTATT-DIDENHEIM,0681957H,117,112,0,5,61,56,3 ème
HAUT-RHIN,COLMAR,0680133A,131,131,0,0,79,52,3 ème
HAUT-RHIN,HIRSINGUE,0680019B,102,99,0,3,51,51,3 ème
HAUT-RHIN,ILLZACH,0680021D,149,145,0,4,69,80,3 ème
HAUT-RHIN,ISSENHEIM,0680144M,206,206,0,0,96,110,3 ème
HAUT-RHIN,LUTTERBACH,0681370V,188,170,15,3,84,104,3 ème
HAUT-RHIN,MULHOUSE,0680110A,160,136,16,8,77,83,3 ème
HAUT-RHIN,MULHOUSE,0681395X,188,154,34,0,102,86,3 ème
HAUT-RHIN,ORBEY,0681448E,91,91,0,0,38,53,3 ème
HAUT-RHIN,SAINT-LOUIS,0681747E,139,136,0,3,73,66,3 ème
HAUT-RHIN,SEPPOIS-LE-BAS,0680071H,65,65,0,0,35,30,3 ème
HAUT-RHIN,THANN,0680074L,22,22,0,0,6,16,3 ème
HAUT-RHIN,THANN,0681541F,78,75,0,3,43,35,3 ème
HAUT-RHIN,WITTELSHEIM,0680079S,89,86,0,3,50,39,3 ème
HAUT-RHIN,WITTENHEIM,0681126E,129,99,26,4,61,68,3 ème
HAUT-RHIN,WITTENHEIM,0681930D,125,125,0,0,67,58,3 ème
GUADELOUPE,GOURBEYRE,9710034K,50,49,0,1,28,22,3 ème
GUADELOUPE,GOURBEYRE,9710067W,11,11,0,0,0,11,3 ème
GUADELOUPE,GRAND-BOURG,9710926E,71,71,0,0,43,28,3 ème
GUADELOUPE,LE GOSIER,9711066G,12,12,0,0,8,4,3 ème
GUADELOUPE,LE MOULE,9710052E,14,14,0,0,8,6,3 ème
GUADELOUPE,LES ABYMES,9711205H,56,56,0,0,21,35,3 ème
GUADELOUPE,POINTE-A-PITRE,9710072B,52,50,0,2,22,30,3 ème
GUADELOUPE,SAINTE-ANNE,9710021W,207,187,18,2,85,122,3 ème
GUADELOUPE,SAINT-FRANCOIS,9710030F,121,117,0,4,58,63,3 ème
GUADELOUPE,SAINT-MARTIN,9710981P,32,32,0,0,13,19,3 ème
GUADELOUPE,SAINT-MARTIN,9711023K,132,125,0,7,63,69,3 ème
GUYANE,KOUROU,9730125Y,224,194,29,1,123,101,3 ème
GUYANE,KOUROU,9730237V,144,136,0,8,67,77,3 ème
GUYANE,MANA,9730192W,151,131,14,6,72,79,3 ème
GUYANE,REMIRE-MONTJOLY,9730334A,108,108,0,0,55,53,3 ème
GUYANE,SAINT-LAURENT-DU-MARONI,9730394R,223,212,0,11,112,111,3 ème
AISNE,BEAUREVOIR,0020004U,66,66,0,0,35,31,3 ème
AISNE,BRAINE,0020009Z,124,119,0,5,58,66,3 ème
AISNE,CHATEAU-THIERRY,0020468Y,51,49,0,2,25,26,3 ème
AISNE,CHATEAU-THIERRY,0021826Z,205,177,23,5,96,109,3 ème
AISNE,CHAUNY,0021493M,146,135,8,3,87,59,3 ème
AISNE,CUFFIES,0021491K,98,96,0,2,44,54,3 ème
AISNE,FERE-EN-TARDENOIS,0020024R,119,109,5,5,47,72,3 ème
AISNE,GUISE,0020483P,24,24,0,0,16,8,3 ème
AISNE,LA CAPELLE,0020479K,17,17,0,0,14,3,3 ème
AISNE,LAON,0020078Z,24,24,0,0,14,10,3 ème
AISNE,MOY-DE-L'AISNE,0020037E,77,77,0,0,38,39,3 ème
AISNE,NEUILLY-SAINT-FRONT,0020038F,95,95,0,0,42,53,3 ème
AISNE,SAINT-QUENTIN,0020080B,142,136,0,6,73,69,3 ème
AISNE,SAINT-QUENTIN,0021478W,16,0,16,0,3,13,3 ème
AISNE,VILLENEUVE-SAINT-GERMAIN,0021490J,98,75,23,0,44,54,3 ème
OISE,BEAUVAIS,0601140N,189,189,0,0,100,89,3 ème
OISE,BEAUVAIS,0601188R,176,156,15,5,87,89,3 ème
OISE,BEAUVAIS,0601487R,135,116,14,5,66,69,3 ème
OISE,BETZ,0601447X,107,107,0,0,61,46,3 ème
OISE,CHANTILLY,0601606V,150,148,0,2,73,77,3 ème
OISE,CLERMONT,0601471Y,166,161,0,5,91,75,3 ème
OISE,CREIL,0601449Z,141,125,10,6,63,78,3 ème
OISE,CREPY-EN-VALOIS,0601363F,17,17,0,0,8,9,3 ème
OISE,CREVECOEUR-LE-GRAND,0600070A,15,0,15,0,4,11,3 ème
OISE,CUISE-LA-MOTTE,0601146V,25,22,0,3,15,10,3 ème
OISE,GOUVIEUX,0601192V,114,99,11,4,54,60,3 ème
OISE,MERU,0601191U,149,131,15,3,80,69,3 ème
OISE,MONTATAIRE,0601178E,188,166,15,7,80,108,3 ème
OISE,MORTEFONTAINE,0601145U,229,228,0,1,102,127,3 ème
OISE,NANTEUIL-LE-HAUDOUIN,0601408E,177,175,0,2,87,90,3 ème
OISE,NOGENT-SUR-OISE,0600062S,13,13,0,0,0,13,3 ème
OISE,NOYON,0601297J,156,121,29,6,79,77,3 ème
OISE,RIBECOURT-DRESLINCOURT,0600046Z,107,103,0,4,56,51,3 ème
OISE,SAINT-MAXIMIN,0600048B,14,14,0,0,2,12,3 ème
OISE,VILLERS-SAINT-PAUL,0601821D,119,115,0,4,63,56,3 ème
SOMME,ABBEVILLE,0800002T,180,167,13,0,87,93,3 ème
SOMME,AILLY-SUR-NOYE,0800004V,120,117,0,3,63,57,3 ème
SOMME,AMIENS,0801212H,133,133,0,0,49,84,3 ème
SOMME,AMIENS,0801220S,115,115,0,0,60,55,3 ème
SOMME,AMIENS,0802214X,17,17,0,0,11,6,3 ème
SOMME,CORBIE,0801511H,66,63,0,3,33,33,3 ème
SOMME,DOULLENS,0800029X,155,134,15,6,72,83,3 ème
SOMME,DOULLENS,0801900F,16,16,0,0,4,12,3 ème
SOMME,FRIVILLE-ESCARBOTIN,0800033B,100,92,0,8,45,55,3 ème
SOMME,GAMACHES,0800034C,137,123,10,4,71,66,3 ème
SOMME,HAM,0801224W,67,67,0,0,32,35,3 ème
SOMME,MERS-LES-BAINS,0800039H,44,44,0,0,25,19,3 ème
SOMME,NESLE,0801369D,67,67,0,0,41,26,3 ème
SOMME,NOUVION,0801488H,55,55,0,0,26,29,3 ème
SOMME,POIX-DE-PICARDIE,0801326G,85,82,0,3,41,44,3 ème
SOMME,ROISEL,0800050V,59,59,0,0,32,27,3 ème
SOMME,ROYE,0801341Y,124,102,17,5,65,59,3 ème
NORD,ANNOEULLIN,0593234V,175,175,0,0,80,95,3 ème
NORD,ARMENTIERES,0593060F,72,72,0,0,12,60,3 ème
NORD,ARMENTIERES,0595382E,202,202,0,0,99,103,3 ème
NORD,AULNOYE-AYMERIES,0590015W,23,23,0,0,7,16,3 ème
NORD,BONDUES,0595385H,224,224,0,0,121,103,3 ème
NORD,BOURBOURG,0592955S,158,158,0,0,79,79,3 ème
NORD,CONDE-SUR-L'ESCAUT,0590050J,127,113,12,2,70,57,3 ème
NORD,CONDE-SUR-L'ESCAUT,0596854E,24,24,0,0,13,11,3 ème
NORD,COUDEKERQUE-BRANCHE,0593182N,55,55,0,0,36,19,3 ème
NORD,COUDEKERQUE-BRANCHE,0593494C,111,93,14,4,48,63,3 ème
NORD,DENAIN,0590264S,25,25,0,0,8,17,3 ème
NORD,DOUAI,0595171A,172,168,0,4,82,90,3 ème
NORD,DOUAI,0595894L,24,24,0,0,12,12,3 ème
NORD,DUNKERQUE,0590200X,107,107,0,0,41,66,3 ème
NORD,DUNKERQUE,0593143W,94,91,0,3,44,50,3 ème
NORD,DUNKERQUE,0596716E,83,81,0,2,41,42,3 ème
NORD,ESTAIRES,0595757M,128,128,0,0,63,65,3 ème
NORD,FOURMIES,0594879H,70,70,0,0,40,30,3 ème
NORD,FOURMIES,0595390N,37,37,0,0,16,21,3 ème
NORD,GRANDE-SYNTHE,0594398K,116,96,17,3,58,58,3 ème
NORD,GRANDE-SYNTHE,0595388L,51,51,0,0,26,25,3 ème
NORD,GRAND-FORT-PHILIPPE,0595712N,38,38,0,0,17,21,3 ème
NORD,HAUTMONT,0592634T,141,141,0,0,69,72,3 ème
NORD,HAUTMONT,0594309N,130,113,15,2,65,65,3 ème
NORD,HAZEBROUCK,0595391P,115,111,0,4,62,53,3 ème
NORD,LA MADELEINE,0592896C,135,135,0,0,70,65,3 ème
NORD,LAMBRES-LEZ-DOUAI,0594298B,115,112,0,3,56,59,3 ème
NORD,LANDRECIES,0595178H,128,117,11,0,72,56,3 ème
NORD,LE CATEAU-CAMBRESIS,0595337F,172,157,13,2,87,85,3 ème
NORD,LE QUESNOY,0595172B,242,233,9,0,105,137,3 ème
NORD,LESQUIN,0593991T,127,127,0,0,58,69,3 ème
NORD,LILLE,0593131H,99,99,0,0,57,42,3 ème
NORD,LILLE,0593179K,111,111,0,0,62,49,3 ème
NORD,LILLE,0593235W,96,81,15,0,36,60,3 ème
NORD,LOON-PLAGE,0595596M,88,84,0,4,46,42,3 ème
NORD,MERVILLE,0592899F,151,149,0,2,83,68,3 ème
NORD,MONS-EN-BAROEUL,0590155Y,102,100,0,2,41,61,3 ème
NORD,ORCHIES,0592900G,118,115,0,3,59,59,3 ème
NORD,ORCHIES,0593040J,35,35,0,0,13,22,3 ème
NORD,PECQUENCOURT,0596529B,114,112,0,2,60,54,3 ème
NORD,PONT-A-MARCQ,0594866U,125,125,0,0,54,71,3 ème
NORD,ROUBAIX,0590190L,111,111,0,0,59,52,3 ème
NORD,ROUBAIX,0592917A,158,158,0,0,88,70,3 ème
NORD,SAINT-ANDRE-LEZ-LILLE,0592832H,24,24,0,0,6,18,3 ème
NORD,SAINT-ANDRE-LEZ-LILLE,0593228N,109,108,0,1,50,59,3 ème
NORD,SAINT-SAULVE,0594644C,103,99,0,4,44,59,3 ème
NORD,SAINT-SAULVE,0595402B,197,195,0,2,100,97,3 ème
NORD,SEBOURG,0593144X,75,75,0,0,37,38,3 ème
NORD,SOLRE-LE-CHATEAU,0590206D,68,68,0,0,34,34,3 ème
NORD,THIANT,0594645D,142,132,10,0,67,75,3 ème
NORD,TOURCOING,0593217B,285,271,14,0,142,143,3 ème
NORD,VALENCIENNES,0593154H,105,105,0,0,55,50,3 ème
NORD,VALENCIENNES,0593680E,84,67,17,0,43,41,3 ème
NORD,VILLENEUVE-D'ASCQ,0593196D,170,155,13,2,76,94,3 ème
NORD,VILLENEUVE-D'ASCQ,0593198F,92,92,0,0,36,56,3 ème
NORD,VILLENEUVE-D'ASCQ,0594291U,135,135,0,0,63,72,3 ème
NORD,VILLENEUVE-D'ASCQ,0594525Y,92,88,0,4,40,52,3 ème
NORD,WAZIERS,0590238N,75,75,0,0,40,35,3 ème
NORD,WAZIERS,0593495D,24,24,0,0,6,18,3 ème
PAS-DE-CALAIS,ANGRES,0622579S,140,140,0,0,68,72,3 ème
PAS-DE-CALAIS,ANZIN-SAINT-AUBIN,0622125Y,253,253,0,0,130,123,3 ème
PAS-DE-CALAIS,ARRAS,0622196A,42,39,0,3,19,23,3 ème
PAS-DE-CALAIS,BERTINCOURT,0620039F,82,82,0,0,40,42,3 ème
PAS-DE-CALAIS,CALAIS,0620189U,24,24,0,0,9,15,3 ème
PAS-DE-CALAIS,CALAIS,0622109F,114,114,0,0,58,56,3 ème
PAS-DE-CALAIS,CALAIS,0622431F,64,62,0,2,26,38,3 ème
PAS-DE-CALAIS,CALAIS,0622432G,100,100,0,0,57,43,3 ème
PAS-DE-CALAIS,CALAIS,0622576N,106,88,17,1,55,51,3 ème
PAS-DE-CALAIS,CALAIS,0623315S,133,131,0,2,68,65,3 ème
PAS-DE-CALAIS,CARVIN,0623919Y,119,116,0,3,67,52,3 ème
PAS-DE-CALAIS,DESVRES,0623023Z,128,111,13,4,67,61,3 ème
PAS-DE-CALAIS,DOUVRIN,0622867E,154,154,0,0,73,81,3 ème
PAS-DE-CALAIS,FOUQUIERES-LES-LENS,0622098U,99,99,0,0,55,44,3 ème
PAS-DE-CALAIS,FRUGES,0622112J,26,26,0,0,11,15,3 ème
PAS-DE-CALAIS,FRUGES,0622195Z,11,11,0,0,4,7,3 ème
PAS-DE-CALAIS,HENIN-BEAUMONT,0620096T,118,102,16,0,52,66,3 ème
PAS-DE-CALAIS,HESDIN,0622139N,41,41,0,0,17,24,3 ème
PAS-DE-CALAIS,HUCQUELIERS,0620104B,101,98,0,3,49,52,3 ème
PAS-DE-CALAIS,LAVENTIE,0622140P,62,62,0,0,30,32,3 ème
PAS-DE-CALAIS,LENS,0622868F,134,119,11,4,61,73,3 ème
PAS-DE-CALAIS,LE TOUQUET-PARIS-PLAGE,0622806N,93,93,0,0,40,53,3 ème
PAS-DE-CALAIS,LIBERCOURT,0622239X,79,79,0,0,34,45,3 ème
PAS-DE-CALAIS,LICQUES,0620194Z,87,87,0,0,38,49,3 ème
PAS-DE-CALAIS,LIEVIN,0622302R,15,0,15,0,3,12,3 ème
PAS-DE-CALAIS,LILLERS,0620121V,24,24,0,0,9,15,3 ème
PAS-DE-CALAIS,LILLERS,0623312N,109,106,0,3,43,66,3 ème
PAS-DE-CALAIS,LONGUENESSE,0623572W,125,125,0,0,52,73,3 ème
PAS-DE-CALAIS,LOOS-EN-GOHELLE,0620123X,87,87,0,0,51,36,3 ème
PAS-DE-CALAIS,LUMBRES,0620124Y,23,23,0,0,5,18,3 ème
PAS-DE-CALAIS,LUMBRES,0622142S,67,67,0,0,33,34,3 ème
PAS-DE-CALAIS,MARQUISE,0622096S,210,200,10,0,108,102,3 ème
PAS-DE-CALAIS,MONTREUIL,0622117P,94,94,0,0,46,48,3 ème
PAS-DE-CALAIS,MONTREUIL,0622951W,165,145,18,2,80,85,3 ème
PAS-DE-CALAIS,PERNES,0620156H,87,87,0,0,45,42,3 ème
PAS-DE-CALAIS,SANGATTE,0623865P,138,138,0,0,77,61,3 ème
PAS-DE-CALAIS,WINGLES,0620258U,24,24,0,0,9,15,3 ème
PAS-DE-CALAIS,WIZERNES,0622874M,128,108,17,3,64,64,3 ème
SEINE-ET-MARNE,BOIS-LE-ROI,0770002J,136,136,0,0,54,82,3 ème
SEINE-ET-MARNE,CHAMPS-SUR-MARNE,0771511Z,137,137,0,0,67,70,3 ème
SEINE-ET-MARNE,CHELLES,0771171E,30,30,0,0,8,22,3 ème
SEINE-ET-MARNE,CHELLES,0771926A,160,160,0,0,78,82,3 ème
SEINE-ET-MARNE,CHESSY,0772651N,140,136,0,4,51,89,3 ème
SEINE-ET-MARNE,ESBLY,0771361L,210,189,16,5,83,127,3 ème
SEINE-ET-MARNE,LAGNY-SUR-MARNE,0771918S,307,307,0,0,170,137,3 ème
SEINE-ET-MARNE,LE CHATELET-EN-BRIE,0771068T,135,124,0,11,56,79,3 ème
SEINE-ET-MARNE,MAGNY-LE-HONGRE,0772713F,161,161,0,0,86,75,3 ème
SEINE-ET-MARNE,MEAUX,0771420A,152,135,16,1,80,72,3 ème
SEINE-ET-MARNE,MELUN,0771070V,92,92,0,0,51,41,3 ème
SEINE-ET-MARNE,MELUN,0771220H,90,90,0,0,44,46,3 ème
SEINE-ET-MARNE,MELUN,0771923X,186,183,0,3,111,75,3 ème
SEINE-ET-MARNE,MOISSY-CRAMAYEL,0772191N,135,135,0,0,67,68,3 ème
SEINE-ET-MARNE,MORET-LOING-ET-ORVANNE,0770038Y,164,161,0,3,80,84,3 ème
SEINE-ET-MARNE,NANGIS,0770040A,180,177,0,3,90,90,3 ème
SEINE-ET-MARNE,OTHIS,0771562E,195,195,0,0,97,98,3 ème
SEINE-ET-MARNE,OZOIR-LA-FERRIERE,0771334G,162,162,0,0,97,65,3 ème
SEINE-ET-MARNE,OZOIR-LA-FERRIERE,0772293Z,102,99,0,3,47,55,3 ème
SEINE-ET-MARNE,PROVINS,0771176K,124,104,20,0,55,69,3 ème
SEINE-ET-MARNE,SAINT-FARGEAU-PONTHIERRY,0771517F,216,216,0,0,106,110,3 ème
SEINE-ET-MARNE,SAINT-SOUPPLETS,0772483F,102,96,0,6,46,56,3 ème
SEINE-ET-MARNE,SAVIGNY-LE-TEMPLE,0772274D,161,157,0,4,73,88,3 ème
SEINE-ET-MARNE,SERRIS,0772589W,138,137,0,1,67,71,3 ème
SEINE-ET-MARNE,VAIRES-SUR-MARNE,0771177L,192,192,0,0,86,106,3 ème
SEINE-ET-MARNE,VAUX-LE-PENIL,0771178M,173,169,0,4,86,87,3 ème
SEINE-ET-MARNE,VERNEUIL-L'ETANG,0771619S,137,134,0,3,58,79,3 ème
SEINE-ET-MARNE,VOISENON,0771930E,197,197,0,0,100,97,3 ème
SEINE-ET-MARNE,VULAINES-SUR-SEINE,0772867Y,108,108,0,0,63,45,3 ème
SEINE-SAINT-DENIS,AUBERVILLIERS,0930902A,109,109,0,0,65,44,3 ème
SEINE-SAINT-DENIS,AULNAY-SOUS-BOIS,0931379U,177,161,16,0,69,108,3 ème
SEINE-SAINT-DENIS,AULNAY-SOUS-BOIS,0932310F,167,167,0,0,80,87,3 ème
SEINE-SAINT-DENIS,BAGNOLET,0931022F,117,117,0,0,62,55,3 ème
SEINE-SAINT-DENIS,BOBIGNY,0930900Y,161,161,0,0,76,85,3 ème
SEINE-SAINT-DENIS,BOBIGNY,0931194T,204,178,22,4,106,98,3 ème
SEINE-SAINT-DENIS,BONDY,0931711E,126,126,0,0,70,56,3 ème
SEINE-SAINT-DENIS,BONDY,0931860S,162,161,0,1,84,78,3 ème
SEINE-SAINT-DENIS,CLICHY-SOUS-BOIS,0930616P,169,164,0,5,84,85,3 ème
SEINE-SAINT-DENIS,CLICHY-SOUS-BOIS,0932366S,157,157,0,0,71,86,3 ème
SEINE-SAINT-DENIS,DRANCY,0931199Y,168,162,0,6,85,83,3 ème
SEINE-SAINT-DENIS,GAGNY,0931233K,22,22,0,0,9,13,3 ème
SEINE-SAINT-DENIS,GAGNY,0931855L,38,38,0,0,0,38,3 ème
SEINE-SAINT-DENIS,GAGNY,0932311G,147,128,16,3,72,75,3 ème
SEINE-SAINT-DENIS,LA COURNEUVE,0930128J,31,31,0,0,4,27,3 ème
SEINE-SAINT-DENIS,LE BLANC-MESNIL,0932580Z,142,140,0,2,72,70,3 ème
SEINE-SAINT-DENIS,LE PRE-SAINT-GERVAIS,0930917S,87,87,0,0,43,44,3 ème
SEINE-SAINT-DENIS,LE RAINCY,0930970Z,12,12,0,0,3,9,3 ème
SEINE-SAINT-DENIS,LE RAINCY,0932772H,0,0,0,0,0,0,3 ème
SEINE-SAINT-DENIS,LES LILAS,0931439J,170,170,0,0,73,97,3 ème
SEINE-SAINT-DENIS,MONTFERMEIL,0931546A,183,179,0,4,88,95,3 ème
SEINE-SAINT-DENIS,MONTREUIL,0931211L,85,85,0,0,39,46,3 ème
SEINE-SAINT-DENIS,MONTREUIL,0931212M,109,89,14,6,45,64,3 ème
SEINE-SAINT-DENIS,MONTREUIL,0931845A,126,126,0,0,70,56,3 ème
SEINE-SAINT-DENIS,NEUILLY-SUR-MARNE,0931228E,109,107,0,2,56,53,3 ème
SEINE-SAINT-DENIS,NOISY-LE-GRAND,0930883E,200,197,0,3,95,105,3 ème
SEINE-SAINT-DENIS,NOISY-LE-GRAND,0931614Z,197,181,16,0,86,111,3 ème
SEINE-SAINT-DENIS,NOISY-LE-SEC,0931610V,189,171,15,3,89,100,3 ème
SEINE-SAINT-DENIS,PANTIN,0931713G,206,192,14,0,99,107,3 ème
SEINE-SAINT-DENIS,PIERREFITTE-SUR-SEINE,0931223Z,196,180,12,4,112,84,3 ème
SEINE-SAINT-DENIS,SAINT-DENIS,0930959M,228,228,0,0,114,114,3 ème
SEINE-SAINT-DENIS,SAINT-DENIS,0931231H,135,135,0,0,61,74,3 ème
SEINE-SAINT-DENIS,SAINT-DENIS,0932273R,137,133,0,4,64,73,3 ème
SEINE-SAINT-DENIS,SAINT-DENIS,0932586F,59,59,0,0,25,34,3 ème
SEINE-SAINT-DENIS,SAINT-DENIS,0932773J,0,0,0,0,0,0,3 ème
SEINE-SAINT-DENIS,SEVRAN,0931979W,192,189,0,3,79,113,3 ème
SEINE-SAINT-DENIS,STAINS,0931225B,156,151,0,5,81,75,3 ème
SEINE-SAINT-DENIS,VILLEPINTE,0931607S,163,144,15,4,76,87,3 ème
VAL-DE-MARNE,ALFORTVILLE,0940126B,12,12,0,0,2,10,3 ème
VAL-DE-MARNE,BOISSY-SAINT-LEGER,0940892J,54,54,0,0,18,36,3 ème
VAL-DE-MARNE,BONNEUIL-SUR-MARNE,0941095E,158,140,16,2,73,85,3 ème
VAL-DE-MARNE,CHAMPIGNY-SUR-MARNE,0941092B,97,97,0,0,55,42,3 ème
VAL-DE-MARNE,CHAMPIGNY-SUR-MARNE,0941299B,218,203,15,0,99,119,3 ème
VAL-DE-MARNE,CHAMPIGNY-SUR-MARNE,0941431V,158,158,0,0,89,69,3 ème
VAL-DE-MARNE,CHARENTON-LE-PONT,0940808T,167,167,0,0,84,83,3 ème
VAL-DE-MARNE,CHENNEVIERES-SUR-MARNE,0940787V,97,93,0,4,56,41,3 ème
VAL-DE-MARNE,CHOISY-LE-ROI,0941229A,199,183,16,0,92,107,3 ème
VAL-DE-MARNE,CRETEIL,0940003T,84,84,0,0,48,36,3 ème
VAL-DE-MARNE,CRETEIL,0941018W,24,24,0,0,7,17,3 ème
VAL-DE-MARNE,CRETEIL,0941351H,126,115,0,11,61,65,3 ème
VAL-DE-MARNE,FONTENAY-SOUS-BOIS,0940516A,201,201,0,0,105,96,3 ème
VAL-DE-MARNE,FONTENAY-SOUS-BOIS,0941296Y,136,123,13,0,68,68,3 ème
VAL-DE-MARNE,GENTILLY,0941099J,120,120,0,0,61,59,3 ème
VAL-DE-MARNE,LE KREMLIN-BICETRE,0940022N,104,104,0,0,43,61,3 ème
VAL-DE-MARNE,LE PERREUX-SUR-MARNE,0940789X,174,174,0,0,101,73,3 ème
VAL-DE-MARNE,MAISONS-ALFORT,0941046B,174,174,0,0,101,73,3 ème
VAL-DE-MARNE,ORLY,0941044Z,131,131,0,0,49,82,3 ème
VAL-DE-MARNE,SAINT-MANDE,0940790Y,137,134,0,3,77,60,3 ème
VAL-DE-MARNE,SAINT-MANDE,0941715D,135,134,0,1,78,57,3 ème
VAL-DE-MARNE,SAINT-MAUR-DES-FOSSES,0940585A,23,23,0,0,7,16,3 ème
VAL-DE-MARNE,SAINT-MAUR-DES-FOSSES,0940811W,90,90,0,0,50,40,3 ème
VAL-DE-MARNE,SAINT-MAURICE,0941597A,107,107,0,0,57,50,3 ème
VAL-DE-MARNE,SUCY-EN-BRIE,0940748C,171,167,0,4,81,90,3 ème
VAL-DE-MARNE,VILLECRESNES,0941412Z,153,153,0,0,56,97,3 ème
VAL-DE-MARNE,VILLEJUIF,0941035P,118,102,16,0,59,59,3 ème
VAL-DE-MARNE,VILLENEUVE-LE-ROI,0941103N,114,114,0,0,52,62,3 ème
VAL-DE-MARNE,VILLENEUVE-LE-ROI,0941234F,114,114,0,0,64,50,3 ème
VAL-DE-MARNE,VILLIERS-SUR-MARNE,0940625U,110,103,0,7,45,65,3 ème
VAL-DE-MARNE,VINCENNES,0942188T,115,113,0,2,55,60,3 ème
VAL-DE-MARNE,VITRY-SUR-SEINE,0941034N,121,121,0,0,55,66,3 ème
VAL-DE-MARNE,VITRY-SUR-SEINE,0942434K,97,91,0,6,46,51,3 ème
PARIS,PARIS,0752251P,112,108,0,4,52,60,3 ème
PARIS,PARIS,0753047E,99,95,0,4,55,44,3 ème
PARIS,PARIS,0754506R,139,139,0,0,75,64,3 ème
PARIS,PARIS,0750676C,10,10,0,0,1,9,3 ème
PARIS,PARIS,0752895P,120,120,0,0,120,0,3 ème
PARIS,PARIS,0752954D,3,3,0,0,2,1,3 ème
PARIS,PARIS,0753978S,58,58,0,0,29,29,3 ème
PARIS,PARIS,0754528P,121,106,13,2,47,74,3 ème
PARIS,PARIS,0750444A,147,146,0,1,71,76,3 ème
PARIS,PARIS,0750610F,111,109,0,2,47,64,3 ème
PARIS,PARIS,0750783U,51,51,0,0,5,46,3 ème
PARIS,PARIS,0752538B,113,113,0,0,53,60,3 ème
PARIS,PARIS,0752540D,112,112,0,0,56,56,3 ème
PARIS,PARIS,0752896R,78,78,0,0,48,30,3 ème
PARIS,PARIS,0752957G,139,131,0,8,59,80,3 ème
PARIS,PARIS,0753937X,94,93,0,1,47,47,3 ème
PARIS,PARIS,0750611G,137,133,0,4,74,63,3 ème
PARIS,PARIS,0751705W,134,131,0,3,64,70,3 ème
PARIS,PARIS,0753908R,141,141,0,0,69,72,3 ème
PARIS,PARIS,0754253R,79,79,0,0,37,42,3 ème
PARIS,PARIS,0752843H,171,171,0,0,98,73,3 ème
PARIS,PARIS,0754305X,159,158,0,1,85,74,3 ème
PARIS,PARIS,0752548M,365,359,0,6,166,199,3 ème
PARIS,PARIS,0752549N,181,180,0,1,79,102,3 ème
PARIS,PARIS,0753996L,82,82,0,0,49,33,3 ème
PARIS,PARIS,0752107H,172,168,0,4,92,80,3 ème
PARIS,PARIS,0752387M,119,119,0,0,63,56,3 ème
PARIS,PARIS,0752552S,152,148,0,4,79,73,3 ème
PARIS,PARIS,0752821J,153,153,0,0,84,69,3 ème
PARIS,PARIS,0752898T,124,120,0,4,73,51,3 ème
PARIS,PARIS,0752958H,116,112,0,4,57,59,3 ème
PARIS,PARIS,0750182R,106,104,0,2,56,50,3 ème
PARIS,PARIS,0750800M,24,24,0,0,13,11,3 ème
PARIS,PARIS,0751793S,91,89,0,2,48,43,3 ème
PARIS,PARIS,0752108J,113,108,0,5,55,58,3 ème
PARIS,PARIS,0754706H,100,96,0,4,42,58,3 ème
PARIS,PARIS,0750360J,106,104,0,2,63,43,3 ème
PARIS,PARIS,0752555V,94,88,0,6,44,50,3 ème
PARIS,PARIS,0752606A,98,96,0,2,60,38,3 ème
PARIS,PARIS,0752556W,112,108,0,4,49,63,3 ème
PARIS,PARIS,0754006X,89,88,0,1,43,46,3 ème
PARIS,PARIS,0755241P,87,84,0,3,39,48,3 ème
PARIS,PARIS,0752248L,79,79,0,0,32,47,3 ème
PARIS,PARIS,0750387N,90,90,0,0,56,34,3 ème
PARIS,PARIS,0750651A,15,11,0,4,5,10,3 ème
PARIS,PARIS,0752902X,251,242,0,9,112,139,3 ème
PARIS,PARIS,0752526N,169,169,0,0,93,76,3 ème
PARIS,PARIS,0752900V,320,304,11,5,131,189,3 ème
PARIS,PARIS,0752924W,91,91,0,0,32,59,3 ème
PARIS,PARIS,0752249M,202,199,0,3,91,111,3 ème
PARIS,PARIS,0752530T,177,171,0,6,91,86,3 ème
ESSONNE,ATHIS-MONS,0911745C,307,294,11,2,148,159,3 ème
ESSONNE,BRUNOY,0910714G,84,84,0,0,37,47,3 ème
ESSONNE,CERNY,0910630R,24,23,0,1,7,17,3 ème
ESSONNE,CHAMPCUEIL,0912233H,182,179,0,3,83,99,3 ème
ESSONNE,CORBEIL-ESSONNES,0911443Z,203,184,15,4,102,101,3 ème
ESSONNE,ETAMPES,0911747E,123,123,0,0,70,53,3 ème
ESSONNE,EVRY-COURCOURONNES,0911254U,31,31,0,0,19,12,3 ème
ESSONNE,EVRY-COURCOURONNES,0912173T,124,119,0,5,64,60,3 ème
ESSONNE,LA NORVILLE,0911255V,145,127,15,3,63,82,3 ème
ESSONNE,LES ULIS,0911127F,156,141,15,0,83,73,3 ème
ESSONNE,LISSES,0911754M,118,114,0,4,44,74,3 ème
ESSONNE,MENNECY,0911185U,283,261,17,5,144,139,3 ème
ESSONNE,MONTGERON,0911353B,24,24,0,0,7,17,3 ème
ESSONNE,NOZAY,0912174U,122,118,0,4,62,60,3 ème
ESSONNE,OLLAINVILLE,0912175V,168,166,0,2,74,94,3 ème
ESSONNE,PALAISEAU,0910046F,107,103,0,4,48,59,3 ème
ESSONNE,PALAISEAU,0910820X,106,106,0,0,53,53,3 ème
ESSONNE,SAINTE-GENEVIEVE-DES-BOIS,0910678T,139,139,0,0,74,65,3 ème
ESSONNE,SAINT-MICHEL-SUR-ORGE,0911257X,197,177,17,3,84,113,3 ème
ESSONNE,SAINT-MICHEL-SUR-ORGE,0911946W,24,24,0,0,8,16,3 ème
ESSONNE,SAVIGNY-SUR-ORGE,0911038J,139,139,0,0,66,73,3 ème
ESSONNE,VILLEBON-SUR-YVETTE,0911335G,158,143,15,0,79,79,3 ème
ESSONNE,VILLEMOISSON-SUR-ORGE,0911145A,170,164,0,6,85,85,3 ème
ESSONNE,VIRY-CHATILLON,0910971L,177,158,15,4,89,88,3 ème
ESSONNE,VIRY-CHATILLON,0911752K,214,214,0,0,123,91,3 ème
ESSONNE,YERRES,0910062Y,200,200,0,0,104,96,3 ème
ESSONNE,YERRES,0912000E,48,42,0,6,45,3,3 ème
HAUTS-DE-SEINE,ANTONY,0921507N,140,140,0,0,71,69,3 ème
HAUTS-DE-SEINE,ASNIERES-SUR-SEINE,0921545E,183,172,9,2,94,89,3 ème
HAUTS-DE-SEINE,ASNIERES-SUR-SEINE,0921902T,204,204,0,0,93,111,3 ème
HAUTS-DE-SEINE,BAGNEUX,0920680P,24,24,0,0,6,18,3 ème
HAUTS-DE-SEINE,BOIS-COLOMBES,0921779J,160,159,0,1,78,82,3 ème
HAUTS-DE-SEINE,BOULOGNE-BILLANCOURT,0921237V,110,107,0,3,51,59,3 ème
HAUTS-DE-SEINE,CHATENAY-MALABRY,0921906X,207,207,0,0,112,95,3 ème
HAUTS-DE-SEINE,CLAMART,0920998K,83,83,0,0,40,43,3 ème
HAUTS-DE-SEINE,CLICHY,0921623P,155,152,0,3,72,83,3 ème
HAUTS-DE-SEINE,COLOMBES,0921229L,22,22,0,0,10,12,3 ème
HAUTS-DE-SEINE,COURBEVOIE,0921550K,120,118,0,2,58,62,3 ème
HAUTS-DE-SEINE,COURBEVOIE,0922020W,111,109,0,2,56,55,3 ème
HAUTS-DE-SEINE,COURBEVOIE,0922867S,17,17,0,0,13,4,3 ème
HAUTS-DE-SEINE,FONTENAY-AUX-ROSES,0920081N,158,157,0,1,83,75,3 ème
HAUTS-DE-SEINE,ISSY-LES-MOULINEAUX,0921003R,46,46,0,0,15,31,3 ème
HAUTS-DE-SEINE,ISSY-LES-MOULINEAUX,0922247T,165,165,0,0,85,80,3 ème
HAUTS-DE-SEINE,ISSY-LES-MOULINEAUX,0922653J,21,21,0,0,3,18,3 ème
HAUTS-DE-SEINE,LE PLESSIS-ROBINSON,0920883K,105,105,0,0,55,50,3 ème
HAUTS-DE-SEINE,MALAKOFF,0921241Z,167,165,0,2,91,76,3 ème
HAUTS-DE-SEINE,MEUDON,0921782M,170,168,0,2,89,81,3 ème
HAUTS-DE-SEINE,MONTROUGE,0921911C,94,94,0,0,44,50,3 ème
HAUTS-DE-SEINE,NANTERRE,0920594W,120,117,0,3,61,59,3 ème
HAUTS-DE-SEINE,NANTERRE,0921940J,90,88,0,2,42,48,3 ème
HAUTS-DE-SEINE,NANTERRE,0922464D,20,20,0,0,6,14,3 ème
HAUTS-DE-SEINE,NEUILLY-SUR-SEINE,0921498D,116,115,0,1,54,62,3 ème
HAUTS-DE-SEINE,PUTEAUX,0921233R,190,190,0,0,100,90,3 ème
HAUTS-DE-SEINE,RUEIL-MALMAISON,0920852B,74,72,0,2,33,41,3 ème
HAUTS-DE-SEINE,RUEIL-MALMAISON,0921235T,149,149,0,0,67,82,3 ème
HAUTS-DE-SEINE,SCEAUX,0921784P,146,145,0,1,73,73,3 ème
HAUTS-DE-SEINE,VILLE-D'AVRAY,0920886N,131,130,0,1,64,67,3 ème
HAUTS-DE-SEINE,VILLENEUVE-LA-GARENNE,0921543C,148,131,12,5,74,74,3 ème
VAL-D'OISE,ARGENTEUIL,0950789S,127,127,0,0,64,63,3 ème
VAL-D'OISE,CERGY,0951401G,176,156,15,5,88,88,3 ème
VAL-D'OISE,DOMONT,0950014Z,194,194,0,0,106,88,3 ème
VAL-D'OISE,ENGHIEN-LES-BAINS,0950930V,97,92,0,5,36,61,3 ème
VAL-D'OISE,FRANCONVILLE,0950793W,117,117,0,0,66,51,3 ème
VAL-D'OISE,GARGES-LES-GONESSE,0952036X,151,149,0,2,82,69,3 ème
VAL-D'OISE,JOUY-LE-MOUTIER,0951527U,161,149,11,1,84,77,3 ème
VAL-D'OISE,LE PLESSIS-BOUCHARD,0951232Y,114,114,0,0,61,53,3 ème
VAL-D'OISE,L'ISLE-ADAM,0950758H,83,83,0,0,34,49,3 ème
VAL-D'OISE,LOUVRES,0951354F,113,109,0,4,61,52,3 ème
VAL-D'OISE,MAGNY-EN-VEXIN,0950823D,57,57,0,0,25,32,3 ème
VAL-D'OISE,MARINES,0950936B,171,158,13,0,78,93,3 ème
VAL-D'OISE,PARMAIN,0951279Z,145,145,0,0,70,75,3 ème
VAL-D'OISE,PIERRELAYE,0951726K,109,108,0,1,59,50,3 ème
VAL-D'OISE,PONTOISE,0950895G,136,133,0,3,69,67,3 ème
VAL-D'OISE,PONTOISE,0951506W,184,183,0,1,97,87,3 ème
VAL-D'OISE,SAINT-GRATIEN,0950037Z,115,115,0,0,66,49,3 ème
VAL-D'OISE,SAINT-OUEN-L'AUMONE,0950658Z,24,24,0,0,3,21,3 ème
VAL-D'OISE,SAINT-PRIX,0951992Z,118,118,0,0,55,63,3 ème
VAL-D'OISE,SARCELLES,0951939S,22,22,0,0,0,22,3 ème
VAL-D'OISE,VILLIERS-LE-BEL,0950796Z,153,148,0,5,78,75,3 ème
VAL-D'OISE,VILLIERS-LE-BEL,0951090U,17,17,0,0,3,14,3 ème
VAL-D'OISE,VILLIERS-LE-BEL,0951993A,162,160,0,2,84,78,3 ème
YVELINES,BONNIERES-SUR-SEINE,0780707V,193,190,0,3,99,94,3 ème
YVELINES,BREVAL,0781862A,110,110,0,0,63,47,3 ème
YVELINES,CHATOU,0781601S,27,27,0,0,7,20,3 ème
YVELINES,CHEVREUSE,0780418F,170,167,0,3,77,93,3 ème
YVELINES,CONFLANS-SAINTE-HONORINE,0780183A,217,200,14,3,108,109,3 ème
YVELINES,ELANCOURT,0780856G,143,140,0,3,70,73,3 ème
YVELINES,GAILLON-SUR-MONTCIENT,0783464S,140,140,0,0,65,75,3 ème
YVELINES,GARGENVILLE,0780758A,162,157,0,5,90,72,3 ème
YVELINES,HOUDAN,0780254C,190,186,0,4,102,88,3 ème
YVELINES,HOUILLES,0783287Z,136,136,0,0,75,61,3 ème
YVELINES,LE CHESNAY-ROCQUENCOURT,0782602E,22,22,0,0,2,20,3 ème
YVELINES,LE CHESNAY-ROCQUENCOURT,0783252L,178,178,0,0,83,95,3 ème
YVELINES,LIMAY,0780255D,135,135,0,0,82,53,3 ème
YVELINES,MAGNANVILLE,0781098V,181,165,13,3,79,102,3 ème
YVELINES,MAISONS-LAFFITTE,0781587B,99,99,0,0,57,42,3 ème
YVELINES,MANTES-LA-JOLIE,0780708W,154,154,0,0,74,80,3 ème
YVELINES,MANTES-LA-JOLIE,0781590E,186,186,0,0,93,93,3 ème
YVELINES,MANTES-LA-JOLIE,0781955B,99,93,0,6,54,45,3 ème
YVELINES,MANTES-LA-JOLIE,0781977A,88,84,0,4,30,58,3 ème
YVELINES,MANTES-LA-VILLE,0780569V,160,141,15,4,69,91,3 ème
YVELINES,MEULAN-EN-YVELINES,0783340G,117,117,0,0,64,53,3 ème
YVELINES,MONTFORT-L'AMAURY,0780262L,202,182,16,4,103,99,3 ème
YVELINES,MONTIGNY-LE-BRETONNEUX,0781954A,112,109,0,3,55,57,3 ème
YVELINES,PLAISIR,0780420H,146,131,15,0,77,69,3 ème
YVELINES,POISSY,0781101Y,118,118,0,0,50,68,3 ème
YVELINES,SAINT-GERMAIN-EN-LAYE,0783816Z,0,0,0,0,0,0,3 ème
YVELINES,VERNEUIL-SUR-SEINE,0780267S,147,129,15,3,58,89,3 ème
YVELINES,VERSAILLES,0783325R,15,15,0,0,8,7,3 ème
LA REUNION,CILAOS,9740096L,74,74,0,0,37,37,3 ème
LA REUNION,LA PLAINE-DES-PALMISTES,9740037X,133,130,0,3,68,65,3 ème
LA REUNION,LE PORT,9740548C,186,184,0,2,85,101,3 ème
LA REUNION,LE PORT,9740812P,171,133,33,5,82,89,3 ème
LA REUNION,LE PORT,9741045T,146,141,0,5,74,72,3 ème
LA REUNION,LES AVIRONS,9740005M,165,165,0,0,90,75,3 ème
LA REUNION,LE TAMPON,9740070H,224,224,0,0,113,111,3 ème
LA REUNION,LE TAMPON,9741581A,180,180,0,0,89,91,3 ème
LA REUNION,SAINT-ANDRE,9740076P,147,147,0,0,77,70,3 ème
LA REUNION,SAINT-BENOIT,9740083X,141,136,0,5,77,64,3 ème
LA REUNION,SAINT-BENOIT,9740702V,168,132,29,7,82,86,3 ème
LA REUNION,SAINT-DENIS,9740080U,228,225,0,3,116,112,3 ème
LA REUNION,SAINT-DENIS,9741044S,197,193,0,4,87,110,3 ème
LA REUNION,SAINT-DENIS,9741188Y,217,215,0,2,109,108,3 ème
LA REUNION,SAINT-DENIS,9741260B,130,127,0,3,61,69,3 ème
LA REUNION,SAINT-LEU,9740018B,126,126,0,0,61,65,3 ème
LA REUNION,SAINT-LOUIS,9741189Z,168,160,0,8,90,78,3 ème
LA REUNION,SAINT-PAUL,9740035V,195,163,30,2,88,107,3 ème
LA REUNION,SAINT-PAUL,9740039Z,224,218,0,6,112,112,3 ème
LA REUNION,SAINT-PAUL,9740784J,246,242,0,4,118,128,3 ème
LA REUNION,SAINT-PAUL,9740932V,276,254,16,6,129,147,3 ème
LA REUNION,SAINT-PIERRE,9740574F,183,145,31,7,93,90,3 ème
LA REUNION,SAINT-PIERRE,9740576H,96,94,0,2,36,60,3 ème
LA REUNION,SAINT-PIERRE,9740811N,168,151,14,3,76,92,3 ème
LA REUNION,SAINT-PIERRE,9741235Z,184,184,0,0,99,85,3 ème
MARTINIQUE,FORT-DE-FRANCE,9720010D,120,107,10,3,49,71,3 ème
MARTINIQUE,FORT-DE-FRANCE,9720064M,199,199,0,0,73,126,3 ème
MARTINIQUE,FORT-DE-FRANCE,9720349X,129,129,0,0,64,65,3 ème
MARTINIQUE,FORT-DE-FRANCE,9720412R,111,85,26,0,59,52,3 ème
MARTINIQUE,FORT-DE-FRANCE,9720855X,16,16,0,0,5,11,3 ème
MARTINIQUE,LE FRANCOIS,9720495F,73,73,0,0,33,40,3 ème
MARTINIQUE,LE MARIN,9720447D,91,75,16,0,41,50,3 ème
MARTINIQUE,LE MORNE-ROUGE,9720066P,41,41,0,0,28,13,3 ème
MARTINIQUE,LE ROBERT,9720019N,80,80,0,0,41,39,3 ème
MARTINIQUE,SAINTE-ANNE,9720514B,38,38,0,0,22,16,3 ème
MARTINIQUE,SAINTE-MARIE,9720513A,76,53,17,6,38,38,3 ème
MAYOTTE,BANDRELE,9760179R,227,226,0,1,113,114,3 ème
MAYOTTE,CHIRONGUI,9760042S,252,252,0,0,125,127,3 ème
MAYOTTE,MAMOUDZOU,9760162X,331,330,0,1,167,164,3 ème
ALLIER,DOMPIERRE-SUR-BESBRE,0030013Y,76,74,0,2,35,41,3 ème
ALLIER,HURIEL,0030018D,68,68,0,0,39,29,3 ème
ALLIER,JALIGNY-SUR-BESBRE,0030019E,33,33,0,0,12,21,3 ème
ALLIER,LAPALISSE,0030092J,96,91,0,5,48,48,3 ème
ALLIER,LE MAYET-DE-MONTAGNE,0030023J,46,46,0,0,22,24,3 ème
ALLIER,MARCILLAT-EN-COMBRAILLE,0030022H,23,23,0,0,12,11,3 ème
ALLIER,MONTLUCON,0030758H,123,117,0,6,52,71,3 ème
ALLIER,MOULINS,0030838V,128,96,31,1,67,61,3 ème
ALLIER,SAINT-YORRE,0031010G,73,73,0,0,35,38,3 ème
ALLIER,VARENNES-SUR-ALLIER,0030924N,14,14,0,0,7,7,3 ème
ALLIER,VICHY,0030050N,134,116,17,1,59,75,3 ème
ALLIER,VICHY,0030070K,108,108,0,0,50,58,3 ème
CANTAL,AURILLAC,0150647X,139,134,0,5,70,69,3 ème
CANTAL,MASSIAC,0150014J,32,32,0,0,13,19,3 ème
CANTAL,MAURIAC,0150016L,73,60,11,2,33,40,3 ème
CANTAL,SAINT-FLOUR,0150029A,90,75,13,2,45,45,3 ème
HAUTE-LOIRE,BRIOUDE,0430109K,6,0,6,0,2,4,3 ème
HAUTE-LOIRE,BRIVES-CHARENSAC,0430101B,22,22,0,0,5,17,3 ème
HAUTE-LOIRE,CRAPONNE-SUR-ARZON,0430010C,37,37,0,0,20,17,3 ème
HAUTE-LOIRE,CRAPONNE-SUR-ARZON,0430068R,21,21,0,0,12,9,3 ème
HAUTE-LOIRE,LA CHAISE-DIEU,0430006Y,17,16,0,1,6,11,3 ème
HAUTE-LOIRE,LE CHAMBON-SUR-LIGNON,0430820H,41,29,12,0,15,26,3 ème
HAUTE-LOIRE,LE MONASTIER-SUR-GAZEILLE,0430017K,56,56,0,0,25,31,3 ème
HAUTE-LOIRE,LE MONASTIER-SUR-GAZEILLE,0430074X,21,21,0,0,9,12,3 ème
HAUTE-LOIRE,LE PUY-EN-VELAY,0430025U,102,100,0,2,49,53,3 ème
HAUTE-LOIRE,LE PUY-EN-VELAY,0430098Y,18,17,0,1,11,7,3 ème
HAUTE-LOIRE,MONISTROL-SUR-LOIRE,0430103D,48,48,0,0,11,37,3 ème
HAUTE-LOIRE,SAINT-DIDIER-EN-VELAY,0430027W,149,149,0,0,74,75,3 ème
HAUTE-LOIRE,SAINTE-SIGOLENE,0430090P,52,49,0,3,22,30,3 ème
HAUTE-LOIRE,YSSINGEAUX,0430135N,125,103,17,5,51,74,3 ème
PUY-DE-DOME,AMBERT,0630001J,24,24,0,0,6,18,3 ème
PUY-DE-DOME,ARLANC,0630006P,40,40,0,0,19,21,3 ème
PUY-DE-DOME,CLERMONT-FERRAND,0631050Z,17,17,0,0,5,12,3 ème
PUY-DE-DOME,CLERMONT-FERRAND,0631410R,196,196,0,0,105,91,3 ème
PUY-DE-DOME,CLERMONT-FERRAND,0631736V,23,23,0,0,6,17,3 ème
PUY-DE-DOME,COURNON-D'AUVERGNE,0630028N,172,171,0,1,84,88,3 ème
PUY-DE-DOME,ISSOIRE,0631604B,171,135,32,4,88,83,3 ème
PUY-DE-DOME,LES MARTRES-DE-VEYRE,0631479R,191,187,0,4,91,100,3 ème
PUY-DE-DOME,MARINGUES,0630039A,106,106,0,0,51,55,3 ème
PUY-DE-DOME,PONTAUMUR,0630047J,47,47,0,0,26,21,3 ème
PUY-DE-DOME,PONTGIBAUD,0630049L,77,77,0,0,43,34,3 ème
PUY-DE-DOME,RIOM,0631121B,125,125,0,0,65,60,3 ème
PUY-DE-DOME,SAINT-ANTHEME,0630058W,13,13,0,0,3,10,3 ème
PUY-DE-DOME,SAINT-DIER-D'AUVERGNE,0630059X,40,40,0,0,21,19,3 ème
PUY-DE-DOME,THIERS,0631238D,189,167,17,5,80,109,3 ème
PUY-DE-DOME,VOLVIC,0630074N,118,116,0,2,52,66,3 ème
PUY-DE-DOME,VOLVIC,0631115V,24,24,0,0,13,11,3 ème
ARDECHE,AUBENAS,0070062E,182,182,0,0,94,88,3 ème
ARDECHE,AUBENAS,0070115M,43,43,0,0,21,22,3 ème
ARDECHE,AUBENAS,0071169H,144,117,24,3,65,79,3 ème
ARDECHE,LES VANS,0070037C,66,66,0,0,36,30,3 ème
ARDECHE,LE TEIL,0070112J,35,34,0,1,8,27,3 ème
ARDECHE,RUOMS,0070863A,59,59,0,0,32,27,3 ème
ARDECHE,VALLON-PONT-D'ARC,0070035A,112,112,0,0,59,53,3 ème
ARDECHE,VILLENEUVE-DE-BERG,0070040F,109,109,0,0,52,57,3 ème
DROME,BEAUMONT-LES-VALENCE,0261528V,125,124,0,1,68,57,3 ème
DROME,CHABEUIL,0260092J,65,65,0,0,24,41,3 ème
DROME,CREST,0260072M,24,24,0,0,8,16,3 ème
DROME,MONTELIMAR,0261034H,23,0,22,1,11,12,3 ème
DROME,PIERRELATTE,0260019E,24,24,0,0,6,18,3 ème
DROME,ROMANS-SUR-ISERE,0260044G,36,36,0,0,12,24,3 ème
DROME,ROMANS-SUR-ISERE,0260078U,26,26,0,0,11,15,3 ème
DROME,SAINT-RAMBERT-D'ALBON,0260029R,117,117,0,0,56,61,3 ème
DROME,VALENCE,0260116K,22,22,0,0,2,20,3 ème
DROME,VALENCE,0261094Y,119,117,0,2,68,51,3 ème
DROME,VALENCE,0261136U,225,222,0,3,116,109,3 ème
HAUTE SAVOIE,ABONDANCE,0741442R,31,31,0,0,15,16,3 ème
HAUTE SAVOIE,ANNECY,0740124H,215,199,16,0,101,114,3 ème
HAUTE SAVOIE,ANNECY,0740929H,227,225,0,2,114,113,3 ème
HAUTE SAVOIE,ANNECY,0741117M,201,184,13,4,109,92,3 ème
HAUTE SAVOIE,BELLEVAUX,0740109S,54,54,0,0,26,28,3 ème
HAUTE SAVOIE,BOEGE,0740048A,102,102,0,0,49,53,3 ème
HAUTE SAVOIE,CHAMONIX-MONT-BLANC,0741116L,137,137,0,0,73,64,3 ème
HAUTE SAVOIE,CRUSEILLES,0740018T,178,178,0,0,88,90,3 ème
HAUTE SAVOIE,DOUVAINE,0740116Z,72,72,0,0,36,36,3 ème
HAUTE SAVOIE,PASSY,0740263J,199,179,15,5,99,100,3 ème
HAUTE SAVOIE,RUMILLY,0741469V,20,20,0,0,8,12,3 ème
HAUTE SAVOIE,SAINT-JORIOZ,0740036M,134,130,0,4,59,75,3 ème
HAUTE SAVOIE,SILLINGY,0741488R,158,156,0,2,84,74,3 ème
HAUTE SAVOIE,THONES,0741283T,119,119,0,0,63,56,3 ème
HAUTE SAVOIE,THONON-LES-BAINS,0740156T,23,23,0,0,11,12,3 ème
HAUTE SAVOIE,THONON-LES-BAINS,0741163M,165,162,0,3,91,74,3 ème
ISERE,BOURGOIN-JALLIEU,0380111P,209,209,0,0,102,107,3 ème
ISERE,CHAMPIER,0383542U,88,88,0,0,46,42,3 ème
ISERE,CHIRENS,0383454Y,175,175,0,0,87,88,3 ème
ISERE,DOMENE,0382268J,140,124,16,0,63,77,3 ème
ISERE,ECHIROLLES,0380021S,148,146,0,2,82,66,3 ème
ISERE,ENTRE-DEUX-GUIERS,0381692H,68,67,0,1,27,41,3 ème
ISERE,GRENOBLE,0381604M,88,88,0,0,43,45,3 ème
ISERE,GRENOBLE,0381664C,245,243,0,2,120,125,3 ème
ISERE,GRENOBLE,0382032C,82,77,0,5,33,49,3 ème
ISERE,GRENOBLE,0382581Z,149,149,0,0,82,67,3 ème
ISERE,LE PONT-DE-BEAUVOISIN,0380053B,36,36,0,0,11,25,3 ème
ISERE,MONESTIER-DE-CLERMONT,0380044S,78,78,0,0,40,38,3 ème
ISERE,MORESTEL,0380046U,149,145,0,4,78,71,3 ème
ISERE,PONT-DE-CHERUY,0382110M,178,161,15,2,97,81,3 ème
ISERE,PONT-EN-ROYANS,0380055D,55,55,0,0,29,26,3 ème
ISERE,RIVES,0382266G,181,167,12,2,87,94,3 ème
ISERE,ROUSSILLON,0380050Y,163,156,0,7,74,89,3 ème
ISERE,SAINT-JEAN-DE-BOURNAY,0382265F,192,187,0,5,95,97,3 ème
ISERE,SAINT-LAURENT-DU-PONT,0380062L,56,56,0,0,28,28,3 ème
ISERE,SAINT-MARCELLIN,0382428H,160,140,16,4,82,78,3 ème
ISERE,SAINT-MAURICE-L'EXIL,0382043P,195,166,25,4,89,106,3 ème
ISERE,SASSENAGE,0382099A,46,46,0,0,16,30,3 ème
ISERE,SEYSSINS,0382431L,129,128,0,1,69,60,3 ème
ISERE,VIENNE,0381678T,63,63,0,0,17,46,3 ème
ISERE,VIENNE,0382195E,189,189,0,0,93,96,3 ème
ISERE,VIF,0382039K,180,175,0,5,82,98,3 ème
ISERE,VILLARD-BONNOT,0381778B,155,155,0,0,82,73,3 ème
ISERE,VIZILLE,0380089R,24,24,0,0,11,13,3 ème
SAVOIE,ALBERTVILLE,0730006K,23,23,0,0,11,12,3 ème
SAVOIE,ALBERTVILLE,0731069R,91,85,0,6,36,55,3 ème
SAVOIE,BARBY,0731306Y,133,130,0,3,71,62,3 ème
SAVOIE,COGNIN,0731113N,128,128,0,0,62,66,3 ème
SAVOIE,FRONTENEX,0730023D,112,108,0,4,57,55,3 ème
SAVOIE,GRESY-SUR-AIX,0731521G,116,111,0,5,53,63,3 ème
SAVOIE,LA MOTTE-SERVOLEX,0730774V,64,62,0,2,11,53,3 ème
SAVOIE,LE CHATELARD,0730020A,78,76,0,2,41,37,3 ème
SAVOIE,MOUTIERS,0730008M,192,166,23,3,103,89,3 ème
SAVOIE,SAINT-ETIENNE-DE-CUINES,0730017X,78,78,0,0,33,45,3 ème
SAVOIE,SAINT-GENIX-LES-VILLAGES,0730036T,171,169,0,2,78,93,3 ème
SAVOIE,SAINT-PAUL-SUR-ISERE,0730769P,33,33,0,0,18,15,3 ème
SAVOIE,UGINE,0730043A,22,22,0,0,6,16,3 ème
AIN,AMBERIEU-EN-BUGEY,0010001W,27,27,0,0,8,19,3 ème
AIN,ARBENT,0010987T,163,161,0,2,76,87,3 ème
AIN,COLIGNY,0011071J,88,88,0,0,46,42,3 ème
AIN,CULOZ,0010022U,108,101,0,7,43,65,3 ème
AIN,FERNEY-VOLTAIRE,0010896U,299,296,0,3,152,147,3 ème
AIN,JASSANS-RIOTTIER,0011193S,148,131,15,2,73,75,3 ème
AIN,MIRIBEL,0011151W,80,80,0,0,39,41,3 ème
AIN,NANTUA,0011068F,72,70,0,2,38,34,3 ème
AIN,PONT-DE-VAUX,0011070H,102,102,0,0,53,49,3 ème
AIN,SAINT-DENIS-LES-BOURG,0011333U,146,144,0,2,73,73,3 ème
AIN,SAINT-RAMBERT-EN-BUGEY,0010039M,66,63,0,3,33,33,3 ème
LOIRE,BALBIGNY,0421455D,108,106,0,2,64,44,3 ème
LOIRE,CHAZELLES-SUR-LYON,0421658Z,86,86,0,0,38,48,3 ème
LOIRE,MONTBRISON,0421002L,24,24,0,0,21,3,3 ème
LOIRE,PANISSIERES,0420023X,79,79,0,0,44,35,3 ème
LOIRE,RIORGES,0421457F,143,140,0,3,72,71,3 ème
LOIRE,SAINT-BONNET-LE-CHATEAU,0421082Y,39,39,0,0,25,14,3 ème
LOIRE,SAINT-CHAMOND,0420968Z,174,155,16,3,79,95,3 ème
LOIRE,SAINT-ETIENNE,0420984S,21,21,0,0,13,8,3 ème
LOIRE,SAINT-ETIENNE,0421041D,118,118,0,0,62,56,3 ème
LOIRE,SAINT-ETIENNE,0421451Z,88,70,16,2,35,53,3 ème
LOIRE,SAINT-ETIENNE,0421801E,154,154,0,0,77,77,3 ème
LOIRE,SAINT-ETIENNE,0421803G,48,42,0,6,22,26,3 ème
LOIRE,SAINT-ETIENNE,0422158T,24,24,0,0,15,9,3 ème
LOIRE,SAINT-GALMIER,0421058X,149,146,0,3,59,90,3 ème
LOIRE,SAINT-GALMIER,0421607U,170,149,17,4,81,89,3 ème
LOIRE,SAINT-GENEST-LERPT,0422160V,21,21,0,0,5,16,3 ème
LOIRE,SAINT-JUST-SAINT-RAMBERT,0421063C,86,86,0,0,32,54,3 ème
LOIRE,SAINT-JUST-SAINT-RAMBERT,0421734G,202,199,0,3,114,88,3 ème
RHONE,ANSE,0690002C,186,183,0,3,90,96,3 ème
RHONE,BEAUJEU,0690005F,50,50,0,0,30,20,3 ème
RHONE,BELLEVILLE-EN-BEAUJOLAIS,0690007H,179,162,17,0,93,86,3 ème
RHONE,CALUIRE-ET-CUIRE,0692165D,19,19,0,0,9,10,3 ème
RHONE,CALUIRE-ET-CUIRE,0692410V,154,151,0,3,74,80,3 ème
RHONE,CHAMPAGNE-AU-MONT-D'OR,0692414Z,178,161,13,4,83,95,3 ème
RHONE,COMMUNAY,0693092L,149,145,0,4,70,79,3 ème
RHONE,ECULLY,0691481K,116,113,0,3,60,56,3 ème
RHONE,ECULLY,0693095P,23,23,0,0,12,11,3 ème
RHONE,GENAS,0693331W,211,211,0,0,94,117,3 ème
RHONE,GIVORS,0690018V,24,24,0,0,12,12,3 ème
RHONE,GIVORS,0691483M,122,118,0,4,64,58,3 ème
RHONE,L'ARBRESLE,0690003D,29,29,0,0,8,21,3 ème
RHONE,LYON,0690043X,38,38,0,0,8,30,3 ème
RHONE,LYON,0690660T,12,12,0,0,8,4,3 ème
RHONE,LYON,0693370N,11,11,0,0,2,9,3 ème
RHONE,LYON,0692693C,141,135,0,6,74,67,3 ème
RHONE,LYON,0692695E,100,95,0,5,51,49,3 ème
RHONE,LYON,0690125L,18,18,0,0,9,9,3 ème
RHONE,LYON,0690601D,33,33,0,0,14,19,3 ème
RHONE,LYON,0691662G,179,179,0,0,100,79,3 ème
RHONE,LYON,0691670R,98,83,14,1,50,48,3 ème
RHONE,LYON,0692696F,212,209,0,3,120,92,3 ème
RHONE,LYON,0692931L,120,120,0,0,54,66,3 ème
RHONE,LYON,0690604G,85,85,0,0,41,44,3 ème
RHONE,LYON,0692938U,56,56,0,0,18,38,3 ème
RHONE,LYON,0690045Z,30,30,0,0,13,17,3 ème
RHONE,MEYZIEU,0691668N,141,140,0,1,55,86,3 ème
RHONE,MEYZIEU,0692335N,167,146,13,8,71,96,3 ème
RHONE,NEUVILLE-SUR-SAONE,0692423J,220,206,14,0,98,122,3 ème
RHONE,OULLINS,0690075G,128,115,13,0,60,68,3 ème
RHONE,OULLINS,0690129R,24,24,0,0,6,18,3 ème
RHONE,RILLIEUX-LA-PAPE,0691680B,23,23,0,0,8,15,3 ème
RHONE,RILLIEUX-LA-PAPE,0692517L,24,24,0,0,10,14,3 ème
RHONE,SAINT-PIERRE-DE-CHANDIEU,0694227V,132,130,0,2,63,69,3 ème
RHONE,SAINT-PRIEST,0691497C,171,165,0,6,85,86,3 ème
RHONE,THIZY-LES-BOURGS,0692164C,35,31,0,4,23,12,3 ème
RHONE,THIZY-LES-BOURGS,0693566B,10,10,0,0,1,9,3 ème
RHONE,VAULX-EN-VELIN,0690249W,121,119,0,2,54,67,3 ème
RHONE,VAULX-EN-VELIN,0690652J,17,17,0,0,0,17,3 ème
RHONE,VENISSIEUX,0692717D,24,24,0,0,10,14,3 ème
RHONE,VILLEFRANCHE-SUR-SAONE,0691644M,24,24,0,0,4,20,3 ème
RHONE,VILLEFRANCHE-SUR-SAONE,0692699J,179,172,0,7,93,86,3 ème
RHONE,VILLEURBANNE,0691478G,167,166,0,1,81,86,3 ème
RHONE,VILLEURBANNE,0691664J,216,198,16,2,120,96,3 ème
RHONE,VILLEURBANNE,0691675W,174,156,16,2,74,100,3 ème
DOUBS,AUDINCOURT,0250003T,138,122,16,0,77,61,3 ème
DOUBS,BART,0251556F,122,120,0,2,58,64,3 ème
DOUBS,BESANCON,0251116C,128,125,0,3,66,62,3 ème
DOUBS,BESANCON,0251348E,132,131,0,1,64,68,3 ème
DOUBS,BESANCON,0251586N,19,17,0,2,7,12,3 ème
DOUBS,BESANCON,0251589S,189,176,13,0,102,87,3 ème
DOUBS,BESANCON,0251592V,22,22,0,0,2,20,3 ème
DOUBS,DOUBS,0251949H,138,122,15,1,68,70,3 ème
DOUBS,LABERGEMENT-SAINTE-MARIE,0251065X,25,25,0,0,13,12,3 ème
DOUBS,LE RUSSEY,0250052W,58,58,0,0,31,27,3 ème
DOUBS,MAICHE,0251373G,118,108,7,3,57,61,3 ème
DOUBS,MANDEURE,0251324D,88,83,0,5,33,55,3 ème
DOUBS,MONTBELIARD,0250067M,23,23,0,0,17,6,3 ème
DOUBS,MONTBELIARD,0251994G,22,22,0,0,1,21,3 ème
DOUBS,PONTARLIER,0251349F,24,24,0,0,5,19,3 ème
DOUBS,PONTARLIER,0251524W,135,133,0,2,59,76,3 ème
DOUBS,PONTARLIER,0251590T,139,139,0,0,82,57,3 ème
DOUBS,PONTARLIER,0251677M,127,125,0,2,62,65,3 ème
DOUBS,ROUGEMONT,0250050U,60,60,0,0,32,28,3 ème
DOUBS,SANCEY,0251061T,26,26,0,0,13,13,3 ème
DOUBS,SAONE,0251376K,157,157,0,0,79,78,3 ème
DOUBS,SOCHAUX,0250056A,184,166,15,3,91,93,3 ème
DOUBS,VALDAHON,0251372F,152,143,0,9,73,79,3 ème
DOUBS,VALENTIGNEY,0251599C,127,125,0,2,65,62,3 ème
HAUTE-SAONE,GRAY,0700010F,75,72,0,3,38,37,3 ème
HAUTE-SAONE,GRAY,0701001H,21,21,0,0,9,12,3 ème
HAUTE-SAONE,GY,0700013J,64,64,0,0,33,31,3 ème
HAUTE-SAONE,LUXEUIL-LES-BAINS,0701078S,24,24,0,0,11,13,3 ème
HAUTE-SAONE,MELISEY,0700925A,78,77,0,1,40,38,3 ème
HAUTE-SAONE,NOIDANS-LES-VESOUL,0701036W,107,105,0,2,57,50,3 ème
HAUTE-SAONE,VESOUL,0701002J,114,114,0,0,48,66,3 ème
HAUTE-SAONE,VILLERSEXEL,0700896U,80,79,0,1,39,41,3 ème
JURA,BLETTERANS,0390004T,102,99,0,3,53,49,3 ème
JURA,CHAMPAGNOLE,0391001B,16,16,0,0,8,8,3 ème
JURA,DOLE,0390015E,23,23,0,0,16,7,3 ème
JURA,LES ROUSSES,0390923S,111,111,0,0,51,60,3 ème
JURA,LONS-LE-SAUNIER,0390906Y,134,130,0,4,64,70,3 ème
JURA,MONT-SOUS-VAUDREY,0390997X,66,66,0,0,30,36,3 ème
JURA,SAINT-AUBIN,0390083D,45,45,0,0,29,16,3 ème
JURA,SALINS-LES-BAINS,0390085F,23,23,0,0,11,12,3 ème
TERRITOIRE DE BELFORT,BELFORT,0900018F,103,102,0,1,50,53,3 ème
TERRITOIRE DE BELFORT,BELFORT,0900235S,63,63,0,0,33,30,3 ème
TERRITOIRE DE BELFORT,BELFORT,0900295G,184,166,16,2,83,101,3 ème
TERRITOIRE DE BELFORT,BELFORT,0900335A,221,221,0,0,114,107,3 ème
TERRITOIRE DE BELFORT,MONTREUX-CHATEAU,0900011Y,74,74,0,0,45,29,3 ème
TERRITOIRE DE BELFORT,MORVILLARS,0900277M,73,70,0,3,41,32,3 ème
COTE D'OR,DIJON,0211227V,95,95,0,0,43,52,3 ème
COTE D'OR,LONGVIC,0210057Y,146,146,0,0,82,64,3 ème
COTE D'OR,SEMUR-EN-AUXOIS,0211088U,52,52,0,0,24,28,3 ème
NIEVRE,CHATEAU-CHINON (VILLE),0580552K,15,15,0,0,8,7,3 ème
NIEVRE,CLAMECY,0580651T,81,81,0,0,31,50,3 ème
NIEVRE,CORBIGNY,0580065F,26,26,0,0,14,12,3 ème
NIEVRE,DECIZE,0580068J,16,16,0,0,7,9,3 ème
NIEVRE,GUERIGNY,0580023K,58,57,0,1,32,26,3 ème
NIEVRE,LA MACHINE,0580028R,28,28,0,0,12,16,3 ème
NIEVRE,NEVERS,0580071M,23,23,0,0,8,15,3 ème
NIEVRE,SAINT-PIERRE-LE-MOUTIER,0580039C,64,64,0,0,30,34,3 ème
SAONE-ET-LOIRE,AUTUN,0710001R,15,15,0,0,4,11,3 ème
SAONE-ET-LOIRE,AUTUN,0711294W,107,87,17,3,50,57,3 ème
SAONE-ET-LOIRE,BUXY,0710007X,81,81,0,0,44,37,3 ème
SAONE-ET-LOIRE,CHALON-SUR-SAONE,0711322B,24,24,0,0,0,24,3 ème
SAONE-ET-LOIRE,CHALON-SUR-SAONE,0711896A,26,26,0,0,13,13,3 ème
SAONE-ET-LOIRE,CHAROLLES,0710155H,93,80,11,2,58,35,3 ème
SAONE-ET-LOIRE,COUCHES,0710025S,58,58,0,0,27,31,3 ème
SAONE-ET-LOIRE,GIVRY,0710125A,16,16,0,0,11,5,3 ème
SAONE-ET-LOIRE,GIVRY,0710154G,120,116,0,4,62,58,3 ème
SAONE-ET-LOIRE,GUEUGNON,0711252A,134,112,18,4,64,70,3 ème
SAONE-ET-LOIRE,LOUHANS,0710042K,23,23,0,0,6,17,3 ème
SAONE-ET-LOIRE,LOUHANS,0711449P,200,179,16,5,105,95,3 ème
SAONE-ET-LOIRE,LUGNY,0710128D,25,25,0,0,12,13,3 ème
SAONE-ET-LOIRE,PARAY-LE-MONIAL,0710061F,98,96,0,2,53,45,3 ème
SAONE-ET-LOIRE,VERDUN-SUR-LE-DOUBS,0710073U,82,82,0,0,39,43,3 ème
YONNE,AUXERRE,0890006Y,180,163,16,1,98,82,3 ème
YONNE,AUXERRE,0890090P,171,166,0,5,78,93,3 ème
YONNE,AVALLON,0890822K,89,73,14,2,41,48,3 ème
YONNE,JOIGNY,0891016W,24,0,24,0,8,16,3 ème
YONNE,MIGENNES,0890017K,98,97,0,1,52,46,3 ème
YONNE,TONNERRE,0890980G,128,100,25,3,56,72,3 ème
YONNE,VILLENEUVE-SUR-YONNE,0890540D,143,140,0,3,76,67,3 ème
COTES D'ARMOR,DINAN,0220081U,150,122,28,0,92,58,3 ème
COTES D'ARMOR,DINAN,0221623V,198,196,0,2,103,95,3 ème
COTES D'ARMOR,LOUDEAC,0220027K,24,24,0,0,9,15,3 ème
COTES D'ARMOR,MERDRIGNAC,0221538C,67,67,0,0,35,32,3 ème
COTES D'ARMOR,PLANCOET,0220038X,103,102,0,1,50,53,3 ème
COTES D'ARMOR,PLENEE-JUGON,0220040Z,78,78,0,0,44,34,3 ème
COTES D'ARMOR,PLENEUF-VAL-ANDRE,0220158C,68,68,0,0,26,42,3 ème
COTES D'ARMOR,PLERIN,0221039K,188,187,0,1,102,86,3 ème
COTES D'ARMOR,PLOUHA,0221512Z,73,73,0,0,38,35,3 ème
COTES D'ARMOR,ROSTRENEN,0221749G,49,48,0,1,28,21,3 ème
COTES D'ARMOR,SAINT-BRIEUC,0220059V,15,15,0,0,12,3,3 ème
COTES D'ARMOR,SAINT-BRIEUC,0220172T,75,75,0,0,25,50,3 ème
COTES D'ARMOR,SAINT-BRIEUC,0221750H,142,142,0,0,66,76,3 ème
COTES D'ARMOR,TREGUIER,0220073K,127,127,0,0,64,63,3 ème
FINISTERE,BANNALEC,0291086Y,70,70,0,0,36,34,3 ème
FINISTERE,BREST,0290100B,120,115,0,5,63,57,3 ème
FINISTERE,BREST,0290108K,24,24,0,0,8,16,3 ème
FINISTERE,BREST,0290149E,103,86,14,3,48,55,3 ème
FINISTERE,BREST,0291594A,87,83,0,4,38,49,3 ème
FINISTERE,BREST,0291868Y,196,196,0,0,106,90,3 ème
FINISTERE,BREST,0292139T,18,18,0,0,4,14,3 ème
FINISTERE,BRIEC,0290244H,60,60,0,0,27,33,3 ème
FINISTERE,CHATEAUNEUF-DU-FAOU,0290252S,16,16,0,0,7,9,3 ème
FINISTERE,LANDERNEAU,0291874E,146,142,0,4,76,70,3 ème
FINISTERE,LANDIVISIAU,0290153J,113,110,0,3,60,53,3 ème
FINISTERE,LANDIVISIAU,0291640A,252,248,0,4,126,126,3 ème
FINISTERE,LANNILIS,0290048V,121,121,0,0,57,64,3 ème
FINISTERE,LESNEVEN,0290049W,145,142,0,3,72,73,3 ème
FINISTERE,LESNEVEN,0291875F,249,235,14,0,120,129,3 ème
FINISTERE,MORLAIX,0291227B,85,83,0,2,54,31,3 ème
FINISTERE,PLABENNEC,0292290G,115,112,0,3,58,57,3 ème
FINISTERE,PLEYBEN,0290053A,68,64,0,4,32,36,3 ème
FINISTERE,PLEYBEN,0290130J,21,21,0,0,3,18,3 ème
FINISTERE,PLOUESCAT,0290056D,42,42,0,0,18,24,3 ème
FINISTERE,PLOUGASNOU,0290057E,23,23,0,0,9,14,3 ème
FINISTERE,PLOZEVET,0290331C,57,57,0,0,26,31,3 ème
FINISTERE,PONT-AVEN,0290060H,47,47,0,0,22,25,3 ème
FINISTERE,PONT-CROIX,0290302W,42,42,0,0,22,20,3 ème
FINISTERE,QUIMPER,0291879K,55,55,0,0,24,31,3 ème
FINISTERE,QUIMPER,0292144Y,23,23,0,0,8,15,3 ème
FINISTERE,ROSPORDEN,0291634U,118,116,0,2,60,58,3 ème
FINISTERE,SAINT-POL-DE-LEON,0290333E,92,76,16,0,53,39,3 ème
FINISTERE,SAINT-POL-DE-LEON,0291883P,131,131,0,0,77,54,3 ème
FINISTERE,SCAER,0290088N,67,67,0,0,32,35,3 ème
FINISTERE,SIZUN,0290089P,70,70,0,0,39,31,3 ème
ILLE-ET-VILAINE,BETTON,0352260S,132,132,0,0,65,67,3 ème
ILLE-ET-VILAINE,CESSON-SEVIGNE,0352972R,19,19,0,0,5,14,3 ème
ILLE-ET-VILAINE,CHARTRES-DE-BRETAGNE,0351852Y,136,136,0,0,62,74,3 ème
ILLE-ET-VILAINE,DOL-DE-BRETAGNE,0350009V,14,14,0,0,8,6,3 ème
ILLE-ET-VILAINE,DOL-DE-BRETAGNE,0350767U,161,158,0,3,87,74,3 ème
ILLE-ET-VILAINE,GUIGNEN,0350864Z,102,102,0,0,55,47,3 ème
ILLE-ET-VILAINE,JANZE,0351053E,169,140,29,0,86,83,3 ème
ILLE-ET-VILAINE,LAILLE,0352959B,82,82,0,0,45,37,3 ème
ILLE-ET-VILAINE,LA MEZIERE,0352760K,126,126,0,0,62,64,3 ème
ILLE-ET-VILAINE,LE RHEU,0351847T,212,211,0,1,96,116,3 ème
ILLE-ET-VILAINE,LIFFRE,0350867C,155,155,0,0,83,72,3 ème
ILLE-ET-VILAINE,ORGERES,0352691K,120,120,0,0,63,57,3 ème
ILLE-ET-VILAINE,REDON,0350775C,198,180,14,4,108,90,3 ème
ILLE-ET-VILAINE,REDON,0350790U,24,24,0,0,12,12,3 ème
ILLE-ET-VILAINE,RENNES,0350027P,151,147,0,4,82,69,3 ème
ILLE-ET-VILAINE,RENNES,0350734H,124,124,0,0,70,54,3 ème
ILLE-ET-VILAINE,RENNES,0350836U,89,89,0,0,49,40,3 ème
ILLE-ET-VILAINE,RENNES,0350963G,175,159,16,0,87,88,3 ème
ILLE-ET-VILAINE,RENNES,0351638R,212,208,0,4,104,108,3 ème
ILLE-ET-VILAINE,RENNES,0352069J,228,197,31,0,99,129,3 ème
ILLE-ET-VILAINE,ROMILLE,0350057X,136,136,0,0,72,64,3 ème
ILLE-ET-VILAINE,SAINT-AUBIN-D'AUBIGNE,0350881T,132,132,0,0,63,69,3 ème
ILLE-ET-VILAINE,SAINT-AUBIN-D'AUBIGNE,0351849V,140,125,14,1,68,72,3 ème
ILLE-ET-VILAINE,SAINT-AUBIN-DU-CORMIER,0350039C,91,91,0,0,42,49,3 ème
ILLE-ET-VILAINE,SAINT-GEORGES-DE-REINTEMBAULT,0350885X,40,40,0,0,17,23,3 ème
ILLE-ET-VILAINE,SAINT-JACQUES-DE-LA-LANDE,0352589Z,111,108,0,3,59,52,3 ème
ILLE-ET-VILAINE,SAINT-MALO,0350044H,73,69,0,4,35,38,3 ème
ILLE-ET-VILAINE,SAINT-MALO,0350916F,156,120,32,4,82,74,3 ème
ILLE-ET-VILAINE,VAL-COUESNON,0350848G,40,40,0,0,27,13,3 ème
ILLE-ET-VILAINE,VITRE,0351909K,168,134,32,2,86,82,3 ème
MORBIHAN,ARRADON,0561598H,156,149,0,7,79,77,3 ème
MORBIHAN,AURAY,0560002Y,140,113,22,5,69,71,3 ème
MORBIHAN,CARNAC,0560006C,94,94,0,0,56,38,3 ème
MORBIHAN,CARNAC,0560127J,74,74,0,0,41,33,3 ème
MORBIHAN,ELVEN,0560129L,111,111,0,0,61,50,3 ème
MORBIHAN,GUEMENE-SUR-SCORFF,0560133R,26,26,0,0,18,8,3 ème
MORBIHAN,JOSSELIN,0560019S,19,19,0,0,9,10,3 ème
MORBIHAN,LANESTER,0560022V,88,88,0,0,45,43,3 ème
MORBIHAN,LA TRINITE-PORHOET,0560174K,56,56,0,0,36,20,3 ème
MORBIHAN,LE FAOUET,0560010G,53,52,0,1,23,30,3 ème
MORBIHAN,LOCMINE,0560024X,62,62,0,0,34,28,3 ème
MORBIHAN,LORIENT,0561330S,102,84,15,3,59,43,3 ème
MORBIHAN,PLOUAY,0561403W,66,66,0,0,32,34,3 ème
MORBIHAN,PLUNERET,0561616C,111,111,0,0,51,60,3 ème
MORBIHAN,QUIBERON,0560168D,13,13,0,0,4,9,3 ème
MORBIHAN,SARZEAU,0560048Y,102,102,0,0,56,46,3 ème
MORBIHAN,VANNES,0560053D,46,46,0,0,15,31,3 ème
MORBIHAN,VANNES,0560115W,113,109,0,4,51,62,3 ème
MORBIHAN,VANNES,0561792U,38,38,0,0,19,19,3 ème
CHER,BOURGES,0180777X,128,112,13,3,59,69,3 ème
CHER,DUN-SUR-AURON,0180736C,94,83,8,3,46,48,3 ème
CHER,SAINT-AMAND-MONTROND,0180025E,24,24,0,0,6,18,3 ème
CHER,SAINT-AMAND-MONTROND,0180026F,16,14,0,2,8,8,3 ème
CHER,SANCERGUES,0180745M,53,53,0,0,23,30,3 ème
EURE-ET-LOIR,CHARTRES,0280756V,59,56,0,3,28,31,3 ème
EURE-ET-LOIR,CHATEAUDUN,0280700J,24,24,0,0,6,18,3 ème
EURE-ET-LOIR,CLOYES-LES-TROIS-RIVIERES,0280867R,88,86,0,2,50,38,3 ème
EURE-ET-LOIR,COURVILLE-SUR-EURE,0280018T,157,153,0,4,75,82,3 ème
EURE-ET-LOIR,DREUX,0280658N,116,112,0,4,56,60,3 ème
EURE-ET-LOIR,DREUX,0280925D,23,23,0,0,10,13,3 ème
EURE-ET-LOIR,GALLARDON,0280701K,109,108,0,1,61,48,3 ème
EURE-ET-LOIR,LUCE,0280009H,28,28,0,0,5,23,3 ème
EURE-ET-LOIR,MAINVILLIERS,0280659P,15,0,15,0,7,8,3 ème
EURE-ET-LOIR,MIGNIERES,0280664V,67,65,0,2,36,31,3 ème
EURE-ET-LOIR,NOGENT-LE-ROTROU,0280669A,42,39,0,3,20,22,3 ème
EURE-ET-LOIR,TOURY,0280884J,96,91,0,5,44,52,3 ème
INDRE,BUZANCAIS,0360498W,121,105,14,2,53,68,3 ème
INDRE,CHATEAUROUX,0360543V,88,88,0,0,55,33,3 ème
INDRE,LA CHATRE,0360720M,104,94,8,2,60,44,3 ème
INDRE,VATAN,0360040Y,64,64,0,0,29,35,3 ème
INDRE-ET-LOIRE,AMBOISE,0371123V,24,24,0,0,9,15,3 ème
INDRE-ET-LOIRE,BLERE,0371124W,120,120,0,0,62,58,3 ème
INDRE-ET-LOIRE,CHATEAU-RENAULT,0370007G,179,166,12,1,86,93,3 ème
INDRE-ET-LOIRE,CHINON,0371159J,138,120,16,2,68,70,3 ème
INDRE-ET-LOIRE,CORMERY,0370010K,105,105,0,0,59,46,3 ème
INDRE-ET-LOIRE,ESVRES,0371204H,111,111,0,0,55,56,3 ème
INDRE-ET-LOIRE,JOUE-LES-TOURS,0371098T,126,123,0,3,76,50,3 ème
INDRE-ET-LOIRE,JOUE-LES-TOURS,0371316E,74,72,0,2,38,36,3 ème
INDRE-ET-LOIRE,LOCHES,0370768J,179,167,9,3,80,99,3 ème
INDRE-ET-LOIRE,LUYNES,0371378X,117,117,0,0,56,61,3 ème
INDRE-ET-LOIRE,MONTRESOR,0370051E,34,34,0,0,12,22,3 ème
INDRE-ET-LOIRE,PREUILLY-SUR-CLAISE,0370738B,23,23,0,0,13,10,3 ème
INDRE-ET-LOIRE,TOURS,0370041U,99,97,0,2,50,49,3 ème
INDRE-ET-LOIRE,TOURS,0370053G,24,24,0,0,4,20,3 ème
INDRE-ET-LOIRE,TOURS,0370743G,78,78,0,0,40,38,3 ème
INDRE-ET-LOIRE,VOUVRAY,0371189S,151,148,0,3,80,71,3 ème
LOIRET,CHATEAU-RENARD,0451107J,106,102,0,4,62,44,3 ème
LOIRET,CHECY,0451365P,166,164,0,2,80,86,3 ème
LOIRET,CLERY-SAINT-ANDRE,0451434P,82,79,0,3,39,43,3 ème
LOIRET,FLEURY-LES-AUBRAIS,0450784H,179,161,16,2,96,83,3 ème
LOIRET,GIEN,0451037H,24,24,0,0,9,15,3 ème
LOIRET,ORLEANS,0450109Z,110,108,0,2,54,56,3 ème
LOIRET,PITHIVIERS,0451332D,50,50,0,0,26,24,3 ème
LOIR-ET-CHER,BLOIS,0410693F,42,42,0,0,13,29,3 ème
LOIR-ET-CHER,BLOIS,0410790L,203,188,15,0,98,105,3 ème
LOIR-ET-CHER,BLOIS,0410860M,159,152,0,7,77,82,3 ème
LOIR-ET-CHER,BLOIS,0410952M,98,95,0,3,58,40,3 ème
LOIR-ET-CHER,BRACIEUX,0410005H,107,104,0,3,45,62,3 ème
LOIR-ET-CHER,LE CONTROIS-EN-SOLOGNE,0410595Z,154,152,0,2,91,63,3 ème
LOIR-ET-CHER,MONDOUBLEAU,0410596A,51,51,0,0,22,29,3 ème
LOIR-ET-CHER,ROMORANTIN-LANTHENAY,0410036S,28,24,0,4,9,19,3 ème
LOIR-ET-CHER,ROMORANTIN-LANTHENAY,0410793P,110,110,0,0,63,47,3 ème
LOIR-ET-CHER,SAMBIN,0410677N,137,137,0,0,67,70,3 ème
LOIR-ET-CHER,SELLES-SUR-CHER,0410651K,74,73,0,1,41,33,3 ème
LOIR-ET-CHER,VENDOME,0410031L,27,24,0,3,5,22,3 ème
LOIR-ET-CHER,VINEUIL,0410773T,38,38,0,0,19,19,3 ème
CORSE-DU-SUD,AJACCIO,6200010S,132,132,0,0,64,68,3 ème
CORSE-DU-SUD,BONIFACIO,6200015X,71,71,0,0,34,37,3 ème
CORSE-DU-SUD,SARROLA-CARCOPINO,6200191N,164,164,0,0,77,87,3 ème
HAUTE-CORSE,BASTIA,7200139N,110,110,0,0,58,52,3 ème
HAUTE-CORSE,BIGUGLIA,7200727C,157,148,9,0,77,80,3 ème
MEURTHE-ET-MOSELLE,BACCARAT,0540001H,84,80,0,4,38,46,3 ème
MEURTHE-ET-MOSELLE,BLENOD-LES-PONT-A-MOUSSON,0541576V,156,124,30,2,74,82,3 ème
MEURTHE-ET-MOSELLE,CHAMPIGNEULLES,0541466A,107,89,16,2,56,51,3 ème
MEURTHE-ET-MOSELLE,CIREY-SUR-VEZOUZE,0540011U,78,74,4,0,36,42,3 ème
MEURTHE-ET-MOSELLE,DIEULOUARD,0540013W,112,111,0,1,54,58,3 ème
MEURTHE-ET-MOSELLE,DOMBASLE-SUR-MEURTHE,0540014X,102,99,0,3,56,46,3 ème
MEURTHE-ET-MOSELLE,DOMBASLE-SUR-MEURTHE,0540015Y,24,24,0,0,3,21,3 ème
MEURTHE-ET-MOSELLE,EINVILLE-AU-JARD,0540017A,67,67,0,0,43,24,3 ème
MEURTHE-ET-MOSELLE,FOUG,0540019C,40,40,0,0,24,16,3 ème
MEURTHE-ET-MOSELLE,HEILLECOURT,0542468P,143,137,0,6,61,82,3 ème
MEURTHE-ET-MOSELLE,JARNY,0540025J,168,149,16,3,95,73,3 ème
MEURTHE-ET-MOSELLE,LONGLAVILLE,0541578X,104,104,0,0,54,50,3 ème
MEURTHE-ET-MOSELLE,LONGUYON,0541452K,26,26,0,0,13,13,3 ème
MEURTHE-ET-MOSELLE,LONGWY,0541989U,126,126,0,0,68,58,3 ème
MEURTHE-ET-MOSELLE,LUNEVILLE,0540037X,23,23,0,0,19,4,3 ème
MEURTHE-ET-MOSELLE,MALZEVILLE,0541474J,126,119,0,7,69,57,3 ème
MEURTHE-ET-MOSELLE,NANCY,0541364P,13,13,0,0,11,2,3 ème
MEURTHE-ET-MOSELLE,NANCY,0541819J,84,84,0,0,35,49,3 ème
MEURTHE-ET-MOSELLE,NEUVES-MAISONS,0541573S,149,132,16,1,73,76,3 ème
MEURTHE-ET-MOSELLE,PONT-A-MOUSSON,0541440X,67,67,0,0,26,41,3 ème
MEURTHE-ET-MOSELLE,TOUL,0541330C,108,105,0,3,49,59,3 ème
MEURTHE-ET-MOSELLE,TOUL,0541565H,140,112,25,3,67,73,3 ème
MEURTHE-ET-MOSELLE,VAL DE BRIEY,0541338L,24,0,24,0,9,15,3 ème
MEURTHE-ET-MOSELLE,VILLERS-LES-NANCY,0541776M,71,68,0,3,32,39,3 ème
MEUSE,ANCEMONT,0550859K,56,56,0,0,23,33,3 ème
MEUSE,ANCERVILLE,0550848Y,73,73,0,0,42,31,3 ème
MEUSE,BAR-LE-DUC,0550046B,81,81,0,0,32,49,3 ème
MEUSE,LIGNY-EN-BARROIS,0550052H,7,7,0,0,3,4,3 ème
MEUSE,LIGNY-EN-BARROIS,0550700M,17,17,0,0,12,5,3 ème
MEUSE,VAUCOULEURS,0550023B,92,90,0,2,43,49,3 ème
MOSELLE,AMNEVILLE,0572689N,114,114,0,0,57,57,3 ème
MOSELLE,BOULAY-MOSELLE,0570225K,36,36,0,0,6,30,3 ème
MOSELLE,CHATEAU-SALINS,0570327W,72,69,0,3,41,31,3 ème
MOSELLE,CREUTZWALD,0572022N,21,21,0,0,7,14,3 ème
MOSELLE,FALCK,0572358D,71,71,0,0,39,32,3 ème
MOSELLE,HAM-SOUS-VARSBERG,0572359E,69,69,0,0,39,30,3 ème
MOSELLE,HARTZVILLER,0570038G,62,62,0,0,35,27,3 ème
MOSELLE,HAYANGE,0570077Z,24,24,0,0,10,14,3 ème
MOSELLE,HAYANGE,0572171A,97,95,0,2,45,52,3 ème
MOSELLE,HAYANGE,0572480L,167,166,0,1,81,86,3 ème
MOSELLE,KEDANGE-SUR-CANNER,0570315H,156,156,0,0,81,75,3 ème
MOSELLE,MARLY,0572082D,121,118,0,3,54,67,3 ème
MOSELLE,MARLY,0572754J,84,84,0,0,45,39,3 ème
MOSELLE,METZ,0570127D,120,120,0,0,56,64,3 ème
MOSELLE,METZ,0572809U,155,155,0,0,84,71,3 ème
MOSELLE,METZ,0572925V,231,231,0,0,116,115,3 ème
MOSELLE,METZ,0573688Z,0,0,0,0,0,0,3 ème
MOSELLE,MONTIGNY-LES-METZ,0570144X,24,24,0,0,0,24,3 ème
MOSELLE,MOULINS-LES-METZ,0572477H,67,48,15,4,36,31,3 ème
MOSELLE,PELTRE,0572928Y,46,46,0,0,20,26,3 ème
MOSELLE,PUTTELANGE-AUX-LACS,0572183N,110,109,0,1,54,56,3 ème
MOSELLE,REMILLY,0572013D,118,117,0,1,65,53,3 ème
MOSELLE,SAINT-AVOLD,0570087K,42,42,0,0,17,25,3 ème
MOSELLE,SAINT-AVOLD,0570268G,16,16,0,0,9,7,3 ème
MOSELLE,SARRALBE,0570093S,92,92,0,0,49,43,3 ème
MOSELLE,SARREBOURG,0572816B,166,161,0,5,77,89,3 ème
MOSELLE,SARREGUEMINES,0572021M,83,77,0,6,38,45,3 ème
MOSELLE,TALANGE,0572174D,109,98,8,3,54,55,3 ème
MOSELLE,THIONVILLE,0572812X,114,111,0,3,63,51,3 ème
MOSELLE,THIONVILLE,0572931B,330,330,0,0,145,185,3 ème
MOSELLE,UCKANGE,0570318L,106,104,0,2,61,45,3 ème
VOSGES,BRUYERES,0880106M,22,22,0,0,17,5,3 ème
VOSGES,ELOYES,0881371M,87,83,0,4,44,43,3 ème
VOSGES,EPINAL,0881119N,13,0,13,0,7,6,3 ème
VOSGES,EPINAL,0881146T,185,164,16,5,83,102,3 ème
VOSGES,GOLBEY,0881097P,162,160,0,2,92,70,3 ème
VOSGES,LAMARCHE,0880034J,26,26,0,0,16,10,3 ème
VOSGES,LIFFOL-LE-GRAND,0881103W,33,33,0,0,12,21,3 ème
VOSGES,MONTHUREUX-SUR-SAONE,0881386D,48,48,0,0,16,32,3 ème
VOSGES,NEUFCHATEAU,0880040R,22,22,0,0,6,16,3 ème
VOSGES,PROVENCHERES-ET-COLROY,0880044V,58,58,0,0,28,30,3 ème
VOSGES,RAMBERVILLERS,0880114W,35,32,0,3,23,12,3 ème
VOSGES,RAON-L'ETAPE,0881370L,17,17,0,0,5,12,3 ème
VOSGES,REMIREMONT,0881498A,16,16,0,0,5,11,3 ème
VOSGES,VAGNEY,0881372N,99,96,0,3,57,42,3 ème
ARDENNES,CHARLEVILLE-MEZIERES,0080011U,122,121,0,1,62,60,3 ème
ARDENNES,CHARLEVILLE-MEZIERES,0080082W,11,11,0,0,3,8,3 ème
ARDENNES,CHARLEVILLE-MEZIERES,0080829H,59,59,0,0,34,25,3 ème
ARDENNES,CHARLEVILLE-MEZIERES,0080994M,88,88,0,0,49,39,3 ème
ARDENNES,FUMAY,0080017A,67,58,7,2,34,33,3 ème
ARDENNES,RAUCOURT-ET-FLABA,0081103F,65,65,0,0,41,24,3 ème
ARDENNES,RETHEL,0080897G,102,100,0,2,57,45,3 ème
ARDENNES,SEDAN,0080826E,79,59,16,4,39,40,3 ème
ARDENNES,SEDAN,0080995N,140,140,0,0,77,63,3 ème
ARDENNES,SIGNY-L'ABBAYE,0081104G,73,73,0,0,37,36,3 ème
AUBE,BRIENNE-LE-CHATEAU,0100007D,107,101,6,0,50,57,3 ème
AUBE,MESNIL-SAINT-LOUP,0100051B,32,32,0,0,16,16,3 ème
AUBE,NOGENT-SUR-SEINE,0100786A,159,159,0,0,93,66,3 ème
AUBE,PINEY,0100013K,91,91,0,0,51,40,3 ème
AUBE,TROYES,0100038M,140,139,0,1,75,65,3 ème
AUBE,TROYES,0100056G,58,58,0,0,33,25,3 ème
HAUTE-MARNE,BOURBONNE-LES-BAINS,0520706K,34,33,0,1,15,19,3 ème
HAUTE-MARNE,CHALINDREY,0520794F,50,50,0,0,24,26,3 ème
HAUTE-MARNE,CHAUMONT,0520733P,77,73,0,4,39,38,3 ème
HAUTE-MARNE,CHAUMONT,0520737U,96,95,0,1,47,49,3 ème
HAUTE-MARNE,COLOMBEY LES DEUX EGLISES,0520814C,31,31,0,0,14,17,3 ème
HAUTE-MARNE,LANGRES,0520052Z,69,68,0,1,41,28,3 ème
HAUTE-MARNE,LANGRES,0520967U,37,37,0,0,17,20,3 ème
HAUTE-MARNE,SAINT-DIZIER,0521123N,9,9,0,0,3,6,3 ème
HAUTE-MARNE,VAL-DE-MEUSE,0520023T,45,45,0,0,22,23,3 ème
HAUTE-MARNE,WASSY,0520708M,78,76,0,2,43,35,3 ème
MARNE,BLANCS-COTEAUX,0510059M,74,74,0,0,37,37,3 ème
MARNE,CHALONS-EN-CHAMPAGNE,0511711H,61,57,0,4,32,29,3 ème
MARNE,EPERNAY,0510068X,23,23,0,0,6,17,3 ème
MARNE,FERE-CHAMPENOISE,0510022X,52,47,0,5,23,29,3 ème
MARNE,FISMES,0511176B,65,63,0,2,31,34,3 ème
MARNE,PONTFAVERGER-MORONVILLIERS,0510030F,66,66,0,0,42,24,3 ème
MARNE,REIMS,0511138K,199,198,0,1,104,95,3 ème
MARNE,REIMS,0511146U,22,22,0,0,2,20,3 ème
MARNE,REIMS,0511799D,125,121,0,4,49,76,3 ème
MARNE,REIMS,0511802G,96,90,0,6,48,48,3 ème
MARNE,SERMAIZE-LES-BAINS,0510052E,101,95,6,0,52,49,3 ème
MARNE,SEZANNE,0510053F,19,19,0,0,8,11,3 ème
MARNE,SEZANNE,0510054G,118,98,18,2,63,55,3 ème
MARNE,TINQUEUX,0511187N,182,157,23,2,89,93,3 ème
MARNE,VITRY-LE-FRANCOIS,0511256N,104,88,15,1,41,63,3 ème
BAS-RHIN,BARR,0673006D,121,104,15,2,54,67,3 ème
BAS-RHIN,BISCHHEIM,0671822S,137,134,0,3,63,74,3 ème
BAS-RHIN,BISCHWILLER,0672130B,223,196,22,5,103,120,3 ème
BAS-RHIN,BOUXWILLER,0672076T,145,127,15,3,64,81,3 ème
BAS-RHIN,DIEMERINGEN,0671741D,82,80,0,2,48,34,3 ème
BAS-RHIN,HAGUENAU,0670024M,24,24,0,0,17,7,3 ème
BAS-RHIN,HAGUENAU,0671509B,24,24,0,0,4,20,3 ème
BAS-RHIN,INGWILLER,0670035Z,80,74,0,6,44,36,3 ème
BAS-RHIN,LA WANTZENAU,0671689X,135,135,0,0,60,75,3 ème
BAS-RHIN,OBERNAI,0670050R,24,24,0,0,1,23,3 ème
BAS-RHIN,PFULGRIESHEIM,0672193V,137,134,0,3,76,61,3 ème
BAS-RHIN,SCHILTIGHEIM,0670062D,22,22,0,0,14,8,3 ème
BAS-RHIN,SCHILTIGHEIM,0672602P,22,22,0,0,7,15,3 ème
BAS-RHIN,SELESTAT,0671832C,24,24,0,0,4,20,3 ème
BAS-RHIN,STRASBOURG,0670129B,24,24,0,0,22,2,3 ème
BAS-RHIN,STRASBOURG,0671692A,112,91,16,5,50,62,3 ème
BAS-RHIN,STRASBOURG,0671907J,209,191,13,5,110,99,3 ème
BAS-RHIN,STRASBOURG,0671958P,127,122,0,5,63,64,3 ème
BAS-RHIN,STRASBOURG,0672129A,158,157,0,1,71,87,3 ème
BAS-RHIN,STRASBOURG,0672306T,185,185,0,0,108,77,3 ème
BAS-RHIN,STRASBOURG,0672806L,24,24,0,0,7,17,3 ème
HAUT-RHIN,BUHL,0682018Z,106,104,0,2,52,54,3 ème
HAUT-RHIN,BURNHAUPT-LE-HAUT,0682017Y,127,119,0,8,59,68,3 ème
HAUT-RHIN,CARSPACH,0680154Y,36,36,0,0,16,20,3 ème
HAUT-RHIN,COLMAR,0680009R,139,134,0,5,71,68,3 ème
HAUT-RHIN,COLMAR,0680084X,142,110,28,4,71,71,3 ème
HAUT-RHIN,COLMAR,0681656F,56,56,0,0,27,29,3 ème
HAUT-RHIN,GUEBWILLER,0681318N,165,131,30,4,78,87,3 ème
HAUT-RHIN,HABSHEIM,0681713T,72,72,0,0,35,37,3 ème
HAUT-RHIN,ILLZACH,0681757R,85,84,0,1,42,43,3 ème
HAUT-RHIN,INGERSHEIM,0681654D,111,108,0,3,56,55,3 ème
HAUT-RHIN,KAYSERSBERG VIGNOBLE,0680022E,65,65,0,0,30,35,3 ème
HAUT-RHIN,KINGERSHEIM,0681369U,141,134,0,7,64,77,3 ème
HAUT-RHIN,MASEVAUX-NIEDERBRUCK,0681265F,120,120,0,0,64,56,3 ème
HAUT-RHIN,MULHOUSE,0680037W,23,23,0,0,4,19,3 ème
HAUT-RHIN,MULHOUSE,0681284B,117,117,0,0,57,60,3 ème
HAUT-RHIN,MUNSTER,0681539D,157,157,0,0,75,82,3 ème
HAUT-RHIN,PULVERSHEIM,0681801N,21,21,0,0,7,14,3 ème
HAUT-RHIN,RIEDISHEIM,0680112C,109,108,0,1,54,55,3 ème
HAUT-RHIN,RIXHEIM,0680129W,171,149,16,6,80,91,3 ème
HAUT-RHIN,ROUFFACH,0680139G,81,81,0,0,41,40,3 ème
HAUT-RHIN,SAINTE-MARIE-AUX-MINES,0680068E,14,14,0,0,5,9,3 ème
HAUT-RHIN,SAINTE-MARIE-AUX-MINES,0681394W,82,66,16,0,45,37,3 ème
HAUT-RHIN,WINTZENHEIM,0681365P,127,108,16,3,70,57,3 ème
GUADELOUPE,BAIE-MAHAULT,9710040S,230,229,0,1,110,120,3 ème
GUADELOUPE,BAIE-MAHAULT,9710057K,176,176,0,0,90,86,3 ème
GUADELOUPE,BAIE-MAHAULT,9710593T,23,23,0,0,7,16,3 ème
GUADELOUPE,BASSE-TERRE,9710061P,36,36,0,0,27,9,3 ème
GUADELOUPE,DESHAIES,9710643X,51,51,0,0,25,26,3 ème
GUADELOUPE,GRAND-BOURG,9711012Y,6,6,0,0,2,4,3 ème
GUADELOUPE,LES ABYMES,9711046K,20,20,0,0,8,12,3 ème
GUADELOUPE,MORNE-A-L'EAU,9710709U,11,11,0,0,2,9,3 ème
GUADELOUPE,PETIT-BOURG,9710016R,259,239,13,7,123,136,3 ème
GUADELOUPE,POINTE-A-PITRE,9710661S,68,68,0,0,36,32,3 ème
GUADELOUPE,POINTE-A-PITRE,9710987W,148,148,0,0,82,66,3 ème
GUADELOUPE,POINTE-A-PITRE,9710988X,98,98,0,0,49,49,3 ème
GUADELOUPE,SAINT-BARTHELEMY,9710035L,77,74,0,3,35,42,3 ème
GUADELOUPE,TROIS-RIVIERES,9710707S,90,88,0,2,43,47,3 ème
GUYANE,CAMOPI,9730451C,31,21,7,3,11,20,3 ème
GUYANE,CAYENNE,9730132F,151,151,0,0,78,73,3 ème
GUYANE,MATOURY,9730536V,83,83,0,0,48,35,3 ème
GUYANE,SAINT-LAURENT-DU-MARONI,9730497C,69,69,0,0,33,36,3 ème
GUYANE,SINNAMARY,9730145V,68,51,11,6,31,37,3 ème
AISNE,ANIZY-LE-GRAND,0020002S,140,125,15,0,63,77,3 ème
AISNE,BOHAIN-EN-VERMANDOIS,0020007X,114,90,16,8,66,48,3 ème
AISNE,BOHAIN-EN-VERMANDOIS,0020498F,8,8,0,0,5,3,3 ème
AISNE,CHAUNY,0020469Z,55,55,0,0,20,35,3 ème
AISNE,CHAUNY,0021906L,18,18,0,0,8,10,3 ème
AISNE,CRECY-SUR-SERRE,0021721K,72,72,0,0,42,30,3 ème
AISNE,FONTAINE-LES-VERVINS,0020470A,51,51,0,0,29,22,3 ème
AISNE,FRESNOY-LE-GRAND,0021661V,78,73,0,5,40,38,3 ème
AISNE,GAUCHY,0021494N,117,102,9,6,51,66,3 ème
AISNE,GUISE,0020030X,85,64,16,5,39,46,3 ème
AISNE,GUISE,0021479X,18,18,0,0,16,2,3 ème
AISNE,HIRSON,0020484R,34,34,0,0,12,22,3 ème
AISNE,LAON,0020034B,24,24,0,0,8,16,3 ème
AISNE,LAON,0020471B,46,46,0,0,27,19,3 ème
AISNE,LAON,0021598B,160,131,23,6,75,85,3 ème
AISNE,LAON,0021685W,152,147,0,5,68,84,3 ème
AISNE,MARLE,0021778X,67,67,0,0,36,31,3 ème
AISNE,SAINS-RICHAUMONT,0020044M,45,45,0,0,26,19,3 ème
AISNE,SAINT-QUENTIN,0020055Z,109,93,16,0,56,53,3 ème
AISNE,SAINT-QUENTIN,0020076X,77,77,0,0,38,39,3 ème
AISNE,SOISSONS,0021525X,150,150,0,0,76,74,3 ème
AISNE,SOISSONS,0021535H,97,93,0,4,46,51,3 ème
OISE,AUNEUIL,0601799E,129,108,16,5,53,76,3 ème
OISE,BEAUVAIS,0601139M,143,138,0,5,67,76,3 ème
OISE,BEAUVAIS,0601190T,162,142,15,5,76,86,3 ème
OISE,BREUIL-LE-VERT,0601834T,158,136,16,6,77,81,3 ème
OISE,CHAUMONT-EN-VEXIN,0600012M,79,79,0,0,39,40,3 ème
OISE,CHAUMONT-EN-VEXIN,0601882V,165,165,0,0,72,93,3 ème
OISE,GUISCARD,0602004C,73,73,0,0,39,34,3 ème
OISE,MERU,0601718S,128,123,0,5,58,70,3 ème
OISE,NOGENT-SUR-OISE,0600036N,136,134,0,2,70,66,3 ème
OISE,NOGENT-SUR-OISE,0601179F,170,166,0,4,89,81,3 ème
OISE,SAINTE-GENEVIEVE,0601938F,147,145,0,2,76,71,3 ème
OISE,SENLIS,0600049C,17,17,0,0,7,10,3 ème
OISE,SENLIS,0601150Z,241,239,0,2,138,103,3 ème
OISE,THOUROTTE,0601446W,171,168,0,3,75,96,3 ème
OISE,VERBERIE,0601407D,121,121,0,0,63,58,3 ème
SOMME,ACHEUX-EN-AMIENOIS,0800003U,57,57,0,0,32,25,3 ème
SOMME,AIRAINES,0801510G,92,73,16,3,39,53,3 ème
SOMME,ALBERT,0801786G,101,78,17,6,48,53,3 ème
SOMME,AMIENS,0800017J,131,108,16,7,64,67,3 ème
SOMME,AMIENS,0800018K,176,146,17,13,73,103,3 ème
SOMME,AMIENS,0801208D,72,72,0,0,33,39,3 ème
SOMME,AMIENS,0801211G,130,130,0,0,67,63,3 ème
SOMME,AMIENS,0802134K,83,78,0,5,43,40,3 ème
SOMME,BEAUCAMPS-LE-VIEUX,0801443J,50,44,0,6,23,27,3 ème
SOMME,FLIXECOURT,0801222U,51,51,0,0,24,27,3 ème
SOMME,PERONNE,0801723N,47,47,0,0,23,24,3 ème
SOMME,VILLERS-BOCAGE,0801339W,130,130,0,0,68,62,3 ème
NORD,ANICHE,0590002G,195,172,16,7,93,102,3 ème
NORD,ARMENTIERES,0593246H,147,137,10,0,80,67,3 ème
NORD,AUBY,0594297A,87,78,9,0,34,53,3 ème
NORD,AUBY,0594532F,23,23,0,0,13,10,3 ème
NORD,AULNOYE-AYMERIES,0595383F,48,48,0,0,24,24,3 ème
NORD,AULNOYE-AYMERIES,0596694F,198,183,13,2,105,93,3 ème
NORD,AULNOY-LEZ-VALENCIENNES,0593673X,108,96,8,4,52,56,3 ème
NORD,AVESNES-LES-AUBERT,0593676A,140,135,0,5,73,67,3 ème
NORD,BEAUCAMPS-LIGNY,0595360F,364,364,0,0,180,184,3 ème
NORD,CAMBRAI,0593061G,48,48,0,0,20,28,3 ème
NORD,CAPPELLE-LA-GRANDE,0593181M,79,76,0,3,40,39,3 ème
NORD,CAUDRY,0590046E,171,171,0,0,86,85,3 ème
NORD,CAUDRY,0595277R,135,109,24,2,65,70,3 ème
NORD,COMINES,0592959W,108,108,0,0,59,49,3 ème
NORD,DOUCHY-LES-MINES,0593484S,191,176,12,3,86,105,3 ème
NORD,ESCAUTPONT,0594409X,58,58,0,0,28,30,3 ème
NORD,ESTAIRES,0597005U,24,24,0,0,13,11,3 ème
NORD,FACHES-THUMESNIL,0592830F,78,78,0,0,45,33,3 ème
NORD,FERRIERE-LA-GRANDE,0593681F,87,78,9,0,37,50,3 ème
NORD,FOURNES-EN-WEPPES,0596801X,29,29,0,0,6,23,3 ème
NORD,FRESNES-SUR-ESCAUT,0593486U,89,89,0,0,44,45,3 ème
NORD,GOUZEAUCOURT,0590087Z,47,47,0,0,25,22,3 ème
NORD,GRANDE-SYNTHE,0594652L,24,24,0,0,8,16,3 ème
NORD,HALLUIN,0592850C,16,16,0,0,3,13,3 ème
NORD,HALLUIN,0593125B,80,80,0,0,42,38,3 ème
NORD,HAUBOURDIN,0594386X,113,113,0,0,52,61,3 ème
NORD,HAZEBROUCK,0590103S,153,136,14,3,80,73,3 ème
NORD,HEM,0594632P,143,127,12,4,72,71,3 ème
NORD,HONDSCHOOTE,0593130G,46,46,0,0,22,24,3 ème
NORD,HONDSCHOOTE,0594642A,104,104,0,0,42,62,3 ème
NORD,JEUMONT,0593132J,67,64,0,3,36,31,3 ème
NORD,JEUMONT,0594418G,72,72,0,0,34,38,3 ème
NORD,LA BASSEE,0590252D,24,24,0,0,17,7,3 ème
NORD,LA BASSEE,0593231S,207,192,15,0,103,104,3 ème
NORD,LALLAING,0593482P,89,72,14,3,47,42,3 ème
NORD,LAMBERSART,0593015G,54,53,0,1,25,29,3 ème
NORD,LAMBERSART,0593134L,164,164,0,0,93,71,3 ème
NORD,LILLE,0590271Z,104,91,13,0,40,64,3 ème
NORD,LILLE,0593177H,60,45,15,0,22,38,3 ème
NORD,LILLE,0593180L,204,191,10,3,90,114,3 ème
NORD,LILLE,0594881K,104,102,0,2,54,50,3 ème
NORD,LILLE,0595396V,98,94,0,4,49,49,3 ème
NORD,LOOS,0593030Y,24,24,0,0,17,7,3 ème
NORD,LYS-LEZ-LANNOY,0593240B,179,158,15,6,88,91,3 ème
NORD,LYS-LEZ-LANNOY,0594380R,10,0,10,0,4,6,3 ème
NORD,MARCHIENNES,0590142J,77,77,0,0,33,44,3 ème
NORD,MARCQ-EN-BAROEUL,0594287P,93,78,12,3,43,50,3 ème
NORD,MARLY,0594302F,22,22,0,0,1,21,3 ème
NORD,MORTAGNE-DU-NORD,0594410Y,66,66,0,0,24,42,3 ème
NORD,NEUVILLE-EN-FERRAIN,0594833H,111,111,0,0,60,51,3 ème
NORD,ORCHIES,0590159C,228,213,15,0,95,133,3 ème
NORD,OSTRICOURT,0594290T,86,76,10,0,45,41,3 ème
NORD,POIX-DU-NORD,0594876E,64,64,0,0,32,32,3 ème
NORD,ROUBAIX,0590187H,16,16,0,0,0,16,3 ème
NORD,ROUBAIX,0592907P,138,135,0,3,69,69,3 ème
NORD,ROUBAIX,0592964B,18,18,0,0,1,17,3 ème
NORD,SAINT-AMAND-LES-EAUX,0594304H,119,119,0,0,59,60,3 ème
NORD,SOLESMES,0594648G,162,149,11,2,83,79,3 ème
NORD,TOURCOING,0593140T,160,160,0,0,75,85,3 ème
NORD,TOURCOING,0594293W,141,141,0,0,74,67,3 ème
NORD,TOURCOING,0596846W,183,183,0,0,99,84,3 ème
NORD,TOURCOING,0596860L,178,163,15,0,90,88,3 ème
NORD,TRELON,0594308M,75,75,0,0,38,37,3 ème
NORD,TRITH-SAINT-LEGER,0594534H,57,57,0,0,34,23,3 ème
NORD,VALENCIENNES,0592715F,126,124,0,2,62,64,3 ème
NORD,WALINCOURT-SELVIGNY,0590228C,88,85,0,3,50,38,3 ème
NORD,WAVRIN,0593475G,110,110,0,0,59,51,3 ème
NORD,WORMHOUT,0593163T,60,60,0,0,34,26,3 ème
PAS-DE-CALAIS,ACHICOURT,0622863A,135,118,16,1,70,65,3 ème
PAS-DE-CALAIS,ARQUES,0622093N,146,146,0,0,73,73,3 ème
PAS-DE-CALAIS,ARRAS,0622082B,101,97,0,4,57,44,3 ème
PAS-DE-CALAIS,ARRAS,0622103Z,132,132,0,0,70,62,3 ème
PAS-DE-CALAIS,ARRAS,0623310L,100,100,0,0,40,60,3 ème
PAS-DE-CALAIS,AUCHY-LES-MINES,0622946R,103,103,0,0,46,57,3 ème
PAS-DE-CALAIS,AUDRUICQ,0620024P,142,127,12,3,72,70,3 ème
PAS-DE-CALAIS,BERCK,0622128B,71,71,0,0,35,36,3 ème
PAS-DE-CALAIS,BEUVRY,0622090K,202,186,16,0,93,109,3 ème
PAS-DE-CALAIS,BILLY-MONTIGNY,0622793Z,119,104,15,0,52,67,3 ème
PAS-DE-CALAIS,BOULOGNE-SUR-MER,0622130D,132,132,0,0,78,54,3 ème
PAS-DE-CALAIS,BRUAY-LA-BUISSIERE,0620192X,24,24,0,0,9,15,3 ème
PAS-DE-CALAIS,CALAIS,0620196B,86,86,0,0,41,45,3 ème
PAS-DE-CALAIS,CALAIS,0622273J,82,62,20,0,43,39,3 ème
PAS-DE-CALAIS,CALAIS,0623918X,103,103,0,0,47,56,3 ème
PAS-DE-CALAIS,CALONNE-RICOUART,0620068M,90,90,0,0,48,42,3 ème
PAS-DE-CALAIS,CARVIN,0620071R,131,115,16,0,65,66,3 ème
PAS-DE-CALAIS,CARVIN,0622134H,173,173,0,0,82,91,3 ème
PAS-DE-CALAIS,ETAPLES,0622136K,72,72,0,0,28,44,3 ème
PAS-DE-CALAIS,FAUQUEMBERGUES,0620082C,68,68,0,0,36,32,3 ème
PAS-DE-CALAIS,FREVENT,0622137L,41,41,0,0,18,23,3 ème
PAS-DE-CALAIS,GRENAY,0622424Y,119,103,16,0,63,56,3 ème
PAS-DE-CALAIS,GUINES,0620088J,102,88,14,0,55,47,3 ème
PAS-DE-CALAIS,HENIN-BEAUMONT,0622795B,169,151,15,3,79,90,3 ème
PAS-DE-CALAIS,HEUCHIN,0622866D,53,53,0,0,24,29,3 ème
PAS-DE-CALAIS,LENS,0622417R,126,126,0,0,74,52,3 ème
PAS-DE-CALAIS,LUMBRES,0622574L,220,202,16,2,101,119,3 ème
PAS-DE-CALAIS,OIGNIES,0620150B,24,24,0,0,11,13,3 ème
PAS-DE-CALAIS,OYE-PLAGE,0623759Z,104,104,0,0,46,58,3 ème
PAS-DE-CALAIS,SAINS-EN-GOHELLE,0622578R,90,90,0,0,44,46,3 ème
PAS-DE-CALAIS,SAINT-MARTIN-BOULOGNE,0623573X,120,120,0,0,55,65,3 ème
PAS-DE-CALAIS,SAINT-OMER,0620162P,24,24,0,0,10,14,3 ème
PAS-DE-CALAIS,SAINT-VENANT,0622091L,110,110,0,0,45,65,3 ème
PAS-DE-CALAIS,SALLAUMINES,0620220C,25,25,0,0,10,15,3 ème
PAS-DE-CALAIS,SAMER,0622950V,137,137,0,0,71,66,3 ème
SEINE-ET-MARNE,BRAY-SUR-SEINE,0770003K,136,136,0,0,72,64,3 ème
SEINE-ET-MARNE,BUSSY-SAINT-GEORGES,0772226B,131,131,0,0,60,71,3 ème
SEINE-ET-MARNE,BUSSY-SAINT-GEORGES,0772601J,91,91,0,0,48,43,3 ème
SEINE-ET-MARNE,CHAMPAGNE-SUR-SEINE,0770920G,43,43,0,0,21,22,3 ème
SEINE-ET-MARNE,CHELLES,0771471F,212,211,0,1,107,105,3 ème
SEINE-ET-MARNE,CHELLES,0771759U,176,160,16,0,83,93,3 ème
SEINE-ET-MARNE,COMBS-LA-VILLE,0771959L,158,158,0,0,77,81,3 ème
SEINE-ET-MARNE,COUILLY-PONT-AUX-DAMES,0771236A,44,44,0,0,18,26,3 ème
SEINE-ET-MARNE,COULOMMIERS,0771233X,55,55,0,0,33,22,3 ème
SEINE-ET-MARNE,CROUY-SUR-OURCQ,0772246Y,70,52,14,4,28,42,3 ème
SEINE-ET-MARNE,EMERAINVILLE,0772119K,119,119,0,0,52,67,3 ème
SEINE-ET-MARNE,FAREMOUTIERS,0771519H,140,140,0,0,71,69,3 ème
SEINE-ET-MARNE,FONTAINEBLEAU,0771200L,30,30,0,0,13,17,3 ème
SEINE-ET-MARNE,LA ROCHETTE,0770943G,31,31,0,0,5,26,3 ème
SEINE-ET-MARNE,LESIGNY,0771421B,201,200,0,1,101,100,3 ème
SEINE-ET-MARNE,LOGNES,0771992X,150,144,0,6,78,72,3 ème
SEINE-ET-MARNE,MEAUX,0770032S,160,159,0,1,73,87,3 ème
SEINE-ET-MARNE,MEAUX,0771880A,20,20,0,0,7,13,3 ème
SEINE-ET-MARNE,MEAUX,0772153X,20,19,0,1,8,12,3 ème
SEINE-ET-MARNE,MELUN,0771339M,198,162,31,5,91,107,3 ème
SEINE-ET-MARNE,MITRY-MORY,0772573D,196,196,0,0,97,99,3 ème
SEINE-ET-MARNE,MONTEREAU-FAULT-YONNE,0771761W,152,152,0,0,83,69,3 ème
SEINE-ET-MARNE,MORMANT,0771620T,183,176,0,7,92,91,3 ème
SEINE-ET-MARNE,NEMOURS,0771478N,161,126,32,3,73,88,3 ème
SEINE-ET-MARNE,OISSERY,0771912K,135,114,16,5,60,75,3 ème
SEINE-ET-MARNE,PONTAULT-COMBAULT,0772331R,139,129,0,10,54,85,3 ème
SEINE-ET-MARNE,PROVINS,0771216D,96,96,0,0,52,44,3 ème
SEINE-ET-MARNE,PROVINS,0772481D,75,72,0,3,35,40,3 ème
SEINE-ET-MARNE,ROISSY-EN-BRIE,0771657H,188,158,25,5,102,86,3 ème
SEINE-ET-MARNE,SAINT-MARD,0771615M,113,113,0,0,57,56,3 ème
SEINE-ET-MARNE,SAVIGNY-LE-TEMPLE,0771518G,173,173,0,0,83,90,3 ème
SEINE-ET-MARNE,TORCY,0771656G,144,125,16,3,77,67,3 ème
SEINE-ET-MARNE,TOURNAN-EN-BRIE,0770051M,213,181,29,3,107,106,3 ème
SEINE-ET-MARNE,VILLENEUVE-SUR-BELLOT,0770057U,91,85,0,6,35,56,3 ème
SEINE-ET-MARNE,VILLEPARISIS,0771333F,125,125,0,0,67,58,3 ème
SEINE-SAINT-DENIS,AUBERVILLIERS,0932043R,42,42,0,0,16,26,3 ème
SEINE-SAINT-DENIS,AULNAY-SOUS-BOIS,0931189M,156,154,0,2,75,81,3 ème
SEINE-SAINT-DENIS,BAGNOLET,0931181D,150,135,12,3,72,78,3 ème
SEINE-SAINT-DENIS,BAGNOLET,0931220W,120,120,0,0,64,56,3 ème
SEINE-SAINT-DENIS,BOBIGNY,0931195U,146,144,0,2,73,73,3 ème
SEINE-SAINT-DENIS,BOBIGNY,0931844Z,89,89,0,0,89,0,3 ème
SEINE-SAINT-DENIS,BOBIGNY,0932123C,9,9,0,0,5,4,3 ème
SEINE-SAINT-DENIS,BONDY,0930933J,19,19,0,0,8,11,3 ème
SEINE-SAINT-DENIS,BONDY,0931788N,141,139,0,2,67,74,3 ème
SEINE-SAINT-DENIS,CLICHY-SOUS-BOIS,0931221X,172,143,29,0,78,94,3 ème
SEINE-SAINT-DENIS,DRANCY,0930907F,96,96,0,0,50,46,3 ème
SEINE-SAINT-DENIS,DRANCY,0931202B,140,140,0,0,77,63,3 ème
SEINE-SAINT-DENIS,DRANCY,0931377S,184,173,11,0,81,103,3 ème
SEINE-SAINT-DENIS,GAGNY,0930858C,164,164,0,0,71,93,3 ème
SEINE-SAINT-DENIS,LA COURNEUVE,0931148T,193,175,16,2,94,99,3 ème
SEINE-SAINT-DENIS,LE BLANC-MESNIL,0931204D,190,190,0,0,86,104,3 ème
SEINE-SAINT-DENIS,LE BLANC-MESNIL,0931433C,181,167,14,0,84,97,3 ème
SEINE-SAINT-DENIS,LE BOURGET,0930963S,50,50,0,0,22,28,3 ème
SEINE-SAINT-DENIS,LE BOURGET,0931187K,156,151,0,5,77,79,3 ème
SEINE-SAINT-DENIS,LES PAVILLONS-SOUS-BOIS,0930100D,101,100,0,1,52,49,3 ème
SEINE-SAINT-DENIS,LES PAVILLONS-SOUS-BOIS,0930136T,30,30,0,0,10,20,3 ème
SEINE-SAINT-DENIS,LIVRY-GARGAN,0932695Z,164,159,0,5,66,98,3 ème
SEINE-SAINT-DENIS,MONTREUIL,0930912L,56,56,0,0,27,29,3 ème
SEINE-SAINT-DENIS,MONTREUIL,0930960N,33,33,0,0,13,20,3 ème
SEINE-SAINT-DENIS,MONTREUIL,0931209J,120,120,0,0,52,68,3 ème
SEINE-SAINT-DENIS,NOISY-LE-GRAND,0931978V,139,139,0,0,62,77,3 ème
SEINE-SAINT-DENIS,NOISY-LE-SEC,0930133P,41,41,0,0,14,27,3 ème
SEINE-SAINT-DENIS,PANTIN,0930135S,30,30,0,0,9,21,3 ème
SEINE-SAINT-DENIS,PANTIN,0931216S,122,122,0,0,61,61,3 ème
SEINE-SAINT-DENIS,PANTIN,0931528F,170,161,9,0,75,95,3 ème
SEINE-SAINT-DENIS,SAINT-DENIS,0931489N,123,110,12,1,57,66,3 ème
SEINE-SAINT-DENIS,SAINT-OUEN,0931143M,175,159,16,0,92,83,3 ème
SEINE-SAINT-DENIS,STAINS,0931226C,178,163,15,0,75,103,3 ème
SEINE-SAINT-DENIS,TREMBLAY-EN-FRANCE,0931191P,157,152,0,5,80,77,3 ème
SEINE-SAINT-DENIS,VILLEPINTE,0932263E,143,143,0,0,75,68,3 ème
SEINE-SAINT-DENIS,VILLETANEUSE,0932334G,118,118,0,0,55,63,3 ème
VAL-DE-MARNE,ALFORTVILLE,0941021Z,121,118,0,3,59,62,3 ème
VAL-DE-MARNE,BOISSY-SAINT-LEGER,0941478W,101,101,0,0,45,56,3 ème
VAL-DE-MARNE,CACHAN,0940823J,19,19,0,0,7,12,3 ème
VAL-DE-MARNE,CACHAN,0941100K,133,133,0,0,55,78,3 ème
VAL-DE-MARNE,CACHAN,0941101L,114,112,0,2,60,54,3 ème
VAL-DE-MARNE,CHAMPIGNY-SUR-MARNE,0940132H,10,10,0,0,4,6,3 ème
VAL-DE-MARNE,CHAMPIGNY-SUR-MARNE,0940807S,77,77,0,0,41,36,3 ème
VAL-DE-MARNE,CHAMPIGNY-SUR-MARNE,0941951K,24,24,0,0,10,14,3 ème
VAL-DE-MARNE,CHAMPIGNY-SUR-MARNE,0942499F,0,0,0,0,0,0,3 ème
VAL-DE-MARNE,CHENNEVIERES-SUR-MARNE,0941470M,23,23,0,0,8,15,3 ème
VAL-DE-MARNE,CHEVILLY-LARUE,0940071S,144,143,0,1,63,81,3 ème
VAL-DE-MARNE,CHEVILLY-LARUE,0940581W,118,118,0,0,62,56,3 ème
VAL-DE-MARNE,CHOISY-LE-ROI,0941231C,103,102,0,1,52,51,3 ème
VAL-DE-MARNE,CHOISY-LE-ROI,0941232D,24,24,0,0,11,13,3 ème
VAL-DE-MARNE,CRETEIL,0940114N,36,36,0,0,14,22,3 ème
VAL-DE-MARNE,CRETEIL,0941942A,31,31,0,0,0,31,3 ème
VAL-DE-MARNE,FONTENAY-SOUS-BOIS,0941090Z,133,133,0,0,71,62,3 ème
VAL-DE-MARNE,FRESNES,0940101Z,100,100,0,0,53,47,3 ème
VAL-DE-MARNE,IVRY-SUR-SEINE,0941026E,113,113,0,0,73,40,3 ème
VAL-DE-MARNE,JOINVILLE-LE-PONT,0940038F,94,94,0,0,44,50,3 ème
VAL-DE-MARNE,JOINVILLE-LE-PONT,0942355Z,10,10,0,0,3,7,3 ème
VAL-DE-MARNE,LA QUEUE-EN-BRIE,0941410X,156,156,0,0,83,73,3 ème
VAL-DE-MARNE,LIMEIL-BREVANNES,0941783C,151,146,0,5,74,77,3 ème
VAL-DE-MARNE,MANDRES-LES-ROSES,0942187S,101,101,0,0,51,50,3 ème
VAL-DE-MARNE,NOGENT-SUR-MARNE,0941599C,114,114,0,0,57,57,3 ème
VAL-DE-MARNE,ORLY,0940138P,34,34,0,0,17,17,3 ème
VAL-DE-MARNE,ORLY,0941042X,148,145,0,3,80,68,3 ème
VAL-DE-MARNE,ORLY,0941891V,34,32,0,2,16,18,3 ème
VAL-DE-MARNE,SUCY-EN-BRIE,0940617K,191,177,14,0,89,102,3 ème
VAL-DE-MARNE,SUCY-EN-BRIE,0941716E,181,181,0,0,84,97,3 ème
VAL-DE-MARNE,THIAIS,0940575P,171,137,32,2,88,83,3 ème
VAL-DE-MARNE,THIAIS,0942119T,19,19,0,0,6,13,3 ème
VAL-DE-MARNE,VILLEJUIF,0941036R,122,122,0,0,60,62,3 ème
VAL-DE-MARNE,VINCENNES,0941718G,140,140,0,0,79,61,3 ème
VAL-DE-MARNE,VITRY-SUR-SEINE,0940042K,119,117,0,2,62,57,3 ème
VAL-DE-MARNE,VITRY-SUR-SEINE,0940794C,99,99,0,0,48,51,3 ème
VAL-DE-MARNE,VITRY-SUR-SEINE,0941029H,160,157,0,3,70,90,3 ème
PARIS,PARIS,0752923V,175,175,0,0,76,99,3 ème
PARIS,PARIS,0750608D,117,115,0,2,49,68,3 ème
PARIS,PARIS,0754290F,52,48,0,4,17,35,3 ème
PARIS,PARIS,0752845K,32,32,0,0,7,25,3 ème
PARIS,PARIS,0750525N,116,114,0,2,55,61,3 ème
PARIS,PARIS,0751710B,26,26,0,0,7,19,3 ème
PARIS,PARIS,0752385K,118,101,16,1,60,58,3 ème
PARIS,PARIS,0752539C,119,113,0,6,62,57,3 ème
PARIS,PARIS,0751563S,103,102,0,1,56,47,3 ème
PARIS,PARIS,0752190Y,128,111,16,1,60,68,3 ème
PARIS,PARIS,0756020L,39,6,0,33,15,24,3 ème
PARIS,PARIS,0752551R,150,145,0,5,64,86,3 ème
PARIS,PARIS,0752917N,184,184,0,0,91,93,3 ème
PARIS,PARIS,0753217P,30,9,0,21,9,21,3 ème
PARIS,PARIS,0755192L,27,27,0,0,16,11,3 ème
PARIS,PARIS,0752319N,213,211,0,2,107,106,3 ème
PARIS,PARIS,0754239A,16,16,0,0,9,7,3 ème
PARIS,PARIS,0755030K,71,67,0,4,30,41,3 ème
PARIS,PARIS,0750484U,71,70,0,1,32,39,3 ème
PARIS,PARIS,0750507U,163,147,16,0,94,69,3 ème
PARIS,PARIS,0750802P,56,56,0,0,11,45,3 ème
PARIS,PARIS,0753345D,111,105,0,6,64,47,3 ème
PARIS,PARIS,0754003U,98,98,0,0,47,51,3 ème
PARIS,PARIS,0755095F,93,89,0,4,52,41,3 ème
PARIS,PARIS,0750550R,95,93,0,2,38,57,3 ème
PARIS,PARIS,0753387Z,10,10,0,0,2,8,3 ème
PARIS,PARIS,0750770E,51,51,0,0,18,33,3 ème
PARIS,PARIS,0752523K,86,86,0,0,49,37,3 ème
PARIS,PARIS,0752524L,110,110,0,0,69,41,3 ème
PARIS,PARIS,0752913J,92,92,0,0,53,39,3 ème
PARIS,PARIS,0753840S,9,0,0,9,2,7,3 ème
PARIS,PARIS,0754757N,99,99,0,0,62,37,3 ème
PARIS,PARIS,0752894N,125,125,0,0,70,55,3 ème
PARIS,PARIS,0752899U,130,130,0,0,67,63,3 ème
PARIS,PARIS,0752842G,270,267,0,3,157,113,3 ème
PARIS,PARIS,0752250N,115,115,0,0,48,67,3 ème
ESSONNE,BOUSSY-SAINT-ANTOINE,0911022S,202,202,0,0,109,93,3 ème
ESSONNE,BRETIGNY-SUR-ORGE,0910827E,131,131,0,0,59,72,3 ème
ESSONNE,BRIIS-SOUS-FORGES,0911920T,128,128,0,0,70,58,3 ème
ESSONNE,BRUNOY,0911746D,255,255,0,0,135,120,3 ème
ESSONNE,CHILLY-MAZARIN,0910777A,197,191,0,6,104,93,3 ème
ESSONNE,CORBEIL-ESSONNES,0910752Y,150,150,0,0,76,74,3 ème
ESSONNE,DOURDAN,0911015J,103,103,0,0,65,38,3 ème
ESSONNE,EVRY-COURCOURONNES,0911250P,111,106,0,5,53,58,3 ème
ESSONNE,EVRY-COURCOURONNES,0911729K,152,150,0,2,82,70,3 ème
ESSONNE,GIF-SUR-YVETTE,0910024G,154,151,0,3,55,99,3 ème
ESSONNE,GRIGNY,0912196T,166,164,0,2,78,88,3 ème
ESSONNE,GUIGNEVILLE-SUR-ESSONNE,0911574S,125,108,15,2,63,62,3 ème
ESSONNE,IGNY,0910969J,180,180,0,0,84,96,3 ème
ESSONNE,ITTEVILLE,0912109Y,156,156,0,0,77,79,3 ème
ESSONNE,MASSY,0910632T,23,23,0,0,10,13,3 ème
ESSONNE,MILLY-LA-FORET,0911404G,132,131,0,1,63,69,3 ème
ESSONNE,MONTGERON,0911396Y,152,137,15,0,69,83,3 ème
ESSONNE,MORANGIS,0910041A,178,174,0,4,97,81,3 ème
ESSONNE,ORSAY,0911749G,88,88,0,0,44,44,3 ème
ESSONNE,QUINCY-SOUS-SENART,0911493D,24,24,0,0,7,17,3 ème
ESSONNE,RIS-ORANGIS,0910049J,204,201,0,3,87,117,3 ème
ESSONNE,RIS-ORANGIS,0911025V,259,237,16,6,134,125,3 ème
ESSONNE,RIS-ORANGIS,0911578W,23,23,0,0,6,17,3 ème
ESSONNE,SAINTE-GENEVIEVE-DES-BOIS,0911042N,194,190,0,4,103,91,3 ème
ESSONNE,SAVIGNY-SUR-ORGE,0911889J,7,7,0,0,2,5,3 ème
ESSONNE,VIRY-CHATILLON,0910056S,111,111,0,0,54,57,3 ème
HAUTS-DE-SEINE,ANTONY,0921243B,88,88,0,0,48,40,3 ème
HAUTS-DE-SEINE,ANTONY,0921868F,114,114,0,0,50,64,3 ème
HAUTS-DE-SEINE,ANTONY,0921901S,393,391,0,2,195,198,3 ème
HAUTS-DE-SEINE,BAGNEUX,0921903U,67,67,0,0,38,29,3 ème
HAUTS-DE-SEINE,BOIS-COLOMBES,0922629H,154,151,0,3,78,76,3 ème
HAUTS-DE-SEINE,BOULOGNE-BILLANCOURT,0921236U,205,202,0,3,96,109,3 ème
HAUTS-DE-SEINE,BOULOGNE-BILLANCOURT,0921239X,190,178,12,0,93,97,3 ème
HAUTS-DE-SEINE,CHATILLON,0920880G,142,123,16,3,71,71,3 ème
HAUTS-DE-SEINE,CLICHY,0921228K,212,199,9,4,99,113,3 ème
HAUTS-DE-SEINE,CLICHY,0922595W,158,155,0,3,71,87,3 ème
HAUTS-DE-SEINE,COLOMBES,0921494Z,130,127,0,3,61,69,3 ème
HAUTS-DE-SEINE,COLOMBES,0921675W,121,108,11,2,56,65,3 ème
HAUTS-DE-SEINE,COLOMBES,0921908Z,232,220,12,0,114,118,3 ème
HAUTS-DE-SEINE,COLOMBES,0922662U,126,126,0,0,63,63,3 ème
HAUTS-DE-SEINE,COURBEVOIE,0921496B,143,122,16,5,57,86,3 ème
HAUTS-DE-SEINE,COURBEVOIE,0922482Y,49,49,0,0,0,49,3 ème
HAUTS-DE-SEINE,COURBEVOIE,0922523T,143,140,0,3,52,91,3 ème
HAUTS-DE-SEINE,GENNEVILLIERS,0921621M,179,178,0,1,87,92,3 ème
HAUTS-DE-SEINE,LEVALLOIS-PERRET,0922630J,157,153,0,4,73,84,3 ème
HAUTS-DE-SEINE,MALAKOFF,0920163C,24,23,0,1,8,16,3 ème
HAUTS-DE-SEINE,MEUDON,0921909A,78,78,0,0,40,38,3 ème
HAUTS-DE-SEINE,MEUDON,0922701L,158,148,10,0,78,80,3 ème
HAUTS-DE-SEINE,MONTROUGE,0920164D,23,23,0,0,13,10,3 ème
HAUTS-DE-SEINE,MONTROUGE,0921190U,104,102,0,2,56,48,3 ème
HAUTS-DE-SEINE,NANTERRE,0920077J,163,149,14,0,80,83,3 ème
HAUTS-DE-SEINE,NANTERRE,0920882J,122,122,0,0,56,66,3 ème
HAUTS-DE-SEINE,NANTERRE,0921353W,140,137,0,3,64,76,3 ème
HAUTS-DE-SEINE,NEUILLY-SUR-SEINE,0921015D,97,97,0,0,41,56,3 ème
HAUTS-DE-SEINE,PUTEAUX,0921500F,15,15,0,0,4,11,3 ème
HAUTS-DE-SEINE,RUEIL-MALMAISON,0921234S,132,132,0,0,68,64,3 ème
HAUTS-DE-SEINE,RUEIL-MALMAISON,0921502H,141,138,0,3,76,65,3 ème
HAUTS-DE-SEINE,SAINT-CLOUD,0922276Z,23,23,0,0,11,12,3 ème
HAUTS-DE-SEINE,SCEAUX,0921785R,164,164,0,0,67,97,3 ème
HAUTS-DE-SEINE,SURESNES,0920884L,193,187,0,6,97,96,3 ème
HAUTS-DE-SEINE,VAUCRESSON,0921935D,44,44,0,0,16,28,3 ème
HAUTS-DE-SEINE,VAUCRESSON,0922143E,79,79,0,0,42,37,3 ème
HAUTS-DE-SEINE,VILLENEUVE-LA-GARENNE,0922277A,14,14,0,0,6,8,3 ème
VAL-D'OISE,ARGENTEUIL,0950800D,47,47,0,0,26,21,3 ème
VAL-D'OISE,ARGENTEUIL,0951138W,152,147,0,5,69,83,3 ème
VAL-D'OISE,ARGENTEUIL,0951139X,113,109,0,4,55,58,3 ème
VAL-D'OISE,ARGENTEUIL,0951230W,148,136,10,2,74,74,3 ème
VAL-D'OISE,ARGENTEUIL,0952114G,174,170,0,4,76,98,3 ème
VAL-D'OISE,BEAUMONT-SUR-OISE,0950933Y,148,146,0,2,78,70,3 ème
VAL-D'OISE,BERNES-SUR-OISE,0952087C,118,118,0,0,61,57,3 ème
VAL-D'OISE,BEZONS,0950888Z,194,178,13,3,100,94,3 ème
VAL-D'OISE,BOUFFEMONT,0951822P,101,101,0,0,50,51,3 ème
VAL-D'OISE,ERMONT,0950657Y,24,24,0,0,11,13,3 ème
VAL-D'OISE,EZANVILLE,0952127W,159,159,0,0,83,76,3 ème
VAL-D'OISE,FRANCONVILLE,0950812S,32,32,0,0,6,26,3 ème
VAL-D'OISE,GOUSSAINVILLE,0950026M,186,168,15,3,98,88,3 ème
VAL-D'OISE,HERBLAY,0950932X,215,202,11,2,95,120,3 ème
VAL-D'OISE,LOUVRES,0950908W,131,126,0,5,62,69,3 ème
VAL-D'OISE,LUZARCHES,0951357J,173,170,0,3,84,89,3 ème
VAL-D'OISE,MERY-SUR-OISE,0951725J,144,140,0,4,65,79,3 ème
VAL-D'OISE,MONTIGNY-LES-CORMEILLES,0951800R,154,154,0,0,74,80,3 ème
VAL-D'OISE,PONTOISE,0950894F,161,159,0,2,77,84,3 ème
VAL-D'OISE,PONTOISE,0951507X,118,118,0,0,46,72,3 ème
VAL-D'OISE,SANNOIS,0951508Y,156,156,0,0,87,69,3 ème
VAL-D'OISE,SARCELLES,0950900M,94,90,0,4,50,44,3 ème
VAL-D'OISE,SARCELLES,0950943J,115,98,13,4,58,57,3 ème
VAL-D'OISE,SARCELLES,0951196J,153,150,0,3,70,83,3 ème
VAL-D'OISE,SOISY-SOUS-MONTMORENCY,0950046J,117,117,0,0,58,59,3 ème
VAL-D'OISE,TAVERNY,0951197K,206,204,0,2,103,103,3 ème
VAL-D'OISE,VILLIERS-LE-BEL,0950749Y,133,123,0,10,59,74,3 ème
YVELINES,ACHERES,0783636D,108,108,0,0,53,55,3 ème
YVELINES,BEYNES,0780713B,195,195,0,0,98,97,3 ème
YVELINES,BUC,0780715D,175,175,0,0,75,100,3 ème
YVELINES,BUC,0783546F,91,91,0,0,45,46,3 ème
YVELINES,CARRIERES-SOUS-POISSY,0780032L,112,112,0,0,49,63,3 ème
YVELINES,CARRIERES-SOUS-POISSY,0781817B,87,87,0,0,42,45,3 ème
YVELINES,CHANTELOUP-LES-VIGNES,0781108F,81,71,10,0,47,34,3 ème
YVELINES,CHATOU,0780575B,114,114,0,0,48,66,3 ème
YVELINES,ECQUEVILLY,0781915H,137,134,0,3,76,61,3 ème
YVELINES,ELANCOURT,0782114Z,135,133,0,2,70,65,3 ème
YVELINES,LE MESNIL-SAINT-DENIS,0780512H,132,129,0,3,64,68,3 ème
YVELINES,LES MUREAUX,0780180X,149,149,0,0,73,76,3 ème
YVELINES,MAISONS-LAFFITTE,0780112Y,102,102,0,0,60,42,3 ème
YVELINES,MANTES-LA-VILLE,0783533S,21,21,0,0,10,11,3 ème
YVELINES,MAUREPAS,0780720J,159,156,0,3,69,90,3 ème
YVELINES,MONTFORT-L'AMAURY,0781600R,161,161,0,0,78,83,3 ème
YVELINES,MONTIGNY-LE-BRETONNEUX,0781662H,244,228,16,0,124,120,3 ème
YVELINES,MONTIGNY-LE-BRETONNEUX,0782087V,121,121,0,0,72,49,3 ème
YVELINES,ORGERUS,0781864C,164,163,0,1,74,90,3 ème
YVELINES,POISSY,0781983G,42,42,0,0,15,27,3 ème
YVELINES,PORCHEVILLE,0781948U,17,17,0,0,0,17,3 ème
YVELINES,RAMBOUILLET,0780256E,167,152,15,0,94,73,3 ème
YVELINES,RAMBOUILLET,0781886B,192,190,0,2,79,113,3 ème
YVELINES,SAINT-GERMAIN-EN-LAYE,0780714C,203,203,0,0,101,102,3 ème
YVELINES,SAINT-GERMAIN-EN-LAYE,0781205L,226,226,0,0,111,115,3 ème
YVELINES,SARTROUVILLE,0783463R,139,136,0,3,68,71,3 ème
YVELINES,TRAPPES,0780187E,134,118,15,1,71,63,3 ème
YVELINES,VELIZY-VILLACOUBLAY,0780265P,142,129,13,0,63,79,3 ème
YVELINES,VERNEUIL-SUR-SEINE,0781537X,255,254,0,1,128,127,3 ème
YVELINES,VILLIERS-SAINT-FREDERIC,0782587N,47,47,0,0,17,30,3 ème
LA REUNION,ENTRE-DEUX,9740006N,112,111,0,1,52,60,3 ème
LA REUNION,LA POSSESSION,9740909V,242,210,32,0,106,136,3 ème
LA REUNION,LES TROIS-BASSINS,9740085Z,120,117,0,3,65,55,3 ème
LA REUNION,L'ETANG-SALE,9741387P,157,153,0,4,68,89,3 ème
LA REUNION,PETITE-ILE,9740654T,186,180,0,6,94,92,3 ème
LA REUNION,SAINT-ANDRE,9740703W,178,176,0,2,95,83,3 ème
LA REUNION,SAINT-DENIS,9740072K,343,343,0,0,149,194,3 ème
LA REUNION,SAINT-DENIS,9740595D,126,119,0,7,62,64,3 ème
LA REUNION,SAINT-DENIS,9740645H,237,217,16,4,95,142,3 ème
LA REUNION,SAINT-DENIS,9741308D,18,18,0,0,7,11,3 ème
LA REUNION,SAINTE-MARIE,9740735F,191,157,29,5,84,107,3 ème
LA REUNION,SAINTE-MARIE,9741323V,208,208,0,0,103,105,3 ème
LA REUNION,SAINTE-SUZANNE,9740679V,13,13,0,0,7,6,3 ème
LA REUNION,SAINT-LOUIS,9740841W,218,185,32,1,104,114,3 ème
LA REUNION,SAINT-PAUL,9741763Y,0,0,0,0,0,0,3 ème
LA REUNION,SAINT-PIERRE,9740027L,211,209,0,2,112,99,3 ème
LA REUNION,SAINT-PIERRE,9740835P,309,307,0,2,172,137,3 ème
LA REUNION,SAINT-PIERRE,9741049X,140,136,0,4,73,67,3 ème
LA REUNION,SALAZIE,9740651P,122,103,14,5,51,71,3 ème
MARTINIQUE,FORT-DE-FRANCE,9720007A,73,73,0,0,36,37,3 ème
MARTINIQUE,FORT-DE-FRANCE,9720515C,15,15,0,0,6,9,3 ème
MARTINIQUE,FORT-DE-FRANCE,9720682J,106,92,12,2,63,43,3 ème
MARTINIQUE,FORT-DE-FRANCE,9720897T,77,77,0,0,34,43,3 ème
MARTINIQUE,LA TRINITE,9720430K,11,11,0,0,6,5,3 ème
MARTINIQUE,LE FRANCOIS,9720428H,139,119,15,5,64,75,3 ème
MARTINIQUE,LE LAMENTIN,9720072W,116,116,0,0,71,45,3 ème
MARTINIQUE,LE LAMENTIN,9720083H,114,105,0,9,53,61,3 ème
MARTINIQUE,LE LAMENTIN,9720470D,159,138,17,4,82,77,3 ème
MARTINIQUE,LE LAMENTIN,9720848P,51,47,0,4,26,25,3 ème
MARTINIQUE,LE MARIGOT,9720028Y,35,35,0,0,22,13,3 ème
MARTINIQUE,LE MORNE-ROUGE,9720016K,30,30,0,0,11,19,3 ème
MARTINIQUE,LE ROBERT,9720043P,79,79,0,0,40,39,3 ème
MARTINIQUE,SAINTE-MARIE,9720006Z,70,65,0,5,31,39,3 ème
MARTINIQUE,SAINTE-MARIE,9720692V,12,12,0,0,2,10,3 ème
MARTINIQUE,SCHOELCHER,9720455M,100,100,0,0,47,53,3 ème
MAYOTTE,DZAOUDZI,9760008E,475,444,26,5,261,214,3 ème
MAYOTTE,MAMOUDZOU,9760314M,397,396,0,1,207,190,3 ème
MAYOTTE,MTSAMBORO,9760230W,416,385,28,3,205,211,3 ème
CALVADOS,CAEN,0141159J,102,102,0,0,57,45,3 ème
CALVADOS,CAEN,0141554N,117,117,0,0,52,65,3 ème
CALVADOS,CAEN,0141810S,123,122,0,1,61,62,3 ème
CALVADOS,CAEN,0141866C,69,69,0,0,9,60,3 ème
CALVADOS,CAUMONT-SUR-AURE,0140038R,85,83,0,2,41,44,3 ème
CALVADOS,DIVES-SUR-MER,0141599M,25,25,0,0,2,23,3 ème
CALVADOS,HEROUVILLE-SAINT-CLAIR,0142173L,54,54,0,0,33,21,3 ème
CALVADOS,IFS,0142271T,202,172,25,5,93,109,3 ème
CALVADOS,LE HOM,0141641H,121,121,0,0,60,61,3 ème
CALVADOS,LE MOLAY-LITTRY,0141642J,74,74,0,0,34,40,3 ème
CALVADOS,LISIEUX,0141197A,43,43,0,0,11,32,3 ème
CALVADOS,LISIEUX,0141219Z,42,34,0,8,19,23,3 ème
CALVADOS,LISIEUX,0141275K,34,34,0,0,15,19,3 ème
CALVADOS,LISIEUX,0141868E,13,13,0,0,7,6,3 ème
CALVADOS,MONDEVILLE,0141256P,145,138,0,7,67,78,3 ème
CALVADOS,NOUES DE SIENNE,0140079K,45,45,0,0,21,24,3 ème
CALVADOS,ORBEC,0141171X,29,29,0,0,8,21,3 ème
CALVADOS,OUISTREHAM,0141271F,153,153,0,0,75,78,3 ème
CALVADOS,TREVIERES,0140082N,38,38,0,0,18,20,3 ème
CALVADOS,VILLERS-BOCAGE,0140088V,126,120,0,6,61,65,3 ème
EURE,BEUZEVILLE,0270006K,125,123,0,2,71,54,3 ème
EURE,CORMEILLES,0270013T,100,100,0,0,53,47,3 ème
EURE,EVREUX,0270019Z,174,168,0,6,81,93,3 ème
EURE,EVREUX,0271104D,123,121,0,2,59,64,3 ème
EURE,EVREUX,0271231S,167,167,0,0,75,92,3 ème
EURE,LES ANDELYS,0271585B,24,24,0,0,4,20,3 ème
EURE,LOUVIERS,0271119V,149,149,0,0,79,70,3 ème
EURE,PACY-SUR-EURE,0271322R,136,136,0,0,73,63,3 ème
EURE,VERNON,0271447B,124,124,0,0,65,59,3 ème
MANCHE,CANISY,0500011R,80,80,0,0,45,35,3 ème
MANCHE,CHERBOURG-EN-COTENTIN,0500024E,65,65,0,0,27,38,3 ème
MANCHE,CHERBOURG-EN-COTENTIN,0500080R,125,107,15,3,66,59,3 ème
MANCHE,CHERBOURG-EN-COTENTIN,0500140F,133,133,0,0,69,64,3 ème
MANCHE,CHERBOURG-EN-COTENTIN,0501702D,113,108,0,5,54,59,3 ème
MANCHE,GRANVILLE,0500036T,24,24,0,0,9,15,3 ème
MANCHE,GRANVILLE,0501705G,152,152,0,0,65,87,3 ème
MANCHE,MARIGNY-LE-LOZON,0500046D,84,81,0,3,44,40,3 ème
MANCHE,MONTEBOURG,0500047E,54,54,0,0,25,29,3 ème
MANCHE,MORTAIN-BOCAGE,0500144K,32,32,0,0,13,19,3 ème
MANCHE,SAINT-HILAIRE-DU-HARCOUET,0500087Y,24,24,0,0,3,21,3 ème
MANCHE,SARTILLY-BAIE-BOCAGE,0500075K,63,63,0,0,19,44,3 ème
MANCHE,SOURDEVAL,0500153V,32,32,0,0,21,11,3 ème
MANCHE,VILLEDIEU-LES-POELES-ROUFFIGNY,0500083U,93,80,10,3,47,46,3 ème
ORNE,ALENCON,0610693X,65,65,0,0,24,41,3 ème
ORNE,ALENCON,0610918S,151,133,16,2,85,66,3 ème
ORNE,ALENCON,0611091E,85,85,0,0,37,48,3 ème
ORNE,ARGENTAN,0610721C,11,11,0,0,6,5,3 ème
ORNE,BELLEME,0610010E,49,47,0,2,24,25,3 ème
ORNE,FLERS,0610021S,23,23,0,0,8,15,3 ème
ORNE,FLERS,0610057F,91,75,14,2,43,48,3 ème
ORNE,FLERS,0611092F,127,123,0,4,53,74,3 ème
ORNE,LA FERTE MACE,0610800N,73,72,0,1,41,32,3 ème
ORNE,MORTAGNE-AU-PERCHE,0610033E,111,98,10,3,64,47,3 ème
ORNE,REMALARD EN PERCHE,0610740Y,48,48,0,0,32,16,3 ème
ORNE,SEES,0610040M,67,64,0,3,34,33,3 ème
ORNE,TINCHEBRAY-BOCAGE,0610714V,34,34,0,0,12,22,3 ème
SEINE MARITIME,AUMALE,0761722J,82,82,0,0,48,34,3 ème
SEINE MARITIME,BIHOREL,0761692B,100,94,0,6,48,52,3 ème
SEINE MARITIME,DEVILLE-LES-ROUEN,0761727P,121,121,0,0,67,54,3 ème
SEINE MARITIME,DEVILLE-LES-ROUEN,0762202F,90,90,0,0,40,50,3 ème
SEINE MARITIME,DIEPPE,0760026R,94,77,14,3,46,48,3 ème
SEINE MARITIME,DIEPPE,0762569E,123,123,0,0,64,59,3 ème
SEINE MARITIME,EU,0760032X,17,17,0,0,2,15,3 ème
SEINE MARITIME,EU,0761730T,41,41,0,0,30,11,3 ème
SEINE MARITIME,FECAMP,0761704P,83,80,0,3,33,50,3 ème
SEINE MARITIME,GOURNAY-EN-BRAY,0760046M,153,135,14,4,73,80,3 ème
SEINE MARITIME,GRAND-COURONNE,0762080Y,72,56,13,3,34,38,3 ème
SEINE MARITIME,HARFLEUR,0762129B,129,129,0,0,63,66,3 ème
SEINE MARITIME,LE HAVRE,0760058A,23,23,0,0,0,23,3 ème
SEINE MARITIME,LE HAVRE,0761325C,107,98,0,9,44,63,3 ème
SEINE MARITIME,LE HAVRE,0761697G,89,86,0,3,42,47,3 ème
SEINE MARITIME,LE HAVRE,0761698H,70,65,0,5,29,41,3 ème
SEINE MARITIME,LE HAVRE,0761783A,55,55,0,0,21,34,3 ème
SEINE MARITIME,LE HAVRE,0762765T,24,24,0,0,1,23,3 ème
SEINE MARITIME,LE TREPORT,0762087F,122,118,0,4,55,67,3 ème
SEINE MARITIME,LUNERAY,0762199C,103,103,0,0,60,43,3 ème
SEINE MARITIME,OFFRANVILLE,0762125X,126,126,0,0,60,66,3 ème
SEINE MARITIME,PORT-JEROME-SUR-SEINE,0762176C,123,119,0,4,60,63,3 ème
SEINE MARITIME,ROUEN,0760100W,46,44,0,2,28,18,3 ème
SEINE MARITIME,ROUEN,0761745J,140,140,0,0,65,75,3 ème
SEINE MARITIME,ROUEN,0761780X,105,100,0,5,58,47,3 ème
SEINE MARITIME,ROUEN,0762566B,149,149,0,0,60,89,3 ème
SEINE MARITIME,SAINT-ETIENNE-DU-ROUVRAY,0762133F,106,106,0,0,49,57,3 ème
SEINE MARITIME,SAINT-VALERY-EN-CAUX,0760108E,108,88,17,3,45,63,3 ème
SEINE MARITIME,SOTTEVILLE-LES-ROUEN,0762211R,32,0,32,0,15,17,3 ème
SEINE MARITIME,YVETOT,0761338S,229,229,0,0,106,123,3 ème
DORDOGNE,BERGERAC,0240119Z,135,118,13,4,71,64,3 ème
DORDOGNE,COULOUNIEIX-CHAMIERS,0240047W,103,86,14,3,49,54,3 ème
DORDOGNE,LA COQUILLE,0240045U,26,26,0,0,14,12,3 ème
DORDOGNE,MAREUIL EN PERIGORD,0240016M,48,48,0,0,19,29,3 ème
DORDOGNE,PAYS DE BELVES,0240962R,77,68,9,0,34,43,3 ème
DORDOGNE,PERIGUEUX,0240029B,131,131,0,0,65,66,3 ème
DORDOGNE,PERIGUEUX,0241042C,174,174,0,0,89,85,3 ème
DORDOGNE,SAINT AULAYE-PUYMANGOU,0240055E,42,42,0,0,19,23,3 ème
DORDOGNE,TOCANE-SAINT-APRE,0240073Z,66,66,0,0,35,31,3 ème
DORDOGNE,VELINES,0240106K,59,59,0,0,32,27,3 ème
GIRONDE,ARCACHON,0332487Z,130,130,0,0,58,72,3 ème
GIRONDE,BAZAS,0330011H,17,17,0,0,10,7,3 ème
GIRONDE,BLANQUEFORT,0333129X,20,20,0,0,9,11,3 ème
GIRONDE,BORDEAUX,0330033G,16,16,0,0,11,5,3 ème
GIRONDE,BORDEAUX,0330140Y,161,142,16,3,78,83,3 ème
GIRONDE,BORDEAUX,0332285E,83,64,16,3,40,43,3 ème
GIRONDE,BORDEAUX,0332488A,252,250,0,2,122,130,3 ème
GIRONDE,BORDEAUX,0332746F,120,120,0,0,53,67,3 ème
GIRONDE,BRUGES,0333274E,140,135,0,5,61,79,3 ème
GIRONDE,CADAUJAC,0333133B,164,164,0,0,83,81,3 ème
GIRONDE,CENON,0331885V,169,148,17,4,80,89,3 ème
GIRONDE,LACANAU,0333287U,137,137,0,0,78,59,3 ème
GIRONDE,LA REOLE,0332248P,154,150,0,4,78,76,3 ème
GIRONDE,LA TESTE-DE-BUCH,0330129L,193,191,0,2,106,87,3 ème
GIRONDE,LATRESNE,0331620G,248,243,0,5,120,128,3 ème
GIRONDE,LE BOUSCAT,0331669K,190,168,17,5,81,109,3 ème
GIRONDE,LEGE-CAP-FERRET,0332657J,144,144,0,0,70,74,3 ème
GIRONDE,LE HAILLAN,0333530H,0,0,0,0,0,0,3 ème
GIRONDE,LEOGNAN,0332244K,169,169,0,0,84,85,3 ème
GIRONDE,LORMONT,0331895F,123,120,0,3,51,72,3 ème
GIRONDE,PAUILLAC,0330102G,12,12,0,0,7,5,3 ème
GIRONDE,PESSAC,0331529H,152,152,0,0,63,89,3 ème
GIRONDE,PESSAC,0331623K,196,196,0,0,103,93,3 ème
GIRONDE,PESSAC,0332191C,111,93,15,3,52,59,3 ème
GIRONDE,PESSAC,0332345V,18,18,0,0,7,11,3 ème
GIRONDE,RAUZAN,0331433D,67,66,0,1,40,27,3 ème
GIRONDE,SAINT-AUBIN-DE-MEDOC,0333093H,189,189,0,0,85,104,3 ème
GIRONDE,SAINTE-FOY-LA-GRANDE,0330163Y,133,117,12,4,62,71,3 ème
GIRONDE,SALLES,0331666G,259,259,0,0,139,120,3 ème
GIRONDE,TALENCE,0331500B,110,110,0,0,56,54,3 ème
LANDES,CAPBRETON,0400071K,83,83,0,0,30,53,3 ème
LANDES,LABRIT,0401077D,69,69,0,0,30,39,3 ème
LANDES,LINXE,0401015L,100,96,0,4,52,48,3 ème
LANDES,MORCENX-LA-NOUVELLE,0400093J,68,64,0,4,37,31,3 ème
LANDES,PARENTIS-EN-BORN,0400046H,24,24,0,0,7,17,3 ème
LANDES,SAINT-PAUL-LES-DAX,0400096M,126,94,28,4,57,69,3 ème
LANDES,SAINT-PIERRE-DU-MONT,0400080V,18,18,0,0,9,9,3 ème
LANDES,SAINT-VINCENT-DE-PAUL,0400916D,23,23,0,0,5,18,3 ème
LANDES,VILLENEUVE-DE-MARSAN,0400043E,106,102,0,4,56,50,3 ème
LOT-ET-GARONNE,AGEN,0470677F,149,147,0,2,81,68,3 ème
LOT-ET-GARONNE,AIGUILLON,0470774L,94,92,0,2,46,48,3 ème
LOT-ET-GARONNE,FUMEL,0470046V,85,71,14,0,34,51,3 ème
LOT-ET-GARONNE,MONSEMPRON-LIBOS,0470048X,73,70,0,3,42,31,3 ème
LOT-ET-GARONNE,NERAC,0470029B,24,24,0,0,7,17,3 ème
LOT-ET-GARONNE,PENNE-D'AGENAIS,0470031D,115,114,0,1,58,57,3 ème
PYRENEES-ATLANTIQUES,ARETTE,0640004G,20,20,0,0,11,9,3 ème
PYRENEES-ATLANTIQUES,ARTIX,0640231D,112,112,0,0,58,54,3 ème
PYRENEES-ATLANTIQUES,BAYONNE,0640144J,21,21,0,0,9,12,3 ème
PYRENEES-ATLANTIQUES,BAYONNE,0641652Y,116,112,0,4,70,46,3 ème
PYRENEES-ATLANTIQUES,BIARRITZ,0640078M,167,164,0,3,76,91,3 ème
PYRENEES-ATLANTIQUES,BIDACHE,0640019Y,64,64,0,0,29,35,3 ème
PYRENEES-ATLANTIQUES,HASPARREN,0640119G,70,70,0,0,38,32,3 ème
PYRENEES-ATLANTIQUES,HASPARREN,0640181Z,21,21,0,0,0,21,3 ème
PYRENEES-ATLANTIQUES,JURANCON,0641411L,136,115,16,5,77,59,3 ème
PYRENEES-ATLANTIQUES,LARUNS,0640035R,16,16,0,0,9,7,3 ème
PYRENEES-ATLANTIQUES,NAY,0641509T,199,198,0,1,101,98,3 ème
PYRENEES-ATLANTIQUES,OLORON-SAINTE-MARIE,0640048E,89,86,0,3,37,52,3 ème
PYRENEES-ATLANTIQUES,ORTHEZ,0640128S,24,24,0,0,7,17,3 ème
PYRENEES-ATLANTIQUES,PAU,0640133X,119,119,0,0,67,52,3 ème
PYRENEES-ATLANTIQUES,SAINT-ETIENNE-DE-BAIGORRY,0640064X,16,16,0,0,6,10,3 ème
PYRENEES-ATLANTIQUES,SAINT-ETIENNE-DE-BAIGORRY,0640162D,16,16,0,0,4,12,3 ème
PYRENEES-ATLANTIQUES,SAINT-JEAN-DE-LUZ,0641559X,119,119,0,0,60,59,3 ème
PYRENEES-ATLANTIQUES,SALIES-DE-BEARN,0640170M,14,14,0,0,10,4,3 ème
PYRENEES-ATLANTIQUES,SAUVETERRE-DE-BEARN,0640171N,18,18,0,0,14,4,3 ème
PYRENEES-ATLANTIQUES,TARDETS-SORHOLUS,0640074H,19,19,0,0,8,11,3 ème
PYRENEES-ATLANTIQUES,USTARITZ,0640136A,87,87,0,0,51,36,3 ème
CORREZE,ARGENTAT-SUR-DORDOGNE,0190779U,46,46,0,0,21,25,3 ème
CORREZE,CORREZE,0190016P,27,27,0,0,12,15,3 ème
CORREZE,LARCHE,0190720E,153,153,0,0,76,77,3 ème
CORREZE,TULLE,0190613N,164,143,16,5,84,80,3 ème
CORREZE,UZERCHE,0190568P,74,74,0,0,36,38,3 ème
CREUSE,BOURGANEUF,0230507B,69,55,14,0,34,35,3 ème
CREUSE,CHATELUS-MALVALEIX,0230011M,37,21,16,0,18,19,3 ème
CREUSE,FELLETIN,0230019W,17,17,0,0,1,16,3 ème
HAUTE-VIENNE,AIXE-SUR-VIENNE,0870086W,35,31,0,4,17,18,3 ème
HAUTE-VIENNE,LE DORAT,0870819T,52,52,0,0,21,31,3 ème
HAUTE-VIENNE,LIMOGES,0870058R,24,24,0,0,0,24,3 ème
HAUTE-VIENNE,LIMOGES,0870071E,215,215,0,0,95,120,3 ème
HAUTE-VIENNE,LIMOGES,0870083T,115,115,0,0,57,58,3 ème
HAUTE-VIENNE,LIMOGES,0870729V,59,59,0,0,30,29,3 ème
HAUTE-VIENNE,LIMOGES,0870791M,103,86,15,2,52,51,3 ème
HAUTE-VIENNE,LIMOGES,0871030X,24,24,0,0,10,14,3 ème
HAUTE-VIENNE,NANTIAT,0870031L,111,111,0,0,53,58,3 ème
HAUTE-VIENNE,SAINT-JUNIEN,0870041X,24,24,0,0,16,8,3 ème
HAUTE-VIENNE,SAINT-JUNIEN,0870042Y,143,124,16,3,78,65,3 ème
HAUTE-VIENNE,SAINT-SULPICE-LAURIERE,0870048E,36,36,0,0,14,22,3 ème
HAUTE-VIENNE,SAINT-YRIEIX-LA-PERCHE,0870051H,22,22,0,0,9,13,3 ème
CHARENTE,ANGOULEME,0160884Z,102,102,0,0,51,51,3 ème
CHARENTE,BAIGNES-SAINTE-RADEGONDE,0160895L,36,36,0,0,20,16,3 ème
CHARENTE,COGNAC,0160119T,24,24,0,0,7,17,3 ème
CHARENTE,COGNAC,0160864C,110,94,16,0,58,52,3 ème
CHARENTE,COGNAC,0161050E,117,117,0,0,63,54,3 ème
CHARENTE,COTEAUX-DU-BLANZACAIS,0160012B,39,39,0,0,15,24,3 ème
CHARENTE,LA ROCHEFOUCAULD-EN-ANGOUMOIS,0160867F,100,100,0,0,52,48,3 ème
CHARENTE,PUYMOYEN,0160968R,16,0,16,0,4,12,3 ème
CHARENTE,RUELLE-SUR-TOUVRE,0160094R,141,138,0,3,77,64,3 ème
CHARENTE,RUFFEC,0160039F,58,48,10,0,25,33,3 ème
CHARENTE,SAINT-MICHEL,0160969S,134,131,0,3,65,69,3 ème
CHARENTE,TERRES-DE-HAUTE-CHARENTE,0160793A,37,37,0,0,22,15,3 ème
CHARENTE-MARITIME,ARCHIAC,0170002K,64,64,0,0,30,34,3 ème
CHARENTE-MARITIME,COZES,0170008S,90,90,0,0,40,50,3 ème
CHARENTE-MARITIME,LA ROCHELLE,0170077S,111,110,0,1,63,48,3 ème
CHARENTE-MARITIME,LA ROCHELLE,0170099R,257,253,0,4,129,128,3 ème
CHARENTE-MARITIME,PONS,0170389F,118,101,14,3,56,62,3 ème
CHARENTE-MARITIME,PONT-L'ABBE-D'ARNOULT,0171340P,149,149,0,0,79,70,3 ème
CHARENTE-MARITIME,ROCHEFORT,0170025K,24,24,0,0,14,10,3 ème
CHARENTE-MARITIME,ROCHEFORT,0171057G,127,126,0,1,60,67,3 ème
CHARENTE-MARITIME,SAINT-AGNANT,0170047J,133,133,0,0,73,60,3 ème
CHARENTE-MARITIME,SAINT-PIERRE-D'OLERON,0171215D,88,88,0,0,50,38,3 ème
CHARENTE-MARITIME,SURGERES,0170070J,21,21,0,0,7,14,3 ème
CHARENTE-MARITIME,SURGERES,0170071K,142,127,14,1,80,62,3 ème
DEUX-SEVRES,BRIOUX-SUR-BOUTONNE,0790010G,65,65,0,0,33,32,3 ème
DEUX-SEVRES,CHEF-BOUTONNE,0790015M,20,20,0,0,7,13,3 ème
DEUX-SEVRES,FRONTENAY-ROHAN-ROHAN,0790699F,159,159,0,0,80,79,3 ème
DEUX-SEVRES,MAZIERES-EN-GATINE,0790044U,70,64,0,6,41,29,3 ème
DEUX-SEVRES,NIORT,0790703K,123,121,0,2,44,79,3 ème
DEUX-SEVRES,NIORT,0790928E,22,22,0,0,5,17,3 ème
DEUX-SEVRES,SAINT-MAIXENT-L'ECOLE,0790072Z,82,82,0,0,45,37,3 ème
DEUX-SEVRES,SECONDIGNY,0790074B,29,29,0,0,15,14,3 ème
DEUX-SEVRES,THOUARS,0791002K,146,111,33,2,68,78,3 ème
VIENNE,CIVRAY,0860010U,18,18,0,0,4,14,3 ème
VIENNE,LENCLOITRE,0860020E,135,128,0,7,72,63,3 ème
VIENNE,LOUDUN,0860765P,55,55,0,0,34,21,3 ème
VIENNE,LUSSAC-LES-CHATEAUX,0860026L,104,101,0,3,41,63,3 ème
VIENNE,MONTMORILLON,0860029P,23,23,0,0,8,15,3 ème
VIENNE,MONTMORILLON,0860031S,97,97,0,0,45,52,3 ème
VIENNE,POITIERS,0860774Z,24,24,0,0,14,10,3 ème
VIENNE,POITIERS,0860789R,19,19,0,0,3,16,3 ème
VIENNE,POITIERS,0861447F,77,77,0,0,40,37,3 ème
VIENNE,VOUILLE,0860772X,93,93,0,0,44,49,3 ème
AUDE,CAPENDU,0110003U,75,73,0,2,31,44,3 ème
AUDE,CARCASSONNE,0110045P,19,19,0,0,3,16,3 ème
AUDE,CARCASSONNE,0110672W,196,167,24,5,103,93,3 ème
AUDE,CHALABRE,0110870L,14,14,0,0,5,9,3 ème
AUDE,LIMOUX,0110859Z,248,211,28,9,128,120,3 ème
AUDE,QUILLAN,0110027V,16,16,0,0,6,10,3 ème
GARD,ALES,0300002P,48,48,0,0,29,19,3 ème
GARD,ALES,0300028T,28,28,0,0,16,12,3 ème
GARD,ALES,0301013N,126,103,16,7,62,64,3 ème
GARD,ALES,0301014P,148,130,16,2,73,75,3 ème
GARD,ALES,0301354J,189,181,0,8,91,98,3 ème
GARD,ANDUZE,0300006U,132,132,0,0,74,58,3 ème
GARD,BAGNOLS-SUR-CEZE,0300950V,42,42,0,0,10,32,3 ème
GARD,BAGNOLS-SUR-CEZE,0301211D,148,125,22,1,75,73,3 ème
GARD,BEAUCAIRE,0300011Z,24,24,0,0,4,20,3 ème
GARD,CLARENSAC,0301723K,127,127,0,0,51,76,3 ème
GARD,NIMES,0300058A,45,45,0,0,3,42,3 ème
GARD,NIMES,0301284H,172,168,0,4,91,81,3 ème
GARD,PONT-SAINT-ESPRIT,0300031W,151,147,0,4,77,74,3 ème
GARD,PONT-SAINT-ESPRIT,0300098U,78,78,0,0,30,48,3 ème
GARD,SAINT-CHRISTOL-LES-ALES,0301778V,48,48,0,0,20,28,3 ème
GARD,SAINT-JEAN-DU-GARD,0300042H,41,41,0,0,21,20,3 ème
GARD,SALINDRES,0300043J,126,124,0,2,68,58,3 ème
GARD,SOMMIERES,0300101X,84,84,0,0,45,39,3 ème
GARD,UZES,0301244P,43,43,0,0,19,24,3 ème
GARD,VILLENEUVE-LES-AVIGNON,0300085E,62,62,0,0,33,29,3 ème
HERAULT,BEZIERS,0340012D,48,48,0,0,12,36,3 ème
HERAULT,BEZIERS,0340016H,132,129,0,3,67,65,3 ème
HERAULT,FLORENSAC,0340024S,81,81,0,0,33,48,3 ème
HERAULT,LA GRANDE-MOTTE,0341656R,94,94,0,0,48,46,3 ème
HERAULT,LANSARGUES,0342076X,220,206,14,0,88,132,3 ème
HERAULT,LATTES,0341028H,209,205,0,4,100,109,3 ème
HERAULT,LODEVE,0340117T,177,163,13,1,90,87,3 ème
HERAULT,MARAUSSAN,0342399Y,3,3,0,0,1,2,3 ème
HERAULT,MARSEILLAN,0342130F,113,108,0,5,50,63,3 ème
HERAULT,MARSILLARGUES,0340034C,76,72,0,4,35,41,3 ème
HERAULT,MAUGUIO,0341368C,202,200,0,2,101,101,3 ème
HERAULT,MONTARNAUD,0342051V,158,154,0,4,78,80,3 ème
HERAULT,MONTPELLIER,0340902W,123,120,0,3,69,54,3 ème
HERAULT,MONTPELLIER,0340904Y,125,125,0,0,70,55,3 ème
HERAULT,MONTPELLIER,0341364Y,123,118,0,5,53,70,3 ème
HERAULT,MONTPELLIER,0341385W,32,32,0,0,3,29,3 ème
HERAULT,MONTPELLIER,0342131G,152,150,0,2,69,83,3 ème
HERAULT,MONTPELLIER,0342147Z,3,3,0,0,1,2,3 ème
HERAULT,OLONZAC,0340057C,66,66,0,0,40,26,3 ème
HERAULT,PEROLS,0341537L,138,138,0,0,69,69,3 ème
HERAULT,PIGNAN,0341870Y,211,202,0,9,106,105,3 ème
HERAULT,ROUJAN,0342326U,107,98,0,9,52,55,3 ème
HERAULT,SAINT-CLEMENT-DE-RIVIERE,0340110K,205,205,0,0,98,107,3 ème
HERAULT,SAINT-GELY-DU-FESC,0341764H,217,214,0,3,108,109,3 ème
HERAULT,SAINT-MATHIEU-DE-TREVIERS,0341705U,137,137,0,0,64,73,3 ème
HERAULT,SERVIAN,0341387Y,175,174,0,1,87,88,3 ème
HERAULT,VENDRES,0342050U,179,179,0,0,92,87,3 ème
LOZERE,MENDE,0480019K,18,18,0,0,3,15,3 ème
LOZERE,SAINT-CHELY-D'APCHER,0480013D,98,93,0,5,58,40,3 ème
LOZERE,SAINT-CHELY-D'APCHER,0480688M,13,13,0,0,3,10,3 ème
LOZERE,SAINT-ETIENNE-VALLEE-FRANCAISE,0480015F,16,16,0,0,10,6,3 ème
LOZERE,VILLEFORT,0480017H,17,17,0,0,7,10,3 ème
PYRENEES-ORIENTALES,ARLES-SUR-TECH,0660480N,70,70,0,0,31,39,3 ème
PYRENEES-ORIENTALES,PERPIGNAN,0660051X,95,95,0,0,51,44,3 ème
PYRENEES-ORIENTALES,PERPIGNAN,0660063K,149,149,0,0,73,76,3 ème
PYRENEES-ORIENTALES,PERPIGNAN,0660522J,164,148,14,2,84,80,3 ème
PYRENEES-ORIENTALES,PRADES,0660068R,49,49,0,0,23,26,3 ème
PYRENEES-ORIENTALES,SAINT-ESTEVE,0660431K,214,198,12,4,97,117,3 ème
PYRENEES-ORIENTALES,SAINT-PAUL-DE-FENOUILLET,0660029Y,45,45,0,0,27,18,3 ème
ARIEGE,LE MAS-D'AZIL,0090010M,52,52,0,0,24,28,3 ème
ARIEGE,LEZAT-SUR-LEZE,0090009L,114,114,0,0,65,49,3 ème
ARIEGE,PAMIERS,0090045A,18,17,0,1,4,14,3 ème
ARIEGE,PAMIERS,0090055L,174,174,0,0,93,81,3 ème
ARIEGE,SAINT-GIRONS,0090038T,18,18,0,0,12,6,3 ème
ARIEGE,SAINT-GIRONS,0090574A,169,155,11,3,88,81,3 ème
ARIEGE,TARASCON-SUR-ARIEGE,0090546V,127,126,0,1,63,64,3 ème
AVEYRON,CRANSAC,0120004P,27,26,0,1,12,15,3 ème
AVEYRON,MARCILLAC-VALLON,0120092K,63,58,0,5,36,27,3 ème
AVEYRON,NAUCELLE,0120017D,34,34,0,0,19,15,3 ème
AVEYRON,NAUCELLE,0121174L,26,26,0,0,6,20,3 ème
AVEYRON,RODEZ,0121309H,9,8,0,1,3,6,3 ème
AVEYRON,SAINT-AFFRIQUE,0121256A,74,69,0,5,35,39,3 ème
GERS,AIGNAN,0320001C,22,22,0,0,13,9,3 ème
GERS,AUCH,0320563N,116,114,0,2,52,64,3 ème
GERS,AUCH,0320650H,125,113,7,5,57,68,3 ème
GERS,CONDOM,0320059R,27,27,0,0,15,12,3 ème
GERS,GIMONT,0320013R,68,65,0,3,32,36,3 ème
GERS,L'ISLE-JOURDAIN,0320014S,105,104,0,1,53,52,3 ème
GERS,L'ISLE-JOURDAIN,0320056M,80,80,0,0,46,34,3 ème
GERS,PLAISANCE,0320028G,41,41,0,0,19,22,3 ème
HAUTE-GARONNE,BAGNERES-DE-LUCHON,0310005M,55,52,0,3,33,22,3 ème
HAUTE-GARONNE,BESSIERES,0312799Z,137,136,0,1,71,66,3 ème
HAUTE-GARONNE,BLAGNAC,0311581A,250,247,0,3,117,133,3 ème
HAUTE-GARONNE,CINTEGABELLE,0313045S,0,0,0,0,0,0,3 ème
HAUTE-GARONNE,COLOMIERS,0311092U,24,23,0,1,3,21,3 ème
HAUTE-GARONNE,COLOMIERS,0312191N,29,29,0,0,10,19,3 ème
HAUTE-GARONNE,FENOUILLET,0312423R,147,142,0,5,65,82,3 ème
HAUTE-GARONNE,LE FOUSSERET,0310015Y,119,110,0,9,55,64,3 ème
HAUTE-GARONNE,MURET,0311319R,218,188,30,0,115,103,3 ème
HAUTE-GARONNE,PIBRAC,0311176K,146,146,0,0,70,76,3 ème
HAUTE-GARONNE,PIBRAC,0311263E,147,142,0,5,74,73,3 ème
HAUTE-GARONNE,PINS-JUSTARET,0312220V,226,226,0,0,97,129,3 ème
HAUTE-GARONNE,PLAISANCE-DU-TOUCH,0312071H,237,234,0,3,125,112,3 ème
HAUTE-GARONNE,PORTET-SUR-GARONNE,0311686P,209,206,0,3,102,107,3 ème
HAUTE-GARONNE,REVEL,0311209W,36,36,0,0,18,18,3 ème
HAUTE-GARONNE,RIEUMES,0310029N,105,105,0,0,58,47,3 ème
HAUTE-GARONNE,SAINT-JEAN,0311722D,194,192,0,2,93,101,3 ème
HAUTE-GARONNE,SAINT-JORY,0312842W,173,168,0,5,75,98,3 ème
HAUTE-GARONNE,SALIES-DU-SALAT,0310035V,128,124,0,4,73,55,3 ème
HAUTE-GARONNE,SEILH,0311967V,136,136,0,0,69,67,3 ème
HAUTE-GARONNE,TOULOUSE,0310037X,181,164,13,4,100,81,3 ème
HAUTE-GARONNE,TOULOUSE,0310052N,18,18,0,0,6,12,3 ème
HAUTE-GARONNE,TOULOUSE,0310054R,31,31,0,0,4,27,3 ème
HAUTE-GARONNE,TOULOUSE,0310056T,23,21,0,2,13,10,3 ème
HAUTE-GARONNE,TOULOUSE,0311111P,238,238,0,0,129,109,3 ème
HAUTE-GARONNE,TOULOUSE,0311265G,150,129,19,2,69,81,3 ème
HAUTE-GARONNE,TOULOUSE,0311630D,154,122,26,6,78,76,3 ème
HAUTE-GARONNE,TOULOUSE,0312064A,20,20,0,0,12,8,3 ème
HAUTE-GARONNE,TOULOUSE,0312759F,25,25,0,0,3,22,3 ème
HAUTE-GARONNE,TOULOUSE,0312885T,21,21,0,0,13,8,3 ème
HAUTE-GARONNE,TOULOUSE,0313080E,0,0,0,0,0,0,3 ème
HAUTE-GARONNE,VILLENEUVE-TOLOSANE,0312611V,177,177,0,0,82,95,3 ème
HAUTES-PYRENEES,BAGNERES-DE-BIGORRE,0650089U,136,132,0,4,63,73,3 ème
LOT,CAHORS,0460493L,14,14,0,0,5,9,3 ème
LOT,MARTEL,0460021Y,48,48,0,0,21,27,3 ème
LOT,PRAYSSAC,0460024B,35,35,0,0,17,18,3 ème
TARN,ALBI,0810004P,23,23,0,0,5,18,3 ème
TARN,ALBI,0810051R,109,107,0,2,58,51,3 ème
TARN,ALBI,0811070Y,25,25,0,0,20,5,3 ème
TARN,CARMAUX,0810787R,103,98,0,5,52,51,3 ème
TARN,CASTRES,0810960D,127,123,0,4,64,63,3 ème
TARN,CASTRES,0810961E,102,100,0,2,46,56,3 ème
TARN,GAILLAC,0811331G,110,110,0,0,58,52,3 ème
TARN,MAZAMET,0810108C,16,16,0,0,11,5,3 ème
TARN,MAZAMET,0810127Y,82,82,0,0,42,40,3 ème
TARN,RABASTENS,0810037A,132,131,0,1,64,68,3 ème
TARN-ET-GARONNE,CASTELSARRASIN,0820066B,177,155,17,5,87,90,3 ème
TARN-ET-GARONNE,GRISOLLES,0820683X,139,137,0,2,55,84,3 ème
TARN-ET-GARONNE,MOISSAC,0820753Y,63,54,0,9,27,36,3 ème
TARN-ET-GARONNE,MONTECH,0820891Y,172,168,0,4,91,81,3 ème
TARN-ET-GARONNE,VALENCE,0820029L,227,217,4,6,115,112,3 ème
TARN-ET-GARONNE,VALENCE,0820899G,16,16,0,0,4,12,3 ème
TARN-ET-GARONNE,VERDUN-SUR-GARONNE,0820922G,95,91,0,4,49,46,3 ème
LOIRE-ATLANTIQUE,ANCENIS-SAINT-GEREON,0441928G,203,203,0,0,112,91,3 ème
LOIRE-ATLANTIQUE,BOUAYE,0441858F,186,186,0,0,96,90,3 ème
LOIRE-ATLANTIQUE,CHATEAUBRIANT,0440005S,24,24,0,0,7,17,3 ème
LOIRE-ATLANTIQUE,CHATEAUBRIANT,0440293E,129,128,0,1,66,63,3 ème
LOIRE-ATLANTIQUE,CHATEAUBRIANT,0441929H,160,160,0,0,75,85,3 ème
LOIRE-ATLANTIQUE,CLISSON,0440008V,181,163,14,4,87,94,3 ème
LOIRE-ATLANTIQUE,CLISSON,0442781J,145,143,0,2,66,79,3 ème
LOIRE-ATLANTIQUE,CORDEMAIS,0442023K,119,115,0,4,53,66,3 ème
LOIRE-ATLANTIQUE,DONGES,0441727N,88,85,0,3,58,30,3 ème
LOIRE-ATLANTIQUE,LA CHAPELLE-SUR-ERDRE,0441547T,116,115,0,1,66,50,3 ème
LOIRE-ATLANTIQUE,LOIREAUXENCE,0442921L,93,93,0,0,51,42,3 ème
LOIRE-ATLANTIQUE,NANTES,0440025N,121,116,0,5,60,61,3 ème
LOIRE-ATLANTIQUE,NANTES,0440034Y,24,24,0,0,1,23,3 ème
LOIRE-ATLANTIQUE,NANTES,0440035Z,24,24,0,0,20,4,3 ème
LOIRE-ATLANTIQUE,NANTES,0440284V,109,109,0,0,56,53,3 ème
LOIRE-ATLANTIQUE,NANTES,0441931K,259,259,0,0,134,125,3 ème
LOIRE-ATLANTIQUE,NANTES,0441933M,207,191,16,0,123,84,3 ème
LOIRE-ATLANTIQUE,NANTES,0441935P,214,199,15,0,109,105,3 ème
LOIRE-ATLANTIQUE,NANTES,0441936R,153,150,0,3,71,82,3 ème
LOIRE-ATLANTIQUE,NANTES,0442775C,47,47,0,0,13,34,3 ème
LOIRE-ATLANTIQUE,PAIMBOEUF,0440056X,23,23,0,0,5,18,3 ème
LOIRE-ATLANTIQUE,PONTCHATEAU,0440541Z,24,24,0,0,7,17,3 ème
LOIRE-ATLANTIQUE,PONTCHATEAU,0442807M,139,139,0,0,76,63,3 ème
LOIRE-ATLANTIQUE,REZE,0440063E,24,24,0,0,13,11,3 ème
LOIRE-ATLANTIQUE,REZE,0440229K,188,188,0,0,99,89,3 ème
LOIRE-ATLANTIQUE,REZE,0440274J,32,32,0,0,13,19,3 ème
LOIRE-ATLANTIQUE,SAINTE-PAZANNE,0442625P,179,176,0,3,91,88,3 ème
LOIRE-ATLANTIQUE,SAINT-JOACHIM,0441728P,68,68,0,0,32,36,3 ème
LOIRE-ATLANTIQUE,SAINT-NAZAIRE,0441941W,190,190,0,0,86,104,3 ème
LOIRE-ATLANTIQUE,SAINT-PHILBERT-DE-GRAND-LIEU,0442186M,98,92,0,6,53,45,3 ème
LOIRE-ATLANTIQUE,SAINT-SEBASTIEN-SUR-LOIRE,0440291C,119,112,0,7,56,63,3 ème
LOIRE-ATLANTIQUE,SAVENAY,0440241Y,279,279,0,0,150,129,3 ème
LOIRE-ATLANTIQUE,SAVENAY,0441657M,129,129,0,0,57,72,3 ème
LOIRE-ATLANTIQUE,TRIGNAC,0441616T,152,132,16,4,84,68,3 ème
LOIRE-ATLANTIQUE,VALLET,0442052S,145,142,0,3,79,66,3 ème
LOIRE-ATLANTIQUE,VERTOU,0442595G,130,128,0,2,61,69,3 ème
MAINE-ET-LOIRE,ANGERS,0490843A,83,80,0,3,34,49,3 ème
MAINE-ET-LOIRE,ANGERS,0491825T,151,151,0,0,77,74,3 ème
MAINE-ET-LOIRE,BAUGE-EN-ANJOU,0490010V,82,80,0,2,39,43,3 ème
MAINE-ET-LOIRE,BEAUFORT-EN-ANJOU,0490922L,161,161,0,0,96,65,3 ème
MAINE-ET-LOIRE,BRISSAC LOIRE AUBANCE,0490853L,134,134,0,0,54,80,3 ème
MAINE-ET-LOIRE,CHEMILLE-EN-ANJOU,0491929F,49,49,0,0,26,23,3 ème
MAINE-ET-LOIRE,CHOLET,0490862W,137,137,0,0,65,72,3 ème
MAINE-ET-LOIRE,CHOLET,0490886X,25,25,0,0,8,17,3 ème
MAINE-ET-LOIRE,DURTAL,0490956Y,51,51,0,0,30,21,3 ème
MAINE-ET-LOIRE,LONGUE-JUMELLES,0490867B,107,107,0,0,61,46,3 ème
MAINE-ET-LOIRE,MAUGES-SUR-LOIRE,0490039B,48,45,0,3,27,21,3 ème
MAINE-ET-LOIRE,MONTREVAULT-SUR-EVRE,0490876L,125,125,0,0,72,53,3 ème
MAINE-ET-LOIRE,OREE D'ANJOU,0490057W,112,112,0,0,61,51,3 ème
MAINE-ET-LOIRE,OREE D'ANJOU,0490856P,135,135,0,0,73,62,3 ème
MAINE-ET-LOIRE,SAUMUR,0491648A,87,69,14,4,41,46,3 ème
MAINE-ET-LOIRE,SEGRE-EN-ANJOU BLEU,0490878N,168,168,0,0,81,87,3 ème
MAINE-ET-LOIRE,SEVREMOINE,0490875K,124,124,0,0,76,48,3 ème
MAINE-ET-LOIRE,SEVREMOINE,0491706N,91,91,0,0,42,49,3 ème
MAINE-ET-LOIRE,TRELAZE,0491646Y,24,24,0,0,8,16,3 ème
MAINE-ET-LOIRE,VERRIERES-EN-ANJOU,0491921X,105,101,0,4,55,50,3 ème
MAYENNE,CHATEAU-GONTIER-SUR-MAYENNE,0530779J,122,103,13,6,66,56,3 ème
MAYENNE,COSSE-LE-VIVIEN,0530030V,50,46,0,4,29,21,3 ème
MAYENNE,ERNEE,0530077W,86,72,13,1,42,44,3 ème
MAYENNE,LAVAL,0530015D,112,109,0,3,63,49,3 ème
MAYENNE,LAVAL,0530914F,70,67,0,3,37,33,3 ème
MAYENNE,MESLAY-DU-MAINE,0530063F,47,46,0,1,30,17,3 ème
MAYENNE,PORT-BRILLET,0530021K,84,84,0,0,45,39,3 ème
MAYENNE,PRE-EN-PAIL-SAINT-SAMSON,0530583W,49,49,0,0,26,23,3 ème
SARTHE,ARNAGE,0720903R,104,104,0,0,54,50,3 ème
SARTHE,BALLON-SAINT MARS,0720004N,75,60,13,2,38,37,3 ème
SARTHE,BEAUMONT-SUR-SARTHE,0720904S,56,55,0,1,23,33,3 ème
SARTHE,BONNETABLE,0721093X,96,96,0,0,54,42,3 ème
SARTHE,CHAMPAGNE,0721086P,96,91,0,5,52,44,3 ème
SARTHE,FRESNAY-SUR-SARTHE,0720019E,52,49,0,3,24,28,3 ème
SARTHE,LA FERTE-BERNARD,0720017C,24,24,0,0,11,13,3 ème
SARTHE,LA FERTE-BERNARD,0720806K,83,83,0,0,34,49,3 ème
SARTHE,LA FLECHE,0720062B,101,100,0,1,52,49,3 ème
SARTHE,LE GRAND-LUCE,0721044U,62,60,0,2,37,25,3 ème
SARTHE,LE LUDE,0721226S,46,46,0,0,18,28,3 ème
SARTHE,LE MANS,0720040C,110,110,0,0,56,54,3 ème
SARTHE,LE MANS,0720797A,100,84,16,0,54,46,3 ème
SARTHE,LE MANS,0720798B,111,106,0,5,48,63,3 ème
SARTHE,LE MANS,0720800D,76,73,0,3,29,47,3 ème
SARTHE,LE MANS,0720815V,80,80,0,0,43,37,3 ème
SARTHE,LE MANS,0720836T,87,77,0,10,43,44,3 ème
SARTHE,LE MANS,0720838V,149,149,0,0,73,76,3 ème
SARTHE,LE MANS,0720983C,48,48,0,0,31,17,3 ème
SARTHE,LE MANS,0721262F,61,58,0,3,32,29,3 ème
SARTHE,LOUE,0720024K,117,117,0,0,61,56,3 ème
SARTHE,MAMERS,0720027N,24,24,0,0,9,15,3 ème
SARTHE,MOULINS-LE-CARBONNEL,0720046J,67,67,0,0,28,39,3 ème
SARTHE,PONTVALLAIN,0721304B,83,82,0,1,43,40,3 ème
SARTHE,SABLE-SUR-SARTHE,0721408P,109,105,0,4,59,50,3 ème
SARTHE,SAINT-CALAIS,0720051P,43,41,0,2,23,20,3 ème
VENDEE,AIZENAY,0850090L,112,112,0,0,55,57,3 ème
VENDEE,AIZENAY,0851560J,150,147,0,3,80,70,3 ème
VENDEE,BELLEVIGNY,0851435Y,118,114,0,4,66,52,3 ème
VENDEE,CHANTONNAY,0851191H,222,217,0,5,119,103,3 ème
VENDEE,CHAVAGNES-EN-PAILLERS,0850073T,91,91,0,0,45,46,3 ème
VENDEE,FONTENAY-LE-COMTE,0850074U,178,163,10,5,91,87,3 ème
VENDEE,LA ROCHE-SUR-YON,0850605W,190,189,0,1,106,84,3 ème
VENDEE,LA ROCHE-SUR-YON,0851643Z,20,20,0,0,0,20,3 ème
VENDEE,LES SABLES-D'OLONNE,0850148Z,112,110,0,2,48,64,3 ème
VENDEE,LES SABLES-D'OLONNE,0850149A,95,78,16,1,55,40,3 ème
VENDEE,LUCON,0850069N,94,90,0,4,45,49,3 ème
VENDEE,MONTAIGU-VENDEE,0851662V,152,151,0,1,69,83,3 ème
VENDEE,MORTAGNE-SUR-SEVRE,0851388X,123,123,0,0,66,57,3 ème
VENDEE,SAINTE-HERMINE,0851146J,65,65,0,0,35,30,3 ème
VENDEE,SAINT-GILLES-CROIX-DE-VIE,0850065J,230,213,17,0,121,109,3 ème
VENDEE,TIFFAUGES,0850125Z,94,94,0,0,44,50,3 ème
ALPES-DE-HTE-PROVENCE,BARCELONNETTE,0040419J,87,84,0,3,36,51,3 ème
ALPES-DE-HTE-PROVENCE,LA MOTTE-DU-CAIRE,0040014U,26,26,0,0,7,19,3 ème
ALPES-DE-HTE-PROVENCE,MANOSQUE,0040055N,157,129,26,2,73,84,3 ème
ALPES-DE-HTE-PROVENCE,SISTERON,0040023D,23,23,0,0,8,15,3 ème
BOUCHES-DU-RHONE,AIX-EN-PROVENCE,0130001F,24,24,0,0,11,13,3 ème
BOUCHES-DU-RHONE,AIX-EN-PROVENCE,0131318M,56,55,0,1,28,28,3 ème
BOUCHES-DU-RHONE,AIX-EN-PROVENCE,0131712R,201,179,22,0,84,117,3 ème
BOUCHES-DU-RHONE,AIX-EN-PROVENCE,0132955S,65,65,0,0,37,28,3 ème
BOUCHES-DU-RHONE,AIX-EN-PROVENCE,0132973L,144,144,0,0,76,68,3 ème
BOUCHES-DU-RHONE,ALLAUCH,0133490Y,206,206,0,0,106,100,3 ème
BOUCHES-DU-RHONE,ARLES,0133274N,25,25,0,0,17,8,3 ème
BOUCHES-DU-RHONE,BOUC-BEL-AIR,0132833J,161,161,0,0,74,87,3 ème
BOUCHES-DU-RHONE,CASSIS,0132324F,180,180,0,0,97,83,3 ème
BOUCHES-DU-RHONE,GEMENOS,0133351X,169,169,0,0,86,83,3 ème
BOUCHES-DU-RHONE,ISTRES,0132318Z,165,160,0,5,86,79,3 ème
BOUCHES-DU-RHONE,ISTRES,0132409Y,145,122,23,0,64,81,3 ème
BOUCHES-DU-RHONE,LA CIOTAT,0130022D,150,149,0,1,74,76,3 ème
BOUCHES-DU-RHONE,LES PENNES-MIRABEAU,0131369T,130,128,0,2,65,65,3 ème
BOUCHES-DU-RHONE,MARSEILLE,0131424C,13,13,0,0,8,5,3 ème
BOUCHES-DU-RHONE,MARSEILLE,0131922U,169,169,0,0,69,100,3 ème
BOUCHES-DU-RHONE,MARSEILLE,0131750G,164,164,0,0,75,89,3 ème
BOUCHES-DU-RHONE,MARSEILLE,0131261A,102,102,0,0,41,61,3 ème
BOUCHES-DU-RHONE,MARSEILLE,0131445A,26,26,0,0,15,11,3 ème
BOUCHES-DU-RHONE,MARSEILLE,0132314V,141,133,0,8,64,77,3 ème
BOUCHES-DU-RHONE,MARSEILLE,0132907P,193,191,0,2,91,102,3 ème
BOUCHES-DU-RHONE,MARSEILLE,0132908R,41,41,0,0,16,25,3 ème
BOUCHES-DU-RHONE,MARSEILLE,0130056R,7,7,0,0,0,7,3 ème
BOUCHES-DU-RHONE,MARSEILLE,0132207D,139,137,0,2,64,75,3 ème
BOUCHES-DU-RHONE,MARSEILLE,0132730X,92,87,0,5,48,44,3 ème
BOUCHES-DU-RHONE,MARSEILLE,0131329Z,78,78,0,0,44,34,3 ème
BOUCHES-DU-RHONE,MARSEILLE,0132407W,154,116,33,5,74,80,3 ème
BOUCHES-DU-RHONE,MARSEILLE,0131757P,147,144,0,3,79,68,3 ème
BOUCHES-DU-RHONE,MARSEILLE,0131375Z,50,50,0,0,31,19,3 ème
BOUCHES-DU-RHONE,MARSEILLE,0131884C,140,140,0,0,72,68,3 ème
BOUCHES-DU-RHONE,MARSEILLE,0131935H,140,140,0,0,70,70,3 ème
BOUCHES-DU-RHONE,MARSEILLE,0131381F,109,109,0,0,61,48,3 ème
BOUCHES-DU-RHONE,MARSEILLE,0132315W,140,139,0,1,67,73,3 ème
BOUCHES-DU-RHONE,MARSEILLE,0132923G,146,143,0,3,77,69,3 ème
BOUCHES-DU-RHONE,MARSEILLE,0132946G,105,105,0,0,45,60,3 ème
BOUCHES-DU-RHONE,MARSEILLE,0131689R,76,64,12,0,35,41,3 ème
BOUCHES-DU-RHONE,MARSEILLE,0132909S,93,93,0,0,44,49,3 ème
BOUCHES-DU-RHONE,MARSEILLE,0133374X,54,54,0,0,19,35,3 ème
BOUCHES-DU-RHONE,MARSEILLE,0132205B,123,123,0,0,59,64,3 ème
BOUCHES-DU-RHONE,MARSEILLE,0131923V,269,264,0,5,135,134,3 ème
BOUCHES-DU-RHONE,MARSEILLE,0131382G,93,93,0,0,51,42,3 ème
BOUCHES-DU-RHONE,MARSEILLE,0133866G,31,31,0,0,13,18,3 ème
BOUCHES-DU-RHONE,MARTIGUES,0132496T,107,107,0,0,60,47,3 ème
BOUCHES-DU-RHONE,PORT-DE-BOUC,0130150T,25,25,0,0,6,19,3 ème
BOUCHES-DU-RHONE,PORT-DE-BOUC,0130151U,45,45,0,0,30,15,3 ème
BOUCHES-DU-RHONE,PORT-SAINT-LOUIS-DU-RHONE,0132323E,91,87,3,1,38,53,3 ème
BOUCHES-DU-RHONE,ROGNAC,0131706J,169,169,0,0,84,85,3 ème
BOUCHES-DU-RHONE,ROGNONAS,0131387M,88,88,0,0,42,46,3 ème
BOUCHES-DU-RHONE,SAINT-MARTIN-DE-CRAU,0132834K,238,237,0,1,103,135,3 ème
BOUCHES-DU-RHONE,SALON-DE-PROVENCE,0130161E,24,24,0,0,11,13,3 ème
BOUCHES-DU-RHONE,SIMIANE-COLLONGUE,0133789Y,113,113,0,0,48,65,3 ème
BOUCHES-DU-RHONE,TRETS,0130166K,116,116,0,0,54,62,3 ème
HAUTES-ALPES,EMBRUN,0050023Y,121,119,0,2,52,69,3 ème
HAUTES-ALPES,GUILLESTRE,0050013M,81,81,0,0,29,52,3 ème
HAUTES-ALPES,LA BATIE-NEUVE,0050639T,69,69,0,0,33,36,3 ème
HAUTES-ALPES,SAINT-BONNET-EN-CHAMPSAUR,0050019U,117,117,0,0,57,60,3 ème
HAUTES-ALPES,SAINT-JEAN-SAINT-NICOLAS,0050039R,44,44,0,0,3,41,3 ème
VAUCLUSE,AVIGNON,0840004Y,12,12,0,0,0,12,3 ème
VAUCLUSE,AVIGNON,0840058G,78,78,0,0,43,35,3 ème
VAUCLUSE,AVIGNON,0840060J,194,194,0,0,104,90,3 ème
VAUCLUSE,AVIGNON,0840064N,78,78,0,0,34,44,3 ème
VAUCLUSE,AVIGNON,0840082H,71,68,0,3,37,34,3 ème
VAUCLUSE,BEDARRIDES,0840011F,114,114,0,0,60,54,3 ème
VAUCLUSE,CADENET,0840014J,124,122,0,2,62,62,3 ème
VAUCLUSE,CARPENTRAS,0840114T,192,155,33,4,86,106,3 ème
VAUCLUSE,CARPENTRAS,0840760V,126,122,0,4,55,71,3 ème
VAUCLUSE,MONTEUX,0840066R,121,121,0,0,53,68,3 ème
VAUCLUSE,ORANGE,0840046U,24,24,0,0,15,9,3 ème
VAUCLUSE,ORANGE,0840762X,128,126,0,2,69,59,3 ème
VAUCLUSE,VALREAS,0840700E,15,15,0,0,7,8,3 ème
ALPES-MARITIMES,ANTIBES,0060823M,61,61,0,0,32,29,3 ème
ALPES-MARITIMES,BREIL-SUR-ROYA,0060008B,35,35,0,0,18,17,3 ème
ALPES-MARITIMES,CAGNES-SUR-MER,0060911H,128,114,14,0,53,75,3 ème
ALPES-MARITIMES,CAGNES-SUR-MER,0061280J,176,176,0,0,92,84,3 ème
ALPES-MARITIMES,CAGNES-SUR-MER,0061737F,143,136,0,7,81,62,3 ème
ALPES-MARITIMES,CANNES,0060720A,170,170,0,0,88,82,3 ème
ALPES-MARITIMES,CANNES,0060799L,207,186,16,5,109,98,3 ème
ALPES-MARITIMES,CONTES,0060019N,201,181,16,4,87,114,3 ème
ALPES-MARITIMES,GRASSE,0060023T,24,24,0,0,10,14,3 ème
ALPES-MARITIMES,LE CANNET,0061239P,194,172,16,6,86,108,3 ème
ALPES-MARITIMES,LE ROURET,0061853G,175,174,0,1,97,78,3 ème
ALPES-MARITIMES,MENTON,0061824A,208,187,16,5,99,109,3 ème
ALPES-MARITIMES,MOUGINS,0061068D,226,203,15,8,79,147,3 ème
ALPES-MARITIMES,NICE,0060038J,22,22,0,0,3,19,3 ème
ALPES-MARITIMES,NICE,0060715V,25,25,0,0,17,8,3 ème
ALPES-MARITIMES,NICE,0060753L,85,85,0,0,58,27,3 ème
ALPES-MARITIMES,NICE,0060838D,127,118,0,9,56,71,3 ème
ALPES-MARITIMES,NICE,0061127T,118,118,0,0,66,52,3 ème
ALPES-MARITIMES,PUGET-THENIERS,0060061J,59,59,0,0,27,32,3 ème
ALPES-MARITIMES,SAINT-LAURENT-DU-VAR,0061738G,158,144,14,0,64,94,3 ème
ALPES-MARITIMES,TENDE,0060072W,25,25,0,0,14,11,3 ème
ALPES-MARITIMES,TOURRETTE-LEVENS,0060068S,190,190,0,0,114,76,3 ème
ALPES-MARITIMES,VALBONNE,0061925K,205,205,0,0,105,100,3 ème
VAR,BORMES-LES-MIMOSAS,0830927G,117,117,0,0,57,60,3 ème
VAR,HYERES,0831014B,14,14,0,0,2,12,3 ème
VAR,HYERES,0831563Y,24,24,0,0,10,14,3 ème
VAR,LA CRAU,0830012M,229,229,0,0,117,112,3 ème
VAR,LA VALETTE-DU-VAR,0830182X,176,158,15,3,81,95,3 ème
VAR,LA VALETTE-DU-VAR,0831218Y,167,140,16,11,77,90,3 ème
VAR,LE MUY,0830958R,111,111,0,0,51,60,3 ème
VAR,PUGET-SUR-ARGENS,0830168G,166,166,0,0,83,83,3 ème
VAR,SAINTE-MAXIME,0830039S,152,152,0,0,70,82,3 ème
VAR,SAINT-RAPHAEL,0830108S,148,148,0,0,81,67,3 ème
VAR,SIX-FOURS-LES-PLAGES,0830051E,179,179,0,0,92,87,3 ème
VAR,SOLLIES-PONT,0831355X,85,85,0,0,43,42,3 ème
VAR,TOULON,0830148K,102,102,0,0,54,48,3 ème
MAYOTTE,M'TSANGAMOUJI,9760167C,306,285,17,4,162,144,3 ème
MAYOTTE,TSINGONI,9760274U,357,341,13,3,175,182,3 ème
CALVADOS,BAYEUX,0140006F,170,141,23,6,85,85,3 ème
CALVADOS,BAYEUX,0141762P,124,119,0,5,64,60,3 ème
CALVADOS,BRETTEVILLE-SUR-LAIZE,0141312A,123,123,0,0,67,56,3 ème
CALVADOS,CAEN,0140018U,24,24,0,0,22,2,3 ème
CALVADOS,CAEN,0141597K,156,134,22,0,73,83,3 ème
CALVADOS,CAEN,0141867D,17,17,0,0,11,6,3 ème
CALVADOS,CONDE-EN-NORMANDIE,0141214U,20,20,0,0,11,9,3 ème
CALVADOS,CONDE-EN-NORMANDIE,0141258S,77,72,0,5,31,46,3 ème
CALVADOS,DEAUVILLE,0141763R,74,74,0,0,38,36,3 ème
CALVADOS,FALAISE,0140052F,24,24,0,0,12,12,3 ème
CALVADOS,FALAISE,0141167T,38,38,0,0,17,21,3 ème
CALVADOS,HONFLEUR,0140056K,8,8,0,0,3,5,3 ème
CALVADOS,ISIGNY-SUR-MER,0141257R,40,38,0,2,23,17,3 ème
CALVADOS,LES MONTS D'AUNAY,0141662F,94,81,13,0,45,49,3 ème
CALVADOS,MEZIDON VALLEE D'AUGE,0140070A,115,112,0,3,56,59,3 ème
CALVADOS,MONDEVILLE,0141687H,24,24,0,0,2,22,3 ème
CALVADOS,POTIGNY,0140077H,81,80,0,1,44,37,3 ème
CALVADOS,SALINE,0141684E,124,122,0,2,64,60,3 ème
CALVADOS,SOULEUVRE EN BOCAGE,0140008H,85,85,0,0,41,44,3 ème
CALVADOS,TROUVILLE-SUR-MER,0141273H,69,57,7,5,40,29,3 ème
CALVADOS,VALDALLIERE,0140086T,70,70,0,0,35,35,3 ème
CALVADOS,VIRE NORMANDIE,0141767V,130,109,16,5,79,51,3 ème
EURE,BOURG-ACHARD,0270007L,192,192,0,0,100,92,3 ème
EURE,BRIONNE,0271606Z,16,16,0,0,2,14,3 ème
EURE,EVREUX,0270022C,134,131,0,3,66,68,3 ème
EURE,EVREUX,0270051J,24,24,0,0,10,14,3 ème
EURE,EVREUX,0271095U,176,157,15,4,78,98,3 ème
EURE,EVREUX,0271173D,129,109,16,4,67,62,3 ème
EURE,GRAND BOURGTHEROULDE,0271317K,197,178,16,3,96,101,3 ème
EURE,LE NEUBOURG,0270032N,125,105,16,4,57,68,3 ème
EURE,LE NEUBOURG,0271885C,146,146,0,0,73,73,3 ème
EURE,LE VAUDREUIL,0271632C,168,163,0,5,81,87,3 ème
EURE,LOUVIERS,0271065L,153,153,0,0,81,72,3 ème
EURE,MANNEVILLE-SUR-RISLE,0271284Z,127,110,17,0,62,65,3 ème
EURE,MONTFORT-SUR-RISLE,0270054M,104,104,0,0,56,48,3 ème
EURE,PONT-AUDEMER,0270036T,151,148,0,3,61,90,3 ème
EURE,PONT-DE-L'ARCHE,0270038V,145,143,0,2,70,75,3 ème
EURE,SAINT-ANDRE-DE-L'EURE,0270041Y,154,139,12,3,79,75,3 ème
EURE,SAINT-MARCEL,0271123Z,120,120,0,0,73,47,3 ème
MANCHE,AVRANCHES,0501525L,83,76,7,0,53,30,3 ème
MANCHE,AVRANCHES,0501704F,108,108,0,0,54,54,3 ème
MANCHE,AVRANCHES,0501787W,11,11,0,0,1,10,3 ème
MANCHE,BRECEY,0501302U,100,100,0,0,43,57,3 ème
MANCHE,BREHAL,0501239A,79,77,0,2,44,35,3 ème
MANCHE,CARENTAN-LES-MARAIS,0501941N,18,18,0,0,4,14,3 ème
MANCHE,CHERBOURG-EN-COTENTIN,0500032N,22,22,0,0,3,19,3 ème
MANCHE,CHERBOURG-EN-COTENTIN,0501677B,19,19,0,0,5,14,3 ème
MANCHE,COUTANCES,0501206P,100,78,20,2,53,47,3 ème
MANCHE,COUTANCES,0501703E,104,104,0,0,56,48,3 ème
MANCHE,COUTANCES,0502009M,41,41,0,0,17,24,3 ème
MANCHE,DUCEY-LES CHERIS,0501240B,65,65,0,0,32,33,3 ème
MANCHE,GRANVILLE,0500039W,152,134,16,2,76,76,3 ème
MANCHE,LA HAGUE,0500006K,103,103,0,0,53,50,3 ème
MANCHE,LESSAY,0501458N,67,64,0,3,37,30,3 ème
MANCHE,MORTAIN-BOCAGE,0500050H,69,67,0,2,42,27,3 ème
MANCHE,PERCY-EN-NORMANDIE,0500052K,49,49,0,0,29,20,3 ème
MANCHE,PERIERS,0500053L,47,47,0,0,25,22,3 ème
MANCHE,PONTORSON,0501241C,61,61,0,0,30,31,3 ème
MANCHE,SAINTE-MERE-EGLISE,0500068C,56,47,9,0,26,30,3 ème
MANCHE,SAINT-HILAIRE-DU-HARCOUET,0500061V,80,71,6,3,36,44,3 ème
MANCHE,VALOGNES,0500155X,80,80,0,0,40,40,3 ème
ORNE,ALENCON,0610003X,125,108,15,2,64,61,3 ème
ORNE,ALENCON,0610004Y,23,23,0,0,0,23,3 ème
ORNE,ALENCON,0611026J,70,64,0,6,42,28,3 ème
ORNE,ARGENTAN,0610006A,15,15,0,0,4,11,3 ème
ORNE,BRIOUZE,0611024G,50,50,0,0,19,31,3 ème
ORNE,LA FERTE MACE,0610019P,15,15,0,0,11,4,3 ème
ORNE,LA FERTE MACE,0610996B,12,0,12,0,3,9,3 ème
ORNE,L'AIGLE,0611156A,113,108,0,5,64,49,3 ème
ORNE,MORTAGNE-AU-PERCHE,0611094H,52,52,0,0,19,33,3 ème
ORNE,MOULINS-LA-MARCHE,0610036H,34,34,0,0,27,7,3 ème
ORNE,TINCHEBRAY-BOCAGE,0610042P,45,45,0,0,27,18,3 ème
SEINE MARITIME,CANTELEU,0760017F,105,86,16,3,37,68,3 ème
SEINE MARITIME,CAUDEBEC-LES-ELBEUF,0762919K,95,92,0,3,48,47,3 ème
SEINE MARITIME,CLERES,0762197A,129,129,0,0,70,59,3 ème
SEINE MARITIME,DOUDEVILLE,0762123V,93,88,0,5,43,50,3 ème
SEINE MARITIME,ELBEUF,0760030V,24,24,0,0,11,13,3 ème
SEINE MARITIME,ELBEUF,0762563Y,205,205,0,0,95,110,3 ème
SEINE MARITIME,FECAMP,0760036B,23,23,0,0,3,20,3 ème
SEINE MARITIME,FECAMP,0761731U,151,151,0,0,77,74,3 ème
SEINE MARITIME,FECAMP,0761785C,126,111,15,0,63,63,3 ème
SEINE MARITIME,FECAMP,0762287Y,89,89,0,0,45,44,3 ème
SEINE MARITIME,GRAND-COURONNE,0762461M,72,72,0,0,37,35,3 ème
SEINE MARITIME,GRUCHET-LE-VALASSE,0762861X,100,97,0,3,48,52,3 ème
SEINE MARITIME,LE HAVRE,0760050S,105,105,0,0,46,59,3 ème
SEINE MARITIME,LE HAVRE,0761739C,85,69,16,0,43,42,3 ème
SEINE MARITIME,LE HAVRE,0761782Z,107,86,17,4,52,55,3 ème
SEINE MARITIME,LE HAVRE,0762081Z,8,0,8,0,2,6,3 ème
SEINE MARITIME,LE HAVRE,0762128A,89,68,16,5,38,51,3 ème
SEINE MARITIME,LE PETIT-QUEVILLY,0761737A,106,106,0,0,51,55,3 ème
SEINE MARITIME,LE TRAIT,0762085D,74,74,0,0,36,38,3 ème
SEINE MARITIME,LILLEBONNE,0762738N,73,73,0,0,39,34,3 ème
SEINE MARITIME,MESNIERES-EN-BRAY,0761330H,45,45,0,0,18,27,3 ème
SEINE MARITIME,MONTIVILLIERS,0761331J,99,99,0,0,53,46,3 ème
SEINE MARITIME,MONTIVILLIERS,0762288Z,129,129,0,0,59,70,3 ème
SEINE MARITIME,MONTVILLE,0762090J,101,101,0,0,51,50,3 ème
SEINE MARITIME,NEUFCHATEL-EN-BRAY,0760079Y,153,141,9,3,76,77,3 ème
SEINE MARITIME,OFFRANVILLE,0760082B,24,24,0,0,2,22,3 ème
SEINE MARITIME,OISSEL,0760083C,139,136,0,3,67,72,3 ème
SEINE MARITIME,PETIT-COURONNE,0760086F,136,136,0,0,68,68,3 ème
SEINE MARITIME,ROUEN,0761337R,74,74,0,0,32,42,3 ème
SEINE MARITIME,ROUEN,0762568D,146,143,0,3,52,94,3 ème
SEINE MARITIME,ROUEN,0763406P,156,145,11,0,68,88,3 ème
SEINE MARITIME,SAINT-AUBIN-LES-ELBEUF,0760101X,102,102,0,0,58,44,3 ème
SEINE MARITIME,SAINT-ROMAIN-DE-COLBOSC,0761689Y,222,222,0,0,134,88,3 ème
SEINE MARITIME,VAL-DE-SCIE,0761956N,166,150,16,0,79,87,3 ème
DORDOGNE,BERGERAC,0240004Z,132,130,0,2,60,72,3 ème
DORDOGNE,BERGERAC,0240007C,20,20,0,0,6,14,3 ème
DORDOGNE,EXCIDEUIL,0241007P,68,67,0,1,35,33,3 ème
DORDOGNE,EYMET,0240014K,76,76,0,0,37,39,3 ème
DORDOGNE,MONTPON-MENESTEROL,0240117X,146,143,0,3,74,72,3 ème
DORDOGNE,PERIGUEUX,0240030C,173,146,25,2,86,87,3 ème
DORDOGNE,PERIGUEUX,0240077D,73,73,0,0,41,32,3 ème
DORDOGNE,PERIGUEUX,0240089S,22,22,0,0,14,8,3 ème
DORDOGNE,PERIGUEUX,0241075N,127,121,0,6,50,77,3 ème
DORDOGNE,PIEGUT-PLUVIERS,0240043S,42,42,0,0,17,25,3 ème
DORDOGNE,RIBERAC,0240086N,21,21,0,0,11,10,3 ème
DORDOGNE,RIBERAC,0241011U,117,97,16,4,62,55,3 ème
DORDOGNE,SAINT-ANTOINE-DE-BREUILH,0240087P,36,36,0,0,17,19,3 ème
DORDOGNE,SAINT-ASTIER,0240650B,152,134,14,4,65,87,3 ème
DORDOGNE,SARLAT-LA-CANEDA,0240048X,23,23,0,0,8,15,3 ème
DORDOGNE,SARLAT-LA-CANEDA,0241076P,58,58,0,0,31,27,3 ème
GIRONDE,AMBARES-ET-LAGRAVE,0331617D,232,226,0,6,122,110,3 ème
GIRONDE,ARSAC,0332704K,193,193,0,0,100,93,3 ème
GIRONDE,BEGLES,0331880P,140,119,15,6,66,74,3 ème
GIRONDE,BLANQUEFORT,0331754C,176,157,16,3,81,95,3 ème
GIRONDE,BLANQUEFORT,0332535B,47,47,0,0,13,34,3 ème
GIRONDE,BORDEAUX,0331492T,152,150,0,2,83,69,3 ème
GIRONDE,BORDEAUX,0331519X,60,60,0,0,30,30,3 ème
GIRONDE,BORDEAUX,0331753B,96,96,0,0,47,49,3 ème
GIRONDE,BORDEAUX,0332490C,295,295,0,0,141,154,3 ème
GIRONDE,CADILLAC,0330059K,186,182,0,4,86,100,3 ème
GIRONDE,CENON,0331464M,155,151,0,4,78,77,3 ème
GIRONDE,COUTRAS,0331621H,243,213,26,4,127,116,3 ème
GIRONDE,CREON,0332283C,252,233,14,5,138,114,3 ème
GIRONDE,LA BREDE,0332494G,156,156,0,0,65,91,3 ème
GIRONDE,LE BOUSCAT,0331523B,173,173,0,0,84,89,3 ème
GIRONDE,LE PIAN-MEDOC,0333529G,0,0,0,0,0,0,3 ème
GIRONDE,LESPARRE-MEDOC,0331528G,61,58,0,3,34,27,3 ème
GIRONDE,LE TEICH,0332982M,92,88,0,4,41,51,3 ème
GIRONDE,LIBOURNE,0330089T,23,23,0,0,11,12,3 ème
GIRONDE,MARTIGNAS-SUR-JALLE,0332743C,94,94,0,0,40,54,3 ème
GIRONDE,MERIGNAC,0331435F,184,184,0,0,91,93,3 ème
GIRONDE,PEUJARD,0332723F,133,130,0,3,56,77,3 ème
GIRONDE,SAINT-ANDRE-DE-CUBZAC,0331757F,241,218,21,2,113,128,3 ème
GIRONDE,SAINT-CIERS-SUR-GIRONDE,0330113U,151,147,0,4,72,79,3 ème
GIRONDE,SAINT-MEDARD-DE-GUIZIERES,0331569B,25,25,0,0,10,15,3 ème
GIRONDE,SAINT-MEDARD-EN-JALLES,0332187Y,224,205,16,3,116,108,3 ème
GIRONDE,SAINT-SYMPHORIEN,0330122D,123,118,0,5,66,57,3 ème
GIRONDE,SAUVETERRE-DE-GUYENNE,0331667H,91,71,15,5,42,49,3 ème
GIRONDE,VILLENAVE-D'ORNON,0332246M,192,173,15,4,94,98,3 ème
LANDES,GABARRET,0400010U,31,31,0,0,18,13,3 ème
LANDES,GABARRET,0400883T,26,26,0,0,11,15,3 ème
LANDES,GRENADE-SUR-L'ADOUR,0400012W,95,95,0,0,54,41,3 ème
LANDES,LABOUHEYRE,0400014Y,100,100,0,0,51,49,3 ème
LANDES,PEYREHORADE,0400027M,23,23,0,0,10,13,3 ème
LANDES,ROQUEFORT,0400034V,57,55,0,2,25,32,3 ème
LANDES,SAINT-MARTIN-DE-SEIGNANX,0400874H,117,117,0,0,64,53,3 ème
LANDES,SAINT-SEVER,0400075P,43,43,0,0,23,20,3 ème
LANDES,SAINT-VINCENT-DE-PAUL,0400068G,26,14,11,1,9,17,3 ème
LANDES,TARNOS,0400049L,24,24,0,0,3,21,3 ème
LANDES,TARTAS,0400042D,122,115,0,7,68,54,3 ème
LOT-ET-GARONNE,AGEN,0470004Z,24,24,0,0,17,7,3 ème
LOT-ET-GARONNE,AGEN,0470008D,136,136,0,0,66,70,3 ème
LOT-ET-GARONNE,BON-ENCONTRE,0470720C,192,177,12,3,93,99,3 ème
LOT-ET-GARONNE,CASSENEUIL,0470067T,79,72,7,0,35,44,3 ème
LOT-ET-GARONNE,CASTELJALOUX,0470012H,86,86,0,0,53,33,3 ème
LOT-ET-GARONNE,CASTELJALOUX,0470068U,33,30,0,3,18,15,3 ème
LOT-ET-GARONNE,DURAS,0470017N,46,46,0,0,30,16,3 ème
LOT-ET-GARONNE,MIRAMONT-DE-GUYENNE,0470024W,78,76,0,2,32,46,3 ème
LOT-ET-GARONNE,MONBAHUS,0470071X,24,21,0,3,9,15,3 ème
LOT-ET-GARONNE,PORT-SAINTE-MARIE,0470032E,57,57,0,0,31,26,3 ème
LOT-ET-GARONNE,TONNEINS,0470073Z,53,53,0,0,22,31,3 ème
LOT-ET-GARONNE,VILLENEUVE-SUR-LOT,0470811B,129,129,0,0,59,70,3 ème
PYRENEES-ATLANTIQUES,ANGLET,0640001D,24,24,0,0,2,22,3 ème
PYRENEES-ATLANTIQUES,ARUDY,0640007K,59,59,0,0,36,23,3 ème
PYRENEES-ATLANTIQUES,ARZACQ-ARRAZIGUET,0640008L,82,82,0,0,43,39,3 ème
PYRENEES-ATLANTIQUES,BAYONNE,0640112Z,162,159,0,3,96,66,3 ème
PYRENEES-ATLANTIQUES,BAYONNE,0640143H,83,83,0,0,48,35,3 ème
PYRENEES-ATLANTIQUES,BAYONNE,0640609P,131,111,16,4,70,61,3 ème
PYRENEES-ATLANTIQUES,BIARRITZ,0640146L,53,53,0,0,22,31,3 ème
PYRENEES-ATLANTIQUES,BOUCAU,0640023C,82,82,0,0,39,43,3 ème
PYRENEES-ATLANTIQUES,CIBOURE,0641941M,77,71,0,6,35,42,3 ème
PYRENEES-ATLANTIQUES,GARLIN,0640025E,50,48,0,2,24,26,3 ème
PYRENEES-ATLANTIQUES,HENDAYE,0640151S,57,57,0,0,30,27,3 ème
PYRENEES-ATLANTIQUES,JURANCON,0641405E,42,42,0,0,17,25,3 ème
PYRENEES-ATLANTIQUES,LEMBEYE,0640037T,65,65,0,0,36,29,3 ème
PYRENEES-ATLANTIQUES,LESCAR,0641391P,207,204,0,3,113,94,3 ème
PYRENEES-ATLANTIQUES,MAULEON-LICHARRE,0640039V,59,55,0,4,29,30,3 ème
PYRENEES-ATLANTIQUES,NAVARRENX,0640045B,36,36,0,0,18,18,3 ème
PYRENEES-ATLANTIQUES,OLORON-SAINTE-MARIE,0640049F,24,24,0,0,1,23,3 ème
PYRENEES-ATLANTIQUES,OLORON-SAINTE-MARIE,0641658E,71,71,0,0,37,34,3 ème
PYRENEES-ATLANTIQUES,PAU,0640132W,52,49,0,3,25,27,3 ème
PYRENEES-ATLANTIQUES,PAU,0642095E,56,56,0,0,24,32,3 ème
PYRENEES-ATLANTIQUES,PONTACQ,0640161C,48,48,0,0,28,20,3 ème
PYRENEES-ATLANTIQUES,SAINT-JEAN-PIED-DE-PORT,0640069C,63,48,15,0,34,29,3 ème
PYRENEES-ATLANTIQUES,SAINT-PEE-SUR-NIVELLE,0640169L,71,71,0,0,39,32,3 ème
CORREZE,ARGENTAT-SUR-DORDOGNE,0190002Z,76,76,0,0,44,32,3 ème
CORREZE,BORT-LES-ORGUES,0190009G,29,29,0,0,13,16,3 ème
CORREZE,BRIVE-LA-GAILLARDE,0190012K,24,24,0,0,21,3,3 ème
CORREZE,BRIVE-LA-GAILLARDE,0190014M,165,135,28,2,79,86,3 ème
CORREZE,USSEL,0190615R,161,143,14,4,80,81,3 ème
CREUSE,CHAMBON-SUR-VOUEIZE,0230010L,47,47,0,0,28,19,3 ème
CREUSE,DUN-LE-PALESTEL,0230408U,41,41,0,0,27,14,3 ème
CREUSE,GUERET,0230487E,137,118,15,4,72,65,3 ème
CREUSE,GUERET,0230488F,139,139,0,0,72,67,3 ème
CREUSE,SAINT-VAURY,0230027E,24,24,0,0,4,20,3 ème
HAUTE-VIENNE,CHATEAUPONSAC,0870009M,52,52,0,0,24,28,3 ème
HAUTE-VIENNE,COUZEIX,0870871Z,168,158,0,10,75,93,3 ème
HAUTE-VIENNE,ISLE,0870658T,148,148,0,0,71,77,3 ème
HAUTE-VIENNE,LIMOGES,0870023C,111,111,0,0,68,43,3 ème
HAUTE-VIENNE,LIMOGES,0870919B,21,21,0,0,7,14,3 ème
HAUTE-VIENNE,SAINT-GERMAIN-LES-BELLES,0870039V,58,58,0,0,30,28,3 ème
HAUTE-VIENNE,SAINT-YRIEIX-LA-PERCHE,0870821V,134,119,13,2,59,75,3 ème
CHARENTE,ANGOULEME,0160005U,89,89,0,0,48,41,3 ème
CHARENTE,ANGOULEME,0161106R,70,67,0,3,30,40,3 ème
CHARENTE,CHABANAIS,0160120U,65,53,12,0,36,29,3 ème
CHARENTE,CHATEAUNEUF-SUR-CHARENTE,0160863B,96,96,0,0,55,41,3 ème
CHARENTE,LA COURONNE,0160024P,160,158,0,2,78,82,3 ème
CHARENTE,MANSLE,0160029V,93,92,0,1,50,43,3 ème
CHARENTE,SAINT-AMANT-DE-BOIXE,0160040G,96,91,0,5,54,42,3 ème
CHARENTE,SAINT-YRIEIX-SUR-CHARENTE,0160083D,20,20,0,0,9,11,3 ème
CHARENTE,SOYAUX,0160894K,112,111,0,1,53,59,3 ème
CHARENTE,VILLEBOIS-LAVALETTE,0160043K,77,77,0,0,39,38,3 ème
CHARENTE-MARITIME,BURIE,0170004M,68,68,0,0,27,41,3 ème
CHARENTE-MARITIME,CHATELAILLON-PLAGE,0171211Z,168,166,0,2,90,78,3 ème
CHARENTE-MARITIME,JONZAC,0170011V,115,112,0,3,47,68,3 ème
CHARENTE-MARITIME,LA ROCHELLE,0170031S,23,23,0,0,10,13,3 ème
CHARENTE-MARITIME,LOULAY,0170012W,48,48,0,0,27,21,3 ème
CHARENTE-MARITIME,MARENNES-HIERS-BROUAGE,0170386C,131,118,11,2,73,58,3 ème
CHARENTE-MARITIME,MATHA,0171159T,84,82,0,2,48,36,3 ème
CHARENTE-MARITIME,MONTENDRE,0170390G,114,87,24,3,57,57,3 ème
CHARENTE-MARITIME,MONTGUYON,0171160U,52,52,0,0,27,25,3 ème
CHARENTE-MARITIME,ROCHEFORT,0170113F,56,56,0,0,31,25,3 ème
CHARENTE-MARITIME,ROCHEFORT,0171056F,162,158,0,4,72,90,3 ème
CHARENTE-MARITIME,ROYAN,0171120A,171,141,28,2,92,79,3 ème
CHARENTE-MARITIME,SAINTES,0170063B,175,147,24,4,85,90,3 ème
CHARENTE-MARITIME,SAINTES,0170102U,81,81,0,0,37,44,3 ème
CHARENTE-MARITIME,SAINTES,0170144P,215,212,0,3,100,115,3 ème
CHARENTE-MARITIME,SAINT-GENIS-DE-SAINTONGE,0170049L,89,85,0,4,47,42,3 ème
CHARENTE-MARITIME,SAINT-JEAN-D'ANGELY,0170052P,21,21,0,0,5,16,3 ème
CHARENTE-MARITIME,SAINT-MARTIN-DE-RE,0171034G,137,137,0,0,76,61,3 ème
CHARENTE-MARITIME,SAINT-PORCHAIRE,0170055T,123,120,0,3,61,62,3 ème
CHARENTE-MARITIME,SAUJON,0170387D,159,157,0,2,83,76,3 ème
DEUX-SEVRES,ARGENTONNAY,0790003Z,59,59,0,0,23,36,3 ème
DEUX-SEVRES,L'ABSIE,0790001X,15,15,0,0,6,9,3 ème
DEUX-SEVRES,LA MOTHE-SAINT-HERAY,0790021U,53,50,0,3,25,28,3 ème
DEUX-SEVRES,MONCOUTANT-SUR-SEVRE,0790966W,68,65,0,3,33,35,3 ème
DEUX-SEVRES,NIORT,0790052C,128,113,15,0,61,67,3 ème
DEUX-SEVRES,NIORT,0790089T,131,130,0,1,71,60,3 ème
DEUX-SEVRES,NIORT,0790709S,167,163,0,4,85,82,3 ème
DEUX-SEVRES,NUEIL-LES-AUBIERS,0790061M,65,65,0,0,35,30,3 ème
DEUX-SEVRES,PARTHENAY,0790071Y,74,70,0,4,34,40,3 ème
DEUX-SEVRES,PARTHENAY,0790090U,23,23,0,0,9,14,3 ème
DEUX-SEVRES,PRAHECQ,0790950D,118,116,0,2,53,65,3 ème
DEUX-SEVRES,SAUZE-VAUSSAIS,0790033G,42,42,0,0,23,19,3 ème
DEUX-SEVRES,THOUARS,0791017B,84,84,0,0,44,40,3 ème
VIENNE,BUXEROLLES,0860799B,145,143,0,2,74,71,3 ème
VIENNE,CHARROUX,0860002K,20,20,0,0,11,9,3 ème
VIENNE,CHATELLERAULT,0860702W,89,87,0,2,49,40,3 ème
VIENNE,CHATELLERAULT,0860753B,105,105,0,0,47,58,3 ème
VIENNE,DANGE-SAINT-ROMAIN,0860015Z,72,72,0,0,38,34,3 ème
VIENNE,LOUDUN,0860023H,117,103,12,2,63,54,3 ème
VIENNE,MONTMORILLON,0860768T,21,21,0,0,12,9,3 ème
VIENNE,POITIERS,0860723U,168,163,0,5,91,77,3 ème
VIENNE,POITIERS,0860758G,140,138,0,2,70,70,3 ème
VIENNE,POITIERS,0860791T,188,187,0,1,84,104,3 ème
VIENNE,VOUNEUIL-SOUS-BIARD,0861457S,171,169,0,2,75,96,3 ème
VIENNE,VOUNEUIL-SUR-VIENNE,0860049L,122,120,0,2,52,70,3 ème
AUDE,CARCASSONNE,0110010B,91,91,0,0,43,48,3 ème
AUDE,CARCASSONNE,0110810W,231,194,31,6,113,118,3 ème
AUDE,COURSAN,0110067N,173,171,0,2,82,91,3 ème
AUDE,CUXAC-CABARDES,0110721Z,87,87,0,0,42,45,3 ème
AUDE,LEZIGNAN-CORBIERES,0110686L,184,181,0,3,92,92,3 ème
AUDE,NARBONNE,0110049U,216,213,0,3,119,97,3 ème
AUDE,PORT-LA-NOUVELLE,0110725D,79,71,0,8,42,37,3 ème
AUDE,QUILLAN,0110675Z,57,57,0,0,31,26,3 ème
AUDE,SAINT-NAZAIRE-D'AUDE,0111015U,160,160,0,0,83,77,3 ème
AUDE,SIGEAN,0110724C,145,145,0,0,78,67,3 ème
GARD,ALES,0300125Y,66,66,0,0,18,48,3 ème
GARD,ALES,0300947S,133,115,13,5,69,64,3 ème
GARD,ALES,0300949U,155,150,0,5,78,77,3 ème
GARD,BEAUCAIRE,0301282F,135,114,16,5,65,70,3 ème
GARD,BELLEGARDE,0301827Y,91,91,0,0,45,46,3 ème
GARD,LA GRAND-COMBE,0301012M,83,76,0,7,44,39,3 ème
GARD,LE GRAU-DU-ROI,0301751R,107,107,0,0,52,55,3 ème
GARD,LE VIGAN,0301326D,112,99,13,0,65,47,3 ème
GARD,NIMES,0300025P,75,72,0,3,41,34,3 ème
GARD,NIMES,0300093N,222,207,15,0,132,90,3 ème
GARD,NIMES,0301356L,323,321,0,2,141,182,3 ème
GARD,UZES,0301283G,181,165,16,0,93,88,3 ème
GARD,UZES,0301721H,109,107,0,2,57,52,3 ème
GARD,VAUVERT,0301096D,229,200,25,4,113,116,3 ème
HERAULT,BEZIERS,0340891J,48,48,0,0,24,24,3 ème
HERAULT,BEZIERS,0341321B,188,165,17,6,92,96,3 ème
HERAULT,CAPESTANG,0341367B,167,166,0,1,90,77,3 ème
HERAULT,CLAPIERS,0341826A,143,140,0,3,72,71,3 ème
HERAULT,CLERMONT-L'HERAULT,0341366A,186,183,0,3,106,80,3 ème
HERAULT,FRONTIGNAN,0342052W,128,125,0,3,72,56,3 ème
HERAULT,GANGES,0340896P,62,62,0,0,30,32,3 ème
HERAULT,LOUPIAN,0342224H,126,112,14,0,68,58,3 ème
HERAULT,LUNEL,0340031Z,187,185,0,2,86,101,3 ème
HERAULT,MONTPELLIER,0340874R,224,224,0,0,123,101,3 ème
HERAULT,MONTPELLIER,0340876T,142,142,0,0,61,81,3 ème
HERAULT,MONTPELLIER,0340996Y,178,162,16,0,95,83,3 ème
HERAULT,MONTPELLIER,0340998A,153,152,0,1,72,81,3 ème
HERAULT,MONTPELLIER,0342012C,35,35,0,0,18,17,3 ème
HERAULT,PAULHAN,0340974Z,143,143,0,0,71,72,3 ème
HERAULT,PEZENAS,0340061G,47,47,0,0,20,27,3 ème
HERAULT,PEZENAS,0340907B,69,69,0,0,37,32,3 ème
HERAULT,SAINT-CHINIAN,0340065L,63,63,0,0,34,29,3 ème
HERAULT,SETE,0340076Y,48,48,0,0,5,43,3 ème
HERAULT,SETE,0341065Y,87,69,14,4,41,46,3 ème
LOZERE,MARVEJOLS,0480024R,78,78,0,0,36,42,3 ème
LOZERE,SAINT-CHELY-D'APCHER,0480038F,63,63,0,0,36,27,3 ème
LOZERE,VIALAS,0480016G,6,6,0,0,3,3,3 ème
PYRENEES-ORIENTALES,ARGELES-SUR-MER,0660001T,177,156,17,4,85,92,3 ème
PYRENEES-ORIENTALES,CERET,0660004W,24,24,0,0,12,12,3 ème
PYRENEES-ORIENTALES,ESTAGEL,0660007Z,71,71,0,0,36,35,3 ème
PYRENEES-ORIENTALES,ILLE-SUR-TET,0660008A,121,118,0,3,63,58,3 ème
PYRENEES-ORIENTALES,LE SOLER,0660653B,155,153,0,2,78,77,3 ème
PYRENEES-ORIENTALES,MILLAS,0660925X,157,151,0,6,67,90,3 ème
PYRENEES-ORIENTALES,PERPIGNAN,0660012E,188,163,17,8,98,90,3 ème
PYRENEES-ORIENTALES,PERPIGNAN,0660017K,112,112,0,0,53,59,3 ème
PYRENEES-ORIENTALES,PERPIGNAN,0660018L,174,170,0,4,92,82,3 ème
PYRENEES-ORIENTALES,PERPIGNAN,0660019M,185,166,17,2,87,98,3 ème
PYRENEES-ORIENTALES,PERPIGNAN,0660049V,198,193,0,5,79,119,3 ème
PYRENEES-ORIENTALES,PERPIGNAN,0660061H,139,139,0,0,70,69,3 ème
PYRENEES-ORIENTALES,PERPIGNAN,0660809W,24,24,0,0,11,13,3 ème
PYRENEES-ORIENTALES,SAINT-CYPRIEN,0660848N,205,205,0,0,107,98,3 ème
PYRENEES-ORIENTALES,TOULOUGES,0660864F,175,175,0,0,93,82,3 ème
ARIEGE,PAMIERS,0090056M,150,147,0,3,93,57,3 ème
ARIEGE,PAMIERS,0090591U,84,84,0,0,46,38,3 ème
ARIEGE,SAVERDUN,0090023B,72,70,0,2,31,41,3 ème
AVEYRON,BARAQUEVILLE,0120032V,102,101,0,1,48,54,3 ème
AVEYRON,BARAQUEVILLE,0120080X,19,19,0,0,11,8,3 ème
AVEYRON,BELMONT-SUR-RANCE,0120081Y,40,40,0,0,18,22,3 ème
AVEYRON,CAPDENAC-GARE,0120002M,67,67,0,0,26,41,3 ème
AVEYRON,CASSAGNES-BEGONHES,0120084B,25,25,0,0,16,9,3 ème
AVEYRON,LAGUIOLE,0120091J,22,22,0,0,10,12,3 ème
AVEYRON,MILLAU,0121259D,133,133,0,0,69,64,3 ème
AVEYRON,MUR-DE-BARREZ,0120016C,34,34,0,0,17,17,3 ème
AVEYRON,REQUISTA,0120019F,39,39,0,0,21,18,3 ème
AVEYRON,REQUISTA,0120068J,15,15,0,0,8,7,3 ème
AVEYRON,RODEZ,0120038B,20,18,0,2,10,10,3 ème
AVEYRON,RODEZ,0120101V,186,181,0,5,102,84,3 ème
AVEYRON,RODEZ,0121430P,254,228,16,10,116,138,3 ème
AVEYRON,SAINT-AMANS-DES-COTS,0121295T,49,47,0,2,23,26,3 ème
AVEYRON,SAINT GENIEZ D'OLT ET D'AUBRAC,0120028R,42,42,0,0,20,22,3 ème
AVEYRON,SALLES-CURAN,0120077U,26,26,0,0,14,12,3 ème
GERS,AUCH,0320006H,109,106,0,3,63,46,3 ème
GERS,EAUZE,0320011N,91,88,0,3,48,43,3 ème
GERS,LECTOURE,0320015T,24,24,0,0,18,6,3 ème
GERS,MIELAN,0320074G,34,34,0,0,20,14,3 ème
HAUTE-GARONNE,ASPET,0310001H,48,46,0,2,23,25,3 ème
HAUTE-GARONNE,BLAGNAC,0311237B,152,148,0,4,71,81,3 ème
HAUTE-GARONNE,BLAGNAC,0311965T,135,135,0,0,70,65,3 ème
HAUTE-GARONNE,CADOURS,0310008R,162,162,0,0,71,91,3 ème
HAUTE-GARONNE,COLOMIERS,0311160T,115,115,0,0,66,49,3 ème
HAUTE-GARONNE,COLOMIERS,0312092F,90,89,0,1,42,48,3 ème
HAUTE-GARONNE,CUGNAUX,0311093V,292,289,0,3,156,136,3 ème
HAUTE-GARONNE,FRONTON,0311721C,199,194,0,5,103,96,3 ème
HAUTE-GARONNE,GRATENTOUR,0312478A,164,161,0,3,94,70,3 ème
HAUTE-GARONNE,GRENADE,0311769E,164,143,18,3,88,76,3 ème
HAUTE-GARONNE,L'ISLE-EN-DODON,0310019C,37,37,0,0,18,19,3 ème
HAUTE-GARONNE,L'UNION,0311094W,182,163,14,5,98,84,3 ème
HAUTE-GARONNE,MONTASTRUC-LA-CONSEILLERE,0310021E,184,183,0,1,77,107,3 ème
HAUTE-GARONNE,MONTESQUIEU-VOLVESTRE,0310022F,93,93,0,0,42,51,3 ème
HAUTE-GARONNE,MURET,0312822Z,24,22,0,2,11,13,3 ème
HAUTE-GARONNE,REVEL,0311846N,129,129,0,0,69,60,3 ème
HAUTE-GARONNE,SAINT-GAUDENS,0310033T,24,24,0,0,15,9,3 ème
HAUTE-GARONNE,SAINT-ORENS-DE-GAMEVILLE,0312140H,149,149,0,0,67,82,3 ème
HAUTE-GARONNE,TOULOUSE,0310093H,136,132,0,4,66,70,3 ème
HAUTE-GARONNE,TOULOUSE,0311112R,192,172,15,5,79,113,3 ème
HAUTE-GARONNE,TOULOUSE,0311144A,108,106,0,2,48,60,3 ème
HAUTE-GARONNE,TOULOUSE,0311150G,85,85,0,0,54,31,3 ème
HAUTE-GARONNE,TOULOUSE,0311169C,84,82,0,2,44,40,3 ème
HAUTE-GARONNE,TOULOUSE,0311171E,111,111,0,0,48,63,3 ème
HAUTE-GARONNE,TOULOUSE,0311219G,20,15,0,5,12,8,3 ème
HAUTE-GARONNE,TOULOUSE,0311327Z,110,95,14,1,52,58,3 ème
HAUTE-GARONNE,TOULOUSE,0311582B,82,82,0,0,37,45,3 ème
HAUTE-GARONNE,TOULOUSE,0311972A,281,275,6,0,147,134,3 ème
HAUTE-GARONNE,TOURNEFEUILLE,0312746S,24,22,0,2,11,13,3 ème
HAUTE-GARONNE,VILLEFRANCHE-DE-LAURAGAIS,0311634H,172,169,0,3,94,78,3 ème
HAUTE-GARONNE,VILLEMUR-SUR-TARN,0311689T,160,144,16,0,83,77,3 ème
HAUTES-PYRENEES,PIERREFITTE-NESTALAS,0650020U,22,22,0,0,11,11,3 ème
HAUTES-PYRENEES,SEMEAC,0650088T,132,131,0,1,67,65,3 ème
HAUTES-PYRENEES,TARBES,0650029D,24,24,0,0,16,8,3 ème
HAUTES-PYRENEES,TRIE-SUR-BAISE,0650037M,50,50,0,0,29,21,3 ème
HAUTES-PYRENEES,VIC-EN-BIGORRE,0650075D,22,22,0,0,11,11,3 ème
LOT,CAHORS,0460006G,226,219,0,7,125,101,3 ème
LOT,CAHORS,0460528Z,149,129,17,3,62,87,3 ème
LOT,CAJARC,0460001B,51,51,0,0,28,23,3 ème
LOT,CASTELNAU MONTRATIER-STE ALAUZIE,0460008J,63,63,0,0,25,38,3 ème
LOT,FIGEAC,0460621A,82,82,0,0,34,48,3 ème
LOT,GOURDON,0460013P,15,15,0,0,10,5,3 ème
LOT,LUZECH,0460020X,85,85,0,0,48,37,3 ème
LOT,MONTCUQ-EN-QUERCY-BLANC,0460022Z,29,29,0,0,12,17,3 ème
LOT,PUY-L'EVEQUE,0460530B,65,65,0,0,41,24,3 ème
LOT,SAINT-CERE,0460593V,108,94,12,2,65,43,3 ème
LOT,SALVIAC,0460027E,36,36,0,0,21,15,3 ème
TARN,ALBI,0810100U,26,26,0,0,13,13,3 ème
TARN,CASTRES,0811064S,116,114,0,2,50,66,3 ème
TARN,GAILLAC,0810993P,184,163,16,5,86,98,3 ème
TARN,GRAULHET,0810995S,14,14,0,0,5,9,3 ème
TARN,LABRUGUIERE,0810026N,123,118,0,5,78,45,3 ème
TARN,LISLE-SUR-TARN,0811340S,84,84,0,0,33,51,3 ème
TARN,MAZAMET,0811324Z,16,16,0,0,7,9,3 ème
TARN,VALENCE-D'ALBIGEOIS,0810043G,64,64,0,0,29,35,3 ème
TARN,VIELMUR-SUR-AGOUT,0810044H,107,107,0,0,52,55,3 ème
TARN-ET-GARONNE,BEAUMONT-DE-LOMAGNE,0820001F,18,18,0,0,0,18,3 ème
TARN-ET-GARONNE,BEAUMONT-DE-LOMAGNE,0820067C,129,125,0,4,64,65,3 ème
TARN-ET-GARONNE,CASTELSARRASIN,0820004J,23,23,0,0,10,13,3 ème
TARN-ET-GARONNE,CAUSSADE,0820048G,77,77,0,0,36,41,3 ème
TARN-ET-GARONNE,LAFRANCAISE,0820011S,133,127,0,6,68,65,3 ème
TARN-ET-GARONNE,LAUZERTE,0820014V,73,70,0,3,27,46,3 ème
LOIRE-ATLANTIQUE,ANCENIS-SAINT-GEREON,0440001M,22,22,0,0,8,14,3 ème
LOIRE-ATLANTIQUE,ANCENIS-SAINT-GEREON,0440147W,187,168,14,5,88,99,3 ème
LOIRE-ATLANTIQUE,BLAIN,0440182J,124,120,0,4,65,59,3 ème
LOIRE-ATLANTIQUE,BLAIN,0440308W,199,168,29,2,95,104,3 ème
LOIRE-ATLANTIQUE,CARQUEFOU,0440422V,175,174,0,1,90,85,3 ème
LOIRE-ATLANTIQUE,CHATEAUBRIANT,0440348P,121,107,13,1,70,51,3 ème
LOIRE-ATLANTIQUE,COUERON,0440010X,235,235,0,0,126,109,3 ème
LOIRE-ATLANTIQUE,COUERON,0440190T,152,152,0,0,77,75,3 ème
LOIRE-ATLANTIQUE,GUEMENE-PENFAO,0440013A,95,93,0,2,52,43,3 ème
LOIRE-ATLANTIQUE,GUEMENE-PENFAO,0440192V,52,52,0,0,25,27,3 ème
LOIRE-ATLANTIQUE,GUERANDE,0440538W,144,144,0,0,79,65,3 ème
LOIRE-ATLANTIQUE,HAUTE-GOULAINE,0440153C,81,81,0,0,36,45,3 ème
LOIRE-ATLANTIQUE,LA MONTAGNE,0440347N,107,106,0,1,43,64,3 ème
LOIRE-ATLANTIQUE,LEGE,0441612N,68,68,0,0,32,36,3 ème
LOIRE-ATLANTIQUE,MACHECOUL-SAINT-MEME,0440352U,24,24,0,0,8,16,3 ème
LOIRE-ATLANTIQUE,NANTES,0440023L,214,190,15,9,102,112,3 ème
LOIRE-ATLANTIQUE,NANTES,0440203G,44,44,0,0,24,20,3 ème
LOIRE-ATLANTIQUE,NANTES,0440206K,21,21,0,0,12,9,3 ème
LOIRE-ATLANTIQUE,NANTES,0440207L,46,46,0,0,12,34,3 ème
LOIRE-ATLANTIQUE,NANTES,0441820P,90,90,0,0,49,41,3 ème
LOIRE-ATLANTIQUE,NANTES,0441821R,85,85,0,0,42,43,3 ème
LOIRE-ATLANTIQUE,NORT-SUR-ERDRE,0441654J,183,180,0,3,93,90,3 ème
LOIRE-ATLANTIQUE,PONTCHATEAU,0440224E,155,155,0,0,64,91,3 ème
LOIRE-ATLANTIQUE,PONTCHATEAU,0440540Y,115,82,32,1,55,60,3 ème
LOIRE-ATLANTIQUE,PORNIC,0440226G,137,137,0,0,77,60,3 ème
LOIRE-ATLANTIQUE,PORNIC,0440289A,189,186,0,3,98,91,3 ème
LOIRE-ATLANTIQUE,REZE,0440534S,133,114,16,3,64,69,3 ème
LOIRE-ATLANTIQUE,RIAILLE,0440232N,65,65,0,0,35,30,3 ème
LOIRE-ATLANTIQUE,SAINT-BREVIN-LES-PINS,0440066H,142,138,0,4,68,74,3 ème
LOIRE-ATLANTIQUE,SAINT-HERBLAIN,0440287Y,107,100,0,7,46,61,3 ème
LOIRE-ATLANTIQUE,SAINT-HERBLAIN,0440311Z,134,118,13,3,67,67,3 ème
LOIRE-ATLANTIQUE,SAINT-HERBLAIN,0441610L,103,88,15,0,53,50,3 ème
LOIRE-ATLANTIQUE,SAINT-NAZAIRE,0442759K,175,173,0,2,87,88,3 ème
LOIRE-ATLANTIQUE,SAINT-SEBASTIEN-SUR-LOIRE,0441548U,184,170,14,0,82,102,3 ème
LOIRE-ATLANTIQUE,SAINT-SEBASTIEN-SUR-LOIRE,0441653H,64,64,0,0,6,58,3 ème
LOIRE-ATLANTIQUE,VALLET,0440242Z,152,152,0,0,87,65,3 ème
MAINE-ET-LOIRE,ANGERS,0490003M,24,24,0,0,11,13,3 ème
MAINE-ET-LOIRE,ANGERS,0492432C,48,48,0,0,26,22,3 ème
MAINE-ET-LOIRE,AVRILLE,0491674D,159,144,15,0,74,85,3 ème
MAINE-ET-LOIRE,BEAUPREAU-EN-MAUGES,0490865Z,61,61,0,0,21,40,3 ème
MAINE-ET-LOIRE,CHEMILLE-EN-ANJOU,0490017C,87,83,0,4,37,50,3 ème
MAINE-ET-LOIRE,CHOLET,0490022H,107,101,0,6,58,49,3 ème
MAINE-ET-LOIRE,CHOLET,0490054T,24,24,0,0,11,13,3 ème
MAINE-ET-LOIRE,CHOLET,0490860U,135,104,31,0,59,76,3 ème
MAINE-ET-LOIRE,CHOLET,0491859E,134,113,16,5,61,73,3 ème
MAINE-ET-LOIRE,LOIRE-AUTHION,0490013Y,23,23,0,0,0,23,3 ème
MAINE-ET-LOIRE,MAUGES-SUR-LOIRE,0491928E,240,223,16,1,125,115,3 ème
MAINE-ET-LOIRE,MONTREUIL-BELLAY,0491262F,85,71,9,5,41,44,3 ème
MAINE-ET-LOIRE,SAINT-BARTHELEMY-D'ANJOU,0490957Z,168,164,0,4,88,80,3 ème
MAINE-ET-LOIRE,SAUMUR,0490910Y,45,45,0,0,16,29,3 ème
MAINE-ET-LOIRE,SEICHES-SUR-LE-LOIR,0491024X,163,158,0,5,81,82,3 ème
MAINE-ET-LOIRE,SEVREMOINE,0490842Z,99,99,0,0,46,53,3 ème
MAINE-ET-LOIRE,VERRIERES-EN-ANJOU,0492420P,24,24,0,0,0,24,3 ème
MAYENNE,CHATEAU-GONTIER-SUR-MAYENNE,0530827L,110,110,0,0,59,51,3 ème
MAYENNE,COSSE-LE-VIVIEN,0530054W,127,127,0,0,61,66,3 ème
MAYENNE,CRAON,0530005T,77,60,17,0,35,42,3 ème
MAYENNE,CRAON,0530055X,92,89,0,3,46,46,3 ème
MAYENNE,EVRON,0530949U,24,24,0,0,9,15,3 ème
MAYENNE,LANDIVY,0530804L,38,38,0,0,15,23,3 ème
MAYENNE,LAVAL,0530068L,25,24,0,1,13,12,3 ème
MAYENNE,LAVAL,0530790W,114,111,0,3,61,53,3 ème
MAYENNE,MAYENNE,0530078X,133,114,15,4,61,72,3 ème
MAYENNE,MAYENNE,0530079Y,24,24,0,0,11,13,3 ème
MAYENNE,VILLAINES-LA-JUHEL,0530066J,37,37,0,0,15,22,3 ème
SARTHE,ARNAGE,0720003M,46,46,0,0,7,39,3 ème
SARTHE,BOULOIRE,0720007S,89,78,11,0,44,45,3 ème
SARTHE,COULAINES,0720906U,102,99,0,3,38,64,3 ème
SARTHE,LA SUZE-SUR-SARTHE,0720905T,116,113,0,3,56,60,3 ème
SARTHE,LE MANS,0720822C,46,46,0,0,26,20,3 ème
SARTHE,LE MANS,0720825F,54,54,0,0,36,18,3 ème
SARTHE,LE MANS,0721090U,110,94,16,0,47,63,3 ème
SARTHE,LOUE,0720808M,46,46,0,0,19,27,3 ème
SARTHE,MAMERS,0720069J,81,65,16,0,38,43,3 ème
SARTHE,MAMERS,0721657K,35,35,0,0,18,17,3 ème
SARTHE,SABLE-SUR-SARTHE,0720070K,135,135,0,0,60,75,3 ème
SARTHE,SABLE-SUR-SARTHE,0720843A,26,26,0,0,12,14,3 ème
SARTHE,SAINT-CALAIS,0720803G,17,17,0,0,5,12,3 ème
VENDEE,CHALLANS,0850146X,24,24,0,0,11,13,3 ème
VENDEE,ESSARTS EN BOCAGE,0850099W,142,142,0,0,84,58,3 ème
VENDEE,FONTENAY-LE-COMTE,0850067L,141,126,12,3,75,66,3 ème
VENDEE,LA CHATAIGNERAIE,0851163C,62,62,0,0,33,29,3 ème
VENDEE,LA ROCHE-SUR-YON,0850028U,47,47,0,0,25,22,3 ème
VENDEE,LA ROCHE-SUR-YON,0850114M,163,163,0,0,91,72,3 ème
VENDEE,LA ROCHE-SUR-YON,0851304F,155,138,14,3,80,75,3 ème
VENDEE,LES BROUZILS,0850091M,111,111,0,0,55,56,3 ème
VENDEE,LES HERBIERS,0851159Y,327,307,13,7,160,167,3 ème
VENDEE,LES SABLES-D'OLONNE,0850043K,24,24,0,0,12,12,3 ème
VENDEE,L'ILE-D'YEU,0850015E,29,29,0,0,13,16,3 ème
VENDEE,L'ILE-D'YEU,0850103A,8,8,0,0,2,6,3 ème
VENDEE,POUZAUGES,0851160Z,173,171,0,2,79,94,3 ème
VENDEE,SAINTE-HERMINE,0850122W,75,75,0,0,33,42,3 ème
VENDEE,SAINT-LAURENT-SUR-SEVRE,0851504Y,24,24,0,0,9,15,3 ème
ALPES-DE-HTE-PROVENCE,DIGNE-LES-BAINS,0040022C,175,146,25,4,86,89,3 ème
ALPES-DE-HTE-PROVENCE,DIGNE-LES-BAINS,0040461E,71,71,0,0,32,39,3 ème
BOUCHES-DU-RHONE,AIX-EN-PROVENCE,0130007M,136,107,29,0,69,67,3 ème
BOUCHES-DU-RHONE,AIX-EN-PROVENCE,0132009N,139,135,0,4,61,78,3 ème
BOUCHES-DU-RHONE,AUBAGNE,0131266F,145,142,0,3,76,69,3 ème
BOUCHES-DU-RHONE,AURIOL,0133510V,184,183,0,1,95,89,3 ème
BOUCHES-DU-RHONE,CARNOUX-EN-PROVENCE,0133335E,119,119,0,0,52,67,3 ème
BOUCHES-DU-RHONE,CHATEAURENARD,0131366P,105,105,0,0,54,51,3 ème
BOUCHES-DU-RHONE,CHATEAURENARD,0131881Z,281,279,0,2,138,143,3 ème
BOUCHES-DU-RHONE,GARDANNE,0131701D,103,101,0,2,60,43,3 ème
BOUCHES-DU-RHONE,ISTRES,0133203L,137,137,0,0,64,73,3 ème
BOUCHES-DU-RHONE,MALLEMORT,0130032P,132,132,0,0,62,70,3 ème
BOUCHES-DU-RHONE,MARSEILLE,0134022B,173,148,21,4,80,93,3 ème
BOUCHES-DU-RHONE,MARSEILLE,0132403S,92,92,0,0,49,43,3 ème
BOUCHES-DU-RHONE,MARSEILLE,0133881Y,165,162,0,3,85,80,3 ème
BOUCHES-DU-RHONE,MARSEILLE,0131260Z,93,89,0,4,45,48,3 ème
BOUCHES-DU-RHONE,MARSEILLE,0131262B,149,122,21,6,62,87,3 ème
BOUCHES-DU-RHONE,MARSEILLE,0132313U,119,119,0,0,56,63,3 ème
BOUCHES-DU-RHONE,MARSEILLE,0130065A,18,18,0,0,3,15,3 ème
BOUCHES-DU-RHONE,MARSEILLE,0131704G,176,158,16,2,97,79,3 ème
BOUCHES-DU-RHONE,MARSEILLE,0131887F,94,93,0,1,43,51,3 ème
BOUCHES-DU-RHONE,MARSEILLE,0130039X,24,24,0,0,11,13,3 ème
BOUCHES-DU-RHONE,MARSEILLE,0131931D,115,115,0,0,59,56,3 ème
BOUCHES-DU-RHONE,MARSEILLE,0132283L,51,51,0,0,29,22,3 ème
BOUCHES-DU-RHONE,MARSEILLE,0130110Z,102,102,0,0,39,63,3 ème
BOUCHES-DU-RHONE,MARSEILLE,0131403E,10,10,0,0,4,6,3 ème
BOUCHES-DU-RHONE,MARSEILLE,0132958V,131,131,0,0,50,81,3 ème
BOUCHES-DU-RHONE,MARSEILLE,0133396W,26,21,0,5,8,18,3 ème
BOUCHES-DU-RHONE,MARSEILLE,0130049H,42,42,0,0,18,24,3 ème
BOUCHES-DU-RHONE,MARSEILLE,0130071G,15,15,0,0,4,11,3 ème
BOUCHES-DU-RHONE,MARSEILLE,0131371V,58,58,0,0,22,36,3 ème
BOUCHES-DU-RHONE,MARSEILLE,0131548M,185,160,24,1,91,94,3 ème
BOUCHES-DU-RHONE,MARSEILLE,0131602W,164,164,0,0,77,87,3 ème
BOUCHES-DU-RHONE,MARSEILLE,0132310R,115,113,0,2,49,66,3 ème
BOUCHES-DU-RHONE,MARSEILLE,0132951M,119,119,0,0,58,61,3 ème
BOUCHES-DU-RHONE,MARTIGUES,0131789Z,121,121,0,0,59,62,3 ème
BOUCHES-DU-RHONE,MARTIGUES,0132210G,24,24,0,0,7,17,3 ème
BOUCHES-DU-RHONE,MIRAMAS,0130146N,37,37,0,0,6,31,3 ème
BOUCHES-DU-RHONE,MIRAMAS,0132326H,117,113,0,4,68,49,3 ème
BOUCHES-DU-RHONE,MIRAMAS,0132327J,121,96,25,0,71,50,3 ème
BOUCHES-DU-RHONE,MIRAMAS,0134245U,57,56,0,1,32,25,3 ème
BOUCHES-DU-RHONE,PORT-DE-BOUC,0132212J,91,75,16,0,51,40,3 ème
BOUCHES-DU-RHONE,SAINT-CHAMAS,0130157A,24,24,0,0,17,7,3 ème
BOUCHES-DU-RHONE,SALON-DE-PROVENCE,0131265E,129,129,0,0,51,78,3 ème
BOUCHES-DU-RHONE,SAUSSET-LES-PINS,0133449D,197,197,0,0,96,101,3 ème
BOUCHES-DU-RHONE,SEPTEMES-LES-VALLONS,0131675A,43,38,0,5,20,23,3 ème
BOUCHES-DU-RHONE,SEPTEMES-LES-VALLONS,0133765X,107,104,0,3,56,51,3 ème
BOUCHES-DU-RHONE,TARASCON,0131388N,49,49,0,0,23,26,3 ème
HAUTES-ALPES,BRIANCON,0050043V,137,136,0,1,73,64,3 ème
HAUTES-ALPES,GAP,0050009H,39,39,0,0,20,19,3 ème
HAUTES-ALPES,GAP,0050562J,143,143,0,0,74,69,3 ème
VAUCLUSE,AVIGNON,0840006A,82,79,0,3,44,38,3 ème
VAUCLUSE,AVIGNON,0840108L,146,124,21,1,57,89,3 ème
VAUCLUSE,AVIGNON,0840697B,114,112,0,2,44,70,3 ème
VAUCLUSE,CARPENTRAS,0840015K,43,43,0,0,20,23,3 ème
VAUCLUSE,LE THOR,0840915N,122,120,0,2,62,60,3 ème
VAUCLUSE,MORIERES-LES-AVIGNON,0841116G,190,189,0,1,95,95,3 ème
VAUCLUSE,ORANGE,0840116V,179,145,29,5,77,102,3 ème
VAUCLUSE,ORANGE,0840853W,193,193,0,0,109,84,3 ème
VAUCLUSE,PERNES-LES-FONTAINES,0840028Z,135,131,0,4,65,70,3 ème
VAUCLUSE,SAULT,0840032D,49,49,0,0,26,23,3 ème
VAUCLUSE,SORGUES,0840068T,170,155,15,0,79,91,3 ème
ALPES-MARITIMES,ANTIBES,0060002V,48,48,0,0,13,35,3 ème
ALPES-MARITIMES,ANTIBES,0060842H,177,156,16,5,82,95,3 ème
ALPES-MARITIMES,ANTIBES,0061119J,151,151,0,0,75,76,3 ème
ALPES-MARITIMES,BEAULIEU-SUR-MER,0061209G,142,139,0,3,64,78,3 ème
ALPES-MARITIMES,BIOT,0061670H,204,204,0,0,93,111,3 ème
ALPES-MARITIMES,CAGNES-SUR-MER,0061635V,24,24,0,0,6,18,3 ème
ALPES-MARITIMES,CANNES,0061279H,145,145,0,0,70,75,3 ème
ALPES-MARITIMES,CANNES,0061342B,114,114,0,0,47,67,3 ème
ALPES-MARITIMES,CANNES,0062122Z,11,11,0,0,6,5,3 ème
ALPES-MARITIMES,GRASSE,0060021R,122,119,0,3,61,61,3 ème
ALPES-MARITIMES,LE CANNET,0061723R,133,133,0,0,72,61,3 ème
ALPES-MARITIMES,MOUANS-SARTOUX,0061795U,182,182,0,0,90,92,3 ème
ALPES-MARITIMES,NICE,0060032C,153,151,0,2,83,70,3 ème
ALPES-MARITIMES,NICE,0060042N,20,20,0,0,15,5,3 ème
ALPES-MARITIMES,NICE,0060050X,237,228,0,9,131,106,3 ème
ALPES-MARITIMES,NICE,0061002G,163,158,0,5,64,99,3 ème
ALPES-MARITIMES,NICE,0061006L,256,256,0,0,136,120,3 ème
ALPES-MARITIMES,NICE,0061129V,125,121,0,4,64,61,3 ème
ALPES-MARITIMES,NICE,0061277F,215,191,15,9,96,119,3 ème
ALPES-MARITIMES,NICE,0061694J,191,186,0,5,100,91,3 ème
ALPES-MARITIMES,PEYMEINADE,0061796V,173,173,0,0,74,99,3 ème
ALPES-MARITIMES,ROQUEBRUNE-CAP-MARTIN,0061458C,141,141,0,0,73,68,3 ème
ALPES-MARITIMES,SAINT-ETIENNE-DE-TINEE,0060063L,48,48,0,0,21,27,3 ème
ALPES-MARITIMES,SAINT-LAURENT-DU-VAR,0061134A,168,158,0,10,86,82,3 ème
ALPES-MARITIMES,SAINT-MARTIN-DU-VAR,0061400P,128,127,0,1,51,77,3 ème
ALPES-MARITIMES,VILLENEUVE-LOUBET,0061825B,160,158,0,2,69,91,3 ème
VAR,CARCES,0831709G,123,121,0,2,59,64,3 ème
VAR,CARQUEIRANNE,0830836H,154,154,0,0,78,76,3 ème
VAR,COGOLIN,0831424X,88,88,0,0,51,37,3 ème
VAR,CUERS,0830013N,188,168,15,5,86,102,3 ème
VAR,CUERS,0830114Y,22,22,0,0,11,11,3 ème
VAR,DRAGUIGNAN,0830016S,25,25,0,0,10,15,3 ème
VAR,DRAGUIGNAN,0831274J,190,173,16,1,97,93,3 ème
VAR,FAYENCE,0830019V,151,151,0,0,80,71,3 ème
VAR,FIGANIERES,0831609Y,115,115,0,0,68,47,3 ème
VAR,FREJUS,0830023Z,150,150,0,0,74,76,3 ème
VAR,FREJUS,0830834F,144,144,0,0,77,67,3 ème
VAR,GASSIN,0831537V,164,164,0,0,79,85,3 ème
VAR,LA FARLEDE,0831514V,148,145,0,3,66,82,3 ème
VAR,LE CASTELLET,0831644L,98,98,0,0,60,38,3 ème
VAR,LE LUC,0830163B,239,221,13,5,115,124,3 ème
VAR,OLLIOULES,0830922B,140,140,0,0,67,73,3 ème
VAR,SAINT-CYR-SUR-MER,0830106P,82,82,0,0,41,41,3 ème
VAR,SAINT-TROPEZ,0830996G,46,46,0,0,17,29,3 ème
VAR,SIX-FOURS-LES-PLAGES,0831354W,30,30,0,0,18,12,3 ème
VAR,TOULON,0830069Z,207,194,12,1,88,119,3 ème
VAR,TOULON,0830181W,149,134,12,3,69,80,3 ème
VAR,TOULON,0830661T,28,28,0,0,12,16,3 ème
VAR,TOULON,0830954L,95,95,0,0,37,58,3 ème
CALVADOS,BAYEUX,0141274J,24,24,0,0,11,13,3 ème
CALVADOS,CAEN,0140025B,149,143,0,6,79,70,3 ème
CALVADOS,CAEN,0141163N,114,114,0,0,46,68,3 ème
CALVADOS,CAEN,0141268C,148,147,0,1,72,76,3 ème
CALVADOS,CAEN,0142133T,48,48,0,0,17,31,3 ème
CALVADOS,DOUVRES-LA-DELIVRANDE,0141193W,15,15,0,0,11,4,3 ème
CALVADOS,FALAISE,0141764S,208,184,20,4,96,112,3 ème
CALVADOS,GIBERVILLE,0141964J,100,97,0,3,40,60,3 ème
CALVADOS,HEROUVILLE-SAINT-CLAIR,0141136J,69,65,0,4,29,40,3 ème
CALVADOS,HEROUVILLE-SAINT-CLAIR,0141363F,92,90,0,2,41,51,3 ème
CALVADOS,LE HOM,0141228J,67,66,0,1,34,33,3 ème
CALVADOS,LIVAROT-PAYS-D'AUGE,0140067X,51,51,0,0,25,26,3 ème
CALVADOS,MERVILLE-FRANCEVILLE-PLAGE,0140069Z,86,86,0,0,46,40,3 ème
CALVADOS,TROUVILLE-SUR-MER,0141863Z,141,141,0,0,71,70,3 ème
EURE,BEAUMONT-LE-ROGER,0271056B,34,34,0,0,14,20,3 ème
EURE,EVREUX,0270018Y,24,24,0,0,5,19,3 ème
EURE,EZY-SUR-EURE,0271238Z,132,129,0,3,76,56,3 ème
EURE,FLEURY-SUR-ANDELLE,0271098X,162,145,13,4,88,74,3 ème
EURE,GISORS,0271321P,150,130,16,4,68,82,3 ème
EURE,GISORS,0271631B,141,141,0,0,67,74,3 ème
EURE,GRAVIGNY,0271172C,176,174,0,2,94,82,3 ème
EURE,LA SAUSSAYE,0271105E,126,126,0,0,71,55,3 ème
EURE,LES ANDELYS,0271320N,135,120,0,15,64,71,3 ème
EURE,MESNIL-EN-OUCHE,0271121X,69,66,0,3,34,35,3 ème
EURE,PONT-AUDEMER,0271097W,24,24,0,0,11,13,3 ème
EURE,ROUTOT,0271285A,77,77,0,0,36,41,3 ème
EURE,RUGLES,0270040X,62,56,0,6,33,29,3 ème
EURE,VAL-DE-REUIL,0271286B,109,90,16,3,53,56,3 ème
EURE,VERNEUIL D'AVRE ET D'ITON,0271319M,24,24,0,0,7,17,3 ème
EURE,VERNON,0271073V,23,23,0,0,8,15,3 ème
EURE,VERNON,0271288D,102,102,0,0,38,64,3 ème
MANCHE,AGNEAUX,0501825M,18,18,0,0,9,9,3 ème
MANCHE,CHERBOURG-EN-COTENTIN,0500132X,12,12,0,0,0,12,3 ème
MANCHE,FLAMANVILLE,0501799J,72,72,0,0,39,33,3 ème
MANCHE,LA HAYE-PESNEL,0500042Z,81,81,0,0,48,33,3 ème
MANCHE,LES PIEUX,0501220E,100,97,0,3,50,50,3 ème
MANCHE,MONTMARTIN-SUR-MER,0500048F,87,87,0,0,50,37,3 ème
MANCHE,SAINT-JAMES,0500149R,14,14,0,0,7,7,3 ème
MANCHE,SAINT-JAMES,0501242D,55,46,9,0,27,28,3 ème
MANCHE,SAINT-LO,0500095G,91,75,14,2,54,37,3 ème
MANCHE,SAINT-LO,0500121K,74,74,0,0,46,28,3 ème
MANCHE,SAINT-SAUVEUR-LE-VICOMTE,0500152U,65,65,0,0,28,37,3 ème
MANCHE,TESSY-BOCAGE,0500078N,72,72,0,0,36,36,3 ème
MANCHE,VILLEDIEU-LES-POELES-ROUFFIGNY,0500123M,29,29,0,0,15,14,3 ème
ORNE,ALENCON,0610692W,18,18,0,0,5,13,3 ème
ORNE,CARROUGES,0610012G,31,31,0,0,17,14,3 ème
ORNE,CEAUCE,0611220V,39,39,0,0,23,16,3 ème
ORNE,FLERS,0610023U,119,117,0,2,75,44,3 ème
ORNE,GACE,0610710R,11,11,0,0,5,6,3 ème
ORNE,L'AIGLE,0610745D,106,86,18,2,44,62,3 ème
ORNE,TRUN,0610044S,73,72,0,1,35,38,3 ème
ORNE,VIMOUTIERS,0610045T,48,48,0,0,24,24,3 ème
SEINE MARITIME,BIHOREL,0761724L,71,71,0,0,33,38,3 ème
SEINE MARITIME,BLANGY-SUR-BRESLE,0760009X,76,62,11,3,42,34,3 ème
SEINE MARITIME,BOIS-GUILLAUME,0761950G,168,150,15,3,84,84,3 ème
SEINE MARITIME,BONSECOURS,0760010Y,92,92,0,0,43,49,3 ème
SEINE MARITIME,BOOS,0762816Y,134,134,0,0,58,76,3 ème
SEINE MARITIME,CANTELEU,0762089H,112,112,0,0,52,60,3 ème
SEINE MARITIME,CANY-BARVILLE,0762126Y,85,80,0,5,45,40,3 ème
SEINE MARITIME,CLEON,0762679Z,96,83,13,0,46,50,3 ème
SEINE MARITIME,CRIQUETOT-L'ESNEVAL,0761784B,200,198,0,2,94,106,3 ème
SEINE MARITIME,DARNETAL,0761778V,114,97,13,4,51,63,3 ème
SEINE MARITIME,DUCLAIR,0760136K,182,179,0,3,98,84,3 ème
SEINE MARITIME,ELBEUF,0761347B,17,17,0,0,5,12,3 ème
SEINE MARITIME,ELBEUF,0762459K,170,145,17,8,85,85,3 ème
SEINE MARITIME,FORGES-LES-EAUX,0761695E,133,126,7,0,70,63,3 ème
SEINE MARITIME,GONFREVILLE-L'ORCHER,0761954L,138,120,15,3,68,70,3 ème
SEINE MARITIME,GOURNAY-EN-BRAY,0761734X,53,53,0,0,27,26,3 ème
SEINE MARITIME,LE GRAND-QUEVILLY,0761690Z,83,79,0,4,49,34,3 ème
SEINE MARITIME,LE HAVRE,0760053V,192,192,0,0,99,93,3 ème
SEINE MARITIME,LE HAVRE,0760069M,95,95,0,0,44,51,3 ème
SEINE MARITIME,LE HAVRE,0761696F,114,114,0,0,60,54,3 ème
SEINE MARITIME,LE HAVRE,0761711X,159,159,0,0,76,83,3 ème
SEINE MARITIME,LE HAVRE,0762226G,68,68,0,0,37,31,3 ème
SEINE MARITIME,LE MESNIL-ESNARD,0761343X,60,60,0,0,3,57,3 ème
SEINE MARITIME,LE MESNIL-ESNARD,0762229K,172,172,0,0,95,77,3 ème
SEINE MARITIME,LONDINIERES,0760137L,58,58,0,0,27,31,3 ème
SEINE MARITIME,LONGUEVILLE-SUR-SCIE,0762086E,103,101,0,2,50,53,3 ème
SEINE MARITIME,MAROMME,0760022L,24,24,0,0,14,10,3 ème
SEINE MARITIME,MONT-SAINT-AIGNAN,0760077W,100,97,0,3,43,57,3 ème
SEINE MARITIME,PAVILLY,0761694D,110,106,0,4,55,55,3 ème
SEINE MARITIME,ROUEN,0761356L,60,60,0,0,31,29,3 ème
SEINE MARITIME,ROUEN,0761720G,127,127,0,0,60,67,3 ème
SEINE MARITIME,ROUEN,0762091K,245,226,15,4,134,111,3 ème
SEINE MARITIME,ROUEN,0762602R,24,24,0,0,5,19,3 ème
SEINE MARITIME,SAINTE-ADRESSE,0762405B,64,64,0,0,22,42,3 ème
SEINE MARITIME,SAINT-ETIENNE-DU-ROUVRAY,0761777U,112,108,0,4,53,59,3 ème
SEINE MARITIME,SAINT-ETIENNE-DU-ROUVRAY,0762964J,23,23,0,0,3,20,3 ème
SEINE MARITIME,SAINT-NICOLAS-D'ALIERMONT,0760105B,171,150,15,6,69,102,3 ème
SEINE MARITIME,SAINT-PIERRE-LES-ELBEUF,0761776T,165,165,0,0,91,74,3 ème
SEINE MARITIME,SAINT-SAENS,0761953K,109,106,0,3,51,58,3 ème
SEINE MARITIME,VALMONT,0760116N,87,87,0,0,36,51,3 ème
SEINE MARITIME,YERVILLE,0761951H,143,129,12,2,68,75,3 ème
SEINE MARITIME,YVETOT,0760118R,184,162,15,7,86,98,3 ème
DORDOGNE,BRANTOME EN PERIGORD,0240010F,65,65,0,0,30,35,3 ème
DORDOGNE,LA ROCHE-CHALAIS,0240083K,22,22,0,0,11,11,3 ème
DORDOGNE,NONTRON,0241041B,80,73,5,2,38,42,3 ème
DORDOGNE,PERIGUEUX,0240984P,23,23,0,0,11,12,3 ème
DORDOGNE,THIVIERS,0240039M,8,8,0,0,1,7,3 ème
DORDOGNE,VERGT,0240056F,79,79,0,0,35,44,3 ème
GIRONDE,ANDERNOS-LES-BAINS,0331890A,200,183,13,4,102,98,3 ème
GIRONDE,ARVEYRES,0332085M,167,161,0,6,81,86,3 ème
GIRONDE,AUDENGE,0330008E,159,159,0,0,76,83,3 ème
GIRONDE,BASSENS,0331884U,124,102,17,5,58,66,3 ème
GIRONDE,BAZAS,0332288H,166,153,11,2,88,78,3 ème
GIRONDE,BLAYE,0332781U,13,12,0,1,6,7,3 ème
GIRONDE,BORDEAUX,0330065S,121,120,0,1,62,59,3 ème
GIRONDE,BORDEAUX,0331461J,210,206,0,4,104,106,3 ème
GIRONDE,BORDEAUX,0331618E,106,97,0,9,53,53,3 ème
GIRONDE,BORDEAUX,0332489B,65,65,0,0,37,28,3 ème
GIRONDE,BORDEAUX,0332493F,251,249,0,2,126,125,3 ème
GIRONDE,BORDEAUX,0332768E,201,200,0,1,111,90,3 ème
GIRONDE,BORDEAUX,0332806W,89,86,0,3,48,41,3 ème
GIRONDE,BORDEAUX,0333532K,0,0,0,0,0,0,3 ème
GIRONDE,CADILLAC,0331524C,47,47,0,0,21,26,3 ème
GIRONDE,CARIGNAN-DE-BORDEAUX,0331490R,121,118,0,3,68,53,3 ème
GIRONDE,CASTELNAU-DE-MEDOC,0330062N,148,141,0,7,69,79,3 ème
GIRONDE,EYSINES,0330076D,14,14,0,0,3,11,3 ème
GIRONDE,EYSINES,0332084L,236,236,0,0,120,116,3 ème
GIRONDE,FLOIRAC,0332189A,135,135,0,0,61,74,3 ème
GIRONDE,FLOIRAC,0332486Y,128,125,0,3,59,69,3 ème
GIRONDE,GRADIGNAN,0331622J,177,177,0,0,98,79,3 ème
GIRONDE,GUITRES,0330138W,104,100,0,4,49,55,3 ème
GIRONDE,GUJAN-MESTRAS,0332870R,18,18,0,0,4,14,3 ème
GIRONDE,LA BREDE,0332343T,158,158,0,0,74,84,3 ème
GIRONDE,LE BOUSCAT,0333108Z,96,96,0,0,54,42,3 ème
GIRONDE,LE HAILLAN,0332437V,176,176,0,0,78,98,3 ème
GIRONDE,LIBOURNE,0333213N,179,161,15,3,89,90,3 ème
GIRONDE,LORMONT,0331619F,135,106,25,4,64,71,3 ème
GIRONDE,LORMONT,0332441Z,20,20,0,0,3,17,3 ème
GIRONDE,MERIGNAC,0330146E,119,119,0,0,65,54,3 ème
GIRONDE,MERIGNAC,0332090T,149,132,15,2,63,86,3 ème
GIRONDE,MIOS,0333329P,152,152,0,0,79,73,3 ème
GIRONDE,PELLEGRUE,0330105K,40,40,0,0,12,28,3 ème
GIRONDE,SAINT-ANDRE-DE-CUBZAC,0332346W,20,19,0,1,6,14,3 ème
GIRONDE,SAINTE-EULALIE,0332705L,113,109,0,4,55,58,3 ème
GIRONDE,SAINT-JEAN-D'ILLAC,0333134C,127,127,0,0,66,61,3 ème
GIRONDE,SAINT-MEDARD-EN-JALLES,0331664E,165,156,0,9,76,89,3 ème
GIRONDE,SAINT-YZAN-DE-SOUDIAC,0331888Y,156,151,0,5,75,81,3 ème
GIRONDE,VERAC,0332706M,167,162,0,5,85,82,3 ème
LANDES,AIRE-SUR-L'ADOUR,0400002K,4,4,0,0,4,0,3 ème
LANDES,BISCARROSSE,0400092H,81,78,0,3,39,42,3 ème
LANDES,CAPBRETON,0400004M,24,24,0,0,10,14,3 ème
LANDES,GABARRET,0400072L,34,34,0,0,18,16,3 ème
LANDES,MIMIZAN,0400105X,130,127,0,3,57,73,3 ème
LANDES,PEYREHORADE,0400028N,120,118,0,2,54,66,3 ème
LANDES,SAINT-GEOURS-DE-MAREMNE,0401070W,106,106,0,0,53,53,3 ème
LANDES,SAINT-PIERRE-DU-MONT,0400103V,149,122,25,2,72,77,3 ème
LANDES,SAINT-SEVER,0400038Z,109,108,0,1,47,62,3 ème
LANDES,TARTAS,0400077S,40,40,0,0,21,19,3 ème
LOT-ET-GARONNE,AGEN,0470005A,175,174,0,1,92,83,3 ème
LOT-ET-GARONNE,AGEN,0470066S,150,142,6,2,79,71,3 ème
LOT-ET-GARONNE,CASTELMORON-SUR-LOT,0470732R,65,65,0,0,42,23,3 ème
LOT-ET-GARONNE,CASTILLONNES,0470014K,37,37,0,0,22,15,3 ème
LOT-ET-GARONNE,FUMEL,0470641S,21,21,0,0,6,15,3 ème
LOT-ET-GARONNE,MARMANDE,0470020S,24,24,0,0,7,17,3 ème
LOT-ET-GARONNE,MARMANDE,0470103G,167,152,10,5,77,90,3 ème
LOT-ET-GARONNE,MEZIN,0470023V,46,46,0,0,18,28,3 ème
LOT-ET-GARONNE,MONFLANQUIN,0470026Y,90,90,0,0,47,43,3 ème
LOT-ET-GARONNE,SAINTE-LIVRADE-SUR-LOT,0470102F,74,73,0,1,33,41,3 ème
LOT-ET-GARONNE,TONNEINS,0470104H,115,96,16,3,58,57,3 ème
LOT-ET-GARONNE,VILLENEUVE-SUR-LOT,0470678G,101,85,15,1,54,47,3 ème
PYRENEES-ATLANTIQUES,BAYONNE,0640179X,22,22,0,0,18,4,3 ème
PYRENEES-ATLANTIQUES,BAYONNE,0641907A,11,11,0,0,6,5,3 ème
PYRENEES-ATLANTIQUES,BAYONNE,0642114A,41,41,0,0,19,22,3 ème
PYRENEES-ATLANTIQUES,CAMBO-LES-BAINS,0640147M,69,69,0,0,37,32,3 ème
PYRENEES-ATLANTIQUES,JURANCON,0640031L,24,24,0,0,5,19,3 ème
PYRENEES-ATLANTIQUES,MORLAAS,0641412M,180,173,0,7,82,98,3 ème
PYRENEES-ATLANTIQUES,NAY,0641657D,107,107,0,0,62,45,3 ème
PYRENEES-ATLANTIQUES,PAU,0640184C,47,47,0,0,16,31,3 ème
PYRENEES-ATLANTIQUES,PAU,0641653Z,133,130,0,3,68,65,3 ème
PYRENEES-ATLANTIQUES,SAINT-JEAN-PIED-DE-PORT,0640165G,25,25,0,0,16,9,3 ème
PYRENEES-ATLANTIQUES,SAINT-JEAN-PIED-DE-PORT,0641844G,19,19,0,0,3,16,3 ème
PYRENEES-ATLANTIQUES,SAINT-PIERRE-D'IRUBE,0642038T,172,172,0,0,100,72,3 ème
CORREZE,BRIVE-LA-GAILLARDE,0190740B,120,119,0,1,60,60,3 ème
CORREZE,LUBERSAC,0190695C,80,80,0,0,40,40,3 ème
CORREZE,MEYMAC,0190089U,9,9,0,0,1,8,3 ème
CORREZE,NEUVIC,0190821P,25,25,0,0,13,12,3 ème
CORREZE,TULLE,0190034J,22,22,0,0,4,18,3 ème
CREUSE,BOURGANEUF,0230008J,24,24,0,0,15,9,3 ème
CREUSE,CHENERAILLES,0230012N,27,27,0,0,14,13,3 ème
CREUSE,CROCQ,0230014R,44,44,0,0,22,22,3 ème
CREUSE,LA SOUTERRAINE,0230032K,116,106,10,0,58,58,3 ème
CREUSE,PARSAC-RIMONDEIX,0230023A,38,38,0,0,18,20,3 ème
HAUTE-VIENNE,AIXE-SUR-VIENNE,0870001D,141,141,0,0,80,61,3 ème
HAUTE-VIENNE,BELLAC,0870120H,77,57,14,6,31,46,3 ème
HAUTE-VIENNE,BESSINES-SUR-GARTEMPE,0870006J,48,48,0,0,19,29,3 ème
HAUTE-VIENNE,CHATEAUNEUF-LA-FORET,0870008L,40,40,0,0,20,20,3 ème
HAUTE-VIENNE,LIMOGES,0870072F,159,157,0,2,75,84,3 ème
HAUTE-VIENNE,LIMOGES,0870960W,95,93,0,2,51,44,3 ème
HAUTE-VIENNE,LIMOGES,0875087G,32,32,0,0,12,20,3 ème
HAUTE-VIENNE,SAINT-LEONARD-DE-NOBLAT,0870820U,120,120,0,0,65,55,3 ème
HAUTE-VIENNE,SAINT-SULPICE-LES-FEUILLES,0870049F,34,34,0,0,14,20,3 ème
CHARENTE,ANGOULEME,0160049S,23,23,0,0,14,9,3 ème
CHARENTE,ANGOULEME,0161048C,180,180,0,0,95,85,3 ème
CHARENTE,ANGOULEME,0161075G,105,104,0,1,39,66,3 ème
CHARENTE,BARBEZIEUX-SAINT-HILAIRE,0160866E,105,86,16,3,51,54,3 ème
CHARENTE,CHASSENEUIL-SUR-BONNIEURE,0160882X,91,74,16,1,44,47,3 ème
CHARENTE,COGNAC,0160116P,104,104,0,0,49,55,3 ème
CHARENTE,CONFOLENS,0160944P,81,75,0,6,47,34,3 ème
CHARENTE,LA ROCHEFOUCAULD-EN-ANGOUMOIS,0160076W,36,36,0,0,24,12,3 ème
CHARENTE,MONTBRON,0160030W,39,39,0,0,20,19,3 ème
CHARENTE-MARITIME,AULNAY,0171213B,50,50,0,0,26,24,3 ème
CHARENTE-MARITIME,COZES,0170111D,22,22,0,0,13,9,3 ème
CHARENTE-MARITIME,JONZAC,0170135E,22,22,0,0,7,15,3 ème
CHARENTE-MARITIME,LA ROCHELLE,0170035W,234,199,32,3,112,122,3 ème
CHARENTE-MARITIME,LA ROCHELLE,0170100S,18,18,0,0,3,15,3 ème
CHARENTE-MARITIME,LA ROCHELLE,0170142M,96,79,16,1,41,55,3 ème
CHARENTE-MARITIME,LA ROCHELLE,0171117X,144,142,0,2,75,69,3 ème
CHARENTE-MARITIME,MARANS,0171022U,118,118,0,0,62,56,3 ème
CHARENTE-MARITIME,MIRAMBEAU,0170016A,53,53,0,0,27,26,3 ème
CHARENTE-MARITIME,ROYAN,0171122C,165,156,0,9,87,78,3 ème
CHARENTE-MARITIME,ROYAN,0171571R,24,24,0,0,10,14,3 ème
CHARENTE-MARITIME,SAINTES,0170059X,155,149,0,6,66,89,3 ème
CHARENTE-MARITIME,SAINTES,0170078T,24,24,0,0,7,17,3 ème
CHARENTE-MARITIME,SAINTES,0170392J,16,0,16,0,8,8,3 ème
CHARENTE-MARITIME,SAINT-HILAIRE-DE-VILLEFRANCHE,0170050M,62,59,0,3,36,26,3 ème
CHARENTE-MARITIME,SAINT-JEAN-D'ANGELY,0171118Y,164,134,24,6,88,76,3 ème
CHARENTE-MARITIME,SAINT-SAVINIEN,0170056U,84,84,0,0,41,43,3 ème
CHARENTE-MARITIME,SURGERES,0170120N,49,49,0,0,22,27,3 ème
CHARENTE-MARITIME,TONNAY-BOUTONNE,0170082X,62,62,0,0,29,33,3 ème
DEUX-SEVRES,ARGENTONNAY,0790060L,38,38,0,0,23,15,3 ème
DEUX-SEVRES,CHAMPDENIERS-SAINT-DENIS,0790013K,56,56,0,0,31,25,3 ème
DEUX-SEVRES,LA CRECHE,0790965V,176,176,0,0,79,97,3 ème
DEUX-SEVRES,LEZAY,0790017P,62,62,0,0,32,30,3 ème
DEUX-SEVRES,NIORT,0790027A,142,140,0,2,72,70,3 ème
DEUX-SEVRES,NIORT,0790710T,143,116,24,3,53,90,3 ème
DEUX-SEVRES,NIORT,0791134D,149,135,14,0,74,75,3 ème
DEUX-SEVRES,SAINT-AUBIN-LE-CLOUD,0790979K,26,0,26,0,14,12,3 ème
DEUX-SEVRES,SAINT-VARENT,0790032F,70,70,0,0,31,39,3 ème
VIENNE,CHATELLERAULT,0860876K,149,133,16,0,69,80,3 ème
VIENNE,CHATELLERAULT,0860984C,165,144,16,5,76,89,3 ème
VIENNE,CIVRAY,0860053R,63,46,17,0,34,29,3 ème
VIENNE,JAUNAY-MARIGNY,0860764N,96,96,0,0,45,51,3 ème
VIENNE,LA ROCHE-POSAY,0860043E,66,66,0,0,36,30,3 ème
VIENNE,MIREBEAU,0860027M,81,81,0,0,42,39,3 ème
VIENNE,POITIERS,0860039A,19,19,0,0,8,11,3 ème
VIENNE,POITIERS,0860756E,149,149,0,0,68,81,3 ème
VIENNE,POITIERS,0861072Y,165,142,17,6,91,74,3 ème
VIENNE,SAINT-GERVAIS-LES-TROIS-CLOCHERS,0860044F,83,83,0,0,46,37,3 ème
VIENNE,SAINT-SAVIN,0860046H,48,48,0,0,15,33,3 ème
AUDE,CARCASSONNE,0110037F,98,98,0,0,43,55,3 ème
AUDE,CARCASSONNE,0110044N,150,150,0,0,95,55,3 ème
AUDE,CARCASSONNE,0110666P,132,127,0,5,75,57,3 ème
AUDE,CARCASSONNE,0110823K,24,24,0,0,9,15,3 ème
AUDE,CASTELNAUDARY,0110825M,201,174,19,8,103,98,3 ème
AUDE,LEZIGNAN-CORBIERES,0111048E,24,24,0,0,13,11,3 ème
AUDE,NARBONNE,0110025T,120,120,0,0,55,65,3 ème
AUDE,NARBONNE,0110068P,135,135,0,0,74,61,3 ème
GARD,AIGUES-MORTES,0300001N,146,146,0,0,72,74,3 ème
GARD,ALES,0300922P,106,106,0,0,63,43,3 ème
GARD,ALES,0301728R,0,0,0,0,0,0,3 ème
GARD,CALVISSON,0301671D,139,136,0,3,76,63,3 ème
GARD,LE VIGAN,0300052U,23,23,0,0,7,16,3 ème
GARD,MANDUEL,0301746K,131,131,0,0,62,69,3 ème
GARD,NIMES,0300062E,139,134,0,5,76,63,3 ème
GARD,NIMES,0300096S,81,81,0,0,33,48,3 ème
GARD,NIMES,0300929X,154,133,16,5,82,72,3 ème
GARD,NIMES,0300945P,236,236,0,0,122,114,3 ème
GARD,NIMES,0301357M,123,123,0,0,85,38,3 ème
GARD,REMOULINS,0300033Y,148,148,0,0,82,66,3 ème
GARD,ROQUEMAURE,0301213F,158,158,0,0,84,74,3 ème
GARD,SAINT-GILLES,0300037C,212,194,16,2,124,88,3 ème
GARD,SAINT-HIPPOLYTE-DU-FORT,0300039E,85,81,0,4,46,39,3 ème
GARD,SAINT-JEAN-DU-GARD,0300041G,25,25,0,0,12,13,3 ème
GARD,VILLENEUVE-LES-AVIGNON,0301214G,218,218,0,0,100,118,3 ème
HERAULT,AGDE,0341032M,120,113,0,7,65,55,3 ème
HERAULT,BEZIERS,0340869K,182,180,0,2,88,94,3 ème
HERAULT,BEZIERS,0340872N,120,120,0,0,49,71,3 ème
HERAULT,CASTRIES,0341280G,176,176,0,0,86,90,3 ème
HERAULT,FRONTIGNAN,0340025T,158,141,14,3,68,90,3 ème
HERAULT,FRONTIGNAN,0340894M,96,96,0,0,52,44,3 ème
HERAULT,LODEVE,0340028W,23,23,0,0,12,11,3 ème
HERAULT,LUNEL,0340897R,122,122,0,0,52,70,3 ème
HERAULT,MAGALAS,0340032A,94,90,0,4,48,46,3 ème
HERAULT,MONTFERRIER-SUR-LEZ,0342297M,62,62,0,0,28,34,3 ème
HERAULT,MONTPELLIER,0340045P,42,42,0,0,26,16,3 ème
HERAULT,MONTPELLIER,0340883A,118,114,0,4,54,64,3 ème
HERAULT,MONTPELLIER,0340955D,199,179,15,5,83,116,3 ème
HERAULT,MONTPELLIER,0341030K,104,104,0,0,48,56,3 ème
HERAULT,MONTPELLIER,0341592W,139,117,14,8,62,77,3 ème
HERAULT,POUSSAN,0340062H,165,164,0,1,82,83,3 ème
HERAULT,SETE,0340078A,42,42,0,0,17,25,3 ème
HERAULT,SETE,0340885C,125,125,0,0,48,77,3 ème
HERAULT,SETE,0340972X,86,82,0,4,51,35,3 ème
HERAULT,VILLENEUVE-LES-MAGUELONE,0342078Z,120,120,0,0,60,60,3 ème
LOZERE,LANGOGNE,0480004U,51,51,0,0,24,27,3 ème
LOZERE,LANGOGNE,0480678B,21,21,0,0,7,14,3 ème
LOZERE,MENDE,0480032Z,96,96,0,0,43,53,3 ème
LOZERE,SAINT-CHELY-D'APCHER,0480680D,25,25,0,0,6,19,3 ème
PYRENEES-ORIENTALES,ARGELES-SUR-MER,0660924W,24,24,0,0,14,10,3 ème
PYRENEES-ORIENTALES,ELNE,0660523K,258,253,0,5,145,113,3 ème
PYRENEES-ORIENTALES,FONT-ROMEU-ODEILLO-VIA,0660057D,20,20,0,0,4,16,3 ème
PYRENEES-ORIENTALES,PERPIGNAN,0660016J,125,122,0,3,59,66,3 ème
PYRENEES-ORIENTALES,PERPIGNAN,0660058E,276,276,0,0,138,138,3 ème
PYRENEES-ORIENTALES,PERPIGNAN,0660077A,70,70,0,0,19,51,3 ème
PYRENEES-ORIENTALES,PERPIGNAN,0660078B,15,0,15,0,4,11,3 ème
PYRENEES-ORIENTALES,PERPIGNAN,0660520G,24,24,0,0,14,10,3 ème
PYRENEES-ORIENTALES,PIA,0660866H,172,169,0,3,93,79,3 ème
PYRENEES-ORIENTALES,PORT-VENDRES,0660038H,90,90,0,0,42,48,3 ème
PYRENEES-ORIENTALES,THUIR,0660030Z,252,235,16,1,114,138,3 ème
ARIEGE,FERRIERES-SUR-ARIEGE,0090003E,22,21,0,1,18,4,3 ème
ARIEGE,PAMIERS,0090015T,24,24,0,0,4,20,3 ème
ARIEGE,SEIX,0090025D,31,31,0,0,10,21,3 ème
AVEYRON,CAPDENAC-GARE,0120082Z,33,33,0,0,17,16,3 ème
AVEYRON,DECAZEVILLE,0120622L,100,82,13,5,43,57,3 ème
AVEYRON,DECAZEVILLE,0121257B,23,21,0,2,10,13,3 ème
AVEYRON,ESPALION,0121176N,100,97,0,3,38,62,3 ème
AVEYRON,ESPALION,0121258C,48,48,0,0,32,16,3 ème
AVEYRON,LA FOUILLADE,0120090H,19,19,0,0,10,9,3 ème
AVEYRON,MARCILLAC-VALLON,0120011X,98,94,0,4,48,50,3 ème
AVEYRON,MILLAU,0120105Z,25,25,0,0,8,17,3 ème
AVEYRON,ONET-LE-CHATEAU,0121500R,82,82,0,0,39,43,3 ème
AVEYRON,RIEUPEYROUX,0120055V,28,28,0,0,11,17,3 ème
AVEYRON,RODEZ,0120037A,15,13,0,2,1,14,3 ème
AVEYRON,SAINT-AFFRIQUE,0120025M,11,10,0,1,1,10,3 ème
AVEYRON,SAINT-AFFRIQUE,0121297V,117,110,6,1,59,58,3 ème
AVEYRON,SEVERAC D'AVEYRON,0120029S,51,51,0,0,26,25,3 ème
AVEYRON,VILLEFRANCHE-DE-ROUERGUE,0121178R,15,0,15,0,3,12,3 ème
GERS,AUCH,0320067Z,24,24,0,0,9,15,3 ème
GERS,CONDOM,0320010M,105,103,0,2,66,39,3 ème
GERS,LECTOURE,0320651J,48,48,0,0,24,24,3 ème
GERS,L'ISLE-JOURDAIN,0320740F,121,103,13,5,52,69,3 ème
GERS,MASSEUBE,0320004F,70,70,0,0,32,38,3 ème
HAUTE-GARONNE,AUSSONNE,0312729Y,177,175,0,2,85,92,3 ème
HAUTE-GARONNE,BAGNERES-DE-LUCHON,0311334G,9,9,0,0,1,8,3 ème
HAUTE-GARONNE,CARBONNE,0311580Z,111,101,8,2,51,60,3 ème
HAUTE-GARONNE,COLOMIERS,0311325X,114,87,27,0,56,58,3 ème
HAUTE-GARONNE,LA SALVETAT-SAINT-GILLES,0312612W,160,140,16,4,67,93,3 ème
HAUTE-GARONNE,LEGUEVIN,0312063Z,10,9,0,1,5,5,3 ème
HAUTE-GARONNE,LHERM,0312697N,168,166,0,2,95,73,3 ème
HAUTE-GARONNE,MONTRABE,0312698P,113,112,0,1,59,54,3 ème
HAUTE-GARONNE,MURET,0310025J,221,216,0,5,104,117,3 ème
HAUTE-GARONNE,PECHBONNIEU,0312700S,207,203,0,4,101,106,3 ème
HAUTE-GARONNE,RAMONVILLE-SAINT-AGNE,0311633G,198,178,16,4,93,105,3 ème
HAUTE-GARONNE,REVEL,0310088C,15,15,0,0,3,12,3 ème
HAUTE-GARONNE,SAINT-BEAT-LEZ,0310031R,25,25,0,0,12,13,3 ème
HAUTE-GARONNE,SAINT-GAUDENS,0311131L,21,18,0,3,7,14,3 ème
HAUTE-GARONNE,SAINT-JORY,0311162V,104,104,0,0,58,46,3 ème
HAUTE-GARONNE,SEYSSES,0313081F,0,0,0,0,0,0,3 ème
HAUTE-GARONNE,TOULOUSE,0310051M,21,21,0,0,7,14,3 ème
HAUTE-GARONNE,TOULOUSE,0310085Z,196,190,0,6,101,95,3 ème
HAUTE-GARONNE,TOULOUSE,0310086A,113,111,0,2,60,53,3 ème
HAUTE-GARONNE,TOULOUSE,0311148E,77,77,0,0,40,37,3 ème
HAUTE-GARONNE,TOULOUSE,0311332E,131,124,0,7,63,68,3 ème
HAUTE-GARONNE,TOULOUSE,0311338L,141,141,0,0,77,64,3 ème
HAUTE-GARONNE,TOULOUSE,0311584D,86,83,0,3,41,45,3 ème
HAUTE-GARONNE,TOULOUSE,0311718Z,222,216,0,6,108,114,3 ème
HAUTE-GARONNE,TOULOUSE,0311963R,126,126,0,0,60,66,3 ème
HAUTE-GARONNE,TOULOUSE,0311964S,182,182,0,0,94,88,3 ème
HAUTE-GARONNE,VERNET,0312610U,163,160,0,3,81,82,3 ème
HAUTES-PYRENEES,LUZ-SAINT-SAUVEUR,0650018S,21,21,0,0,16,5,3 ème
HAUTES-PYRENEES,MONLEON-MAGNOAC,0650885J,22,22,0,0,8,14,3 ème
HAUTES-PYRENEES,TARBES,0650740B,125,109,16,0,59,66,3 ème
HAUTES-PYRENEES,TARBES,0650835E,122,119,0,3,59,63,3 ème
HAUTES-PYRENEES,TARBES,0650880D,123,119,0,4,62,61,3 ème
LOT,GRAMAT,0460565P,70,70,0,0,34,36,3 ème
LOT,LACAPELLE-MARIVAL,0460015S,68,68,0,0,41,27,3 ème
LOT,VAYRAC,0460030H,42,42,0,0,22,20,3 ème
TARN,ALBI,0810003N,25,25,0,0,20,5,3 ème
TARN,ALBI,0810052S,193,191,0,2,106,87,3 ème
TARN,CARMAUX,0810012Y,21,21,0,0,2,19,3 ème
TARN,CASTRES,0811063R,163,149,14,0,91,72,3 ème
TARN,GAILLAC,0811065T,88,88,0,0,45,43,3 ème
TARN,LABASTIDE-ROUAIROUX,0810025M,44,44,0,0,26,18,3 ème
TARN,LACAUNE,0810027P,58,52,6,0,26,32,3 ème
TARN,MASSAC-SERAN,0811066U,50,50,0,0,24,26,3 ème
TARN,RABASTENS,0810092K,38,38,0,0,19,19,3 ème
TARN,SAINT-JUERY,0810124V,157,153,0,4,72,85,3 ème
TARN,SAINT-SULPICE-LA-POINTE,0810122T,59,44,15,0,22,37,3 ème
TARN-ET-GARONNE,BEAUMONT-DE-LOMAGNE,0820047F,49,49,0,0,30,19,3 ème
TARN-ET-GARONNE,CASTELSARRASIN,0820713E,106,102,0,4,60,46,3 ème
TARN-ET-GARONNE,MONTAUBAN,0820684Y,146,143,0,3,72,74,3 ème
TARN-ET-GARONNE,MONTAUBAN,0820755A,100,100,0,0,48,52,3 ème
TARN-ET-GARONNE,NEGREPELISSE,0820824A,135,132,0,3,69,66,3 ème
TARN-ET-GARONNE,SAINT-ANTONIN-NOBLE-VAL,0820704V,72,72,0,0,40,32,3 ème
LOIRE-ATLANTIQUE,AIGREFEUILLE-SUR-MAINE,0440179F,132,128,0,4,69,63,3 ème
LOIRE-ATLANTIQUE,CARQUEFOU,0442029S,204,204,0,0,108,96,3 ème
LOIRE-ATLANTIQUE,COUERON,0440310Y,24,24,0,0,12,12,3 ème
LOIRE-ATLANTIQUE,DERVAL,0440423W,91,91,0,0,40,51,3 ème
LOIRE-ATLANTIQUE,GUERANDE,0440193W,217,216,0,1,112,105,3 ème
LOIRE-ATLANTIQUE,HERIC,0442728B,164,163,0,1,72,92,3 ème
LOIRE-ATLANTIQUE,LA BAULE-ESCOUBLAC,0441859G,112,96,16,0,54,58,3 ème
LOIRE-ATLANTIQUE,LA CHAPELLE-SUR-ERDRE,0442011X,140,136,0,4,69,71,3 ème
LOIRE-ATLANTIQUE,LA CHAPELLE-SUR-ERDRE,0442388G,46,46,0,0,21,25,3 ème
LOIRE-ATLANTIQUE,LEGE,0440196Z,77,77,0,0,37,40,3 ème
LOIRE-ATLANTIQUE,LIGNE,0442691L,165,162,0,3,87,78,3 ème
LOIRE-ATLANTIQUE,LOIREAUXENCE,0440243A,68,68,0,0,21,47,3 ème
LOIRE-ATLANTIQUE,MACHECOUL-SAINT-MEME,0440018F,102,87,15,0,54,48,3 ème
LOIRE-ATLANTIQUE,MACHECOUL-SAINT-MEME,0441930J,184,169,15,0,105,79,3 ème
LOIRE-ATLANTIQUE,NANTES,0440211R,53,50,0,3,33,20,3 ème
LOIRE-ATLANTIQUE,NANTES,0440283U,112,96,16,0,49,63,3 ème
LOIRE-ATLANTIQUE,NANTES,0440285W,128,128,0,0,59,69,3 ème
LOIRE-ATLANTIQUE,NANTES,0440286X,64,64,0,0,31,33,3 ème
LOIRE-ATLANTIQUE,NANTES,0441932L,195,190,0,5,104,91,3 ème
LOIRE-ATLANTIQUE,NANTES,0441937S,101,101,0,0,44,57,3 ème
LOIRE-ATLANTIQUE,NANTES,0442119P,39,39,0,0,12,27,3 ème
LOIRE-ATLANTIQUE,NANTES,0442835T,144,143,0,1,69,75,3 ème
LOIRE-ATLANTIQUE,PORNICHET,0440228J,119,119,0,0,64,55,3 ème
LOIRE-ATLANTIQUE,SAINTE-PAZANNE,0440236T,98,98,0,0,42,56,3 ème
LOIRE-ATLANTIQUE,SAINT-GILDAS-DES-BOIS,0441939U,145,145,0,0,83,62,3 ème
LOIRE-ATLANTIQUE,SAINT-HERBLAIN,0440016D,143,140,0,3,72,71,3 ème
LOIRE-ATLANTIQUE,SAINT-HERBLAIN,0442637C,19,19,0,0,13,6,3 ème
LOIRE-ATLANTIQUE,SAINT-NAZAIRE,0440074S,48,48,0,0,13,35,3 ème
LOIRE-ATLANTIQUE,SAINT-NAZAIRE,0440235S,135,121,14,0,64,71,3 ème
LOIRE-ATLANTIQUE,SAINT-NAZAIRE,0440314C,183,170,12,1,85,98,3 ème
LOIRE-ATLANTIQUE,SAINT-NAZAIRE,0441613P,91,70,16,5,41,50,3 ème
LOIRE-ATLANTIQUE,SAVENAY,0442806L,113,111,0,2,53,60,3 ème
LOIRE-ATLANTIQUE,VALLONS-DE-L'ERDRE,0441655K,64,61,0,3,36,28,3 ème
MAINE-ET-LOIRE,ANGERS,0490004N,148,146,0,2,71,77,3 ème
MAINE-ET-LOIRE,ANGERS,0490061A,107,104,0,3,55,52,3 ème
MAINE-ET-LOIRE,ANGERS,0490783K,94,89,0,5,45,49,3 ème
MAINE-ET-LOIRE,ANGERS,0490844B,210,192,13,5,109,101,3 ème
MAINE-ET-LOIRE,ANGERS,0491703K,63,47,15,1,30,33,3 ème
MAINE-ET-LOIRE,ANGERS,0491922Y,176,176,0,0,75,101,3 ème
MAINE-ET-LOIRE,ANGERS,0491924A,183,183,0,0,100,83,3 ème
MAINE-ET-LOIRE,BAUGE-EN-ANJOU,0490849G,118,118,0,0,61,57,3 ème
MAINE-ET-LOIRE,BELLEVIGNE-EN-LAYON,0490046J,77,77,0,0,37,40,3 ème
MAINE-ET-LOIRE,BRISSAC LOIRE AUBANCE,0490014Z,124,124,0,0,66,58,3 ème
MAINE-ET-LOIRE,CANDE,0490854M,76,76,0,0,40,36,3 ème
MAINE-ET-LOIRE,CHOLET,0490829K,137,136,0,1,67,70,3 ème
MAINE-ET-LOIRE,DOUE-EN-ANJOU,0490023J,87,83,0,4,44,43,3 ème
MAINE-ET-LOIRE,LE LION-D'ANGERS,0490027N,155,146,0,9,72,83,3 ème
MAINE-ET-LOIRE,LE MAY-SUR-EVRE,0490869D,57,57,0,0,27,30,3 ème
MAINE-ET-LOIRE,LES HAUTS-D'ANJOU,0491705M,129,129,0,0,71,58,3 ème
MAINE-ET-LOIRE,LES PONTS-DE-CE,0491260D,174,167,0,7,89,85,3 ème
MAINE-ET-LOIRE,LONGUE-JUMELLES,0490028P,93,74,14,5,48,45,3 ème
MAINE-ET-LOIRE,SAINT-BARTHELEMY-D'ANJOU,0490925P,15,0,15,0,7,8,3 ème
MAINE-ET-LOIRE,SAINT-GEORGES-SUR-LOIRE,0491645X,144,144,0,0,76,68,3 ème
MAINE-ET-LOIRE,SAUMUR,0491826U,53,53,0,0,32,21,3 ème
MAINE-ET-LOIRE,SEGRE-EN-ANJOU BLEU,0490782J,24,24,0,0,14,10,3 ème
MAINE-ET-LOIRE,SEGRE-EN-ANJOU BLEU,0490840X,36,36,0,0,14,22,3 ème
MAINE-ET-LOIRE,SEGRE-EN-ANJOU BLEU,0491927D,42,42,0,0,12,30,3 ème
MAYENNE,BAIS,0530003R,43,43,0,0,22,21,3 ème
MAYENNE,EVRON,0530007V,85,64,16,5,40,45,3 ème
MAYENNE,GREZ-EN-BOUERE,0530031W,64,64,0,0,34,30,3 ème
MAYENNE,LAVAL,0530041G,115,97,15,3,63,52,3 ème
MAYENNE,LAVAL,0530051T,224,224,0,0,120,104,3 ème
MAYENNE,LAVAL,0530082B,131,129,0,2,62,69,3 ème
MAYENNE,LAVAL,0530778H,48,48,0,0,12,36,3 ème
MAYENNE,LAVAL,0530904V,30,30,0,0,14,16,3 ème
MAYENNE,MAYENNE,0530053V,149,129,14,6,71,78,3 ème
MAYENNE,SAINT-PIERRE-LA-COUR,0530065H,81,81,0,0,43,38,3 ème
SARTHE,ANCINNES,0720002L,60,60,0,0,35,25,3 ème
SARTHE,BEAUMONT-SUR-SARTHE,0721655H,39,39,0,0,18,21,3 ème
SARTHE,BESSE-SUR-BRAYE,0721089T,39,39,0,0,18,21,3 ème
SARTHE,LA FERTE-BERNARD,0721364S,156,136,15,5,86,70,3 ème
SARTHE,LE MANS,0720068H,87,87,0,0,41,46,3 ème
SARTHE,LE MANS,0720081X,92,92,0,0,45,47,3 ème
SARTHE,LE MANS,0720799C,134,134,0,0,69,65,3 ème
SARTHE,LE MANS,0720835S,81,81,0,0,35,46,3 ème
SARTHE,LE MANS,0720984D,150,148,0,2,74,76,3 ème
SARTHE,LE MANS,0720987G,103,97,0,6,53,50,3 ème
SARTHE,LE MANS,0721363R,166,166,0,0,68,98,3 ème
SARTHE,MAYET,0720988H,75,75,0,0,38,37,3 ème
SARTHE,MONTVAL-SUR-LOIR,0720013Y,48,48,0,0,5,43,3 ème
SARTHE,MONTVAL-SUR-LOIR,0720067G,110,94,16,0,54,56,3 ème
SARTHE,MULSANNE,0721281B,78,78,0,0,46,32,3 ème
SARTHE,NOYEN-SUR-SARTHE,0721263G,111,111,0,0,62,49,3 ème
SARTHE,SABLE-SUR-SARTHE,0720989J,119,100,13,6,62,57,3 ème
SARTHE,SAINT-COSME-EN-VAIRAIS,0720053S,40,38,0,2,22,18,3 ème
SARTHE,VIBRAYE,0720058X,77,77,0,0,41,36,3 ème
VENDEE,AUBIGNY-LES CLOUZEAUX,0851620Z,147,144,0,3,79,68,3 ème
VENDEE,FONTENAY-LE-COMTE,0850068M,24,24,0,0,10,14,3 ème
VENDEE,FONTENAY-LE-COMTE,0851344Z,24,24,0,0,5,19,3 ème
VENDEE,LA ROCHE-SUR-YON,0850063G,161,143,14,4,57,104,3 ème
VENDEE,LA ROCHE-SUR-YON,0850082C,179,149,26,4,85,94,3 ème
VENDEE,LE POIRE-SUR-VIE,0850111J,169,169,0,0,98,71,3 ème
VENDEE,LES SABLES-D'OLONNE,0850084E,96,96,0,0,52,44,3 ème
VENDEE,LES SABLES-D'OLONNE,0851220P,144,144,0,0,77,67,3 ème
VENDEE,L'ILE-D'ELLE,0850014D,67,67,0,0,31,36,3 ème
VENDEE,LUCON,0850607Y,74,58,16,0,39,35,3 ème
VENDEE,POUZAUGES,0850024P,86,80,0,6,41,45,3 ème
VENDEE,ROCHESERVIERE,0850113L,134,134,0,0,59,75,3 ème
VENDEE,SAINTE-CECILE,0851295W,29,29,0,0,0,29,3 ème
VENDEE,SAINT-GILLES-CROIX-DE-VIE,0851181X,218,216,0,2,100,118,3 ème
ALPES-DE-HTE-PROVENCE,BEVONS,0040378P,13,0,13,0,3,10,3 ème
ALPES-DE-HTE-PROVENCE,CASTELLANE,0040004H,44,44,0,0,22,22,3 ème
ALPES-DE-HTE-PROVENCE,DIGNE-LES-BAINS,0040034R,38,38,0,0,12,26,3 ème
ALPES-DE-HTE-PROVENCE,DIGNE-LES-BAINS,0040044B,93,93,0,0,54,39,3 ème
ALPES-DE-HTE-PROVENCE,ORAISON,0040051J,81,81,0,0,29,52,3 ème
ALPES-DE-HTE-PROVENCE,SISTERON,0040420K,119,119,0,0,57,62,3 ème
ALPES-DE-HTE-PROVENCE,VOLX,0040535K,98,96,0,2,46,52,3 ème
BOUCHES-DU-RHONE,AIX-EN-PROVENCE,0132568W,210,210,0,0,110,100,3 ème
BOUCHES-DU-RHONE,AIX-EN-PROVENCE,0132915Y,162,162,0,0,79,83,3 ème
BOUCHES-DU-RHONE,ARLES,0130171R,17,17,0,0,2,15,3 ème
BOUCHES-DU-RHONE,AUBAGNE,0131622T,143,139,0,4,66,77,3 ème
BOUCHES-DU-RHONE,BERRE-L'ETANG,0131705H,191,175,16,0,96,95,3 ème
BOUCHES-DU-RHONE,CHATEAUNEUF-LES-MARTIGUES,0132494R,208,206,0,2,109,99,3 ème
BOUCHES-DU-RHONE,GARDANNE,0131700C,151,151,0,0,73,78,3 ème
BOUCHES-DU-RHONE,GARDANNE,0133244F,24,24,0,0,12,12,3 ème
BOUCHES-DU-RHONE,GIGNAC-LA-NERTHE,0133381E,177,174,0,3,92,85,3 ème
BOUCHES-DU-RHONE,LA FARE-LES-OLIVIERS,0133016H,166,163,0,3,87,79,3 ème
BOUCHES-DU-RHONE,LES PENNES-MIRABEAU,0132565T,192,192,0,0,106,86,3 ème
BOUCHES-DU-RHONE,MARIGNANE,0132921E,223,221,0,2,114,109,3 ème
BOUCHES-DU-RHONE,MARSEILLE,0130072H,6,6,0,0,0,6,3 ème
BOUCHES-DU-RHONE,MARSEILLE,0132732Z,167,167,0,0,87,80,3 ème
BOUCHES-DU-RHONE,MARSEILLE,0132947H,170,170,0,0,73,97,3 ème
BOUCHES-DU-RHONE,MARSEILLE,0132404T,134,134,0,0,65,69,3 ème
BOUCHES-DU-RHONE,MARSEILLE,0131606A,24,24,0,0,2,22,3 ème
BOUCHES-DU-RHONE,MARSEILLE,0130058T,23,23,0,0,8,15,3 ème
BOUCHES-DU-RHONE,MARSEILLE,0130136C,88,88,0,0,44,44,3 ème
BOUCHES-DU-RHONE,MARSEILLE,0132954R,84,84,0,0,41,43,3 ème
BOUCHES-DU-RHONE,MARSEILLE,0130093F,131,127,0,4,67,64,3 ème
BOUCHES-DU-RHONE,MARSEILLE,0131336G,90,90,0,0,43,47,3 ème
BOUCHES-DU-RHONE,MARSEILLE,0131434N,38,38,0,0,3,35,3 ème
BOUCHES-DU-RHONE,MARSEILLE,0132561N,105,103,0,2,47,58,3 ème
BOUCHES-DU-RHONE,MARSEILLE,0130063Y,42,42,0,0,30,12,3 ème
BOUCHES-DU-RHONE,MARTIGUES,0132208E,132,118,14,0,69,63,3 ème
BOUCHES-DU-RHONE,MIRAMAS,0132497U,110,110,0,0,49,61,3 ème
BOUCHES-DU-RHONE,ORGON,0132217P,171,155,16,0,84,87,3 ème
BOUCHES-DU-RHONE,PELISSANNE,0133114P,140,137,0,3,65,75,3 ème
BOUCHES-DU-RHONE,PORT-SAINT-LOUIS-DU-RHONE,0132280H,24,22,0,2,12,12,3 ème
BOUCHES-DU-RHONE,SAINT-VICTORET,0132007L,178,178,0,0,96,82,3 ème
BOUCHES-DU-RHONE,SALON-DE-PROVENCE,0131485U,43,43,0,0,28,15,3 ème
HAUTES-ALPES,BRIANCON,0050519M,121,107,13,1,51,70,3 ème
HAUTES-ALPES,GAP,0050010J,133,129,0,4,61,72,3 ème
HAUTES-ALPES,GAP,0050025A,173,156,15,2,82,91,3 ème
VAUCLUSE,APT,0840070V,68,68,0,0,32,36,3 ème
VAUCLUSE,AVIGNON,0840041N,29,29,0,0,18,11,3 ème
VAUCLUSE,AVIGNON,0840051Z,111,111,0,0,55,56,3 ème
VAUCLUSE,AVIGNON,0840073Y,122,121,0,1,69,53,3 ème
VAUCLUSE,AVIGNON,0840738W,139,138,0,1,78,61,3 ème
VAUCLUSE,AVIGNON,0840758T,131,131,0,0,78,53,3 ème
VAUCLUSE,AVIGNON,0840970Y,128,126,0,2,62,66,3 ème
VAUCLUSE,BOLLENE,0840699D,124,124,0,0,58,66,3 ème
VAUCLUSE,CABRIERES-D'AVIGNON,0841019B,178,178,0,0,81,97,3 ème
VAUCLUSE,CARPENTRAS,0840016L,48,48,0,0,29,19,3 ème
VAUCLUSE,CAVAILLON,0840020R,170,164,0,6,78,92,3 ème
VAUCLUSE,ORANGE,0840763Y,43,43,0,0,11,32,3 ème
VAUCLUSE,PERTUIS,0840029A,144,126,18,0,65,79,3 ème
VAUCLUSE,PERTUIS,0840918S,23,23,0,0,7,16,3 ème
VAUCLUSE,VAISON-LA-ROMAINE,0840035G,177,177,0,0,92,85,3 ème
ALPES-MARITIMES,ANTIBES,0060076A,84,83,0,1,39,45,3 ème
ALPES-MARITIMES,ANTIBES,0061133Z,107,102,0,5,49,58,3 ème
ALPES-MARITIMES,GRASSE,0061240R,126,126,0,0,55,71,3 ème
ALPES-MARITIMES,GRASSE,0061459D,227,227,0,0,104,123,3 ème
ALPES-MARITIMES,L'ESCARENE,0061826C,75,74,0,1,38,37,3 ème
ALPES-MARITIMES,MENTON,0060028Y,22,22,0,0,8,14,3 ème
ALPES-MARITIMES,MENTON,0060744B,86,86,0,0,41,45,3 ème
ALPES-MARITIMES,NICE,0060045S,117,114,0,3,59,58,3 ème
ALPES-MARITIMES,NICE,0060048V,254,244,0,10,122,132,3 ème
ALPES-MARITIMES,NICE,0060776L,22,22,0,0,13,9,3 ème
ALPES-MARITIMES,NICE,0060841G,193,178,15,0,99,94,3 ème
ALPES-MARITIMES,NICE,0061131X,203,174,16,13,108,95,3 ème
ALPES-MARITIMES,NICE,0061461F,148,148,0,0,77,71,3 ème
ALPES-MARITIMES,NICE,0061722P,21,21,0,0,10,11,3 ème
ALPES-MARITIMES,NICE,0061772U,26,26,0,0,16,10,3 ème
ALPES-MARITIMES,SAINT-SAUVEUR-SUR-TINEE,0060066P,54,54,0,0,18,36,3 ème
ALPES-MARITIMES,SAINT-VALLIER-DE-THIEY,0061986B,115,115,0,0,54,61,3 ème
ALPES-MARITIMES,SOSPEL,0060067R,38,38,0,0,15,23,3 ème
ALPES-MARITIMES,VALDEBLORE,0061987C,11,11,0,0,5,6,3 ème
ALPES-MARITIMES,VENCE,0061135B,202,202,0,0,106,96,3 ème
VAR,COGOLIN,0830837J,219,200,14,5,114,105,3 ème
VAR,LA LONDE-LES-MAURES,0830031H,70,70,0,0,30,40,3 ème
VAR,LA SEYNE-SUR-MER,0830180V,148,122,22,4,58,90,3 ème
VAR,LA SEYNE-SUR-MER,0830925E,200,199,0,1,96,104,3 ème
VAR,MONTAUROUX,0831610Z,185,169,14,2,95,90,3 ème
VAR,OLLIOULES,0831187P,23,21,0,2,6,17,3 ème
VAR,SAINT-MAXIMIN-LA-SAINTE-BAUME,0831442S,203,201,0,2,104,99,3 ème
VAR,SAINT-MAXIMIN-LA-SAINTE-BAUME,0831559U,24,24,0,0,10,14,3 ème
VAR,SAINT-RAPHAEL,0830075F,149,149,0,0,66,83,3 ème
VAR,SIX-FOURS-LES-PLAGES,0831012Z,193,178,14,1,98,95,3 ème
VAR,SOLLIES-PONT,0830831C,175,175,0,0,92,83,3 ème
VAR,TOULON,0830116A,34,34,0,0,17,17,3 ème
VAR,TOULON,0830128N,8,8,0,0,5,3,3 ème
VAR,TOULON,0830955M,84,83,0,1,44,40,3 ème
VAR,TOULON,0831053U,181,160,16,5,89,92,3 ème
ALLIER,CUSSET,0030010V,182,163,16,3,89,93,3 ème
ALLIER,DOMERAT,0030956Y,73,69,0,4,34,39,3 ème
ALLIER,GANNAT,0030905T,24,24,0,0,7,17,3 ème
ALLIER,LE DONJON,0030014Z,16,16,0,0,9,7,3 ème
ALLIER,MONTLUCON,0030026M,24,24,0,0,6,18,3 ème
ALLIER,MONTLUCON,0030105Y,23,23,0,0,11,12,3 ème
ALLIER,MOULINS,0030062B,151,150,0,1,90,61,3 ème
ALLIER,TRONGET,0030046J,42,42,0,0,19,23,3 ème
ALLIER,VALLON-EN-SULLY,0030047K,60,60,0,0,35,25,3 ème
CANTAL,AURILLAC,0150005Z,103,98,0,5,52,51,3 ème
CANTAL,AURILLAC,0150006A,24,24,0,0,7,17,3 ème
CANTAL,MURAT,0150023U,36,36,0,0,18,18,3 ème
CANTAL,NEUSSARGUES EN PINATELLE,0150065P,12,12,0,0,6,6,3 ème
CANTAL,PLEAUX,0150025W,10,10,0,0,5,5,3 ème
CANTAL,SAINT-CERNIN,0150028Z,37,36,0,1,17,20,3 ème
CANTAL,SAINT-FLOUR,0150030B,19,19,0,0,6,13,3 ème
CANTAL,SAINT-FLOUR,0150666T,67,67,0,0,38,29,3 ème
HAUTE-LOIRE,AUREC-SUR-LOIRE,0430052Y,50,50,0,0,29,21,3 ème
HAUTE-LOIRE,BLESLE,0430002U,10,10,0,0,6,4,3 ème
HAUTE-LOIRE,BRIVES-CHARENSAC,0430899U,82,69,12,1,47,35,3 ème
HAUTE-LOIRE,LANDOS,0430012E,36,36,0,0,19,17,3 ème
HAUTE-LOIRE,LE PUY-EN-VELAY,0431009N,73,73,0,0,25,48,3 ème
HAUTE-LOIRE,PAULHAGUET,0430019M,25,25,0,0,9,16,3 ème
HAUTE-LOIRE,SAUGUES,0430092S,23,23,0,0,14,9,3 ème
HAUTE-LOIRE,TENCE,0430034D,39,39,0,0,23,16,3 ème
PUY-DE-DOME,AIGUEPERSE,0630079U,163,163,0,0,70,93,3 ème
PUY-DE-DOME,AIGUEPERSE,0631084L,7,7,0,0,4,3,3 ème
PUY-DE-DOME,BILLOM,0631080G,54,52,0,2,28,26,3 ème
PUY-DE-DOME,BRASSAC-LES-MINES,0630012W,24,24,0,0,13,11,3 ème
PUY-DE-DOME,BRASSAC-LES-MINES,0631503S,42,42,0,0,17,25,3 ème
PUY-DE-DOME,CHAMALIERES,0631125F,175,169,0,6,76,99,3 ème
PUY-DE-DOME,CLERMONT-FERRAND,0631099C,51,51,0,0,33,18,3 ème
PUY-DE-DOME,CLERMONT-FERRAND,0631199L,145,143,0,2,66,79,3 ème
PUY-DE-DOME,CLERMONT-FERRAND,0631408N,15,15,0,0,7,8,3 ème
PUY-DE-DOME,CLERMONT-FERRAND,0631411S,147,147,0,0,70,77,3 ème
PUY-DE-DOME,ISSOIRE,0631448G,84,83,0,1,36,48,3 ème
PUY-DE-DOME,LA MONNERIE-LE-MONTEL,0631762Y,86,86,0,0,39,47,3 ème
PUY-DE-DOME,MURAT-LE-QUAIRE,0630010U,42,42,0,0,21,21,3 ème
PUY-DE-DOME,RIOM,0631735U,138,135,0,3,69,69,3 ème
PUY-DE-DOME,RIOM,0631985R,48,48,0,0,20,28,3 ème
PUY-DE-DOME,SAINT-GERMAIN-L'HERM,0630064C,23,23,0,0,9,14,3 ème
PUY-DE-DOME,THIERS,0631407M,26,26,0,0,13,13,3 ème
ARDECHE,ANNONAY,0070059B,122,117,0,5,65,57,3 ème
ARDECHE,ANNONAY,0070060C,166,166,0,0,89,77,3 ème
ARDECHE,ANNONAY,0071300A,123,122,0,1,63,60,3 ème
ARDECHE,AUBENAS,0071245R,84,83,0,1,39,45,3 ème
ARDECHE,BOURG-SAINT-ANDEOL,0070860X,130,130,0,0,63,67,3 ème
ARDECHE,CHOMERAC,0070009X,24,24,0,0,2,22,3 ème
ARDECHE,LARGENTIERE,0070080Z,47,43,0,4,21,26,3 ème
ARDECHE,LE CHEYLARD,0070861Y,27,27,0,0,10,17,3 ème
ARDECHE,PRIVAS,0070114L,30,30,0,0,10,20,3 ème
ARDECHE,PRIVAS,0071246S,236,231,0,5,128,108,3 ème
ARDECHE,PRIVAS,0071281E,46,46,0,0,28,18,3 ème
ARDECHE,SAINT-AGREVE,0070023M,32,32,0,0,16,16,3 ème
ARDECHE,TOURNON-SUR-RHONE,0070031W,23,23,0,0,4,19,3 ème
DROME,CHABEUIL,0260003M,145,142,0,3,82,63,3 ème
DROME,CHATEAUNEUF-DE-GALAURE,0261134S,62,62,0,0,0,62,3 ème
DROME,CREST,0260006R,24,24,0,0,14,10,3 ème
DROME,CREST,0260945L,86,86,0,0,32,54,3 ème
DROME,CREST,0261030D,147,126,16,5,66,81,3 ème
DROME,LE GRAND-SERRE,0260011W,67,67,0,0,29,38,3 ème
DROME,LIVRON-SUR-DROME,0260096N,126,126,0,0,61,65,3 ème
DROME,NYONS,0261089T,169,167,0,2,90,79,3 ème
DROME,PIERRELATTE,0260098R,101,101,0,0,59,42,3 ème
DROME,PIERRELATTE,0261010G,133,118,9,6,77,56,3 ème
DROME,ROMANS-SUR-ISERE,0260067G,99,99,0,0,52,47,3 ème
DROME,SAINT-DONAT-SUR-L'HERBASSE,0260099S,83,83,0,0,41,42,3 ème
DROME,SAINT-JEAN-EN-ROYANS,0260027N,68,68,0,0,41,27,3 ème
DROME,VALENCE,0260117L,121,121,0,0,57,64,3 ème
HAUTE SAVOIE,ABONDANCE,0740001Z,48,48,0,0,25,23,3 ème
HAUTE SAVOIE,ANNECY,0740083N,120,119,0,1,65,55,3 ème
HAUTE SAVOIE,ANNECY,0740274W,169,166,0,3,84,85,3 ème
HAUTE SAVOIE,ANNECY,0741101V,24,24,0,0,15,9,3 ème
HAUTE SAVOIE,ANNECY,0741164N,25,25,0,0,19,6,3 ème
HAUTE SAVOIE,ANNECY,0741285V,33,33,0,0,0,33,3 ème
HAUTE SAVOIE,ANNEMASSE,0741165P,292,282,0,10,148,144,3 ème
HAUTE SAVOIE,EVIAN-LES-BAINS,0740021W,208,203,0,5,110,98,3 ème
HAUTE SAVOIE,FAVERGES-SEYTHENEX,0740023Y,149,144,0,5,76,73,3 ème
HAUTE SAVOIE,MARIGNIER,0741501E,144,140,0,4,73,71,3 ème
HAUTE SAVOIE,SAINT-JEAN-D'AULPS,0740034K,113,113,0,0,52,61,3 ème
HAUTE SAVOIE,SALLANCHES,0740155S,22,22,0,0,0,22,3 ème
HAUTE SAVOIE,SEYSSEL,0740041T,127,127,0,0,73,54,3 ème
ISERE,BEAUREPAIRE,0382101C,152,149,0,3,74,78,3 ème
ISERE,CROLLES,0382781S,155,152,0,3,66,89,3 ème
ISERE,EYBENS,0383494S,108,106,0,2,56,52,3 ème
ISERE,GRENOBLE,0381696M,111,111,0,0,57,54,3 ème
ISERE,GRENOBLE,0382035F,166,140,24,2,84,82,3 ème
ISERE,GRENOBLE,0382111N,144,144,0,0,77,67,3 ème
ISERE,JARRIE,0382782T,107,106,0,1,38,69,3 ème
ISERE,LA COTE-SAINT-ANDRE,0381689E,149,147,0,2,75,74,3 ème
ISERE,LE BOURG-D'OISANS,0380007B,115,115,0,0,66,49,3 ème
ISERE,LE PONT-DE-BEAUVOISIN,0381703V,107,107,0,0,53,54,3 ème
ISERE,L'ISLE-D'ABEAU,0382786X,120,99,15,6,65,55,3 ème
ISERE,MENS,0380039L,52,52,0,0,23,29,3 ème
ISERE,PONT-DE-CHERUY,0381602K,24,24,0,0,11,13,3 ème
ISERE,SAINT-CHEF,0383301G,160,160,0,0,74,86,3 ème
ISERE,SAINT-MARTIN-D'HERES,0380065P,82,76,0,6,35,47,3 ème
ISERE,SAINT-MARTIN-D'HERES,0381812N,147,142,0,5,70,77,3 ème
ISERE,SAINT-QUENTIN-FALLAVIER,0382706K,136,135,0,1,73,63,3 ème
ISERE,SAINT-SIMEON-DE-BRESSIEUX,0380068T,103,97,0,6,53,50,3 ème
ISERE,TULLINS,0380067S,141,141,0,0,79,62,3 ème
ISERE,VIENNE,0381907S,203,171,30,2,106,97,3 ème
ISERE,VILLEFONTAINE,0382864G,103,103,0,0,46,57,3 ème
ISERE,VOIRON,0380092U,24,24,0,0,6,18,3 ème
ISERE,VOIRON,0381710C,176,176,0,0,90,86,3 ème
ISERE,VOREPPE,0381805F,46,46,0,0,18,28,3 ème
ISERE,VOREPPE,0382663N,103,103,0,0,57,46,3 ème
SAVOIE,AIX-LES-BAINS,0731041K,143,143,0,0,72,71,3 ème
SAVOIE,AIX-LES-BAINS,0731271K,12,12,0,0,12,0,3 ème
SAVOIE,ALBERTVILLE,0731224J,83,80,0,3,45,38,3 ème
SAVOIE,CHAMBERY,0730764J,243,239,0,4,120,123,3 ème
SAVOIE,CHAMBERY,0730901H,157,157,0,0,95,62,3 ème
SAVOIE,CHAMBERY,0731042L,168,166,0,2,85,83,3 ème
SAVOIE,ENTRELACS,0730004H,108,108,0,0,61,47,3 ème
SAVOIE,LA MOTTE-SERVOLEX,0731441V,141,139,0,2,68,73,3 ème
SAVOIE,LA RAVOIRE,0730032N,27,27,0,0,2,25,3 ème
SAVOIE,LA RAVOIRE,0730765K,130,100,30,0,55,75,3 ème
SAVOIE,MOUTIERS,0730029K,24,24,0,0,7,17,3 ème
SAVOIE,NOVALAISE,0730031M,74,74,0,0,34,40,3 ème
SAVOIE,SAINT-MICHEL-DE-MAURIENNE,0730984Y,62,62,0,0,31,31,3 ème
AIN,AMBERIEU-EN-BUGEY,0010002X,211,208,0,3,91,120,3 ème
AIN,AMBERIEU-EN-BUGEY,0010076C,82,81,0,1,37,45,3 ème
AIN,BOURG-EN-BRESSE,0010021T,24,23,0,1,17,7,3 ème
AIN,BOURG-EN-BRESSE,0010082J,213,210,0,3,113,100,3 ème
AIN,BOURG-EN-BRESSE,0010823P,122,122,0,0,71,51,3 ème
AIN,MARBOZ,0010089S,23,23,0,0,14,9,3 ème
AIN,MIRIBEL,0010964T,140,127,13,0,66,74,3 ème
AIN,MONTREAL-LA-CLUSE,0011325K,164,162,0,2,82,82,3 ème
AIN,NANTUA,0010032E,12,12,0,0,4,8,3 ème
AIN,OYONNAX,0010034G,24,24,0,0,12,12,3 ème
AIN,OYONNAX,0010035H,138,131,0,7,70,68,3 ème
AIN,PERON,0011388D,167,167,0,0,81,86,3 ème
AIN,PONT-DE-VEYLE,0010820L,111,107,0,4,62,49,3 ème
AIN,SAINT-DIDIER-SUR-CHALARONNE,0010095Y,121,121,0,0,56,65,3 ème
AIN,SAINT-GENIS-POUILLY,0010975E,169,165,0,4,72,97,3 ème
AIN,SAINT-TRIVIER-DE-COURTES,0010040N,73,72,0,1,31,42,3 ème
AIN,THOISSEY,0010042R,136,136,0,0,72,64,3 ème
AIN,VALSERHONE,0010008D,154,137,16,1,74,80,3 ème
AIN,VALSERHONE,0011066D,139,136,0,3,60,79,3 ème
AIN,VILLARS-LES-DOMBES,0010939R,163,162,0,1,68,95,3 ème
LOIRE,ANDREZIEUX-BOUTHEON,0421487N,253,237,16,0,127,126,3 ème
LOIRE,BOEN-SUR-LIGNON,0421085B,125,124,0,1,60,65,3 ème
LOIRE,BOURG-ARGENTAL,0421043F,35,35,0,0,14,21,3 ème
LOIRE,CHARLIEU,0420008F,24,24,0,0,7,17,3 ème
LOIRE,CHARLIEU,0421800D,100,100,0,0,49,51,3 ème
LOIRE,FEURS,0421057W,113,113,0,0,53,60,3 ème
LOIRE,LA GRAND-CROIX,0421086C,154,149,0,5,73,81,3 ème
LOIRE,LA RICAMARIE,0421689H,78,74,0,4,38,40,3 ème
LOIRE,LA TALAUDIERE,0421171V,216,212,0,4,107,109,3 ème
LOIRE,LE COTEAU,0421489R,20,20,0,0,10,10,3 ème
LOIRE,MABLY,0421852K,117,99,16,2,56,61,3 ème
LOIRE,MONTBRISON,0421032U,126,123,0,3,54,72,3 ème
LOIRE,RENAISON,0421735H,123,123,0,0,69,54,3 ème
LOIRE,RIVE-DE-GIER,0420029D,17,17,0,0,4,13,3 ème
LOIRE,RIVE-DE-GIER,0421014Z,124,124,0,0,60,64,3 ème
LOIRE,RIVE-DE-GIER,0421680Y,102,96,0,6,48,54,3 ème
LOIRE,ROANNE,0420076E,21,21,0,0,5,16,3 ème
LOIRE,ROANNE,0420978K,108,108,0,0,49,59,3 ème
LOIRE,SAINT-CHAMOND,0420078G,17,17,0,0,3,14,3 ème
LOIRE,SAINT-CHAMOND,0420996E,22,22,0,0,0,22,3 ème
LOIRE,SAINT-CHAMOND,0421799C,250,246,0,4,140,110,3 ème
LOIRE,SAINT-ETIENNE,0420916T,139,121,16,2,67,72,3 ème
LOIRE,SAINT-ETIENNE,0420958N,21,21,0,0,7,14,3 ème
LOIRE,SAINT-ETIENNE,0420991Z,25,25,0,0,1,24,3 ème
LOIRE,SAINT-ETIENNE,0421016B,47,47,0,0,26,21,3 ème
LOIRE,SAINT-ETIENNE,0421678W,259,252,0,7,129,130,3 ème
LOIRE,SAINT-ETIENNE,0421679X,174,165,0,9,82,92,3 ème
LOIRE,SAINT-HEAND,0421565Y,158,158,0,0,82,76,3 ème
LOIRE,SORBIERS,0421608V,5,5,0,0,0,5,3 ème
RHONE,AMPLEPUIS,0690001B,71,69,0,2,42,29,3 ème
RHONE,BRIGNAIS,0690008J,24,24,0,0,4,20,3 ème
RHONE,BRON,0690010L,23,23,0,0,8,15,3 ème
RHONE,CLAVEISOLLES,0690585L,31,31,0,0,14,17,3 ème
RHONE,CONDRIEU,0690015S,153,148,0,5,84,69,3 ème
RHONE,DARDILLY,0693504J,24,24,0,0,9,15,3 ème
RHONE,DECINES-CHARPIEU,0691495A,119,114,0,5,52,67,3 ème
RHONE,DECINES-CHARPIEU,0692800U,23,23,0,0,4,19,3 ème
RHONE,ECULLY,0690510E,186,184,0,2,87,99,3 ème
RHONE,FONTAINES-SUR-SAONE,0691736M,168,166,0,2,87,81,3 ème
RHONE,GIVORS,0690210D,76,76,0,0,34,42,3 ème
RHONE,LA MULATIERE,0692923C,115,115,0,0,55,60,3 ème
RHONE,LENTILLY,0693286X,170,169,0,1,74,96,3 ème
RHONE,LIMAS,0692420F,200,181,17,2,101,99,3 ème
RHONE,LYON,0692928H,190,190,0,0,104,86,3 ème
RHONE,LYON,0690053H,193,175,16,2,96,97,3 ème
RHONE,LYON,0690131T,118,112,0,6,63,55,3 ème
RHONE,LYON,0692411W,133,129,0,4,65,68,3 ème
RHONE,LYON,0692921A,466,458,0,8,217,249,3 ème
RHONE,LYON,0692936S,172,172,0,0,92,80,3 ème
RHONE,LYON,0693371P,22,22,0,0,16,6,3 ème
RHONE,LYON,0690046A,22,22,0,0,10,12,3 ème
RHONE,LYON,0692578C,165,163,0,2,76,89,3 ème
RHONE,LYON,0690092A,24,24,0,0,16,8,3 ème
RHONE,MEYZIEU,0692704P,137,136,0,1,60,77,3 ème
RHONE,RILLIEUX-LA-PAPE,0691626T,24,24,0,0,11,13,3 ème
RHONE,RILLIEUX-LA-PAPE,0691651V,149,146,0,3,78,71,3 ème
RHONE,SAINTE-FOY-L'ARGENTIERE,0690078K,103,102,0,1,61,42,3 ème
RHONE,SAINT-GENIS-LAVAL,0693287Y,92,92,0,0,45,47,3 ème
RHONE,SAINT-PRIEST,0693094N,20,20,0,0,6,14,3 ème
RHONE,SOUCIEU-EN-JARREST,0693046L,150,149,0,1,74,76,3 ème
RHONE,TARARE,0690085T,22,22,0,0,7,15,3 ème
RHONE,VAULX-EN-VELIN,0693045K,27,27,0,0,15,12,3 ème
RHONE,VENISSIEUX,0690094C,193,189,0,4,100,93,3 ème
RHONE,VENISSIEUX,0691480J,156,152,0,4,82,74,3 ème
RHONE,VENISSIEUX,0691730F,178,172,0,6,84,94,3 ème
RHONE,VENISSIEUX,0692343X,166,153,13,0,76,90,3 ème
RHONE,VILLEURBANNE,0690103M,31,31,0,0,7,24,3 ème
RHONE,VILLEURBANNE,0690109U,24,24,0,0,19,5,3 ème
RHONE,VILLEURBANNE,0690280E,177,175,0,2,78,99,3 ème
RHONE,VILLEURBANNE,0692390Y,18,12,0,6,5,13,3 ème
RHONE,VILLEURBANNE,0694497N,0,0,0,0,0,0,3 ème
DOUBS,BESANCON,0251573Z,275,271,0,4,144,131,3 ème
DOUBS,BETHONCOURT,0251209D,99,99,0,0,52,47,3 ème
DOUBS,CHATILLON-LE-DUC,0251857H,148,148,0,0,75,73,3 ème
DOUBS,LES FONTENELLES,0251064W,20,20,0,0,8,12,3 ème
DOUBS,MONTBELIARD,0250035C,136,134,0,2,74,62,3 ème
DOUBS,MONTBELIARD,0251057N,117,117,0,0,57,60,3 ème
DOUBS,MORTEAU,0251067Z,100,100,0,0,56,44,3 ème
DOUBS,PAYS-DE-CLERVAL,0250016G,39,39,0,0,17,22,3 ème
DOUBS,POUILLEY-LES-VIGNES,0251673H,158,158,0,0,71,87,3 ème
DOUBS,VOUJEAUCOURT,0251130T,148,129,16,3,76,72,3 ème
HAUTE-SAONE,FAVERNEY,0700006B,55,54,0,1,20,35,3 ème
HAUTE-SAONE,HERICOURT,0700063N,79,79,0,0,42,37,3 ème
HAUTE-SAONE,LURE,0700065R,49,49,0,0,23,26,3 ème
HAUTE-SAONE,SCEY-SUR-SAONE-ET-SAINT-ALBIN,0700894S,95,94,0,1,58,37,3 ème
JURA,CHAMPAGNOLE,0390075V,65,65,0,0,37,28,3 ème
JURA,CROTENAY,0390055Y,11,0,11,0,5,6,3 ème
JURA,HAUTS DE BIENNE,0390028U,83,80,0,3,45,38,3 ème
JURA,HAUTS DE BIENNE,0390081B,26,26,0,0,14,12,3 ème
JURA,LONS-LE-SAUNIER,0391003D,59,59,0,0,35,24,3 ème
JURA,MOIRANS-EN-MONTAGNE,0390024P,20,20,0,0,2,18,3 ème
JURA,POLIGNY,0390072S,19,19,0,0,10,9,3 ème
JURA,POLIGNY,0390798F,107,92,13,2,52,55,3 ème
JURA,SAINT-LAURENT-EN-GRANDVAUX,0390916J,64,61,0,3,32,32,3 ème
TERRITOIRE DE BELFORT,BELFORT,0900006T,140,136,0,4,71,69,3 ème
TERRITOIRE DE BELFORT,BELFORT,0900425Y,26,26,0,0,14,12,3 ème
TERRITOIRE DE BELFORT,GIROMAGNY,0900009W,95,89,0,6,50,45,3 ème
COTE D'OR,AUXONNE,0211452P,180,166,14,0,76,104,3 ème
COTE D'OR,BEAUNE,0211230Y,154,139,13,2,82,72,3 ème
COTE D'OR,BRAZEY-EN-PLAINE,0211756V,124,109,15,0,62,62,3 ème
COTE D'OR,CHENOVE,0211096C,87,87,0,0,49,38,3 ème
COTE D'OR,CHENOVE,0211356K,39,39,0,0,10,29,3 ème
COTE D'OR,DIJON,0211151M,238,235,0,3,115,123,3 ème
COTE D'OR,DIJON,0211526V,116,116,0,0,60,56,3 ème
COTE D'OR,FONTAINE-FRANCAISE,0210027R,48,48,0,0,23,25,3 ème
COTE D'OR,IS-SUR-TILLE,0210029T,166,151,15,0,93,73,3 ème
COTE D'OR,LAIGNES,0210030U,17,17,0,0,11,6,3 ème
COTE D'OR,POUILLY-EN-AUXOIS,0210041F,59,59,0,0,34,25,3 ème
COTE D'OR,SELONGEY,0211557D,65,65,0,0,29,36,3 ème
COTE D'OR,SEMUR-EN-AUXOIS,0211527W,102,84,16,2,56,46,3 ème
NIEVRE,COSNE-COURS-SUR-LOIRE,0580014A,24,24,0,0,6,18,3 ème
NIEVRE,COSNE-COURS-SUR-LOIRE,0580066G,38,38,0,0,20,18,3 ème
NIEVRE,DECIZE,0580017D,98,79,15,4,52,46,3 ème
NIEVRE,DECIZE,0580761M,11,11,0,0,6,5,3 ème
NIEVRE,DONZY,0580018E,24,24,0,0,6,18,3 ème
NIEVRE,LORMES,0580026N,8,8,0,0,2,6,3 ème
NIEVRE,NEVERS,0580061B,126,124,0,2,59,67,3 ème
NIEVRE,POUILLY-SUR-LOIRE,0580035Y,33,33,0,0,20,13,3 ème
NIEVRE,SAINT-AMAND-EN-PUISAYE,0580037A,23,23,0,0,19,4,3 ème
NIEVRE,VARZY,0581009G,27,16,8,3,16,11,3 ème
SAONE-ET-LOIRE,AUTUN,0711350G,76,76,0,0,36,40,3 ème
SAONE-ET-LOIRE,BLANZY,0711384U,54,54,0,0,20,34,3 ème
SAONE-ET-LOIRE,CHALON-SUR-SAONE,0710106E,196,196,0,0,78,118,3 ème
SAONE-ET-LOIRE,CHALON-SUR-SAONE,0710537Y,117,114,0,3,58,59,3 ème
SAONE-ET-LOIRE,CHALON-SUR-SAONE,0711448N,150,150,0,0,91,59,3 ème
SAONE-ET-LOIRE,CHARNAY-LES-MACON,0711050F,24,0,24,0,8,16,3 ème
SAONE-ET-LOIRE,CUISERY,0710034B,90,90,0,0,44,46,3 ème
SAONE-ET-LOIRE,ETANG-SUR-ARROUX,0710038F,54,54,0,0,30,24,3 ème
SAONE-ET-LOIRE,LA CLAYETTE,0710022N,43,43,0,0,24,19,3 ème
SAONE-ET-LOIRE,LOUHANS,0711925G,36,36,0,0,18,18,3 ème
SAONE-ET-LOIRE,MACON,0710110J,139,139,0,0,73,66,3 ème
SAONE-ET-LOIRE,MACON,0711052H,194,191,0,3,98,96,3 ème
SAONE-ET-LOIRE,MACON,0711053J,150,148,0,2,86,64,3 ème
SAONE-ET-LOIRE,SAINT-GERMAIN-DU-PLAIN,0710067M,130,127,0,3,66,64,3 ème
SAONE-ET-LOIRE,SAINT-MARTIN-EN-BRESSE,0711451S,72,70,0,2,34,38,3 ème
SAONE-ET-LOIRE,SAINT-VALLIER,0711296Y,135,135,0,0,70,65,3 ème
SAONE-ET-LOIRE,SENNECEY-LE-GRAND,0710070R,95,95,0,0,52,43,3 ème
YONNE,AVALLON,0890009B,71,69,0,2,43,28,3 ème
YONNE,AVALLON,0891053L,21,21,0,0,9,12,3 ème
YONNE,CHARNY OREE DE PUISAYE,0890014G,49,49,0,0,21,28,3 ème
YONNE,SAINT-FARGEAU,0890022R,102,101,0,1,52,50,3 ème
YONNE,SAINT-GEORGES-SUR-BAULCHE,0891043A,137,135,0,2,68,69,3 ème
YONNE,SENS,0890053Z,24,24,0,0,8,16,3 ème
YONNE,SENS,0890067P,17,17,0,0,5,12,3 ème
YONNE,TOUCY,0890035E,95,82,13,0,45,50,3 ème
COTES D'ARMOR,BROONS,0221127F,152,148,0,4,69,83,3 ème
COTES D'ARMOR,CHATELAUDREN-PLOUAGAT,0220006M,170,170,0,0,84,86,3 ème
COTES D'ARMOR,GUERLEDAN,0220032R,48,48,0,0,32,16,3 ème
COTES D'ARMOR,GUINGAMP,0220098M,156,156,0,0,76,80,3 ème
COTES D'ARMOR,LANNION,0220082V,128,111,17,0,60,68,3 ème
COTES D'ARMOR,LANVOLLON,0220144M,60,60,0,0,19,41,3 ème
COTES D'ARMOR,LOUDEAC,0221509W,139,112,25,2,74,65,3 ème
COTES D'ARMOR,LOUDEAC,0221747E,62,59,0,3,35,27,3 ème
COTES D'ARMOR,MATIGNON,0220029M,38,38,0,0,13,25,3 ème
COTES D'ARMOR,PLEMET,0221037H,51,47,0,4,24,27,3 ème
COTES D'ARMOR,PLESTIN-LES-GREVES,0221541F,80,80,0,0,43,37,3 ème
COTES D'ARMOR,PLOEUC-L'HERMITAGE,0220157B,35,35,0,0,14,21,3 ème
COTES D'ARMOR,PLOEUC-L'HERMITAGE,0221568K,68,64,0,4,34,34,3 ème
COTES D'ARMOR,PLOUARET,0220045E,51,51,0,0,26,25,3 ème
COTES D'ARMOR,PONTRIEUX,0221542G,58,54,0,4,27,31,3 ème
COTES D'ARMOR,SAINT-BRIEUC,0220117H,21,21,0,0,8,13,3 ème
COTES D'ARMOR,SAINT-BRIEUC,0221999D,58,55,0,3,34,24,3 ème
FINISTERE,BREST,0290243G,84,80,0,4,43,41,3 ème
FINISTERE,BREST,0291089B,91,73,16,2,44,47,3 ème
FINISTERE,BREST,0291103S,26,26,0,0,8,18,3 ème
FINISTERE,BREST,0291595B,147,147,0,0,80,67,3 ème
FINISTERE,BREST,0291866W,61,61,0,0,38,23,3 ème
FINISTERE,BRIEC,0290019N,98,98,0,0,56,42,3 ème
FINISTERE,CHATEAULIN,0291590W,109,107,0,2,62,47,3 ème
FINISTERE,CHATEAULIN,0291872C,93,92,0,1,50,43,3 ème
FINISTERE,CHATEAUNEUF-DU-FAOU,0292006Y,79,79,0,0,28,51,3 ème
FINISTERE,GUILERS,0291716H,94,94,0,0,46,48,3 ème
FINISTERE,GUILVINEC,0291631R,74,74,0,0,35,39,3 ème
FINISTERE,MORLAIX,0290105G,22,22,0,0,8,14,3 ème
FINISTERE,MORLAIX,0290163V,90,90,0,0,46,44,3 ème
FINISTERE,PLEYBEN,0290288F,33,33,0,0,19,14,3 ème
FINISTERE,PLOUGASTEL-DAOULAS,0290297R,92,92,0,0,43,49,3 ème
FINISTERE,PONT-L'ABBE,0290064M,225,209,16,0,112,113,3 ème
FINISTERE,PONT-L'ABBE,0291877H,110,108,0,2,64,46,3 ème
FINISTERE,QUIMPER,0291878J,158,152,0,6,86,72,3 ème
FINISTERE,QUIMPER,0291880L,220,204,13,3,118,102,3 ème
FINISTERE,QUIMPERLE,0290078C,24,24,0,0,9,15,3 ème
FINISTERE,QUIMPERLE,0290307B,12,12,0,0,3,9,3 ème
FINISTERE,QUIMPERLE,0291635V,152,132,15,5,75,77,3 ème
FINISTERE,QUIMPERLE,0291881M,127,127,0,0,54,73,3 ème
FINISTERE,SAINT-RENAN,0290314J,258,256,0,2,108,150,3 ème
FINISTERE,SAINT-THEGONNEC LOC-EGUINER,0290316L,35,35,0,0,21,14,3 ème
ILLE-ET-VILAINE,FOUGERES,0350762N,124,118,0,6,60,64,3 ème
ILLE-ET-VILAINE,REDON,0350732F,15,0,15,0,4,11,3 ème
ILLE-ET-VILAINE,REDON,0350969N,132,116,16,0,73,59,3 ème
ILLE-ET-VILAINE,RENNES,0350033W,141,138,0,3,64,77,3 ème
ILLE-ET-VILAINE,RENNES,0350747X,17,0,17,0,3,14,3 ème
ILLE-ET-VILAINE,RENNES,0350895H,145,126,16,3,68,77,3 ème
ILLE-ET-VILAINE,RENNES,0351796M,145,145,0,0,71,74,3 ème
ILLE-ET-VILAINE,RENNES,0351851X,126,111,15,0,60,66,3 ème
ILLE-ET-VILAINE,RENNES,0352070K,228,226,0,2,105,123,3 ème
ILLE-ET-VILAINE,SAINT-GEORGES-DE-REINTEMBAULT,0350041E,46,46,0,0,24,22,3 ème
ILLE-ET-VILAINE,SAINT-GREGOIRE,0350780H,224,224,0,0,111,113,3 ème
ILLE-ET-VILAINE,SAINT-MALO,0350773A,143,141,0,2,67,76,3 ème
ILLE-ET-VILAINE,SAINT-MALO,0350896J,99,95,0,4,53,46,3 ème
ILLE-ET-VILAINE,SAINT-MEEN-LE-GRAND,0350887Z,63,63,0,0,25,38,3 ème
ILLE-ET-VILAINE,SAINT-MEEN-LE-GRAND,0351850W,88,88,0,0,32,56,3 ème
ILLE-ET-VILAINE,TINTENIAC,0350051R,173,169,0,4,90,83,3 ème
ILLE-ET-VILAINE,VAL-COUESNON,0350052S,40,40,0,0,20,20,3 ème
ILLE-ET-VILAINE,VITRE,0350892E,86,84,0,2,38,48,3 ème
ILLE-ET-VILAINE,VITRE,0351785A,231,231,0,0,114,117,3 ème
MORBIHAN,ARRADON,0560122D,53,53,0,0,33,20,3 ème
MORBIHAN,GRAND-CHAMP,0560132P,115,115,0,0,50,65,3 ème
MORBIHAN,GUEMENE-SUR-SCORFF,0561358X,79,79,0,0,34,45,3 ème
MORBIHAN,HENNEBONT,0560214D,139,123,16,0,69,70,3 ème
MORBIHAN,LANESTER,0560215E,94,78,16,0,43,51,3 ème
MORBIHAN,LA ROCHE-BERNARD,0560169E,139,139,0,0,67,72,3 ème
MORBIHAN,LE FAOUET,0560158T,33,33,0,0,17,16,3 ème
MORBIHAN,LOCMINE,0561377T,135,135,0,0,72,63,3 ème
MORBIHAN,LORIENT,0560181T,48,48,0,0,12,36,3 ème
MORBIHAN,MALESTROIT,0560150J,147,146,0,1,84,63,3 ème
MORBIHAN,PLOERMEL,0560105K,24,24,0,0,5,19,3 ème
MORBIHAN,QUESTEMBERT,0560166B,124,118,0,6,56,68,3 ème
MORBIHAN,ROHAN,0560171G,69,69,0,0,36,33,3 ème
MORBIHAN,SAINT-JEAN-BREVELAY,0560063P,36,36,0,0,17,19,3 ème
MORBIHAN,SAINT-JEAN-BREVELAY,0560172H,102,102,0,0,66,36,3 ème
MORBIHAN,THEIX-NOYALO,0561940E,136,136,0,0,66,70,3 ème
MORBIHAN,VANNES,0560223N,162,139,23,0,88,74,3 ème
MORBIHAN,VANNES,0561544Z,203,203,0,0,97,106,3 ème
CHER,BOURGES,0180568V,20,15,0,5,8,12,3 ème
CHER,BOURGES,0180571Y,21,21,0,0,4,17,3 ème
CHER,BOURGES,0180721L,159,159,0,0,81,78,3 ème
CHER,HENRICHEMONT,0180019Y,84,84,0,0,51,33,3 ème
CHER,LIGNIERES,0180020Z,47,47,0,0,25,22,3 ème
CHER,SAINT-DOULCHARD,0180643B,151,151,0,0,80,71,3 ème
CHER,VIERZON,0180037T,148,145,0,3,62,86,3 ème
EURE-ET-LOIR,CHATEAUDUN,0280679L,65,65,0,0,32,33,3 ème
EURE-ET-LOIR,CHATEAUDUN,0280957N,61,59,0,2,36,25,3 ème
EURE-ET-LOIR,JANVILLE-EN-BEAUCE,0280680M,75,75,0,0,41,34,3 ème
EURE-ET-LOIR,LA LOUPE,0280869T,89,89,0,0,46,43,3 ème
EURE-ET-LOIR,LUCE,0280803W,129,129,0,0,70,59,3 ème
EURE-ET-LOIR,MAINVILLIERS,0280034K,117,115,0,2,50,67,3 ème
EURE-ET-LOIR,NOGENT-LE-ROTROU,0280903E,107,79,26,2,51,56,3 ème
EURE-ET-LOIR,NOGENT-LE-ROTROU,0281021H,14,14,0,0,0,14,3 ème
INDRE,ARDENTES,0360573C,67,67,0,0,46,21,3 ème
INDRE,CHATEAUROUX,0360050J,17,0,17,0,7,10,3 ème
INDRE,CHATEAUROUX,0360690E,117,114,0,3,55,62,3 ème
INDRE,ISSOUDUN,0360544W,101,99,0,2,50,51,3 ème
INDRE,SAINT-BENOIT-DU-SAULT,0360033R,34,34,0,0,17,17,3 ème
INDRE,SAINTE-SEVERE-SUR-INDRE,0360037V,33,33,0,0,19,14,3 ème
INDRE,TOURNON-SAINT-MARTIN,0360038W,28,28,0,0,13,15,3 ème
INDRE-ET-LOIRE,AVOINE,0370994E,108,106,0,2,55,53,3 ème
INDRE-ET-LOIRE,BALLAN-MIRE,0371403Z,134,134,0,0,66,68,3 ème
INDRE-ET-LOIRE,CHINON,0371100V,23,23,0,0,3,20,3 ème
INDRE-ET-LOIRE,JOUE-LES-TOURS,0370740D,150,135,15,0,70,80,3 ème
INDRE-ET-LOIRE,JOUE-LES-TOURS,0370791J,65,64,0,1,30,35,3 ème
INDRE-ET-LOIRE,JOUE-LES-TOURS,0370888P,24,24,0,0,7,17,3 ème
INDRE-ET-LOIRE,MONTBAZON,0370793L,167,165,0,2,84,83,3 ème
INDRE-ET-LOIRE,MONTLOUIS-SUR-LOIRE,0370799T,164,161,0,3,83,81,3 ème
INDRE-ET-LOIRE,MONTS,0370993D,143,143,0,0,84,59,3 ème
INDRE-ET-LOIRE,RICHELIEU,0370739C,23,23,0,0,10,13,3 ème
INDRE-ET-LOIRE,SAVIGNE-SUR-LATHAN,0370034L,73,73,0,0,36,37,3 ème
INDRE-ET-LOIRE,TOURS,0370033K,150,116,32,2,69,81,3 ème
INDRE-ET-LOIRE,TOURS,0370039S,56,56,0,0,35,21,3 ème
INDRE-ET-LOIRE,TOURS,0370886M,164,163,0,1,89,75,3 ème
INDRE-ET-LOIRE,TOURS,0371327S,119,119,0,0,49,70,3 ème
LOIRET,BEAUGENCY,0450759F,21,21,0,0,11,10,3 ème
LOIRET,BRIARE,0450008P,107,93,11,3,61,46,3 ème
LOIRET,CHALETTE-SUR-LOING,0450840U,164,139,21,4,74,90,3 ème
LOIRET,CHALETTE-SUR-LOING,0451442Y,45,45,0,0,10,35,3 ème
LOIRET,FLEURY-LES-AUBRAIS,0451544J,151,151,0,0,76,75,3 ème
LOIRET,GIEN,0451331C,72,72,0,0,32,40,3 ème
LOIRET,INGRE,0451068S,219,215,0,4,108,111,3 ème
LOIRET,MEUNG-SUR-LOIRE,0451735S,48,48,0,0,20,28,3 ème
LOIRET,MONTARGIS,0450789N,119,117,0,2,63,56,3 ème
LOIRET,OLIVET,0450118J,118,118,0,0,58,60,3 ème
LOIRET,OLIVET,0451499K,119,117,0,2,56,63,3 ème
LOIRET,ORLEANS,0450758E,71,65,6,0,22,49,3 ème
LOIRET,ORLEANS,0451333E,107,107,0,0,56,51,3 ème
LOIRET,POILLY-LEZ-GIEN,0451286D,105,87,15,3,47,58,3 ème
LOIRET,SAINT-JEAN-DE-BRAYE,0451072W,230,210,16,4,111,119,3 ème
LOIRET,SAINT-JEAN-DE-LA-RUELLE,0450066C,51,51,0,0,4,47,3 ème
LOIRET,SAINT-JEAN-DE-LA-RUELLE,0450069F,111,103,0,8,45,66,3 ème
LOIR-ET-CHER,BEAUCE LA ROMAINE,0410016V,101,98,0,3,49,52,3 ème
LOIR-ET-CHER,BLOIS,0410832G,26,23,0,3,17,9,3 ème
LOIR-ET-CHER,MER,0410631N,116,112,0,4,48,68,3 ème
LOIR-ET-CHER,MONTRICHARD VAL DE CHER,0410632P,114,113,0,1,57,57,3 ème
LOIR-ET-CHER,MOREE,0410013S,67,66,0,1,38,29,3 ème
LOIR-ET-CHER,ROMORANTIN-LANTHENAY,0410684W,63,63,0,0,29,34,3 ème
LOIR-ET-CHER,SAINT-AMAND-LONGPRE,0410024D,59,59,0,0,30,29,3 ème
LOIR-ET-CHER,VEUZAIN-SUR-LOIRE,0410716F,152,150,0,2,72,80,3 ème
LOIR-ET-CHER,VINEUIL,0410715E,169,163,0,6,87,82,3 ème
CORSE-DU-SUD,PORTO-VECCHIO,6200040Z,179,179,0,0,75,104,3 ème
CORSE-DU-SUD,PROPRIANO,6200041A,73,71,0,2,32,41,3 ème
CORSE-DU-SUD,SANTA-MARIA-SICHE,6200045E,38,38,0,0,14,24,3 ème
CORSE-DU-SUD,SARTENE,6200055R,36,36,0,0,22,14,3 ème
HAUTE-CORSE,BASTIA,7200013B,199,179,15,5,94,105,3 ème
HAUTE-CORSE,LURI,7200027S,28,28,0,0,13,15,3 ème
HAUTE-CORSE,MOLTIFAO,7200028T,22,22,0,0,13,9,3 ème
HAUTE-CORSE,PRUNELLI-DI-FIUMORBO,7200086F,199,195,3,1,93,106,3 ème
MEURTHE-ET-MOSELLE,AUDUN-LE-ROMAN,0541470E,63,63,0,0,34,29,3 ème
MEURTHE-ET-MOSELLE,BLAINVILLE-SUR-L'EAU,0540005M,124,103,18,3,65,59,3 ème
MEURTHE-ET-MOSELLE,DOMBASLE-SUR-MEURTHE,0541325X,105,105,0,0,46,59,3 ème
MEURTHE-ET-MOSELLE,ESSEY-LES-NANCY,0541211Y,136,136,0,0,61,75,3 ème
MEURTHE-ET-MOSELLE,LAXOU,0540047H,69,66,0,3,35,34,3 ème
MEURTHE-ET-MOSELLE,LAXOU,0541469D,58,57,0,1,35,23,3 ème
MEURTHE-ET-MOSELLE,LONGWY,0541334G,97,96,0,1,41,56,3 ème
MEURTHE-ET-MOSELLE,LUNEVILLE,0541329B,136,91,42,3,64,72,3 ème
MEURTHE-ET-MOSELLE,LUNEVILLE,0542293Z,23,23,0,0,4,19,3 ème
MEURTHE-ET-MOSELLE,MONT-SAINT-MARTIN,0540088C,56,56,0,0,33,23,3 ème
MEURTHE-ET-MOSELLE,NANCY,0541339M,161,161,0,0,73,88,3 ème
MEURTHE-ET-MOSELLE,NANCY,0541568L,78,78,0,0,35,43,3 ème
MEURTHE-ET-MOSELLE,NANCY,0541778P,112,106,0,6,52,60,3 ème
MEURTHE-ET-MOSELLE,NANCY,0541994Z,54,54,0,0,29,25,3 ème
MEURTHE-ET-MOSELLE,POMPEY,0540085Z,23,23,0,0,6,17,3 ème
MEURTHE-ET-MOSELLE,PONT-SAINT-VINCENT,0540060X,25,25,0,0,14,11,3 ème
MEURTHE-ET-MOSELLE,PULNOY,0541956H,127,127,0,0,61,66,3 ème
MEURTHE-ET-MOSELLE,THIAUCOURT-REGNIEVILLE,0540064B,45,45,0,0,24,21,3 ème
MEURTHE-ET-MOSELLE,TOMBLAINE,0541569M,160,160,0,0,79,81,3 ème
MEURTHE-ET-MOSELLE,VAL DE BRIEY,0540008R,105,105,0,0,49,56,3 ème
MEUSE,BAR-LE-DUC,0550890U,87,85,0,2,39,48,3 ème
MEUSE,BOULIGNY,0550006H,44,44,0,0,23,21,3 ème
MEUSE,DAMVILLERS,0550009L,42,42,0,0,20,22,3 ème
MEUSE,ETAIN,0550011N,106,90,15,1,52,54,3 ème
MEUSE,FRESNES-EN-WOEVRE,0550012P,55,54,0,1,24,31,3 ème
MEUSE,GONDRECOURT-LE-CHATEAU,0550013R,29,29,0,0,19,10,3 ème
MEUSE,LIGNY-EN-BARROIS,0550014S,94,87,6,1,50,44,3 ème
MEUSE,VAUBECOURT,0550022A,35,35,0,0,21,14,3 ème
MEUSE,VERDUN,0550891V,18,18,0,0,2,16,3 ème
MOSELLE,ALGRANGE,0572169Y,66,66,0,0,31,35,3 ème
MOSELLE,ARS-SUR-MOSELLE,0572015F,110,108,0,2,55,55,3 ème
MOSELLE,BITCHE,0573361U,127,115,9,3,70,57,3 ème
MOSELLE,BOULAY-MOSELLE,0570010B,173,157,10,6,100,73,3 ème
MOSELLE,BOUZONVILLE,0570248K,40,40,0,0,15,25,3 ème
MOSELLE,COCHEREN,0572490X,82,75,0,7,30,52,3 ème
MOSELLE,CREUTZWALD,0572690P,121,113,6,2,69,52,3 ème
MOSELLE,FAULQUEMONT,0570026U,74,74,0,0,30,44,3 ème
MOSELLE,FORBACH,0572813Y,121,116,0,5,61,60,3 ème
MOSELLE,HOMBOURG-HAUT,0572491Y,53,53,0,0,28,25,3 ème
MOSELLE,L'HOPITAL,0572487U,95,95,0,0,51,44,3 ème
MOSELLE,MARANGE-SILVANGE,0572586B,101,101,0,0,44,57,3 ème
MOSELLE,METZ,0570055A,112,109,0,3,58,54,3 ème
MOSELLE,METZ,0570124A,44,44,0,0,20,24,3 ème
MOSELLE,METZ,0572640K,150,146,0,4,66,84,3 ème
MOSELLE,METZ,0572923T,77,77,0,0,41,36,3 ème
MOSELLE,MONTIGNY-LES-METZ,0572927X,257,257,0,0,132,125,3 ème
MOSELLE,MOUSSEY,0570074W,43,43,0,0,29,14,3 ème
MOSELLE,MOYEUVRE-GRANDE,0572017H,86,78,8,0,47,39,3 ème
MOSELLE,PHALSBOURG,0572929Z,89,89,0,0,52,37,3 ème
MOSELLE,ROHRBACH-LES-BITCHE,0572496D,114,113,0,1,54,60,3 ème
MOSELLE,ROMBAS,0570146Z,24,24,0,0,6,18,3 ème
MOSELLE,SAINT-AVOLD,0570223H,55,55,0,0,33,22,3 ème
MOSELLE,SAINTE-MARIE-AUX-CHENES,0570091P,133,133,0,0,62,71,3 ème
MOSELLE,SARREBOURG,0570095U,40,40,0,0,9,31,3 ème
MOSELLE,SARREGUEMINES,0570099Y,39,39,0,0,17,22,3 ème
MOSELLE,SIERCK-LES-BAINS,0572026T,154,154,0,0,66,88,3 ème
MOSELLE,THIONVILLE,0572355A,120,96,16,8,60,60,3 ème
MOSELLE,THIONVILLE,0572932C,305,305,0,0,152,153,3 ème
MOSELLE,VIGY,0572354Z,96,96,0,0,41,55,3 ème
MOSELLE,YUTZ,0570115R,229,224,0,5,118,111,3 ème
VOSGES,CHATENOIS,0880011J,46,46,0,0,21,25,3 ème
VOSGES,CONTREXEVILLE,0880013L,24,24,0,0,14,10,3 ème
VOSGES,CORCIEUX,0880014M,36,34,0,2,16,20,3 ème
VOSGES,CORNIMONT,0881397R,69,69,0,0,28,41,3 ème
VOSGES,EPINAL,0881530K,25,25,0,0,4,21,3 ème
VOSGES,GERARDMER,0881446U,121,121,0,0,52,69,3 ème
VOSGES,MIRECOURT,0880035K,117,114,0,3,57,60,3 ème
VOSGES,NEUFCHATEAU,0880041S,107,97,7,3,50,57,3 ème
VOSGES,NEUFCHATEAU,0880112U,29,29,0,0,20,9,3 ème
VOSGES,REMIREMONT,0880096B,72,68,0,4,39,33,3 ème
VOSGES,REMIREMONT,0880155R,101,101,0,0,53,48,3 ème
VOSGES,SAINT-DIE-DES-VOSGES,0880098D,79,79,0,0,40,39,3 ème
VOSGES,SAINT-DIE-DES-VOSGES,0881099S,97,95,0,2,40,57,3 ème
ARDENNES,ATTIGNY,0081100C,70,70,0,0,35,35,3 ème
ARDENNES,CHARLEVILLE-MEZIERES,0080894D,78,62,16,0,34,44,3 ème
ARDENNES,CHARLEVILLE-MEZIERES,0080954U,67,65,0,2,32,35,3 ème
ARDENNES,MONTHERME,0080827F,54,54,0,0,23,31,3 ème
ARDENNES,NOUVION-SUR-MEUSE,0080896F,92,91,0,1,50,42,3 ème
ARDENNES,RETHEL,0080039Z,24,24,0,0,13,11,3 ème
ARDENNES,REVIN,0080040A,18,18,0,0,12,6,3 ème
ARDENNES,SEDAN,0080046G,64,62,0,2,35,29,3 ème
ARDENNES,SEDAN,0080047H,33,33,0,0,1,32,3 ème
ARDENNES,SIGNY-LE-PETIT,0081105H,64,64,0,0,31,33,3 ème
ARDENNES,VILLERS-SEMEUSE,0081001V,83,80,0,3,47,36,3 ème
ARDENNES,VOUZIERS,0080089D,39,39,0,0,27,12,3 ème
AUBE,ARCIS-SUR-AUBE,0100665U,125,125,0,0,58,67,3 ème
AUBE,BAR-SUR-AUBE,0100003Z,21,21,0,0,5,16,3 ème
AUBE,CHAOURCE,0100008E,45,45,0,0,25,20,3 ème
AUBE,ERVY-LE-CHATEL,0100010G,65,65,0,0,31,34,3 ème
AUBE,LA CHAPELLE-SAINT-LUC,0100807Y,103,92,10,1,50,53,3 ème
AUBE,TROYES,0100078F,25,25,0,0,16,9,3 ème
AUBE,TROYES,0100962S,111,111,0,0,58,53,3 ème
AUBE,VENDEUVRE-SUR-BARSE,0100028B,45,45,0,0,22,23,3 ème
HAUTE-MARNE,BOURMONT-ENTRE-MEUSE-ET-MOUZON,0520004X,56,56,0,0,29,27,3 ème
HAUTE-MARNE,FAYL-BILLOT,0520017L,38,38,0,0,23,15,3 ème
HAUTE-MARNE,LE MONTSAUGEONNAIS,0520026W,67,67,0,0,32,35,3 ème
HAUTE-MARNE,NOGENT,0520025V,79,76,0,3,39,40,3 ème
HAUTE-MARNE,SAINT-DIZIER,0520029Z,12,12,0,0,2,10,3 ème
HAUTE-MARNE,SAINT-DIZIER,0520049W,101,78,20,3,52,49,3 ème
HAUTE-MARNE,WASSY,0520709N,21,0,21,0,10,11,3 ème
MARNE,AVIZE,0510002A,82,82,0,0,34,48,3 ème
MARNE,AY-CHAMPAGNE,0511432E,103,103,0,0,54,49,3 ème
MARNE,CHALONS-EN-CHAMPAGNE,0510007F,24,24,0,0,10,14,3 ème
MARNE,CORMONTREUIL,0511961E,137,133,0,4,68,69,3 ème
MARNE,EPERNAY,0510016R,128,121,0,7,62,66,3 ème
MARNE,EPERNAY,0511173Y,131,131,0,0,69,62,3 ème
MARNE,EPERNAY,0511189R,108,91,11,6,52,56,3 ème
MARNE,FRIGNICOURT,0511474A,91,85,0,6,43,48,3 ème
MARNE,MAREUIL-LE-PORT,0510028D,67,67,0,0,33,34,3 ème
MARNE,MOURMELON-LE-GRAND,0510029E,106,104,0,2,52,54,3 ème
MARNE,REIMS,0510037N,24,24,0,0,4,20,3 ème
MARNE,REIMS,0510044W,123,120,0,3,57,66,3 ème
MARNE,REIMS,0511085C,149,147,0,2,73,76,3 ème
MARNE,REIMS,0511108C,163,143,16,4,84,79,3 ème
MARNE,REIMS,0511139L,116,116,0,0,48,68,3 ème
MARNE,REIMS,0511531M,113,111,0,2,52,61,3 ème
MARNE,SAINTE-MENEHOULD,0511191T,116,107,6,3,67,49,3 ème
MARNE,VITRY-LE-FRANCOIS,0511476C,101,98,0,3,55,46,3 ème
BAS-RHIN,BARR,0672133E,140,140,0,0,79,61,3 ème
BAS-RHIN,BRUMATH,0670009W,178,175,0,3,89,89,3 ème
BAS-RHIN,DETTWILLER,0672197Z,54,54,0,0,29,25,3 ème
BAS-RHIN,ECKBOLSHEIM,0670016D,105,105,0,0,56,49,3 ème
BAS-RHIN,LINGOLSHEIM,0672765S,151,148,0,3,55,96,3 ème
BAS-RHIN,MARCKOLSHEIM,0671600A,127,125,0,2,64,63,3 ème
BAS-RHIN,MUNDOLSHEIM,0672013Z,126,109,15,2,60,66,3 ème
BAS-RHIN,OBERNAI,0672078V,152,134,15,3,90,62,3 ème
BAS-RHIN,SARRE-UNION,0672614C,15,15,0,0,3,12,3 ème
BAS-RHIN,SAVERNE,0670058Z,24,24,0,0,8,16,3 ème
BAS-RHIN,SCHILTIGHEIM,0670065G,118,118,0,0,67,51,3 ème
BAS-RHIN,SELESTAT,0671696E,48,48,0,0,22,26,3 ème
BAS-RHIN,SELTZ,0671597X,118,97,15,6,53,65,3 ème
BAS-RHIN,STRASBOURG,0670105A,159,144,12,3,69,90,3 ème
BAS-RHIN,STRASBOURG,0671608J,289,289,0,0,154,135,3 ème
BAS-RHIN,STRASBOURG,0671691Z,141,118,21,2,75,66,3 ème
BAS-RHIN,STRASBOURG,0672303P,90,90,0,0,57,33,3 ème
BAS-RHIN,WISSEMBOURG,0670114K,37,37,0,0,12,25,3 ème
HAUT-RHIN,CERNAY,0681810Y,41,41,0,0,7,34,3 ème
HAUT-RHIN,COLMAR,0680132Z,91,90,0,1,49,42,3 ème
HAUT-RHIN,DANNEMARIE,0680012U,112,106,0,6,56,56,3 ème
HAUT-RHIN,FESSENHEIM,0681965S,97,97,0,0,54,43,3 ème
HAUT-RHIN,GUEBWILLER,0680016Y,35,35,0,0,19,16,3 ème
HAUT-RHIN,ILLFURTH,0681932F,71,71,0,0,42,29,3 ème
HAUT-RHIN,MASEVAUX-NIEDERBRUCK,0680027K,22,22,0,0,10,12,3 ème
HAUT-RHIN,MULHOUSE,0681661L,176,176,0,0,104,72,3 ème
HAUT-RHIN,OTTMARSHEIM,0680056S,92,92,0,0,47,45,3 ème
HAUT-RHIN,RIBEAUVILLE,0680137E,34,34,0,0,21,13,3 ème
HAUT-RHIN,SAINT-LOUIS,0680065B,126,122,0,4,71,55,3 ème
HAUT-RHIN,ZILLISHEIM,0681663N,175,175,0,0,87,88,3 ème
GUADELOUPE,BOUILLANTE,9710026B,87,69,15,3,45,42,3 ème
GUADELOUPE,CAPESTERRE-BELLE-EAU,9711231L,100,91,0,9,47,53,3 ème
GUADELOUPE,GOYAVE,9710644Y,67,64,0,3,31,36,3 ème
GUADELOUPE,LA DESIRADE,9710033J,16,16,0,0,7,9,3 ème
GUADELOUPE,LE MOULE,9710064T,83,83,0,0,41,42,3 ème
GUADELOUPE,LE MOULE,9711218X,149,149,0,0,68,81,3 ème
GUADELOUPE,LES ABYMES,9710405N,139,116,17,6,62,77,3 ème
GUADELOUPE,LES ABYMES,9710710V,210,192,14,4,98,112,3 ème
GUADELOUPE,PORT-LOUIS,9710584H,56,54,0,2,27,29,3 ème
GUADELOUPE,SAINT-MARTIN,9711087E,112,100,8,4,60,52,3 ème
GUYANE,APATOU,9730337D,139,122,11,6,75,64,3 ème
GUYANE,CAYENNE,9730130D,162,157,0,5,89,73,3 ème
GUYANE,KOUROU,9730306V,126,121,0,5,63,63,3 ème
GUYANE,MACOURIA,9730374U,231,199,26,6,110,121,3 ème
GUYANE,MARIPASOULA,9730193X,151,144,7,0,71,80,3 ème
GUYANE,MATOURY,9730182K,244,236,0,8,117,127,3 ème
GUYANE,MATOURY,9730218Z,199,195,0,4,98,101,3 ème
GUYANE,SAINT-LAURENT-DU-MARONI,9730248G,232,227,0,5,125,107,3 ème
AISNE,CHARLY-SUR-MARNE,0020011B,195,194,0,1,98,97,3 ème
AISNE,CHAUNY,0020015F,133,133,0,0,64,69,3 ème
AISNE,CONDE-EN-BRIE,0020016G,93,93,0,0,55,38,3 ème
AISNE,COUCY-LE-CHATEAU-AUFFRIQUE,0020018J,92,88,0,4,44,48,3 ème
AISNE,LA FERE,0021518P,96,96,0,0,53,43,3 ème
AISNE,LAON,0020090M,174,150,21,3,87,87,3 ème
AISNE,MONTCORNET,0021489H,42,42,0,0,21,21,3 ème
AISNE,ROZOY-SUR-SERRE,0020043L,50,50,0,0,24,26,3 ème
AISNE,SAINT-QUENTIN,0020054Y,72,71,0,1,38,34,3 ème
AISNE,SAINT-QUENTIN,0021823W,114,111,0,3,57,57,3 ème
AISNE,TERGNIER,0022113L,24,19,0,5,11,13,3 ème
AISNE,VAILLY-SUR-AISNE,0020065K,68,68,0,0,37,31,3 ème
AISNE,VERMAND,0020066L,79,79,0,0,39,40,3 ème
AISNE,VIC-SUR-AISNE,0021722L,87,87,0,0,42,45,3 ème
OISE,BEAUVAIS,0600003C,14,14,0,0,4,10,3 ème
OISE,BRETEUIL,0601406C,122,120,0,2,61,61,3 ème
OISE,COMPIEGNE,0600016S,37,37,0,0,9,28,3 ème
OISE,COMPIEGNE,0600018U,90,90,0,0,46,44,3 ème
OISE,COMPIEGNE,0601142R,253,250,0,3,118,135,3 ème
OISE,COMPIEGNE,0601501F,76,76,0,0,37,39,3 ème
OISE,CREPY-EN-VALOIS,0601833S,110,106,0,4,54,56,3 ème
OISE,FROISSY,0601176C,100,97,0,3,52,48,3 ème
OISE,GRANDVILLIERS,0601897L,16,16,0,0,8,8,3 ème
OISE,LACROIX-SAINT-OUEN,0601937E,150,146,0,4,71,79,3 ème
OISE,LIANCOURT,0600032J,165,162,0,3,86,79,3 ème
OISE,MARSEILLE-EN-BEAUVAISIS,0601365H,103,103,0,0,59,44,3 ème
OISE,MERU,0601157G,79,79,0,0,33,46,3 ème
OISE,MERU,0601470X,15,15,0,0,4,11,3 ème
OISE,MONTATAIRE,0601870G,14,14,0,0,7,7,3 ème
OISE,NEUILLY-EN-THELLE,0601847G,218,203,15,0,105,113,3 ème
OISE,NOGENT-SUR-OISE,0601846F,49,49,0,0,23,26,3 ème
OISE,PONT-SAINTE-MAXENCE,0601896K,30,30,0,0,14,16,3 ème
OISE,RESSONS-SUR-MATZ,0600045Y,122,122,0,0,64,58,3 ème
SOMME,AILLY-SUR-SOMME,0801325F,126,120,0,6,64,62,3 ème
SOMME,AMIENS,0801210F,101,100,0,1,51,50,3 ème
SOMME,AMIENS,0801264P,113,87,16,10,46,67,3 ème
SOMME,AMIENS,0801437C,223,213,0,10,113,110,3 ème
SOMME,AMIENS,0801616X,89,63,16,10,44,45,3 ème
SOMME,BERNAVILLE,0800022P,74,69,0,5,38,36,3 ème
SOMME,DOMART-EN-PONTHIEU,0801485E,88,71,16,1,42,46,3 ème
SOMME,DOULLENS,0801213J,48,48,0,0,21,27,3 ème
SOMME,FEUQUIERES-EN-VIMEU,0801371F,134,118,12,4,70,64,3 ème
SOMME,FRIVILLE-ESCARBOTIN,0801864S,17,17,0,0,6,11,3 ème
SOMME,LONGUEAU,0800038G,104,101,0,3,48,56,3 ème
SOMME,MONTDIDIER,0800041K,115,96,15,4,66,49,3 ème
SOMME,MOREUIL,0801439E,125,120,0,5,50,75,3 ème
SOMME,PERONNE,0801537L,177,155,16,6,100,77,3 ème
SOMME,RIVERY,0801373H,178,165,8,5,90,88,3 ème
SOMME,ROYE,0801227Z,99,99,0,0,56,43,3 ème
SOMME,RUE,0801228A,22,21,0,1,11,11,3 ème
SOMME,SAINT-VALERY-SUR-SOMME,0801490K,86,79,0,7,38,48,3 ème
SOMME,VILLERS-BRETONNEUX,0800057C,107,101,0,6,56,51,3 ème
NORD,BAILLEUL,0592930P,153,153,0,0,76,77,3 ème
NORD,BOUCHAIN,0593672W,196,181,15,0,96,100,3 ème
NORD,BOURBOURG,0594640Y,95,83,12,0,44,51,3 ème
NORD,BRAY-DUNES,0590030M,102,90,8,4,48,54,3 ème
NORD,CAMBRAI,0592611T,23,23,0,0,2,21,3 ème
NORD,CAMBRAI,0595174D,156,156,0,0,72,84,3 ème
NORD,CASSEL,0594872A,104,99,0,5,55,49,3 ème
NORD,COMINES,0593244F,98,81,12,5,48,50,3 ème
NORD,COUSOLRE,0590055P,35,35,0,0,23,12,3 ème
NORD,CROCHTE,0595595L,72,61,11,0,45,27,3 ème
NORD,DENAIN,0590062X,127,112,11,4,57,70,3 ème
NORD,DENAIN,0594299C,98,98,0,0,49,49,3 ème
NORD,DENAIN,0594300D,83,70,11,2,38,45,3 ème
NORD,DOUAI,0592733A,113,94,16,3,53,60,3 ème
NORD,DOUAI,0593071T,56,54,0,2,20,36,3 ème
NORD,DUNKERQUE,0590179Z,109,106,0,3,55,54,3 ème
NORD,DUNKERQUE,0592713D,87,87,0,0,37,50,3 ème
NORD,DUNKERQUE,0595389M,134,134,0,0,64,70,3 ème
NORD,DUNKERQUE,0595918M,49,49,0,0,1,48,3 ème
NORD,ESCAUDAIN,0592751V,124,124,0,0,60,64,3 ème
NORD,FEIGNIES,0594168K,67,67,0,0,31,36,3 ème
NORD,GONDECOURT,0595166V,133,133,0,0,62,71,3 ème
NORD,GRANDE-SYNTHE,0590088A,101,101,0,0,42,59,3 ème
NORD,GRAVELINES,0590090C,133,130,0,3,54,79,3 ème
NORD,HAUBOURDIN,0596059R,172,157,14,1,81,91,3 ème
NORD,HAZEBROUCK,0590102R,24,24,0,0,14,10,3 ème
NORD,HOUPLINES,0594638W,121,109,11,1,54,67,3 ème
NORD,LAMBERSART,0593226L,112,110,0,2,59,53,3 ème
NORD,LAMBERSART,0595393S,143,141,0,2,64,79,3 ème
NORD,LILLE,0592890W,84,84,0,0,41,43,3 ème
NORD,LILLE,0593168Y,169,169,0,0,94,75,3 ème
NORD,LILLE,0595286A,210,210,0,0,106,104,3 ème
NORD,LILLE,0595394T,76,76,0,0,36,40,3 ème
NORD,LILLE,0595397W,184,184,0,0,83,101,3 ème
NORD,LILLE,0595483P,13,0,13,0,3,10,3 ème
NORD,LILLE,0596833G,145,144,0,1,74,71,3 ème
NORD,LOUVROIL,0593034C,7,7,0,0,1,6,3 ème
NORD,MARCQ-EN-BAROEUL,0595993U,93,93,0,0,48,45,3 ème
NORD,MARLY,0593674Y,158,140,17,1,76,82,3 ème
NORD,MARQUETTE-LEZ-LILLE,0593474F,128,128,0,0,64,64,3 ème
NORD,MAUBEUGE,0590150T,128,125,0,3,70,58,3 ème
NORD,MERVILLE,0594294X,87,68,13,6,46,41,3 ème
NORD,NEUVILLE-EN-FERRAIN,0594537L,71,69,0,2,37,34,3 ème
NORD,NIEPPE,0594505B,73,73,0,0,38,35,3 ème
NORD,PERENCHIES,0592901H,63,63,0,0,37,26,3 ème
NORD,PETITE-FORET,0590007M,135,135,0,0,76,59,3 ème
NORD,PROVIN,0595758N,112,108,0,4,52,60,3 ème
NORD,RONCHIN,0593237Y,124,114,8,2,57,67,3 ème
NORD,ROUBAIX,0590183D,114,110,0,4,62,52,3 ème
NORD,ROUBAIX,0592973L,21,21,0,0,12,9,3 ème
NORD,ROUBAIX,0594389A,163,147,16,0,72,91,3 ème
NORD,ROUBAIX,0595168X,145,145,0,0,69,76,3 ème
NORD,SAINS-DU-NORD,0594538M,47,47,0,0,25,22,3 ème
NORD,SECLIN,0593145Y,210,207,0,3,99,111,3 ème
NORD,SOLESMES,0595401A,112,112,0,0,55,57,3 ème
NORD,SOMAIN,0590248Z,171,169,0,2,90,81,3 ème
NORD,SOMAIN,0594405T,163,122,36,5,70,93,3 ème
NORD,STEENVOORDE,0593147A,37,37,0,0,19,18,3 ème
NORD,STEENVOORDE,0593992U,121,121,0,0,50,71,3 ème
NORD,TOURCOING,0594394F,154,136,16,2,69,85,3 ème
NORD,VALENCIENNES,0590270Y,22,22,0,0,8,14,3 ème
NORD,VILLERS-OUTREAUX,0593157L,46,46,0,0,22,24,3 ème
NORD,WALLERS,0593678C,130,130,0,0,72,58,3 ème
NORD,WASQUEHAL,0593241C,106,106,0,0,47,59,3 ème
NORD,WATTEN,0594650J,127,127,0,0,61,66,3 ème
NORD,WATTIGNIES,0594524X,79,59,16,4,37,42,3 ème
PAS-DE-CALAIS,ANNEZIN,0622797D,135,135,0,0,74,61,3 ème
PAS-DE-CALAIS,ARRAS,0622083C,151,151,0,0,75,76,3 ème
PAS-DE-CALAIS,ARRAS,0622864B,107,107,0,0,53,54,3 ème
PAS-DE-CALAIS,AUCHEL,0620021L,122,102,17,3,70,52,3 ème
PAS-DE-CALAIS,BAPAUME,0620030W,24,24,0,0,1,23,3 ème
PAS-DE-CALAIS,BAPAUME,0620031X,138,136,0,2,73,65,3 ème
PAS-DE-CALAIS,BAPAUME,0622104A,78,78,0,0,40,38,3 ème
PAS-DE-CALAIS,BARLIN,0622268D,134,123,11,0,72,62,3 ème
PAS-DE-CALAIS,BEAURAINVILLE,0622435K,89,89,0,0,41,48,3 ème
PAS-DE-CALAIS,BERCK,0620036C,168,152,13,3,101,67,3 ème
PAS-DE-CALAIS,BETHUNE,0622425Z,152,150,0,2,66,86,3 ème
PAS-DE-CALAIS,BETHUNE,0623569T,149,147,0,2,76,73,3 ème
PAS-DE-CALAIS,BIACHE-SAINT-VAAST,0620047P,141,141,0,0,82,59,3 ème
PAS-DE-CALAIS,BOULOGNE-SUR-MER,0620051U,110,92,16,2,52,58,3 ème
PAS-DE-CALAIS,BOULOGNE-SUR-MER,0620055Y,98,83,15,0,50,48,3 ème
PAS-DE-CALAIS,BOURLON,0622132F,37,37,0,0,18,19,3 ème
PAS-DE-CALAIS,BRUAY-LA-BUISSIERE,0622428C,127,109,15,3,50,77,3 ème
PAS-DE-CALAIS,BULLY-LES-MINES,0620197C,167,166,0,1,84,83,3 ème
PAS-DE-CALAIS,CALAIS,0623570U,117,117,0,0,53,64,3 ème
PAS-DE-CALAIS,COURRIERES,0622264Z,137,121,14,2,72,65,3 ème
PAS-DE-CALAIS,DAINVILLE,0620014D,166,149,16,1,77,89,3 ème
PAS-DE-CALAIS,DOURGES,0623322Z,129,129,0,0,55,74,3 ème
PAS-DE-CALAIS,ETAPLES,0622572J,132,114,18,0,69,63,3 ème
PAS-DE-CALAIS,HENIN-BEAUMONT,0622581U,114,114,0,0,60,54,3 ème
PAS-DE-CALAIS,HOUDAIN,0622871J,145,126,15,4,79,66,3 ème
PAS-DE-CALAIS,LEFOREST,0622085E,142,142,0,0,70,72,3 ème
PAS-DE-CALAIS,LIEVIN,0620119T,167,151,16,0,93,74,3 ème
PAS-DE-CALAIS,LILLERS,0622799F,112,91,18,3,53,59,3 ème
PAS-DE-CALAIS,LONGUENESSE,0622575M,114,111,0,3,40,74,3 ème
PAS-DE-CALAIS,MARQUION,0620130E,162,147,12,3,81,81,3 ème
PAS-DE-CALAIS,NOEUX-LES-MINES,0622269E,145,127,12,6,69,76,3 ème
PAS-DE-CALAIS,OIGNIES,0623018U,104,86,18,0,55,49,3 ème
PAS-DE-CALAIS,SAINT-ETIENNE-AU-MONT,0623115Z,143,129,12,2,68,75,3 ème
PAS-DE-CALAIS,SAINT-MARTIN-BOULOGNE,0622434J,116,113,0,3,58,58,3 ème
PAS-DE-CALAIS,SAINT-OMER,0623574Y,73,73,0,0,35,38,3 ème
PAS-DE-CALAIS,SAINT-POL-SUR-TERNOISE,0620167V,24,24,0,0,16,8,3 ème
PAS-DE-CALAIS,SALLAUMINES,0620170Y,79,66,13,0,35,44,3 ème
PAS-DE-CALAIS,VENDIN-LE-VIEIL,0622792Y,134,132,0,2,66,68,3 ème
SEINE-ET-MARNE,BAILLY-ROMAINVILLIERS,0772548B,120,120,0,0,57,63,3 ème
SEINE-ET-MARNE,BRIE-COMTE-ROBERT,0771225N,53,53,0,0,27,26,3 ème
SEINE-ET-MARNE,BROU-SUR-CHANTEREINE,0770005M,78,77,0,1,44,34,3 ème
SEINE-ET-MARNE,CHAMPS-SUR-MARNE,0772090D,91,72,15,4,55,36,3 ème
SEINE-ET-MARNE,CHELLES,0772923J,0,0,0,0,0,0,3 ème
SEINE-ET-MARNE,CLAYE-SOUILLY,0770014X,135,135,0,0,65,70,3 ème
SEINE-ET-MARNE,CLAYE-SOUILLY,0771911J,137,133,0,4,59,78,3 ème
SEINE-ET-MARNE,CLAYE-SOUILLY,0771995A,22,22,0,0,6,16,3 ème
SEINE-ET-MARNE,COMBS-LA-VILLE,0771997C,24,24,0,0,7,17,3 ème
SEINE-ET-MARNE,CONGIS-SUR-THEROUANNE,0771658J,22,22,0,0,10,12,3 ème
SEINE-ET-MARNE,COULOMMIERS,0771760V,124,121,0,3,59,65,3 ème
SEINE-ET-MARNE,DAMMARIE-LES-LYS,0771027Y,25,25,0,0,11,14,3 ème
SEINE-ET-MARNE,DAMMARIE-LES-LYS,0771476L,149,149,0,0,67,82,3 ème
SEINE-ET-MARNE,DAMMARTIN-EN-GOELE,0772190M,202,195,0,7,93,109,3 ème
SEINE-ET-MARNE,DONNEMARIE-DONTILLY,0770020D,109,104,0,5,58,51,3 ème
SEINE-ET-MARNE,FONTAINEBLEAU,0770928R,226,226,0,0,109,117,3 ème
SEINE-ET-MARNE,FONTENAY-TRESIGNY,0772227C,110,110,0,0,46,64,3 ème
SEINE-ET-MARNE,LAGNY-SUR-MARNE,0770027L,135,131,0,4,65,70,3 ème
SEINE-ET-MARNE,LIZY-SUR-OURCQ,0771362M,100,100,0,0,56,44,3 ème
SEINE-ET-MARNE,MEAUX,0771172F,123,105,13,5,68,55,3 ème
SEINE-ET-MARNE,MEAUX,0771921V,329,329,0,0,187,142,3 ème
SEINE-ET-MARNE,MELUN,0770033T,88,88,0,0,51,37,3 ème
SEINE-ET-MARNE,MOISSY-CRAMAYEL,0771618R,142,142,0,0,63,79,3 ème
SEINE-ET-MARNE,MONTEVRAIN,0772819W,144,144,0,0,69,75,3 ème
SEINE-ET-MARNE,NANDY,0772126T,122,122,0,0,65,57,3 ème
SEINE-ET-MARNE,NOISIEL,0771841H,121,121,0,0,59,62,3 ème
SEINE-ET-MARNE,OZOIR-LA-FERRIERE,0771217E,224,224,0,0,113,111,3 ème
SEINE-ET-MARNE,PONTAULT-COMBAULT,0771175J,189,186,0,3,98,91,3 ème
SEINE-ET-MARNE,REBAIS,0771770F,96,94,0,2,47,49,3 ème
SEINE-ET-MARNE,ROZAY-EN-BRIE,0771514C,176,176,0,0,89,87,3 ème
SEINE-ET-MARNE,SAINT-PIERRE-LES-NEMOURS,0771218F,107,107,0,0,49,58,3 ème
SEINE-ET-MARNE,SOUPPES-SUR-LOING,0770048J,73,73,0,0,33,40,3 ème
SEINE-ET-MARNE,TORCY,0771991W,107,103,0,4,42,65,3 ème
SEINE-ET-MARNE,TOURNAN-EN-BRIE,0772342C,24,24,0,0,10,14,3 ème
SEINE-ET-MARNE,VARENNES-SUR-SEINE,0770945J,24,24,0,0,2,22,3 ème
SEINE-ET-MARNE,VERT-SAINT-DENIS,0771365R,229,227,0,2,106,123,3 ème
SEINE-ET-MARNE,VILLENEUVE-LE-COMTE,0772650M,17,17,0,0,4,13,3 ème
SEINE-ET-MARNE,VILLEPARISIS,0772868Z,91,91,0,0,40,51,3 ème
SEINE-SAINT-DENIS,AUBERVILLIERS,0931024H,13,13,0,0,3,10,3 ème
SEINE-SAINT-DENIS,AUBERVILLIERS,0931185H,166,166,0,0,82,84,3 ème
SEINE-SAINT-DENIS,AUBERVILLIERS,0931709C,114,114,0,0,54,60,3 ème
SEINE-SAINT-DENIS,AUBERVILLIERS,0932694Y,95,87,0,8,45,50,3 ème
SEINE-SAINT-DENIS,AUBERVILLIERS,0932726H,95,89,0,6,41,54,3 ème
SEINE-SAINT-DENIS,AULNAY-SOUS-BOIS,0930859D,234,234,0,0,91,143,3 ème
SEINE-SAINT-DENIS,AULNAY-SOUS-BOIS,0930891N,123,109,13,1,56,67,3 ème
SEINE-SAINT-DENIS,AULNAY-SOUS-BOIS,0931843Y,198,198,0,0,90,108,3 ème
SEINE-SAINT-DENIS,AULNAY-SOUS-BOIS,0932578X,153,153,0,0,68,85,3 ème
SEINE-SAINT-DENIS,BOBIGNY,0931196V,163,163,0,0,74,89,3 ème
SEINE-SAINT-DENIS,BONDY,0930906E,122,122,0,0,73,49,3 ème
SEINE-SAINT-DENIS,DRANCY,0931200Z,155,146,9,0,80,75,3 ème
SEINE-SAINT-DENIS,DUGNY,0931573E,27,27,0,0,1,26,3 ème
SEINE-SAINT-DENIS,EPINAY-SUR-SEINE,0930893R,230,210,15,5,119,111,3 ème
SEINE-SAINT-DENIS,LA COURNEUVE,0931429Y,167,166,0,1,85,82,3 ème
SEINE-SAINT-DENIS,LE BLANC-MESNIL,0930611J,154,154,0,0,71,83,3 ème
SEINE-SAINT-DENIS,LE BLANC-MESNIL,0930831Y,15,15,0,0,2,13,3 ème
SEINE-SAINT-DENIS,LE BLANC-MESNIL,0930884F,165,165,0,0,86,79,3 ème
SEINE-SAINT-DENIS,L'ILE-SAINT-DENIS,0931765N,97,91,0,6,54,43,3 ème
SEINE-SAINT-DENIS,LIVRY-GARGAN,0930620U,178,162,16,0,91,87,3 ème
SEINE-SAINT-DENIS,MONTFERMEIL,0931707A,171,155,16,0,80,91,3 ème
SEINE-SAINT-DENIS,MONTREUIL,0931151W,135,119,16,0,70,65,3 ème
SEINE-SAINT-DENIS,MONTREUIL,0931448U,142,142,0,0,78,64,3 ème
SEINE-SAINT-DENIS,MONTREUIL,0931712F,130,130,0,0,73,57,3 ème
SEINE-SAINT-DENIS,MONTREUIL,0932696A,102,99,0,3,53,49,3 ème
SEINE-SAINT-DENIS,NEUILLY-SUR-MARNE,0931485J,153,150,0,3,80,73,3 ème
SEINE-SAINT-DENIS,NOISY-LE-GRAND,0931214P,184,166,16,2,77,107,3 ème
SEINE-SAINT-DENIS,NOISY-LE-SEC,0932725G,151,145,0,6,79,72,3 ème
SEINE-SAINT-DENIS,ROMAINVILLE,0931381W,189,174,15,0,91,98,3 ème
SEINE-SAINT-DENIS,ROSNY-SOUS-BOIS,0930586G,134,128,0,6,82,52,3 ème
SEINE-SAINT-DENIS,SAINT-DENIS,0931490P,94,94,0,0,43,51,3 ème
SEINE-SAINT-DENIS,SAINT-OUEN,0931144N,106,103,0,3,47,59,3 ème
SEINE-SAINT-DENIS,SEVRAN,0930897V,148,145,0,3,75,73,3 ème
SEINE-SAINT-DENIS,STAINS,0930920V,124,124,0,0,54,70,3 ème
SEINE-SAINT-DENIS,STAINS,0931147S,139,135,0,4,63,76,3 ème
SEINE-SAINT-DENIS,TREMBLAY-EN-FRANCE,0931497X,168,160,7,1,85,83,3 ème
SEINE-SAINT-DENIS,VILLEMOMBLE,0930043S,124,124,0,0,63,61,3 ème
SEINE-SAINT-DENIS,VILLEMOMBLE,0931846B,233,233,0,0,131,102,3 ème
SEINE-SAINT-DENIS,VILLEPINTE,0932260B,33,33,0,0,11,22,3 ème
SEINE-SAINT-DENIS,VILLETANEUSE,0931206F,138,136,0,2,74,64,3 ème
VAL-DE-MARNE,ABLON-SUR-SEINE,0941709X,116,116,0,0,62,54,3 ème
VAL-DE-MARNE,ALFORTVILLE,0941020Y,116,113,0,3,53,63,3 ème
VAL-DE-MARNE,BRY-SUR-MARNE,0940887D,116,116,0,0,61,55,3 ème
VAL-DE-MARNE,BRY-SUR-MARNE,0941014S,155,155,0,0,85,70,3 ème
VAL-DE-MARNE,CACHAN,0940806R,79,79,0,0,42,37,3 ème
VAL-DE-MARNE,CHAMPIGNY-SUR-MARNE,0940786U,144,144,0,0,72,72,3 ème
VAL-DE-MARNE,CHOISY-LE-ROI,0941040V,114,114,0,0,54,60,3 ème
VAL-DE-MARNE,FONTENAY-SOUS-BOIS,0941298A,19,19,0,0,7,12,3 ème
VAL-DE-MARNE,FRESNES,0940094S,76,76,0,0,38,38,3 ème
VAL-DE-MARNE,FRESNES,0940582X,105,105,0,0,53,52,3 ème
VAL-DE-MARNE,IVRY-SUR-SEINE,0941972H,34,34,0,0,11,23,3 ème
VAL-DE-MARNE,L'HAY-LES-ROSES,0940551N,161,144,17,0,76,85,3 ème
VAL-DE-MARNE,MAISONS-ALFORT,0941023B,73,73,0,0,27,46,3 ème
VAL-DE-MARNE,MAISONS-ALFORT,0941712A,167,167,0,0,86,81,3 ème
VAL-DE-MARNE,NOGENT-SUR-MARNE,0940137N,4,4,0,0,1,3,3 ème
VAL-DE-MARNE,NOGENT-SUR-MARNE,0940810V,79,79,0,0,32,47,3 ème
VAL-DE-MARNE,NOGENT-SUR-MARNE,0941091A,120,118,0,2,58,62,3 ème
VAL-DE-MARNE,NOGENT-SUR-MARNE,0941713B,151,151,0,0,75,76,3 ème
VAL-DE-MARNE,SAINT-MAUR-DES-FOSSES,0941093C,179,179,0,0,88,91,3 ème
VAL-DE-MARNE,SAINT-MAUR-DES-FOSSES,0941220R,192,176,14,2,94,98,3 ème
VAL-DE-MARNE,SANTENY,0941782B,130,126,0,4,57,73,3 ème
VAL-DE-MARNE,THIAIS,0940853S,15,15,0,0,3,12,3 ème
VAL-DE-MARNE,THIAIS,0941233E,112,112,0,0,54,58,3 ème
VAL-DE-MARNE,VALENTON,0942482M,100,100,0,0,47,53,3 ème
VAL-DE-MARNE,VILLEJUIF,0941037S,144,144,0,0,69,75,3 ème
VAL-DE-MARNE,VINCENNES,0941598B,125,125,0,0,59,66,3 ème
PARIS,PARIS,0750584C,91,91,0,0,43,48,3 ème
PARIS,PARIS,0750609E,139,139,0,0,64,75,3 ème
PARIS,PARIS,0752189X,110,110,0,0,49,61,3 ème
PARIS,PARIS,0752542F,109,109,0,0,57,52,3 ème
PARIS,PARIS,0753936W,120,105,15,0,58,62,3 ème
PARIS,PARIS,0750553U,20,20,0,0,2,18,3 ème
PARIS,PARIS,0752694W,100,100,0,0,54,46,3 ème
PARIS,PARIS,0752906B,153,153,0,0,87,66,3 ème
PARIS,PARIS,0752799K,15,15,0,0,11,4,3 ème
PARIS,PARIS,0752901W,89,87,0,2,44,45,3 ème
PARIS,PARIS,0752935H,207,207,0,0,105,102,3 ème
PARIS,PARIS,0753256G,51,51,0,0,17,34,3 ème
PARIS,PARIS,0750588G,39,36,0,3,18,21,3 ème
PARIS,PARIS,0752547L,86,83,0,3,42,44,3 ème
PARIS,PARIS,0752550P,196,196,0,0,107,89,3 ème
PARIS,PARIS,0752926Y,155,155,0,0,55,100,3 ème
PARIS,PARIS,0752553T,212,212,0,0,128,84,3 ème
PARIS,PARIS,0752927Z,169,169,0,0,86,83,3 ème
PARIS,PARIS,0750546L,90,90,0,0,41,49,3 ème
PARIS,PARIS,0752252R,14,0,14,0,5,9,3 ème
PARIS,PARIS,0753206C,30,30,0,0,29,1,3 ème
PARIS,PARIS,0753381T,179,179,0,0,100,79,3 ème
PARIS,PARIS,0755433Y,106,89,15,2,55,51,3 ème
PARIS,PARIS,0752695X,100,100,0,0,56,44,3 ème
PARIS,PARIS,0753369E,107,107,0,0,85,22,3 ème
PARIS,PARIS,0755747P,93,91,0,2,54,39,3 ème
PARIS,PARIS,0751703U,81,81,0,0,35,46,3 ème
PARIS,PARIS,0750478M,106,93,13,0,43,63,3 ème
PARIS,PARIS,0750508V,11,11,0,0,4,7,3 ème
PARIS,PARIS,0750591K,138,134,0,4,63,75,3 ème
PARIS,PARIS,0750808W,29,29,0,0,13,16,3 ème
PARIS,PARIS,0750828T,23,23,0,0,6,17,3 ème
PARIS,PARIS,0752557X,86,86,0,0,50,36,3 ème
PARIS,PARIS,0752696Y,129,129,0,0,56,73,3 ème
PARIS,PARIS,0754007Y,122,122,0,0,68,54,3 ème
PARIS,PARIS,0754355B,108,94,14,0,51,57,3 ème
PARIS,PARIS,0751790N,153,153,0,0,66,87,3 ème
PARIS,PARIS,0752187V,85,80,0,5,41,44,3 ème
PARIS,PARIS,0752874S,170,170,0,0,102,68,3 ème
PARIS,PARIS,0754025T,41,22,0,19,8,33,3 ème
PARIS,PARIS,0752534X,94,93,0,1,47,47,3 ème
ESSONNE,ATHIS-MONS,0910025H,168,164,0,4,92,76,3 ème
ESSONNE,BRETIGNY-SUR-ORGE,0911490A,151,135,16,0,59,92,3 ème
ESSONNE,BRUNOY,0910009R,222,203,16,3,109,113,3 ème
ESSONNE,BURES-SUR-YVETTE,0910967G,139,139,0,0,63,76,3 ème
ESSONNE,CORBEIL-ESSONNES,0910829G,242,239,0,3,134,108,3 ème
ESSONNE,CORBEIL-ESSONNES,0911024U,143,141,0,2,73,70,3 ème
ESSONNE,DRAVEIL,0910016Y,175,175,0,0,93,82,3 ème
ESSONNE,EPINAY-SUR-ORGE,0910017Z,180,180,0,0,82,98,3 ème
ESSONNE,ETRECHY,0911447D,120,118,0,2,53,67,3 ème
ESSONNE,EVRY-COURCOURONNES,0911444A,112,110,0,2,52,60,3 ème
ESSONNE,EVRY-COURCOURONNES,0911865H,165,163,0,2,78,87,3 ème
ESSONNE,GIF-SUR-YVETTE,0911354C,209,203,0,6,99,110,3 ème
ESSONNE,JUVISY-SUR-ORGE,0911028Y,147,147,0,0,72,75,3 ème
ESSONNE,LA NORVILLE,0911152H,227,227,0,0,124,103,3 ème
ESSONNE,LARDY,0912276E,123,118,0,5,51,72,3 ème
ESSONNE,LA VILLE-DU-BOIS,0911751J,247,245,0,2,139,108,3 ème
ESSONNE,LIMOURS,0910028L,174,174,0,0,98,76,3 ème
ESSONNE,MARCOUSSIS,0911032C,112,111,0,1,60,52,3 ème
ESSONNE,MAROLLES-EN-HUREPOIX,0911572P,139,133,0,6,69,70,3 ème
ESSONNE,MONTGERON,0910817U,143,143,0,0,72,71,3 ème
ESSONNE,MONTLHERY,0911345T,238,234,0,4,114,124,3 ème
ESSONNE,MORSANG-SUR-ORGE,0911488Y,140,140,0,0,76,64,3 ème
ESSONNE,ORSAY,0911143Y,145,145,0,0,53,92,3 ème
ESSONNE,PALAISEAU,0911034E,174,171,0,3,83,91,3 ème
ESSONNE,SAINT-GERMAIN-LES-ARPAJON,0911899V,141,136,0,5,50,91,3 ème
ESSONNE,SAVIGNY-SUR-ORGE,0910716J,97,97,0,0,46,51,3 ème
ESSONNE,SAVIGNY-SUR-ORGE,0911252S,274,254,15,5,149,125,3 ème
ESSONNE,SAVIGNY-SUR-ORGE,0912142J,24,24,0,0,6,18,3 ème
ESSONNE,SOISY-SUR-SEINE,0912086Y,129,125,0,4,58,71,3 ème
ESSONNE,VIGNEUX-SUR-SEINE,0911146B,181,167,14,0,108,73,3 ème
ESSONNE,VILLABE,0912257J,120,116,0,4,68,52,3 ème
ESSONNE,VILLEBON-SUR-YVETTE,0911750H,122,122,0,0,56,66,3 ème
HAUTS-DE-SEINE,ASNIERES-SUR-SEINE,0921622N,196,196,0,0,100,96,3 ème
HAUTS-DE-SEINE,BAGNEUX,0921778H,98,98,0,0,47,51,3 ème
HAUTS-DE-SEINE,BOULOGNE-BILLANCOURT,0920905J,198,198,0,0,105,93,3 ème
HAUTS-DE-SEINE,BOULOGNE-BILLANCOURT,0922443F,22,22,0,0,11,11,3 ème
HAUTS-DE-SEINE,CHATENAY-MALABRY,0921181J,146,144,0,2,64,82,3 ème
HAUTS-DE-SEINE,CLAMART,0920068Z,214,214,0,0,95,119,3 ème
HAUTS-DE-SEINE,CLAMART,0920854D,176,176,0,0,92,84,3 ème
HAUTS-DE-SEINE,COLOMBES,0920592U,148,148,0,0,76,72,3 ème
HAUTS-DE-SEINE,COURBEVOIE,0921625S,24,24,0,0,8,16,3 ème
HAUTS-DE-SEINE,GARCHES,0920810F,27,9,18,0,5,22,3 ème
HAUTS-DE-SEINE,GARCHES,0920881H,141,139,0,2,70,71,3 ème
HAUTS-DE-SEINE,GENNEVILLIERS,0921541A,175,159,16,0,89,86,3 ème
HAUTS-DE-SEINE,ISSY-LES-MOULINEAUX,0920877D,137,136,0,1,70,67,3 ème
HAUTS-DE-SEINE,ISSY-LES-MOULINEAUX,0921396T,130,127,0,3,64,66,3 ème
HAUTS-DE-SEINE,ISSY-LES-MOULINEAUX,0922610M,131,130,0,1,75,56,3 ème
HAUTS-DE-SEINE,LA GARENNE-COLOMBES,0921162N,127,125,0,2,64,63,3 ème
HAUTS-DE-SEINE,LEVALLOIS-PERRET,0921007V,185,185,0,0,102,83,3 ème
HAUTS-DE-SEINE,LEVALLOIS-PERRET,0922751R,22,22,0,0,0,22,3 ème
HAUTS-DE-SEINE,MEUDON,0921554P,106,106,0,0,46,60,3 ème
HAUTS-DE-SEINE,MEUDON,0922340U,30,30,0,0,1,29,3 ème
HAUTS-DE-SEINE,MONTROUGE,0920855E,134,125,9,0,65,69,3 ème
HAUTS-DE-SEINE,NANTERRE,0921589C,106,106,0,0,52,54,3 ème
HAUTS-DE-SEINE,NEUILLY-SUR-SEINE,0921781L,149,147,0,2,71,78,3 ème
HAUTS-DE-SEINE,NEUILLY-SUR-SEINE,0921912D,114,114,0,0,114,0,3 ème
HAUTS-DE-SEINE,RUEIL-MALMAISON,0921915G,281,281,0,0,0,281,3 ème
HAUTS-DE-SEINE,SAINT-CLOUD,0920700L,109,105,0,4,55,54,3 ème
HAUTS-DE-SEINE,SAINT-CLOUD,0921020J,36,36,0,0,0,36,3 ème
HAUTS-DE-SEINE,SCEAUX,0921918K,147,147,0,0,67,80,3 ème
HAUTS-DE-SEINE,SEVRES,0921244C,228,228,0,0,113,115,3 ème
HAUTS-DE-SEINE,VANVES,0921240Y,138,135,0,3,76,62,3 ème
HAUTS-DE-SEINE,VANVES,0921783N,147,147,0,0,75,72,3 ème
VAL-D'OISE,ARGENTEUIL,0950884V,101,96,0,5,49,52,3 ème
VAL-D'OISE,ARGENTEUIL,0951094Y,166,164,0,2,71,95,3 ème
VAL-D'OISE,ARGENTEUIL,0951356H,189,187,0,2,89,100,3 ème
VAL-D'OISE,ARNOUVILLE,0951143B,149,146,0,3,74,75,3 ème
VAL-D'OISE,AUVERS-SUR-OISE,0951823R,109,101,0,8,42,67,3 ème
VAL-D'OISE,BEAUCHAMP,0952086B,146,146,0,0,68,78,3 ème
VAL-D'OISE,BEZONS,0950887Y,190,187,0,3,102,88,3 ème
VAL-D'OISE,BEZONS,0952173W,16,16,0,0,5,11,3 ème
VAL-D'OISE,CERGY,0951617S,158,156,0,2,71,87,3 ème
VAL-D'OISE,CERGY,0952282P,22,22,0,0,11,11,3 ème
VAL-D'OISE,COURDIMANCHE,0951724H,170,170,0,0,88,82,3 ème
VAL-D'OISE,DEUIL-LA-BARRE,0950682A,133,130,0,3,56,77,3 ème
VAL-D'OISE,DEUIL-LA-BARRE,0952140K,110,110,0,0,46,64,3 ème
VAL-D'OISE,ECOUEN,0950752B,103,103,0,0,49,54,3 ème
VAL-D'OISE,ENGHIEN-LES-BAINS,0951504U,262,262,0,0,129,133,3 ème
VAL-D'OISE,ERMONT,0950739M,145,129,16,0,68,77,3 ème
VAL-D'OISE,FRANCONVILLE,0950022H,149,145,0,4,61,88,3 ème
VAL-D'OISE,FRANCONVILLE,0951100E,149,129,15,5,56,93,3 ème
VAL-D'OISE,FRANCONVILLE,0952088D,129,126,0,3,69,60,3 ème
VAL-D'OISE,GARGES-LES-GONESSE,0950023J,189,171,16,2,99,90,3 ème
VAL-D'OISE,GARGES-LES-GONESSE,0950711G,157,154,0,3,77,80,3 ème
VAL-D'OISE,GARGES-LES-GONESSE,0951098C,154,143,11,0,74,80,3 ème
VAL-D'OISE,GARGES-LES-GONESSE,0951787B,24,24,0,0,4,20,3 ème
VAL-D'OISE,GONESSE,0951920W,145,141,0,4,79,66,3 ème
VAL-D'OISE,GOUSSAINVILLE,0951050A,145,143,0,2,70,75,3 ème
VAL-D'OISE,GOUSSAINVILLE,0952128X,127,124,0,3,62,65,3 ème
VAL-D'OISE,HERBLAY,0951696C,112,109,0,3,60,52,3 ème
VAL-D'OISE,HERBLAY,0952205F,126,126,0,0,69,57,3 ème
VAL-D'OISE,MARGENCY,0951505V,204,204,0,0,105,99,3 ème
VAL-D'OISE,MERIEL,0951991Y,133,130,0,3,71,62,3 ème
VAL-D'OISE,MONTIGNY-LES-CORMEILLES,0951154N,161,156,0,5,83,78,3 ème
VAL-D'OISE,MONTMAGNY,0951909J,132,129,0,3,65,67,3 ème
VAL-D'OISE,MONTMORENCY,0951799P,133,133,0,0,69,64,3 ème
VAL-D'OISE,PERSAN,0950934Z,210,194,16,0,120,90,3 ème
VAL-D'OISE,PISCOP,0951817J,47,47,0,0,25,22,3 ème
VAL-D'OISE,SAINT-OUEN-L'AUMONE,0951195H,166,150,11,5,83,83,3 ème
VAL-D'OISE,SANNOIS,0950722U,139,137,0,2,79,60,3 ème
VAL-D'OISE,SANNOIS,0952136F,43,43,0,0,6,37,3 ème
VAL-D'OISE,SARCELLES,0950045H,142,123,17,2,70,72,3 ème
VAL-D'OISE,SARCELLES,0950947N,21,21,0,0,8,13,3 ème
VAL-D'OISE,SARCELLES,0951682M,30,30,0,0,30,0,3 ème
VAL-D'OISE,SARCELLES,0951945Y,115,115,0,0,59,56,3 ème
VAL-D'OISE,VAUREAL,0951636M,112,112,0,0,50,62,3 ème
VAL-D'OISE,VILLIERS-LE-BEL,0951916S,63,63,0,0,31,32,3 ème
YVELINES,AUBERGENVILLE,0780506B,155,137,14,4,65,90,3 ème
YVELINES,BONNELLES,0781846H,72,72,0,0,38,34,3 ème
YVELINES,CHAMBOURCY,0781683F,145,145,0,0,66,79,3 ème
YVELINES,CROISSY-SUR-SEINE,0780847X,113,112,0,1,53,60,3 ème
YVELINES,FONTENAY-LE-FLEURY,0780185C,163,146,15,2,76,87,3 ème
YVELINES,GUYANCOURT,0780581H,132,127,0,5,58,74,3 ème
YVELINES,GUYANCOURT,0783378Y,90,86,0,4,49,41,3 ème
YVELINES,HOUILLES,0780269U,204,201,0,3,100,104,3 ème
YVELINES,HOUILLES,0783253M,161,161,0,0,74,87,3 ème
YVELINES,LA CELLE-SAINT-CLOUD,0780036R,130,128,0,2,53,77,3 ème
YVELINES,LE CHESNAY-ROCQUENCOURT,0781586A,280,280,0,0,140,140,3 ème
YVELINES,LES ESSARTS-LE-ROI,0780574A,170,166,0,4,77,93,3 ème
YVELINES,LES MUREAUX,0780572Y,171,159,12,0,84,87,3 ème
YVELINES,LES MUREAUX,0781914G,141,138,0,3,67,74,3 ème
YVELINES,LE VESINET,0781105C,159,159,0,0,75,84,3 ème
YVELINES,LIMAY,0782115A,152,134,15,3,68,84,3 ème
YVELINES,MANTES-LA-JOLIE,0781896M,81,81,0,0,37,44,3 ème
YVELINES,MANTES-LA-JOLIE,0783774D,137,121,16,0,59,78,3 ème
YVELINES,MARLY-LE-ROI,0780119F,245,245,0,0,120,125,3 ème
YVELINES,MAUREPAS,0780419G,158,143,15,0,80,78,3 ème
YVELINES,MEULAN-EN-YVELINES,0780571X,178,162,10,6,84,94,3 ème
YVELINES,MONTIGNY-LE-BRETONNEUX,0781263Z,119,119,0,0,57,62,3 ème
YVELINES,MONTIGNY-LE-BRETONNEUX,0783592F,20,20,0,0,10,10,3 ème
YVELINES,POISSY,0783358B,233,228,0,5,117,116,3 ème
YVELINES,RAMBOUILLET,0780846W,83,83,0,0,47,36,3 ème
YVELINES,RAMBOUILLET,0783338E,179,179,0,0,87,92,3 ème
YVELINES,ROSNY-SUR-SEINE,0781916J,134,132,0,2,64,70,3 ème
YVELINES,SAINT-GERMAIN-EN-LAYE,0781204K,254,254,0,0,112,142,3 ème
YVELINES,SAINT-GERMAIN-EN-LAYE,0781620M,227,223,0,4,113,114,3 ème
YVELINES,SARTROUVILLE,0780577D,83,83,0,0,36,47,3 ème
YVELINES,SARTROUVILLE,0780579F,110,108,0,2,54,56,3 ème
YVELINES,TRAPPES,0781618K,110,106,0,4,55,55,3 ème
YVELINES,VELIZY-VILLACOUBLAY,0780210E,143,141,0,2,65,78,3 ème
YVELINES,VERSAILLES,0781106D,149,149,0,0,70,79,3 ème
YVELINES,VERSAILLES,0781298M,86,83,0,3,51,35,3 ème
YVELINES,VILLEPREUX,0780260J,166,166,0,0,72,94,3 ème
YVELINES,VOISINS-LE-BRETONNEUX,0781789W,114,113,0,1,46,68,3 ème
LA REUNION,LA POSSESSION,9740084Y,185,181,0,4,100,85,3 ème
LA REUNION,SAINT-ANDRE,9740598G,249,215,29,5,111,138,3 ème
LA REUNION,SAINT-BENOIT,9740065C,137,132,0,5,66,71,3 ème
LA REUNION,SAINTE-MARIE,9741649Z,54,54,0,0,30,24,3 ème
LA REUNION,SAINTE-SUZANNE,9740094J,192,159,27,6,89,103,3 ème
LA REUNION,SAINT-JOSEPH,9740577J,241,207,32,2,113,128,3 ème
LA REUNION,SAINT-LEU,9740546A,305,296,0,9,153,152,3 ème
LA REUNION,SAINT-PAUL,9740069G,174,170,0,4,76,98,3 ème
LA REUNION,SAINT-PAUL,9740469S,190,190,0,0,82,108,3 ème
LA REUNION,SAINT-PAUL,9740596E,150,150,0,0,80,70,3 ème
LA REUNION,SAINT-PIERRE,9741346V,195,175,16,4,100,95,3 ème
MARTINIQUE,BASSE-POINTE,9720472F,53,49,4,0,25,28,3 ème
MARTINIQUE,FORT-DE-FRANCE,9720411P,120,113,0,7,57,63,3 ème
MARTINIQUE,FORT-DE-FRANCE,9720708M,107,104,0,3,54,53,3 ème
MARTINIQUE,FORT-DE-FRANCE,9720774J,170,170,0,0,154,16,3 ème
MARTINIQUE,LE DIAMANT,9720035F,82,79,0,3,41,41,3 ème
MARTINIQUE,LE LAMENTIN,9720091S,12,12,0,0,3,9,3 ème
MARTINIQUE,LE LORRAIN,9720445B,64,61,0,3,32,32,3 ème
MARTINIQUE,LES TROIS-ILETS,9720498J,99,99,0,0,49,50,3 ème
MARTINIQUE,LE VAUCLIN,9720031B,97,97,0,0,51,46,3 ème
MARTINIQUE,SCHOELCHER,9720424D,15,15,0,0,8,7,3 ème
MARTINIQUE,SCHOELCHER,9720684L,66,66,0,0,32,34,3 ème
MAYOTTE,BANDRABOUA,9760094Y,291,289,0,2,165,126,3 ème
MAYOTTE,KANI-KELI,9760166B,183,179,0,4,94,89,3 ème
MAYOTTE,KOUNGOU,9760244L,487,451,29,7,245,242,3 ème
MAYOTTE,MAMOUDZOU,9760219J,414,407,0,7,225,189,3 ème
ALLIER,COSNE-D'ALLIER,0030009U,65,58,0,7,33,32,3 ème
ALLIER,CUSSET,0031082K,24,24,0,0,16,8,3 ème
ALLIER,DESERTINES,0030860U,132,105,21,6,62,70,3 ème
ALLIER,GANNAT,0030980Z,33,33,0,0,21,12,3 ème
ALLIER,LURCY-LEVIS,0030021G,27,27,0,0,13,14,3 ème
ALLIER,MONTLUCON,0030119N,48,42,0,6,27,21,3 ème
ALLIER,MOULINS,0030112F,21,21,0,0,15,6,3 ème
ALLIER,NERIS-LES-BAINS,0030042E,43,43,0,0,23,20,3 ème
ALLIER,YZEURE,0030038A,44,44,0,0,13,31,3 ème
CANTAL,AURILLAC,0150613K,11,0,11,0,3,8,3 ème
CANTAL,AURILLAC,0150708N,66,66,0,0,29,37,3 ème
CANTAL,AURILLAC,0150729L,118,101,15,2,60,58,3 ème
CANTAL,AURILLAC,0150760V,21,21,0,0,9,12,3 ème
CANTAL,CHAUDES-AIGUES,0150010E,27,27,0,0,13,14,3 ème
CANTAL,LAROQUEBROU,0150013H,47,47,0,0,20,27,3 ème
CANTAL,MAURS,0150018N,47,43,0,4,24,23,3 ème
CANTAL,SAINT-MAMET-LA-SALVETAT,0150581A,70,64,0,6,42,28,3 ème
HAUTE-LOIRE,ALLEGRE,0430001T,57,57,0,0,28,29,3 ème
HAUTE-LOIRE,AUREC-SUR-LOIRE,0430987P,41,41,0,0,15,26,3 ème
HAUTE-LOIRE,BRIOUDE,0430003V,24,24,0,0,11,13,3 ème
HAUTE-LOIRE,DUNIERES,0430069S,54,54,0,0,32,22,3 ème
HAUTE-LOIRE,LE PUY-EN-VELAY,0430020N,20,20,0,0,3,17,3 ème
HAUTE-LOIRE,LE PUY-EN-VELAY,0430024T,19,19,0,0,11,8,3 ème
HAUTE-LOIRE,LE PUY-EN-VELAY,0430043N,138,134,0,4,74,64,3 ème
HAUTE-LOIRE,SAINT-DIDIER-EN-VELAY,0430084H,105,105,0,0,48,57,3 ème
HAUTE-LOIRE,SAINT-JULIEN-CHAPTEUIL,0430030Z,99,96,0,3,43,56,3 ème
HAUTE-LOIRE,TENCE,0430093T,31,31,0,0,17,14,3 ème
PUY-DE-DOME,AMBERT,0631083K,39,39,0,0,20,19,3 ème
PUY-DE-DOME,AMBERT,0631153L,85,78,5,2,38,47,3 ème
PUY-DE-DOME,AUBIERE,0631451K,183,167,14,2,102,81,3 ème
PUY-DE-DOME,BOURG-LASTIC,0630011V,20,20,0,0,10,10,3 ème
PUY-DE-DOME,CHAMALIERES,0631730N,116,116,0,0,65,51,3 ème
PUY-DE-DOME,CHAMPEIX,0630016A,89,87,0,2,38,51,3 ème
PUY-DE-DOME,CLERMONT-FERRAND,0630022G,56,56,0,0,13,43,3 ème
PUY-DE-DOME,LES ANCIZES-COMPS,0631482U,56,56,0,0,26,30,3 ème
PUY-DE-DOME,MARINGUES,0631097A,19,19,0,0,10,9,3 ème
PUY-DE-DOME,PIONSAT,0630046H,18,18,0,0,10,8,3 ème
PUY-DE-DOME,PONT-DU-CHATEAU,0631101E,60,60,0,0,31,29,3 ème
PUY-DE-DOME,ROCHEFORT-MONTAGNE,0630056U,64,64,0,0,27,37,3 ème
PUY-DE-DOME,SAINT-AMANT-ROCHE-SAVINE,0630057V,7,7,0,0,1,6,3 ème
PUY-DE-DOME,SAINT-GERMAIN-LEMBRON,0630062A,86,84,0,2,38,48,3 ème
PUY-DE-DOME,SAINT-GERVAIS-D'AUVERGNE,0630065D,28,27,0,1,15,13,3 ème
PUY-DE-DOME,THIERS,0630078T,24,24,0,0,15,9,3 ème
PUY-DE-DOME,VIC-LE-COMTE,0630072L,103,97,0,6,48,55,3 ème
ARDECHE,ANNONAY,0070001N,23,23,0,0,11,12,3 ème
ARDECHE,CRUAS,0070010Y,67,67,0,0,36,31,3 ème
ARDECHE,LAMASTRE,0070872K,63,63,0,0,37,26,3 ème
ARDECHE,LARGENTIERE,0070016E,18,18,0,0,4,14,3 ème
ARDECHE,LA VOULTE-SUR-RHONE,0070042H,130,118,12,0,61,69,3 ème
ARDECHE,LE CHEYLARD,0070849K,83,83,0,0,37,46,3 ème
ARDECHE,LE TEIL,0070847H,146,142,0,4,75,71,3 ème
ARDECHE,MONTPEZAT-SOUS-BAUZON,0070018G,65,65,0,0,23,42,3 ème
ARDECHE,SAINT-CIRGUES-EN-MONTAGNE,0070024N,23,23,0,0,13,10,3 ème
ARDECHE,SAINT-SAUVEUR-DE-MONTAGUT,0070025P,36,36,0,0,16,20,3 ème
ARDECHE,TOURNON-SUR-RHONE,0070092M,112,112,0,0,58,54,3 ème
ARDECHE,VALS-LES-BAINS,0070846G,64,62,0,2,30,34,3 ème
ARDECHE,VERNOUX-EN-VIVARAIS,0070890E,49,49,0,0,27,22,3 ème
DROME,BOURG-LES-VALENCE,0260766S,219,188,31,0,101,118,3 ème
DROME,BUIS-LES-BARONNIES,0260002L,34,34,0,0,17,17,3 ème
DROME,CHATEAUNEUF-DE-GALAURE,0261133R,65,65,0,0,65,0,3 ème
DROME,LA CHAPELLE-EN-VERCORS,0260004N,54,54,0,0,26,28,3 ème
DROME,LORIOL-SUR-DROME,0260012X,102,102,0,0,46,56,3 ème
DROME,MONTELIMAR,0261135T,118,118,0,0,60,58,3 ème
DROME,PIERRELATTE,0261090U,93,93,0,0,48,45,3 ème
DROME,ROMANS-SUR-ISERE,0260850H,177,161,15,1,97,80,3 ème
DROME,ROMANS-SUR-ISERE,0260997T,170,151,16,3,79,91,3 ème
DROME,SAINT-PAUL-TROIS-CHATEAUX,0261032F,141,141,0,0,74,67,3 ème
DROME,SAINT-SORLIN-EN-VALLOIRE,0260030S,119,114,0,5,59,60,3 ème
DROME,VALENCE,0261095Z,166,161,0,5,59,107,3 ème
DROME,VALENCE,0261137V,161,161,0,0,86,75,3 ème
HAUTE SAVOIE,ALBY-SUR-CHERAN,0740002A,119,119,0,0,50,69,3 ème
HAUTE SAVOIE,ANNECY,0740071A,142,117,24,1,65,77,3 ème
HAUTE SAVOIE,ANNECY,0740105M,156,156,0,0,81,75,3 ème
HAUTE SAVOIE,CLUSES,0740112V,154,154,0,0,70,84,3 ème
HAUTE SAVOIE,CLUSES,0740911N,230,226,0,4,103,127,3 ème
HAUTE SAVOIE,COLLONGES-SOUS-SALEVE,0740144E,40,40,0,0,13,27,3 ème
HAUTE SAVOIE,DOUVAINE,0740020V,147,147,0,0,72,75,3 ème
HAUTE SAVOIE,RUMILLY,0740126K,185,185,0,0,105,80,3 ème
HAUTE SAVOIE,RUMILLY,0741757H,127,127,0,0,63,64,3 ème
HAUTE SAVOIE,SAINT-PAUL-EN-CHABLAIS,0741308V,126,125,0,1,64,62,3 ème
HAUTE SAVOIE,SAMOENS,0740040S,49,49,0,0,25,24,3 ème
HAUTE SAVOIE,THONES,0741187N,165,165,0,0,66,99,3 ème
HAUTE SAVOIE,THONON-LES-BAINS,0740059M,24,24,0,0,1,23,3 ème
HAUTE SAVOIE,VILLE-LA-GRAND,0741284U,227,227,0,0,113,114,3 ème
ISERE,BOURGOIN-JALLIEU,0382271M,24,23,0,1,4,20,3 ème
ISERE,CORENC,0382041M,116,112,0,4,58,58,3 ème
ISERE,CORENC,0382579X,151,146,0,5,64,87,3 ème
ISERE,COUBLEVIE,0382495F,199,183,15,1,89,110,3 ème
ISERE,ECHIROLLES,0382031B,25,25,0,0,9,16,3 ème
ISERE,FONTAINE,0380356F,104,100,0,4,48,56,3 ème
ISERE,GIERES,0381694K,148,147,0,1,77,71,3 ème
ISERE,GONCELIN,0383300F,128,124,0,4,59,69,3 ème
ISERE,GRENOBLE,0383370G,154,154,0,0,74,80,3 ème
ISERE,LA COTE-SAINT-ANDRE,0382147C,150,117,29,4,70,80,3 ème
ISERE,LA MURE,0381701T,46,46,0,0,32,14,3 ème
ISERE,LA TOUR-DU-PIN,0380278W,193,158,31,4,97,96,3 ème
ISERE,LA TOUR-DU-PIN,0381706Y,151,147,0,4,71,80,3 ème
ISERE,LE TOUVET,0382204P,167,167,0,0,93,74,3 ème
ISERE,L'ISLE-D'ABEAU,0383455Z,169,165,0,4,79,90,3 ème
ISERE,MEYLAN,0381777A,131,127,0,4,64,67,3 ème
ISERE,MOIRANS,0381908T,103,98,0,5,66,37,3 ème
ISERE,SAINT-GEORGES-D'ESPERANCHE,0383141H,85,85,0,0,46,39,3 ème
ISERE,SAINT-JEAN-DE-MOIRANS,0381704W,70,70,0,0,32,38,3 ème
ISERE,SAINT-JEAN-DE-SOUDAIN,0382621T,157,157,0,0,69,88,3 ème
ISERE,SAINT-MARCELLIN,0380063M,24,24,0,0,12,12,3 ème
ISERE,TIGNIEU-JAMEYZIEU,0382705J,155,155,0,0,81,74,3 ème
ISERE,VIENNE,0380083J,24,24,0,0,9,15,3 ème
ISERE,VILLEFONTAINE,0382104F,144,119,22,3,73,71,3 ème
ISERE,VILLEFONTAINE,0382506T,119,117,0,2,59,60,3 ème
ISERE,VILLEMOIRIEU,0383475W,124,124,0,0,65,59,3 ème
ISERE,VIZILLE,0381779C,215,201,13,1,100,115,3 ème
ISERE,VOIRON,0382169B,20,20,0,0,3,17,3 ème
ISERE,VOIRON,0382584C,121,121,0,0,56,65,3 ème
SAVOIE,ALBERTVILLE,0730904L,183,155,23,5,88,95,3 ème
SAVOIE,ALBERTVILLE,0731045P,13,0,13,0,5,8,3 ème
SAVOIE,BOURG-SAINT-MAURICE,0730009N,133,133,0,0,59,74,3 ème
SAVOIE,BOZEL,0730010P,77,77,0,0,38,39,3 ème
SAVOIE,CHAMBERY,0730016W,24,24,0,0,5,19,3 ème
SAVOIE,CHAMBERY,0730762G,122,122,0,0,56,66,3 ème
SAVOIE,CHAMBERY,0730855H,87,84,0,3,47,40,3 ème
SAVOIE,LA MOTTE-SERVOLEX,0730028J,80,76,0,4,36,44,3 ème
SAVOIE,LA RAVOIRE,0730982W,95,75,16,4,53,42,3 ème
SAVOIE,MODANE,0730049G,101,101,0,0,49,52,3 ème
SAVOIE,SAINT-JEAN-DE-MAURIENNE,0730037U,24,24,0,0,7,17,3 ème
SAVOIE,SAINT-JEAN-DE-MAURIENNE,0730903K,146,128,15,3,68,78,3 ème
SAVOIE,SAINT-PIERRE-D'ALBIGNY,0730042Z,132,128,0,4,66,66,3 ème
SAVOIE,VAL-D'ARC,0730001E,79,73,0,6,37,42,3 ème
AIN,BELLEY,0011067E,217,193,15,9,109,108,3 ème
AIN,BEYNOST,0011360Y,136,134,0,2,60,76,3 ème
AIN,BOURG-EN-BRESSE,0010079F,122,118,0,4,43,79,3 ème
AIN,BOURG-EN-BRESSE,0010099C,24,24,0,0,15,9,3 ème
AIN,BOURG-EN-BRESSE,0010966V,14,0,14,0,5,9,3 ème
AIN,BRIORD,0011429Y,159,156,0,3,76,83,3 ème
AIN,CESSY,0010878Z,25,25,0,0,11,14,3 ème
AIN,CEYZERIAT,0011387C,157,155,0,2,73,84,3 ème
AIN,CHATILLON-SUR-CHALARONNE,0010084L,36,36,0,0,17,19,3 ème
AIN,DAGNEUX,0010083K,173,173,0,0,87,86,3 ème
AIN,DIVONNE-LES-BAINS,0011011U,140,140,0,0,77,63,3 ème
AIN,GEX,0010088R,170,166,0,4,99,71,3 ème
AIN,MONTCEAUX,0011415H,163,161,0,2,78,85,3 ème
AIN,MONTREVEL-EN-BRESSE,0010895T,156,156,0,0,73,83,3 ème
AIN,OYONNAX,0010092V,115,114,0,1,57,58,3 ème
AIN,OYONNAX,0010802S,190,158,29,3,93,97,3 ème
AIN,PONT-D'AIN,0010037K,142,137,0,5,71,71,3 ème
AIN,PREVESSIN-MOENS,0011301J,204,197,0,7,92,112,3 ème
LOIRE,CHARLIEU,0421572F,163,163,0,0,96,67,3 ème
LOIRE,FIRMINY,0420073B,24,24,0,0,5,19,3 ème
LOIRE,MONTBRISON,0420075D,24,24,0,0,10,14,3 ème
LOIRE,PELUSSIN,0421049M,38,38,0,0,22,16,3 ème
LOIRE,REGNY,0421490S,80,80,0,0,41,39,3 ème
LOIRE,RIVE-DE-GIER,0420982P,24,24,0,0,9,15,3 ème
LOIRE,ROANNE,0420035K,135,115,17,3,66,69,3 ème
LOIRE,ROANNE,0420077F,24,21,0,3,11,13,3 ème
LOIRE,ROANNE,0421683B,109,109,0,0,51,58,3 ème
LOIRE,ROANNE,0421684C,78,78,0,0,47,31,3 ème
LOIRE,ROANNE,0421797A,144,125,15,4,75,69,3 ème
LOIRE,ROCHE-LA-MOLIERE,0421174Y,169,166,0,3,82,87,3 ème
LOIRE,SAINT-BONNET-LE-CHATEAU,0420038N,138,138,0,0,67,71,3 ème
LOIRE,SAINT-CHAMOND,0421006R,20,20,0,0,12,8,3 ème
LOIRE,SAINT-ETIENNE,0420058K,211,207,0,4,102,109,3 ème
LOIRE,SAINT-ETIENNE,0421452A,207,205,0,2,97,110,3 ème
LOIRE,SAINT-ETIENNE,0421677V,114,114,0,0,59,55,3 ème
LOIRE,SAINT-ETIENNE,0421798B,61,47,14,0,30,31,3 ème
LOIRE,SAINT-ETIENNE,0421980Z,24,24,0,0,7,17,3 ème
LOIRE,SAINT-GENEST-MALIFAUX,0421059Y,93,93,0,0,34,59,3 ème
LOIRE,SAINT-GERMAIN-LAVAL,0420060M,53,53,0,0,26,27,3 ème
LOIRE,SAINT-ROMAIN-LE-PUY,0422136U,178,173,0,5,88,90,3 ème
LOIRE,UNIEUX,0421068H,139,135,0,4,70,69,3 ème
LOIRE,VEAUCHE,0422293P,180,175,0,5,84,96,3 ème
RHONE,AMPLEPUIS,0690672F,91,91,0,0,52,39,3 ème
RHONE,BRINDAS,0693890D,194,191,0,3,90,104,3 ème
RHONE,BRON,0692576A,153,135,16,2,76,77,3 ème
RHONE,BRON,0693834T,129,125,0,4,66,63,3 ème
RHONE,CHASSIEU,0691614E,130,127,0,3,52,78,3 ème
RHONE,DECINES-CHARPIEU,0691649T,110,110,0,0,59,51,3 ème
RHONE,DECINES-CHARPIEU,0692157V,166,146,16,4,67,99,3 ème
RHONE,FEYZIN,0692520P,104,102,0,2,50,54,3 ème
RHONE,GIVORS,0692583H,148,128,16,4,67,81,3 ème
RHONE,GRIGNY,0692419E,180,161,17,2,83,97,3 ème
RHONE,L'ARBRESLE,0691482L,164,153,11,0,87,77,3 ème
RHONE,LYON,0692932M,167,163,0,4,91,76,3 ème
RHONE,LYON,0690597Z,80,80,0,0,45,35,3 ème
RHONE,LYON,0692933N,295,295,0,0,144,151,3 ème
RHONE,LYON,0692694D,89,86,0,3,42,47,3 ème
RHONE,LYON,0692934P,87,85,0,2,44,43,3 ème
RHONE,LYON,0690534F,181,181,0,0,93,88,3 ème
RHONE,LYON,0692338S,197,192,0,5,95,102,3 ème
RHONE,LYON,0690040U,19,19,0,0,5,14,3 ème
RHONE,LYON,0690651H,24,24,0,0,11,13,3 ème
RHONE,LYON,0693374T,22,22,0,0,1,21,3 ème
RHONE,LYON,0690036P,132,115,14,3,53,79,3 ème
RHONE,MIONS,0692579D,168,163,0,5,73,95,3 ème
RHONE,MORNANT,0690611P,119,119,0,0,66,53,3 ème
RHONE,MORNANT,0692346A,151,151,0,0,80,71,3 ème
RHONE,OULLINS,0690281F,23,23,0,0,17,6,3 ème
RHONE,OULLINS,0690653K,36,36,0,0,12,24,3 ème
RHONE,OULLINS,0692942Y,56,56,0,0,31,25,3 ème
RHONE,PIERRE-BENITE,0690076H,74,70,0,4,28,46,3 ème
RHONE,SAINT-FONS,0692342W,190,171,15,4,89,101,3 ème
RHONE,SAINT-GENIS-LAVAL,0692521R,90,86,0,4,38,52,3 ème
RHONE,SAINT-GEORGES-DE-RENEINS,0690080M,179,160,14,5,85,94,3 ème
RHONE,SAINT-LAURENT-DE-CHAMOUSSET,0690614T,63,63,0,0,35,28,3 ème
RHONE,SAINT-MARTIN-EN-HAUT,0690615U,110,110,0,0,54,56,3 ème
RHONE,SAINT-PRIEST,0692160Y,152,135,16,1,66,86,3 ème
RHONE,SAINT-SYMPHORIEN-D'OZON,0691496B,156,155,0,1,82,74,3 ème
RHONE,SAINT-SYMPHORIEN-SUR-COISE,0692925E,100,96,0,4,42,58,3 ème
RHONE,TARARE,0690618X,101,100,0,1,51,50,3 ème
RHONE,TARARE,0692700K,217,195,16,6,110,107,3 ème
RHONE,VAULX-EN-VELIN,0691793Z,122,118,0,4,53,69,3 ème
RHONE,VILLEURBANNE,0692155T,161,140,16,5,78,83,3 ème
RHONE,VILLEURBANNE,0693491V,21,21,0,0,8,13,3 ème
RHONE,VILLIE-MORGON,0690117C,115,111,0,4,53,62,3 ème
DOUBS,BAUME-LES-DAMES,0250005V,110,108,0,2,56,54,3 ème
DOUBS,BESANCON,0250011B,24,24,0,0,9,15,3 ème
DOUBS,BESANCON,0250012C,107,107,0,0,47,60,3 ème
DOUBS,BESANCON,0251208C,174,156,16,2,82,92,3 ème
DOUBS,FRASNE,0250018J,77,77,0,0,44,33,3 ème
DOUBS,HERIMONCOURT,0251375J,73,73,0,0,20,53,3 ème
DOUBS,LE RUSSEY,0251058P,21,21,0,0,5,16,3 ème
DOUBS,MAICHE,0251053J,70,70,0,0,37,33,3 ème
DOUBS,MONTBELIARD,0251395F,171,155,15,1,87,84,3 ème
DOUBS,MORTEAU,0251090Z,223,208,9,6,115,108,3 ème
DOUBS,PIREY,0251063V,94,94,0,0,48,46,3 ème
DOUBS,PONTARLIER,0251112Y,18,18,0,0,6,12,3 ème
DOUBS,SANCEY,0250055Z,52,52,0,0,28,24,3 ème
HAUTE-SAONE,HERICOURT,0700787A,175,159,13,3,80,95,3 ème
HAUTE-SAONE,LUXEUIL-LES-BAINS,0701192R,143,124,16,3,71,72,3 ème
HAUTE-SAONE,PESMES,0700027Z,85,85,0,0,46,39,3 ème
HAUTE-SAONE,VESOUL,0700038L,24,24,0,0,5,19,3 ème
HAUTE-SAONE,VESOUL,0700785Y,161,159,0,2,85,76,3 ème
JURA,CLAIRVAUX-LES-LACS,0390009Y,63,63,0,0,30,33,3 ème
JURA,DOLE,0390013C,24,24,0,0,4,20,3 ème
JURA,DOLE,0390800H,123,121,0,2,64,59,3 ème
JURA,DOLE,0390883Y,146,115,31,0,52,94,3 ème
JURA,LAVANS-LES-SAINT-CLAUDE,0391035N,52,52,0,0,32,20,3 ème
JURA,LONS-LE-SAUNIER,0390020K,24,24,0,0,5,19,3 ème
JURA,MOIRANS-EN-MONTAGNE,0390025R,57,55,0,2,30,27,3 ème
JURA,SAINT-CLAUDE,0390786T,10,10,0,0,1,9,3 ème
JURA,SALINS-LES-BAINS,0390962J,85,85,0,0,51,34,3 ème
JURA,TAVAUX,0390823H,73,73,0,0,30,43,3 ème
TERRITOIRE DE BELFORT,BELFORT,0900236T,24,24,0,0,13,11,3 ème
TERRITOIRE DE BELFORT,BELFORT,0900351T,101,85,16,0,49,52,3 ème
TERRITOIRE DE BELFORT,ROUGEMONT-LE-CHATEAU,0900013A,76,76,0,0,35,41,3 ème
COTE D'OR,BEAUNE,0210006T,35,35,0,0,12,23,3 ème
COTE D'OR,BEAUNE,0211626D,135,135,0,0,72,63,3 ème
COTE D'OR,CHATILLON-SUR-SEINE,0210014B,100,83,13,4,50,50,3 ème
COTE D'OR,DIJON,0210024M,121,118,0,3,54,67,3 ème
COTE D'OR,DIJON,0211089V,61,61,0,0,11,50,3 ème
COTE D'OR,DIJON,0211091X,25,25,0,0,19,6,3 ème
COTE D'OR,DIJON,0211357L,120,120,0,0,57,63,3 ème
COTE D'OR,DIJON,0211389W,210,210,0,0,112,98,3 ème
COTE D'OR,DIJON,0211525U,155,155,0,0,84,71,3 ème
COTE D'OR,DIJON,0211986V,32,32,0,0,0,32,3 ème
COTE D'OR,DIJON,0212119P,175,175,0,0,80,95,3 ème
COTE D'OR,ECHENON,0211358M,84,84,0,0,49,35,3 ème
COTE D'OR,LIERNAIS,0211524T,11,11,0,0,4,7,3 ème
COTE D'OR,MIREBEAU-SUR-BEZE,0210033X,124,122,0,2,61,63,3 ème
COTE D'OR,NUITS-SAINT-GEORGES,0210038C,149,146,0,3,81,68,3 ème
COTE D'OR,QUETIGNY,0211477S,170,154,16,0,88,82,3 ème
COTE D'OR,RECEY-SUR-OURCE,0210043H,26,26,0,0,9,17,3 ème
COTE D'OR,SEURRE,0210050R,67,67,0,0,25,42,3 ème
COTE D'OR,VENAREY-LES-LAUMES,0211184Y,74,74,0,0,30,44,3 ème
NIEVRE,CERCY-LA-TOUR,0580002M,25,25,0,0,16,9,3 ème
NIEVRE,CHATEAU-CHINON (VILLE),0580005R,36,28,4,4,20,16,3 ème
NIEVRE,FOURCHAMBAULT,0580020G,40,40,0,0,4,36,3 ème
NIEVRE,FOURCHAMBAULT,0580553L,175,159,15,1,80,95,3 ème
NIEVRE,LA CHARITE-SUR-LOIRE,0580610Y,95,79,11,5,44,51,3 ème
NIEVRE,MONTSAUCHE-LES-SETTONS,0580029S,26,26,0,0,15,11,3 ème
NIEVRE,NEVERS,0580034X,81,81,0,0,34,47,3 ème
NIEVRE,NEVERS,0580542Z,106,95,0,11,58,48,3 ème
NIEVRE,NEVERS,0580682B,95,91,0,4,43,52,3 ème
NIEVRE,PREMERY,0580036Z,31,31,0,0,14,17,3 ème
NIEVRE,SAINT-BENIN-D'AZY,0580038B,43,43,0,0,21,22,3 ème
NIEVRE,SAINT-SAULGE,0580040D,25,25,0,0,16,9,3 ème
SAONE-ET-LOIRE,BOURBON-LANCY,0710005V,99,99,0,0,50,49,3 ème
SAONE-ET-LOIRE,CHALON-SUR-SAONE,0710536X,112,94,16,2,50,62,3 ème
SAONE-ET-LOIRE,CHATENOY-LE-ROYAL,0711585M,63,59,0,4,30,33,3 ème
SAONE-ET-LOIRE,CHAUFFAILLES,0710121W,22,22,0,0,14,8,3 ème
SAONE-ET-LOIRE,GENELARD,0710039G,69,69,0,0,41,28,3 ème
SAONE-ET-LOIRE,LE CREUSOT,0710026T,22,22,0,0,11,11,3 ème
SAONE-ET-LOIRE,LE CREUSOT,0711324D,79,77,0,2,41,38,3 ème
SAONE-ET-LOIRE,MACON,0710048S,22,22,0,0,3,19,3 ème
SAONE-ET-LOIRE,MACON,0711249X,20,20,0,0,10,10,3 ème
SAONE-ET-LOIRE,MONTCHANIN,0710060E,99,97,0,2,48,51,3 ème
SAONE-ET-LOIRE,PARAY-LE-MONIAL,0710087J,24,24,0,0,9,15,3 ème
SAONE-ET-LOIRE,PIERRE-DE-BRESSE,0710063H,46,46,0,0,25,21,3 ème
SAONE-ET-LOIRE,SAINT-REMY,0711293V,133,114,16,3,68,65,3 ème
SAONE-ET-LOIRE,SANVIGNES-LES-MINES,0710069P,61,61,0,0,35,26,3 ème
YONNE,AUXERRE,0890005X,24,24,0,0,4,20,3 ème
YONNE,AUXERRE,0891054M,181,178,0,3,83,98,3 ème
YONNE,CHABLIS,0890013F,88,88,0,0,50,38,3 ème
YONNE,MIGENNES,0890977D,111,95,16,0,56,55,3 ème
YONNE,NOYERS,0890019M,45,45,0,0,18,27,3 ème
YONNE,PARON,0891235J,152,147,0,5,76,76,3 ème
YONNE,SAINT-FLORENTIN,0890024T,117,115,0,2,62,55,3 ème
YONNE,SENS,0890790A,229,209,16,4,106,123,3 ème
COTES D'ARMOR,BEGARD,0221518F,110,110,0,0,63,47,3 ème
COTES D'ARMOR,BELLE-ISLE-EN-TERRE,0221539D,46,46,0,0,25,21,3 ème
COTES D'ARMOR,BOURBRIAC,0220003J,41,41,0,0,23,18,3 ème
COTES D'ARMOR,CALLAC,0221540E,32,32,0,0,18,14,3 ème
COTES D'ARMOR,DINAN,0221743A,98,96,0,2,50,48,3 ème
COTES D'ARMOR,ERQUY,0220015X,43,43,0,0,21,22,3 ème
COTES D'ARMOR,GUINGAMP,0220019B,19,19,0,0,4,15,3 ème
COTES D'ARMOR,LANNION,0220104U,247,228,16,3,117,130,3 ème
COTES D'ARMOR,LANNION,0221931E,109,104,0,5,39,70,3 ème
COTES D'ARMOR,MERDRIGNAC,0220149T,24,24,0,0,8,16,3 ème
COTES D'ARMOR,PAIMPOL,0220151V,66,65,0,1,28,38,3 ème
COTES D'ARMOR,PLENEE-JUGON,0220154Y,22,22,0,0,12,10,3 ème
COTES D'ARMOR,PLENEUF-VAL-ANDRE,0221126E,70,70,0,0,33,37,3 ème
COTES D'ARMOR,PLEUMEUR-BODOU,0221819H,67,67,0,0,38,29,3 ème
COTES D'ARMOR,PLOUASNE,0220046F,61,61,0,0,32,29,3 ème
COTES D'ARMOR,PLOUBAZLANEC,0221866J,19,19,0,0,4,15,3 ème
COTES D'ARMOR,PLOUER-SUR-RANCE,0220047G,170,170,0,0,90,80,3 ème
COTES D'ARMOR,PONTRIEUX,0220166L,11,11,0,0,5,6,3 ème
COTES D'ARMOR,QUINTIN,0221028Y,117,112,0,5,59,58,3 ème
COTES D'ARMOR,QUINTIN,0221748F,170,155,15,0,91,79,3 ème
COTES D'ARMOR,ROSTRENEN,0221038J,69,69,0,0,38,31,3 ème
COTES D'ARMOR,SAINT-BRIEUC,0220185G,137,134,0,3,74,63,3 ème
COTES D'ARMOR,SAINT-BRIEUC,0221867K,17,17,0,0,10,7,3 ème
FINISTERE,BREST,0290131K,74,71,0,3,28,46,3 ème
FINISTERE,CROZON,0290256W,52,52,0,0,23,29,3 ème
FINISTERE,FOUESNANT,0291101P,177,177,0,0,85,92,3 ème
FINISTERE,GUILVINEC,0290674A,27,27,0,0,11,16,3 ème
FINISTERE,GUIPAVAS,0291968G,111,107,0,4,48,63,3 ème
FINISTERE,LE CONQUET,0290106H,30,30,0,0,13,17,3 ème
FINISTERE,LE RELECQ-KERHUON,0290151G,102,86,16,0,50,52,3 ème
FINISTERE,PLOUDALMEZEAU,0291638Y,64,64,0,0,31,33,3 ème
FINISTERE,PLOUESCAT,0290293L,53,53,0,0,30,23,3 ème
FINISTERE,PLOUZANE,0291656T,56,56,0,0,19,37,3 ème
FINISTERE,PLOUZANE,0291929P,93,93,0,0,51,42,3 ème
FINISTERE,PONT-DE-BUIS-LES-QUIMERCH,0290093U,75,75,0,0,32,43,3 ème
FINISTERE,POULDREUZIC,0290304Y,58,58,0,0,19,39,3 ème
FINISTERE,QUIMPER,0290306A,73,73,0,0,33,40,3 ème
FINISTERE,QUIMPER,0290347V,16,0,16,0,6,10,3 ème
FINISTERE,ROSPORDEN,0290310E,62,62,0,0,25,37,3 ème
ILLE-ET-VILAINE,ARGENTRE-DU-PLESSIS,0350849H,124,124,0,0,65,59,3 ème
ILLE-ET-VILAINE,BAIN-DE-BRETAGNE,0350851K,215,213,0,2,103,112,3 ème
ILLE-ET-VILAINE,BAIN-DE-BRETAGNE,0350970P,150,113,32,5,83,67,3 ème
ILLE-ET-VILAINE,BRUZ,0350002M,167,153,14,0,80,87,3 ème
ILLE-ET-VILAINE,BRUZ,0350852L,340,340,0,0,174,166,3 ème
ILLE-ET-VILAINE,CANCALE,0350003N,103,103,0,0,63,40,3 ème
ILLE-ET-VILAINE,CESSON-SEVIGNE,0350793X,34,34,0,0,5,29,3 ème
ILLE-ET-VILAINE,CHATEAUGIRON,0350855P,138,138,0,0,72,66,3 ème
ILLE-ET-VILAINE,COMBOURG,0350857S,95,95,0,0,45,50,3 ème
ILLE-ET-VILAINE,FOUGERES,0350761M,12,12,0,0,6,6,3 ème
ILLE-ET-VILAINE,GUIPRY-MESSAC,0352957Z,53,53,0,0,22,31,3 ème
ILLE-ET-VILAINE,JANZE,0350866B,156,151,0,5,83,73,3 ème
ILLE-ET-VILAINE,LA RICHARDAIS,0353036K,115,115,0,0,55,60,3 ème
ILLE-ET-VILAINE,LIFFRE,0351790F,167,167,0,0,82,85,3 ème
ILLE-ET-VILAINE,MAEN ROCH,0350040D,66,61,0,5,31,35,3 ème
ILLE-ET-VILAINE,MONTAUBAN-DE-BRETAGNE,0352247C,140,139,0,1,68,72,3 ème
ILLE-ET-VILAINE,MORDELLES,0350874K,160,157,0,3,82,78,3 ème
ILLE-ET-VILAINE,MORDELLES,0352030S,103,101,0,2,44,59,3 ème
ILLE-ET-VILAINE,NOYAL-SUR-VILAINE,0352167R,163,163,0,0,83,80,3 ème
ILLE-ET-VILAINE,PACE,0352274G,189,188,0,1,89,100,3 ème
ILLE-ET-VILAINE,RENNES,0350030T,37,37,0,0,5,32,3 ème
ILLE-ET-VILAINE,RENNES,0350032V,24,24,0,0,13,11,3 ème
ILLE-ET-VILAINE,RENNES,0350839X,133,125,0,8,67,66,3 ème
ILLE-ET-VILAINE,RENNES,0350913C,103,88,15,0,51,52,3 ème
ILLE-ET-VILAINE,RENNES,0350965J,138,134,0,4,77,61,3 ème
ILLE-ET-VILAINE,SAINT-AUBIN-DU-CORMIER,0350882U,71,71,0,0,42,29,3 ème
ILLE-ET-VILAINE,SAINT-MALO,0350062C,34,34,0,0,10,24,3 ème
ILLE-ET-VILAINE,SAINT-MALO,0350889B,67,67,0,0,30,37,3 ème
ILLE-ET-VILAINE,SAINT-MALO,0352072M,24,24,0,0,10,14,3 ème
ILLE-ET-VILAINE,TINTENIAC,0350891D,177,159,18,0,96,81,3 ème
ILLE-ET-VILAINE,VAL D'ANAST,0350869E,42,42,0,0,26,16,3 ème
MORBIHAN,BRECH,0560023W,177,177,0,0,90,87,3 ème
MORBIHAN,CAUDAN,0560128K,52,52,0,0,21,31,3 ème
MORBIHAN,ELVEN,0561965G,155,155,0,0,89,66,3 ème
MORBIHAN,ETEL,0560008E,14,14,0,0,0,14,3 ème
MORBIHAN,GUIDEL,0560136U,172,170,0,2,74,98,3 ème
MORBIHAN,HENNEBONT,0560018R,155,155,0,0,78,77,3 ème
MORBIHAN,HENNEBONT,0561401U,158,153,0,5,85,73,3 ème
MORBIHAN,JOSSELIN,0561378U,63,63,0,0,33,30,3 ème
MORBIHAN,LANGUIDIC,0560143B,87,87,0,0,48,39,3 ème
MORBIHAN,MALANSAC,0561410D,72,69,0,3,38,34,3 ème
MORBIHAN,MALESTROIT,0560058J,78,78,0,0,37,41,3 ème
MORBIHAN,MAURON,0560152L,31,31,0,0,17,14,3 ème
MORBIHAN,MUZILLAC,0560033G,101,101,0,0,49,52,3 ème
MORBIHAN,MUZILLAC,0560153M,104,104,0,0,56,48,3 ème
MORBIHAN,PLOEMEUR,0560104J,135,135,0,0,57,78,3 ème
MORBIHAN,PLOERMEL,0560226S,118,99,13,6,61,57,3 ème
MORBIHAN,PLOUAY,0560037L,109,109,0,0,50,59,3 ème
MORBIHAN,PONTIVY,0560110R,215,195,18,2,108,107,3 ème
MORBIHAN,PONTIVY,0560182U,31,31,0,0,12,19,3 ème
MORBIHAN,PORT-LOUIS,0561379V,113,113,0,0,54,59,3 ème
MORBIHAN,PRIZIAC,0560197K,24,24,0,0,2,22,3 ème
MORBIHAN,QUIBERON,0561329R,43,43,0,0,13,30,3 ème
MORBIHAN,ROHAN,0560047X,64,64,0,0,33,31,3 ème
MORBIHAN,VANNES,0560198L,32,32,0,0,3,29,3 ème
CHER,AUBIGNY-SUR-NERE,0180002E,133,122,11,0,60,73,3 ème
CHER,AVORD,0180004G,80,80,0,0,47,33,3 ème
CHER,BOURGES,0180010N,23,23,0,0,15,8,3 ème
CHER,BOURGES,0180591V,170,164,0,6,84,86,3 ème
CHER,SAINT-AMAND-MONTROND,0180646E,85,84,0,1,46,39,3 ème
CHER,SAINT-AMAND-MONTROND,0180769N,133,117,15,1,70,63,3 ème
CHER,SANCERRE,0180031L,94,84,7,3,38,56,3 ème
CHER,VIERZON,0180644C,142,139,0,3,65,77,3 ème
EURE-ET-LOIR,ANET,0281038B,119,118,0,1,65,54,3 ème
EURE-ET-LOIR,AUNEAU-BLEURY-SAINT-SYMPHORIEN,0280001Z,145,145,0,0,78,67,3 ème
EURE-ET-LOIR,BONNEVAL,0280866P,127,125,0,2,47,80,3 ème
EURE-ET-LOIR,BREZOLLES,0280005D,95,91,0,4,50,45,3 ème
EURE-ET-LOIR,CHARTRES,0280044W,55,48,0,7,22,33,3 ème
EURE-ET-LOIR,CHARTRES,0280751P,175,141,32,2,74,101,3 ème
EURE-ET-LOIR,CHARTRES,0280883H,133,133,0,0,66,67,3 ème
EURE-ET-LOIR,CHATEAUDUN,0280656L,66,63,0,3,35,31,3 ème
EURE-ET-LOIR,CHATEAUNEUF-EN-THYMERAIS,0280016R,103,102,0,1,49,54,3 ème
EURE-ET-LOIR,DREUX,0280865N,123,108,15,0,54,69,3 ème
EURE-ET-LOIR,EPERNON,0280889P,131,131,0,0,64,67,3 ème
EURE-ET-LOIR,MAINTENON,0280033J,152,148,0,4,76,76,3 ème
EURE-ET-LOIR,NOGENT-LE-ROTROU,0280924C,102,97,0,5,45,57,3 ème
EURE-ET-LOIR,SAINT-MAURICE-SAINT-GERMAIN,0280741D,37,24,13,0,14,23,3 ème
EURE-ET-LOIR,VERNOUILLET,0280024Z,112,110,0,2,45,67,3 ème
INDRE,CHATEAUROUX,0360016X,101,99,0,2,53,48,3 ème
INDRE,CHATEAUROUX,0360567W,116,115,0,1,62,54,3 ème
INDRE,EGUZON-CHANTOME,0360023E,37,37,0,0,20,17,3 ème
INDRE,ISSOUDUN,0360568X,38,38,0,0,19,19,3 ème
INDRE,SAINT-GAULTIER,0360546Y,52,52,0,0,28,24,3 ème
INDRE-ET-LOIRE,AMBOISE,0371248F,112,107,0,5,49,63,3 ème
INDRE-ET-LOIRE,BOURGUEIL,0370733W,19,19,0,0,10,9,3 ème
INDRE-ET-LOIRE,BOURGUEIL,0370995F,100,100,0,0,52,48,3 ème
INDRE-ET-LOIRE,CHAMBRAY-LES-TOURS,0370741E,81,81,0,0,39,42,3 ème
INDRE-ET-LOIRE,CHATEAU-LA-VALLIERE,0370006F,56,46,10,0,27,29,3 ème
INDRE-ET-LOIRE,DESCARTES,0371192V,50,48,0,2,20,30,3 ème
INDRE-ET-LOIRE,LIGUEIL,0370015R,73,73,0,0,45,28,3 ème
INDRE-ET-LOIRE,L'ILE-BOUCHARD,0370013N,49,49,0,0,20,29,3 ème
INDRE-ET-LOIRE,LOCHES,0371329U,91,91,0,0,40,51,3 ème
INDRE-ET-LOIRE,NEUILLE-PONT-PIERRE,0370022Y,133,131,0,2,71,62,3 ème
INDRE-ET-LOIRE,NOUATRE,0370024A,30,30,0,0,15,15,3 ème
INDRE-ET-LOIRE,PREUILLY-SUR-CLAISE,0370026C,44,44,0,0,27,17,3 ème
INDRE-ET-LOIRE,SAINT-AVERTIN,0370887N,147,147,0,0,60,87,3 ème
INDRE-ET-LOIRE,SAINT-CYR-SUR-LOIRE,0370792K,75,74,0,1,38,37,3 ème
INDRE-ET-LOIRE,SAINT-PIERRE-DES-CORPS,0370767H,91,73,15,3,44,47,3 ème
INDRE-ET-LOIRE,TOURS,0370729S,146,145,0,1,85,61,3 ème
INDRE-ET-LOIRE,TOURS,0370745J,118,118,0,0,58,60,3 ème
INDRE-ET-LOIRE,TOURS,0370769K,113,113,0,0,42,71,3 ème
INDRE-ET-LOIRE,TOURS,0370771M,6,6,0,0,2,4,3 ème
INDRE-ET-LOIRE,TOURS,0371099U,32,32,0,0,13,19,3 ème
LOIRET,BEAUGENCY,0450005L,190,185,0,5,103,87,3 ème
LOIRET,CHALETTE-SUR-LOING,0451148D,146,141,0,5,73,73,3 ème
LOIRET,FLEURY-LES-AUBRAIS,0451067R,24,24,0,0,16,8,3 ème
LOIRET,JARGEAU,0451069T,144,137,0,7,71,73,3 ème
LOIRET,MEUNG-SUR-LOIRE,0450038X,126,110,14,2,64,62,3 ème
LOIRET,ORLEANS,0450936Y,173,159,10,4,82,91,3 ème
LOIRET,ORLEANS,0451070U,161,139,14,8,84,77,3 ème
LOIRET,ORLEANS,0451334F,223,223,0,0,119,104,3 ème
LOIRET,ORLEANS,0451421A,174,174,0,0,89,85,3 ème
LOIRET,PUISEAUX,0450063Z,102,101,0,1,44,58,3 ème
LOIRET,SAINTE-GENEVIEVE-DES-BOIS,0450016Y,109,108,0,1,50,59,3 ème
LOIRET,SAINT-JEAN-DE-BRAYE,0450064A,41,41,0,0,4,37,3 ème
LOIRET,SAINT-JEAN-DE-LA-RUELLE,0451241E,97,84,13,0,55,42,3 ème
LOIRET,SAINT-JEAN-LE-BLANC,0451074Y,112,111,0,1,54,58,3 ème
LOIRET,SARAN,0451038J,139,133,0,6,70,69,3 ème
LOIRET,SULLY-SUR-LOIRE,0450790P,104,100,0,4,45,59,3 ème
LOIR-ET-CHER,BLOIS,0410001D,24,24,0,0,4,20,3 ème
LOIR-ET-CHER,BLOIS,0410593X,173,155,16,2,87,86,3 ème
LOIR-ET-CHER,MER,0410681T,37,33,0,4,21,16,3 ème
LOIR-ET-CHER,ROMORANTIN-LANTHENAY,0410019Y,219,193,24,2,111,108,3 ème
LOIR-ET-CHER,SAINT-AIGNAN,0410718H,28,24,0,4,6,22,3 ème
LOIR-ET-CHER,VENDOME,0410688A,76,76,0,0,42,34,3 ème
CORSE-DU-SUD,AJACCIO,6200185G,70,70,0,0,45,25,3 ème
HAUTE-CORSE,BASTIA,7200624R,119,114,0,5,58,61,3 ème
HAUTE-CORSE,CORTE,7200004S,109,101,4,4,59,50,3 ème
HAUTE-CORSE,LUCCIANA,7200053V,180,173,0,7,88,92,3 ème
HAUTE-CORSE,PENTA-DI-CASINCA,7200160L,111,109,2,0,57,54,3 ème
HAUTE-CORSE,SAINT-FLORENT,7200044K,49,49,0,0,27,22,3 ème
MEURTHE-ET-MOSELLE,ART-SUR-MEURTHE,0542449U,18,18,0,0,4,14,3 ème
MEURTHE-ET-MOSELLE,BAYON,0541852V,117,117,0,0,77,40,3 ème
MEURTHE-ET-MOSELLE,FLAVIGNY-SUR-MOSELLE,0541268K,23,23,0,0,7,16,3 ème
MEURTHE-ET-MOSELLE,FROUARD,0541326Y,72,71,0,1,38,34,3 ème
MEURTHE-ET-MOSELLE,HOMECOURT,0541471F,114,114,0,0,58,56,3 ème
MEURTHE-ET-MOSELLE,JARNY,0541331D,83,83,0,0,38,45,3 ème
MEURTHE-ET-MOSELLE,LONGLAVILLE,0541605B,21,21,0,0,11,10,3 ème
MEURTHE-ET-MOSELLE,LONGWY,0540030P,24,24,0,0,9,15,3 ème
MEURTHE-ET-MOSELLE,NANCY,0540081V,28,28,0,0,6,22,3 ème
MEURTHE-ET-MOSELLE,NANCY,0540110B,106,95,11,0,49,57,3 ème
MEURTHE-ET-MOSELLE,NANCY,0541327Z,72,72,0,0,28,44,3 ème
MEURTHE-ET-MOSELLE,NANCY,0541501N,79,79,0,0,46,33,3 ème
MEURTHE-ET-MOSELLE,NANCY,0541995A,203,203,0,0,98,105,3 ème
MEURTHE-ET-MOSELLE,NANCY,0542409A,53,52,0,1,28,25,3 ème
MEURTHE-ET-MOSELLE,NOMENY,0540054R,78,78,0,0,41,37,3 ème
MEURTHE-ET-MOSELLE,PAGNY-SUR-MOSELLE,0541567K,80,80,0,0,40,40,3 ème
MEURTHE-ET-MOSELLE,PIENNES,0541332E,74,74,0,0,41,33,3 ème
MEURTHE-ET-MOSELLE,PONT-A-MOUSSON,0540112D,144,141,0,3,71,73,3 ème
MEURTHE-ET-MOSELLE,TOMBLAINE,0540061Y,24,24,0,0,14,10,3 ème
MEURTHE-ET-MOSELLE,TOUL,0540067E,25,25,0,0,7,18,3 ème
MEURTHE-ET-MOSELLE,TUCQUEGNIEUX,0541333F,80,78,0,2,40,40,3 ème
MEURTHE-ET-MOSELLE,VAL DE BRIEY,0541985P,84,84,0,0,49,35,3 ème
MEURTHE-ET-MOSELLE,VILLERUPT,0542418K,179,164,13,2,82,97,3 ème
MEUSE,BAR-LE-DUC,0550701N,81,64,14,3,44,37,3 ème
MEUSE,REVIGNY-SUR-ORNAIN,0550018W,67,63,0,4,34,33,3 ème
MEUSE,VERDUN,0550024C,103,100,0,3,45,58,3 ème
MEUSE,VERDUN,0550758A,45,31,14,0,24,21,3 ème
MOSELLE,ALBESTROFF,0572691R,67,67,0,0,39,28,3 ème
MOSELLE,BEHREN-LES-FORBACH,0573268T,68,61,7,0,26,42,3 ème
MOSELLE,CATTENOM,0571994H,83,83,0,0,38,45,3 ème
MOSELLE,DIEUZE,0570279U,25,25,0,0,14,11,3 ème
MOSELLE,DIEUZE,0572814Z,83,76,0,7,42,41,3 ème
MOSELLE,FAMECK,0573269U,200,195,0,5,99,101,3 ème
MOSELLE,FLORANGE,0570317K,122,102,18,2,55,67,3 ème
MOSELLE,FONTOY,0572009Z,110,91,17,2,59,51,3 ème
MOSELLE,HETTANGE-GRANDE,0572025S,141,140,0,1,77,64,3 ème
MOSELLE,LE BAN-SAINT-MARTIN,0570128E,174,169,0,5,96,78,3 ème
MOSELLE,LEMBERG,0572020L,73,73,0,0,43,30,3 ème
MOSELLE,MAIZIERES-LES-METZ,0572164T,190,183,5,2,92,98,3 ème
MOSELLE,METZ,0570061G,24,24,0,0,18,6,3 ème
MOSELLE,METZ,0572348T,127,113,9,5,60,67,3 ème
MOSELLE,METZ,0572350V,119,99,15,5,56,63,3 ème
MOSELLE,MORHANGE,0570073V,97,84,10,3,42,55,3 ème
MOSELLE,PETITE-ROSSELLE,0572493A,49,49,0,0,22,27,3 ème
MOSELLE,PHALSBOURG,0572815A,147,144,0,3,75,72,3 ème
MOSELLE,SAINT-AVOLD,0570143W,101,97,0,4,55,46,3 ème
MOSELLE,SARREBOURG,0570097W,115,95,16,4,66,49,3 ème
MOSELLE,SARREGUEMINES,0572930A,100,100,0,0,55,45,3 ème
MOSELLE,STIRING-WENDEL,0570104D,117,114,0,3,59,58,3 ème
MOSELLE,WOIPPY,0572579U,107,102,0,5,48,59,3 ème
VOSGES,BRUYERES,0880005C,141,129,11,1,65,76,3 ème
VOSGES,BRUYERES,0880133S,23,23,0,0,9,14,3 ème
VOSGES,EPINAL,0880021V,24,24,0,0,9,15,3 ème
VOSGES,EPINAL,0880150K,135,135,0,0,65,70,3 ème
VOSGES,EPINAL,0881496Y,160,160,0,0,88,72,3 ème
VOSGES,FRAIZE,0881410E,85,83,0,2,45,40,3 ème
VOSGES,LA BRESSE,0880105L,59,59,0,0,29,30,3 ème
VOSGES,LE THOLY,0881148V,53,53,0,0,25,28,3 ème
VOSGES,MARTIGNY-LES-BAINS,0880108P,20,20,0,0,7,13,3 ème
VOSGES,RUPT-SUR-MOSELLE,0880054F,36,36,0,0,21,15,3 ème
VOSGES,SAINT-DIE-DES-VOSGES,0880057J,24,24,0,0,20,4,3 ème
VOSGES,SAINT-DIE-DES-VOSGES,0880100F,56,55,0,1,21,35,3 ème
VOSGES,XERTIGNY,0881369K,106,95,10,1,54,52,3 ème
ARDENNES,CHARLEVILLE-MEZIERES,0080028M,21,20,0,1,10,11,3 ème
ARDENNES,CHARLEVILLE-MEZIERES,0080079T,79,63,16,0,43,36,3 ème
ARDENNES,CHARLEVILLE-MEZIERES,0080925M,72,72,0,0,39,33,3 ème
ARDENNES,DOUZY,0080016Z,70,70,0,0,32,38,3 ème
ARDENNES,GIVET,0080948M,75,75,0,0,37,38,3 ème
ARDENNES,RETHEL,0080088C,51,51,0,0,24,27,3 ème
ARDENNES,REVIN,0080949N,83,76,0,7,37,46,3 ème
ARDENNES,ROCROI,0081098A,43,43,0,0,26,17,3 ème
ARDENNES,VOUZIERS,0081097Z,94,79,13,2,44,50,3 ème
AUBE,BAR-SUR-AUBE,0100902B,99,92,6,1,46,53,3 ème
AUBE,ROMILLY-SUR-SEINE,0100054E,81,81,0,0,46,35,3 ème
AUBE,SAINTE-SAVINE,0100055F,45,45,0,0,24,21,3 ème
AUBE,TROYES,0100081J,228,213,14,1,97,131,3 ème
AUBE,TROYES,0100945Y,24,24,0,0,7,17,3 ème
AUBE,TROYES,0100961R,103,103,0,0,58,45,3 ème
HAUTE-MARNE,LANGRES,0520040L,112,93,12,7,50,62,3 ème
MARNE,CHALONS-EN-CHAMPAGNE,0510010J,173,172,0,1,97,76,3 ème
MARNE,CHALONS-EN-CHAMPAGNE,0511129A,182,171,11,0,98,84,3 ème
MARNE,EPERNAY,0511327R,138,123,12,3,63,75,3 ème
MARNE,FISMES,0511188P,118,118,0,0,57,61,3 ème
MARNE,REIMS,0511145T,25,25,0,0,14,11,3 ème
MARNE,REIMS,0511178D,138,136,0,2,70,68,3 ème
MARNE,REIMS,0511179E,109,109,0,0,53,56,3 ème
MARNE,REIMS,0511180F,107,107,0,0,64,43,3 ème
MARNE,REIMS,0511214T,112,93,16,3,52,60,3 ème
MARNE,REIMS,0511470W,179,141,32,6,85,94,3 ème
MARNE,SAINT-THIERRY,0510051D,111,107,0,4,50,61,3 ème
MARNE,SUIPPES,0510056J,78,74,0,4,41,37,3 ème
MARNE,VERZY,0510060N,104,104,0,0,57,47,3 ème
BAS-RHIN,ACHENHEIM,0671686U,135,134,0,1,79,56,3 ème
BAS-RHIN,BENFELD,0670003P,208,205,0,3,112,96,3 ème
BAS-RHIN,DAMBACH-LA-VILLE,0670011Y,101,101,0,0,54,47,3 ème
BAS-RHIN,DRUSENHEIM,0672074R,129,129,0,0,57,72,3 ème
BAS-RHIN,DUTTLENHEIM,0672896J,105,102,0,3,53,52,3 ème
BAS-RHIN,HAGUENAU,0672136H,192,191,0,1,109,83,3 ème
BAS-RHIN,HAGUENAU,0672298J,125,125,0,0,63,62,3 ème
BAS-RHIN,HERRLISHEIM,0671911N,67,67,0,0,28,39,3 ème
BAS-RHIN,ILLKIRCH-GRAFFENSTADEN,0670087F,39,39,0,0,7,32,3 ème
BAS-RHIN,MERTZWILLER,0671912P,72,70,0,2,39,33,3 ème
BAS-RHIN,MOLSHEIM,0672131C,77,75,0,2,32,45,3 ème
BAS-RHIN,MUTZIG,0671828Y,143,139,0,4,79,64,3 ème
BAS-RHIN,OBERNAI,0672132D,92,91,0,1,48,44,3 ème
BAS-RHIN,OSTWALD,0672072N,152,149,0,3,72,80,3 ème
BAS-RHIN,ROSHEIM,0671913R,151,151,0,0,75,76,3 ème
BAS-RHIN,SARRE-UNION,0670056X,140,126,12,2,69,71,3 ème
BAS-RHIN,SAVERNE,0671986V,167,143,16,8,70,97,3 ème
BAS-RHIN,SCHILTIGHEIM,0670066H,218,200,16,2,111,107,3 ème
BAS-RHIN,SCHIRMECK,0670068K,101,95,0,6,46,55,3 ème
BAS-RHIN,SCHWEIGHOUSE-SUR-MODER,0671960S,109,106,0,3,57,52,3 ème
BAS-RHIN,SELESTAT,0672134F,84,82,0,2,39,45,3 ème
BAS-RHIN,STRASBOURG,0671590P,183,171,11,1,99,84,3 ème
BAS-RHIN,STRASBOURG,0671825V,153,153,0,0,68,85,3 ème
BAS-RHIN,STRASBOURG,0671909L,151,149,0,2,81,70,3 ème
BAS-RHIN,STRASBOURG,0671915T,214,214,0,0,120,94,3 ème
BAS-RHIN,STRASBOURG,0672301M,187,187,0,0,95,92,3 ème
BAS-RHIN,STRASBOURG,0672459J,125,89,31,5,59,66,3 ème
BAS-RHIN,STRASBOURG,0673079H,80,80,0,0,42,38,3 ème
BAS-RHIN,STRASBOURG,0673178R,0,0,0,0,0,0,3 ème
BAS-RHIN,SUNDHOUSE,0670106B,108,104,0,4,49,59,3 ème
BAS-RHIN,TRUCHTERSHEIM,0670107C,140,140,0,0,69,71,3 ème
BAS-RHIN,WOERTH,0671596W,99,97,0,2,49,50,3 ème
HAUT-RHIN,ALTKIRCH,0680001G,45,45,0,0,21,24,3 ème
HAUT-RHIN,CERNAY,0680006M,183,181,0,2,85,98,3 ème
HAUT-RHIN,COLMAR,0680010S,48,48,0,0,23,25,3 ème
HAUT-RHIN,COLMAR,0680088B,116,114,0,2,64,52,3 ème
HAUT-RHIN,COLMAR,0681123B,226,191,33,2,115,111,3 ème
HAUT-RHIN,COLMAR,0681659J,140,140,0,0,70,70,3 ème
HAUT-RHIN,ENSISHEIM,0680013V,181,163,17,1,97,84,3 ème
HAUT-RHIN,HEGENHEIM,0681268J,166,166,0,0,86,80,3 ème
HAUT-RHIN,INGERSHEIM,0681817F,24,24,0,0,8,16,3 ème
HAUT-RHIN,LANDSER,0681660K,144,144,0,0,64,80,3 ème
HAUT-RHIN,MULHOUSE,0680039Y,48,48,0,0,26,22,3 ème
HAUT-RHIN,MULHOUSE,0680111B,175,140,29,6,81,94,3 ème
HAUT-RHIN,MULHOUSE,0681127F,178,148,25,5,95,83,3 ème
HAUT-RHIN,PFASTATT,0681267H,121,118,0,3,74,47,3 ème
HAUT-RHIN,RIBEAUVILLE,0680101R,174,165,0,9,80,94,3 ème
HAUT-RHIN,RIEDISHEIM,0680136D,152,152,0,0,74,78,3 ème
HAUT-RHIN,ROUFFACH,0681366R,104,100,0,4,51,53,3 ème
HAUT-RHIN,THANN,0681368T,143,109,32,2,65,78,3 ème
HAUT-RHIN,WITTELSHEIM,0681888H,18,18,0,0,10,8,3 ème
GUADELOUPE,ANSE-BERTRAND,9710025A,49,49,0,0,25,24,3 ème
GUADELOUPE,BAIE-MAHAULT,9711086D,185,185,0,0,90,95,3 ème
GUADELOUPE,BAILLIF,9710041T,64,64,0,0,31,33,3 ème
GUADELOUPE,BASSE-TERRE,9710985U,130,130,0,0,76,54,3 ème
GUADELOUPE,CAPESTERRE-DE-MARIE-GALANTE,9710032H,21,21,0,0,10,11,3 ème
GUADELOUPE,LE MOULE,9710015P,171,147,16,8,85,86,3 ème
GUADELOUPE,PETIT-CANAL,9710028D,107,103,0,4,55,52,3 ème
GUADELOUPE,POINTE-A-PITRE,9710686U,77,60,16,1,38,39,3 ème
GUADELOUPE,POINTE-A-PITRE,9710722H,18,18,0,0,13,5,3 ème
GUADELOUPE,POINTE-NOIRE,9710029E,64,64,0,0,42,22,3 ème
GUADELOUPE,SAINT-CLAUDE,9710036M,109,109,0,0,54,55,3 ème
GUADELOUPE,SAINTE-ANNE,9710687V,84,79,0,5,38,46,3 ème
GUADELOUPE,SAINT-MARTIN,9710022X,213,199,13,1,100,113,3 ème
GUADELOUPE,TERRE-DE-HAUT,9711155D,24,24,0,0,7,17,3 ème
GUYANE,CAYENNE,9730091L,214,204,0,10,120,94,3 ème
GUYANE,IRACOUBO,9730219A,40,30,9,1,22,18,3 ème
GUYANE,REMIRE-MONTJOLY,9730370P,174,166,0,8,84,90,3 ème
GUYANE,ROURA,9730289B,48,48,0,0,24,24,3 ème
GUYANE,SAINT-LAURENT-DU-MARONI,9730329V,316,281,33,2,170,146,3 ème
AISNE,BELLEU,0021659T,112,112,0,0,60,52,3 ème
AISNE,BOHAIN-EN-VERMANDOIS,0022131F,49,49,0,0,27,22,3 ème
AISNE,CHATEAU-THIERRY,0021724N,146,144,0,2,71,75,3 ème
AISNE,CHAUNY,0022008X,30,30,0,0,9,21,3 ème
AISNE,LA CAPELLE,0021595Y,76,72,0,4,30,46,3 ème
AISNE,LA FERE,0022210S,11,11,0,0,4,7,3 ème
AISNE,LE NOUVION-EN-THIERACHE,0020039G,74,72,0,2,43,31,3 ème
AISNE,LIESSE-NOTRE-DAME,0020472C,44,44,0,0,24,20,3 ème
AISNE,SAINT-GOBAIN,0020046P,72,68,0,4,40,32,3 ème
AISNE,SAINT-MICHEL,0021663X,43,43,0,0,19,24,3 ème
AISNE,SAINT-QUENTIN,0020079A,15,15,0,0,5,10,3 ème
AISNE,SISSONNE,0021686X,100,94,0,6,54,46,3 ème
AISNE,SOISSONS,0021492L,138,115,23,0,58,80,3 ème
AISNE,SOISSONS,0021691C,130,125,0,5,61,69,3 ème
AISNE,SOISSONS,0022180J,12,12,0,0,8,4,3 ème
AISNE,VILLERS-COTTERETS,0021688Z,150,135,10,5,82,68,3 ème
AISNE,WASSIGNY,0020072T,48,48,0,0,31,17,3 ème
OISE,AGNETZ,0601155E,214,210,0,4,93,121,3 ème
OISE,BEAUVAIS,0600007G,137,134,0,3,64,73,3 ème
OISE,BEAUVAIS,0601162M,21,21,0,0,12,9,3 ème
OISE,BORNEL,0602077G,128,127,0,1,66,62,3 ème
OISE,BREUIL-LE-VERT,0601787S,17,17,0,0,7,10,3 ème
OISE,CAUFFRY,0601607W,166,146,14,6,82,84,3 ème
OISE,COMPIEGNE,0601524F,112,94,15,3,53,59,3 ème
OISE,COULOISY,0600028E,148,148,0,0,71,77,3 ème
OISE,CREIL,0600022Y,175,175,0,0,85,90,3 ème
OISE,CREIL,0601177D,258,239,16,3,119,139,3 ème
OISE,ESTREES-SAINT-DENIS,0601432F,234,228,0,6,118,116,3 ème
OISE,FORMERIE,0601469W,101,81,16,4,50,51,3 ème
OISE,GRANDVILLIERS,0600030G,98,92,0,6,49,49,3 ème
OISE,LA CHAPELLE-EN-SERVAL,0601766U,84,84,0,0,42,42,3 ème
OISE,LASSIGNY,0601970R,91,91,0,0,46,45,3 ème
OISE,MAIGNELAY-MONTIGNY,0601180G,68,64,0,4,34,34,3 ème
OISE,MARGNY-LES-COMPIEGNE,0601193W,182,162,16,4,91,91,3 ème
OISE,NOAILLES,0601443T,217,215,0,2,99,118,3 ème
OISE,NOYON,0600041U,15,15,0,0,7,8,3 ème
OISE,NOYON,0601158H,66,66,0,0,36,30,3 ème
OISE,NOYON,0601605U,160,154,0,6,77,83,3 ème
OISE,PONT-SAINTE-MAXENCE,0601296H,122,119,0,3,64,58,3 ème
OISE,SENLIS,0600050D,108,108,0,0,50,58,3 ème
OISE,SENLIS,0601367K,125,111,14,0,61,64,3 ème
SOMME,ABBEVILLE,0801368C,108,108,0,0,51,57,3 ème
SOMME,ABBEVILLE,0801512J,161,134,17,10,65,96,3 ème
SOMME,AILLY-LE-HAUT-CLOCHER,0801372G,94,92,0,2,41,53,3 ème
SOMME,ALBERT,0801375K,104,99,0,5,55,49,3 ème
SOMME,AMIENS,0800013E,17,17,0,0,5,12,3 ème
SOMME,AMIENS,0801263N,129,124,0,5,63,66,3 ème
SOMME,AMIENS,0801533G,145,144,0,1,75,70,3 ème
SOMME,AMIENS,0801628K,15,15,0,0,7,8,3 ème
SOMME,AMIENS,0801949J,21,21,0,0,8,13,3 ème
SOMME,HAM,0801252B,16,16,0,0,5,11,3 ème
SOMME,MONTDIDIER,0801853E,17,17,0,0,9,8,3 ème
SOMME,OISEMONT,0800045P,64,64,0,0,34,30,3 ème
SOMME,PERONNE,0801951L,16,16,0,0,6,10,3 ème
SOMME,ROSIERES-EN-SANTERRE,0800051W,84,79,0,5,42,42,3 ème
SOMME,RUE,0801489J,77,77,0,0,37,40,3 ème
NORD,ANICHE,0592610S,24,24,0,0,11,13,3 ème
NORD,ANZIN,0590006L,122,122,0,0,67,55,3 ème
NORD,ARLEUX,0594401N,187,172,13,2,88,99,3 ème
NORD,ARMENTIERES,0592946G,64,64,0,0,36,28,3 ème
NORD,AVESNES-SUR-HELPE,0595384G,68,68,0,0,36,32,3 ème
NORD,BAVAY,0593490Y,139,136,0,3,71,68,3 ème
NORD,BERGUES,0592933T,105,105,0,0,54,51,3 ème
NORD,BRUAY-SUR-L'ESCAUT,0590031N,133,116,15,2,68,65,3 ème
NORD,CAMBRAI,0593171B,245,242,0,3,114,131,3 ème
NORD,COUDEKERQUE-BRANCHE,0593120W,114,106,8,0,58,56,3 ème
NORD,CYSOING,0590057S,163,161,0,2,87,76,3 ème
NORD,CYSOING,0592960X,192,192,0,0,89,103,3 ème
NORD,DECHY,0590058T,100,100,0,0,55,45,3 ème
NORD,DOUAI,0594402P,163,149,14,0,76,87,3 ème
NORD,DOUAI,0595190W,68,57,11,0,23,45,3 ème
NORD,DUNKERQUE,0593058D,27,27,0,0,16,11,3 ème
NORD,DUNKERQUE,0593663L,117,101,16,0,52,65,3 ème
NORD,DUNKERQUE,0593664M,83,80,0,3,46,37,3 ème
NORD,DUNKERQUE,0593666P,153,135,15,3,68,85,3 ème
NORD,ESTAIRES,0593103C,41,32,9,0,20,21,3 ème
NORD,FLINES-LEZ-RACHES,0590082U,82,82,0,0,37,45,3 ème
NORD,FOURMIES,0595177G,51,51,0,0,33,18,3 ème
NORD,GRAVELINES,0593123Z,60,60,0,0,32,28,3 ème
NORD,HAZEBROUCK,0595170Z,177,177,0,0,93,84,3 ème
NORD,IWUY,0590107W,78,78,0,0,35,43,3 ème
NORD,JEUMONT,0590109Y,78,75,0,3,40,38,3 ème
NORD,LA BASSEE,0592950L,194,194,0,0,108,86,3 ème
NORD,LAMBERSART,0595163S,84,71,13,0,31,53,3 ème
NORD,LEERS,0595713P,106,106,0,0,52,54,3 ème
NORD,LILLE,0590111A,23,23,0,0,15,8,3 ème
NORD,LILLE,0593006X,20,20,0,0,12,8,3 ème
NORD,LILLE,0596957S,23,23,0,0,11,12,3 ème
NORD,LINSELLES,0596172N,88,85,0,3,34,54,3 ème
NORD,LOOS,0590133Z,24,24,0,0,2,22,3 ème
NORD,LOOS,0593233U,99,99,0,0,47,52,3 ème
NORD,LOOS,0594541R,10,10,0,0,4,6,3 ème
NORD,LOURCHES,0594533G,136,136,0,0,72,64,3 ème
NORD,LOUVROIL,0593686L,75,75,0,0,38,37,3 ème
NORD,MARCQ-EN-BAROEUL,0595398X,386,386,0,0,177,209,3 ème
NORD,MARCQ-EN-BAROEUL,0597115N,48,48,0,0,22,26,3 ème
NORD,MAUBEUGE,0590151U,67,63,0,4,35,32,3 ème
NORD,MAUBEUGE,0593254S,67,50,15,2,25,42,3 ème
NORD,MOUVAUX,0594527A,98,77,14,7,45,53,3 ème
NORD,NIEPPE,0596988A,108,107,0,1,44,64,3 ème
NORD,ONNAING,0590157A,118,118,0,0,64,54,3 ème
NORD,QUIEVRECHAIN,0594303G,100,100,0,0,43,57,3 ème
NORD,RONCHIN,0594865T,71,69,0,2,30,41,3 ème
NORD,ROUBAIX,0592886S,89,89,0,0,44,45,3 ème
NORD,ROUBAIX,0592963A,23,20,0,3,15,8,3 ème
NORD,ROUBAIX,0595167W,99,96,0,3,52,47,3 ème
NORD,ROUBAIX,0595302T,222,218,0,4,114,108,3 ème
NORD,SAINT-AMAND-LES-EAUX,0590192N,23,23,0,0,8,15,3 ème
NORD,SAINT-AMAND-LES-EAUX,0594411Z,157,148,8,1,65,92,3 ème
NORD,SECLIN,0592833J,24,24,0,0,9,15,3 ème
NORD,SECLIN,0593662K,139,124,15,0,77,62,3 ème
NORD,SOMAIN,0592976P,33,33,0,0,15,18,3 ème
NORD,TOURCOING,0590217R,23,23,0,0,14,9,3 ème
NORD,TOURCOING,0592965C,54,54,0,0,16,38,3 ème
NORD,TOURCOING,0592980U,37,37,0,0,21,16,3 ème
NORD,VALENCIENNES,0590224Y,171,171,0,0,89,82,3 ème
NORD,VIEUX-CONDE,0594412A,144,137,7,0,75,69,3 ème
NORD,VILLENEUVE-D'ASCQ,0595328W,135,122,13,0,65,70,3 ème
NORD,VILLENEUVE-D'ASCQ,0595404D,335,335,0,0,162,173,3 ème
NORD,WATTIGNIES,0595597N,132,132,0,0,76,56,3 ème
NORD,WATTRELOS,0593160P,286,286,0,0,147,139,3 ème
NORD,WATTRELOS,0594392D,84,84,0,0,41,43,3 ème
NORD,WATTRELOS,0595169Y,86,81,0,5,37,49,3 ème
NORD,WORMHOUT,0594643B,114,114,0,0,57,57,3 ème
PAS-DE-CALAIS,AIRE-SUR-LA-LYS,0622100W,229,229,0,0,119,110,3 ème
PAS-DE-CALAIS,ARRAS,0620011A,23,23,0,0,3,20,3 ème
PAS-DE-CALAIS,ARRAS,0622789V,106,89,14,3,55,51,3 ème
PAS-DE-CALAIS,ARRAS,0624343J,18,16,2,0,10,8,3 ème
PAS-DE-CALAIS,AUCHEL,0623313P,93,93,0,0,50,43,3 ème
PAS-DE-CALAIS,AUCHY-LES-HESDIN,0622097T,43,43,0,0,23,20,3 ème
PAS-DE-CALAIS,AUXI-LE-CHATEAU,0620025R,45,45,0,0,18,27,3 ème
PAS-DE-CALAIS,AVESNES-LE-COMTE,0620026S,123,108,15,0,53,70,3 ème
PAS-DE-CALAIS,AVION,0622420U,123,107,12,4,58,65,3 ème
PAS-DE-CALAIS,AVION,0622422W,128,128,0,0,65,63,3 ème
PAS-DE-CALAIS,BETHUNE,0622129C,124,124,0,0,58,66,3 ème
PAS-DE-CALAIS,BETHUNE,0622947S,165,148,17,0,85,80,3 ème
PAS-DE-CALAIS,BRUAY-LA-BUISSIERE,0623314R,112,112,0,0,57,55,3 ème
PAS-DE-CALAIS,CALAIS,0622211S,20,20,0,0,14,6,3 ème
PAS-DE-CALAIS,COULOGNE,0620073T,92,88,0,4,44,48,3 ème
PAS-DE-CALAIS,COURCELLES-LES-LENS,0622943M,123,102,15,6,73,50,3 ème
PAS-DE-CALAIS,DESVRES,0622135J,51,51,0,0,26,25,3 ème
PAS-DE-CALAIS,FRUGES,0620085F,96,96,0,0,50,46,3 ème
PAS-DE-CALAIS,HENIN-BEAUMONT,0623328F,24,24,0,0,9,15,3 ème
PAS-DE-CALAIS,HERSIN-COUPIGNY,0620097U,83,83,0,0,42,41,3 ème
PAS-DE-CALAIS,LAVENTIE,0622427B,156,156,0,0,79,77,3 ème
PAS-DE-CALAIS,LENS,0622115M,274,271,0,3,171,103,3 ème
PAS-DE-CALAIS,LE PORTEL,0622095R,138,119,19,0,63,75,3 ème
PAS-DE-CALAIS,LIEVIN,0623377J,23,23,0,0,0,23,3 ème
PAS-DE-CALAIS,MARCK,0622873L,145,145,0,0,81,64,3 ème
PAS-DE-CALAIS,MARLES-LES-MINES,0622272H,114,112,0,2,51,63,3 ème
PAS-DE-CALAIS,NORRENT-FONTES,0620195A,102,102,0,0,57,45,3 ème
PAS-DE-CALAIS,NOYELLES-SOUS-LENS,0623016S,68,63,0,5,32,36,3 ème
PAS-DE-CALAIS,OUTREAU,0620221D,23,23,0,0,2,21,3 ème
PAS-DE-CALAIS,PAS-EN-ARTOIS,0623112W,79,79,0,0,42,37,3 ème
PAS-DE-CALAIS,SAINT-OMER,0620165T,152,150,0,2,81,71,3 ème
PAS-DE-CALAIS,SAINT-OMER,0622119S,38,37,0,1,20,18,3 ème
PAS-DE-CALAIS,SAINT-POL-SUR-TERNOISE,0622790W,154,141,13,0,80,74,3 ème
PAS-DE-CALAIS,THEROUANNE,0620172A,151,148,0,3,87,64,3 ème
PAS-DE-CALAIS,VERMELLES,0623022Y,100,95,0,5,46,54,3 ème
SEINE-ET-MARNE,AVON,0771422C,125,107,16,2,59,66,3 ème
SEINE-ET-MARNE,CESSON,0771662N,131,126,0,5,52,79,3 ème
SEINE-ET-MARNE,CHAMPAGNE-SUR-SEINE,0771342R,137,116,16,5,66,71,3 ème
SEINE-ET-MARNE,CHELLES,0771766B,205,185,17,3,106,99,3 ème
SEINE-ET-MARNE,COULOMMIERS,0770924L,20,20,0,0,9,11,3 ème
SEINE-ET-MARNE,CRECY-LA-CHAPELLE,0771667U,169,165,0,4,86,83,3 ème
SEINE-ET-MARNE,CREGY-LES-MEAUX,0772248A,152,148,0,4,66,86,3 ème
SEINE-ET-MARNE,FONTAINEBLEAU,0771424E,112,112,0,0,48,64,3 ème
SEINE-ET-MARNE,JUILLY,0771917R,105,105,0,0,62,43,3 ème
SEINE-ET-MARNE,LA FERTE-GAUCHER,0771661M,168,147,16,5,88,80,3 ème
SEINE-ET-MARNE,LA FERTE-SOUS-JOUARRE,0771222K,108,108,0,0,58,50,3 ème
SEINE-ET-MARNE,LA FERTE-SOUS-JOUARRE,0771659K,128,112,16,0,64,64,3 ème
SEINE-ET-MARNE,LAGNY-SUR-MARNE,0771768D,125,111,14,0,62,63,3 ème
SEINE-ET-MARNE,LE MEE-SUR-SEINE,0772056S,144,143,0,1,76,68,3 ème
SEINE-ET-MARNE,LIEUSAINT,0772429X,89,88,0,1,47,42,3 ème
SEINE-ET-MARNE,LOGNES,0772125S,108,108,0,0,52,56,3 ème
SEINE-ET-MARNE,LORREZ-LE-BOCAGE-PREAUX,0770030P,129,127,0,2,54,75,3 ème
SEINE-ET-MARNE,MEAUX,0771029A,178,178,0,0,75,103,3 ème
SEINE-ET-MARNE,MEAUX,0771173G,160,160,0,0,85,75,3 ème
SEINE-ET-MARNE,MELUN,0770934X,23,23,0,0,10,13,3 ème
SEINE-ET-MARNE,MITRY-MORY,0771331D,152,141,11,0,68,84,3 ème
SEINE-ET-MARNE,MONTEREAU-FAULT-YONNE,0771174H,131,131,0,0,65,66,3 ème
SEINE-ET-MARNE,NOISIEL,0771940R,23,23,0,0,10,13,3 ème
SEINE-ET-MARNE,PERTHES,0772427V,150,150,0,0,63,87,3 ème
SEINE-ET-MARNE,ROISSY-EN-BRIE,0771563F,197,197,0,0,107,90,3 ème
SEINE-ET-MARNE,SAINT-GERMAIN-SUR-MORIN,0772714G,154,152,0,2,76,78,3 ème
SEINE-ET-MARNE,SAINT-THIBAULT-DES-VIGNES,0772154Y,154,149,0,5,86,68,3 ème
SEINE-ET-MARNE,TRILPORT,0772091E,142,138,0,4,75,67,3 ème
SEINE-ET-MARNE,VILLEPARISIS,0771878Y,173,151,16,6,76,97,3 ème
SEINE-SAINT-DENIS,AUBERVILLIERS,0930903B,93,93,0,0,50,43,3 ème
SEINE-SAINT-DENIS,AUBERVILLIERS,0932122B,19,19,0,0,10,9,3 ème
SEINE-SAINT-DENIS,AULNAY-SOUS-BOIS,0930846P,31,31,0,0,13,18,3 ème
SEINE-SAINT-DENIS,AULNAY-SOUS-BOIS,0931434D,164,156,0,8,80,84,3 ème
SEINE-SAINT-DENIS,AULNAY-SOUS-BOIS,0932652C,59,59,0,0,24,35,3 ème
SEINE-SAINT-DENIS,DRANCY,0930892P,151,151,0,0,77,74,3 ème
SEINE-SAINT-DENIS,DUGNY,0931376R,148,146,0,2,75,73,3 ème
SEINE-SAINT-DENIS,EPINAY-SUR-SEINE,0931145P,192,177,15,0,96,96,3 ème
SEINE-SAINT-DENIS,EPINAY-SUR-SEINE,0931207G,123,119,0,4,59,64,3 ème
SEINE-SAINT-DENIS,LA COURNEUVE,0931188L,188,186,0,2,93,95,3 ème
SEINE-SAINT-DENIS,LA COURNEUVE,0931738J,7,7,0,0,3,4,3 ème
SEINE-SAINT-DENIS,LE RAINCY,0930629D,192,192,0,0,97,95,3 ème
SEINE-SAINT-DENIS,LES PAVILLONS-SOUS-BOIS,0930089S,143,139,0,4,64,79,3 ème
SEINE-SAINT-DENIS,LES PAVILLONS-SOUS-BOIS,0930966V,66,66,0,0,35,31,3 ème
SEINE-SAINT-DENIS,MONTREUIL,0931210K,128,126,0,2,60,68,3 ème
SEINE-SAINT-DENIS,NEUILLY-PLAISANCE,0930623X,188,182,0,6,88,100,3 ème
SEINE-SAINT-DENIS,NEUILLY-SUR-MARNE,0930894S,206,184,16,6,99,107,3 ème
SEINE-SAINT-DENIS,NOISY-LE-GRAND,0931369H,19,19,0,0,6,13,3 ème
SEINE-SAINT-DENIS,NOISY-LE-SEC,0931710D,145,145,0,0,68,77,3 ème
SEINE-SAINT-DENIS,NOISY-LE-SEC,0931883S,79,74,0,5,45,34,3 ème
SEINE-SAINT-DENIS,PANTIN,0931217T,114,110,0,4,53,61,3 ème
SEINE-SAINT-DENIS,PANTIN,0931218U,115,114,0,1,57,58,3 ème
SEINE-SAINT-DENIS,PANTIN,0931764M,7,7,0,0,0,7,3 ème
SEINE-SAINT-DENIS,ROSNY-SOUS-BOIS,0930593P,205,191,14,0,104,101,3 ème
SEINE-SAINT-DENIS,ROSNY-SOUS-BOIS,0931723T,137,134,0,3,72,65,3 ème
SEINE-SAINT-DENIS,SAINT-DENIS,0930138V,30,30,0,0,16,14,3 ème
SEINE-SAINT-DENIS,SAINT-DENIS,0931232J,156,142,14,0,71,85,3 ème
SEINE-SAINT-DENIS,SAINT-DENIS,0932582B,156,155,0,1,75,81,3 ème
SEINE-SAINT-DENIS,SEVRAN,0931190N,182,167,15,0,89,93,3 ème
SEINE-SAINT-DENIS,SEVRAN,0932262D,169,169,0,0,101,68,3 ème
SEINE-SAINT-DENIS,TREMBLAY-EN-FRANCE,0931193S,23,23,0,0,13,10,3 ème
SEINE-SAINT-DENIS,VAUJOURS,0932301W,157,157,0,0,76,81,3 ème
SEINE-SAINT-DENIS,VILLEPINTE,0931192R,159,158,0,1,70,89,3 ème
VAL-DE-MARNE,BONNEUIL-SUR-MARNE,0940171A,6,0,6,0,2,4,3 ème
VAL-DE-MARNE,CHARENTON-LE-PONT,0941353K,179,179,0,0,83,96,3 ème
VAL-DE-MARNE,CHOISY-LE-ROI,0940141T,9,9,0,0,3,6,3 ème
VAL-DE-MARNE,CHOISY-LE-ROI,0941710Y,132,132,0,0,63,69,3 ème
VAL-DE-MARNE,CRETEIL,0940521F,113,113,0,0,66,47,3 ème
VAL-DE-MARNE,CRETEIL,0940884A,117,117,0,0,62,55,3 ème
VAL-DE-MARNE,CRETEIL,0942127B,138,135,0,3,72,66,3 ème
VAL-DE-MARNE,IVRY-SUR-SEINE,0941781A,194,194,0,0,92,102,3 ème
VAL-DE-MARNE,LE KREMLIN-BICETRE,0940809U,86,86,0,0,43,43,3 ème
VAL-DE-MARNE,LE KREMLIN-BICETRE,0941679P,85,85,0,0,48,37,3 ème
VAL-DE-MARNE,LIMEIL-BREVANNES,0941603G,137,117,16,4,67,70,3 ème
VAL-DE-MARNE,MAISONS-ALFORT,0941596Z,151,135,15,1,63,88,3 ème
VAL-DE-MARNE,ORMESSON-SUR-MARNE,0941017V,127,125,0,2,57,70,3 ème
VAL-DE-MARNE,SAINT-MANDE,0940024R,36,36,0,0,19,17,3 ème
VAL-DE-MARNE,SAINT-MAUR-DES-FOSSES,0940879V,113,113,0,0,60,53,3 ème
VAL-DE-MARNE,THIAIS,0940090M,172,172,0,0,92,80,3 ème
VAL-DE-MARNE,VILLEJUIF,0941039U,117,112,0,5,49,68,3 ème
VAL-DE-MARNE,VILLENEUVE-LE-ROI,0941602F,74,74,0,0,39,35,3 ème
VAL-DE-MARNE,VILLENEUVE-SAINT-GEORGES,0940791Z,130,114,16,0,67,63,3 ème
VAL-DE-MARNE,VILLENEUVE-SAINT-GEORGES,0941952L,22,22,0,0,8,14,3 ème
VAL-DE-MARNE,VILLIERS-SUR-MARNE,0941411Y,168,152,16,0,75,93,3 ème
VAL-DE-MARNE,VINCENNES,0940793B,175,175,0,0,90,85,3 ème
VAL-DE-MARNE,VITRY-SUR-SEINE,0940874P,93,93,0,0,48,45,3 ème
VAL-DE-MARNE,VITRY-SUR-SEINE,0941032L,103,103,0,0,44,59,3 ème
VAL-DE-MARNE,VITRY-SUR-SEINE,0941294W,23,23,0,0,9,14,3 ème
PARIS,PARIS,0750362L,108,104,0,4,53,55,3 ème
PARIS,PARIS,0750465Y,99,98,0,1,38,61,3 ème
PARIS,PARIS,0750558Z,6,6,0,0,1,5,3 ème
PARIS,PARIS,0752537A,111,110,0,1,66,45,3 ème
PARIS,PARIS,0752911G,119,117,0,2,60,59,3 ème
PARIS,PARIS,0752934G,258,256,0,2,126,132,3 ème
PARIS,PARIS,0753518S,138,138,0,0,66,72,3 ème
PARIS,PARIS,0753985Z,147,141,0,6,67,80,3 ème
PARIS,PARIS,0754861B,10,0,0,10,2,8,3 ème
PARIS,PARIS,0755000C,139,139,0,0,87,52,3 ème
PARIS,PARIS,0752544H,120,120,0,0,60,60,3 ème
PARIS,PARIS,0755840R,51,51,0,0,18,33,3 ème
PARIS,PARIS,0750436S,39,39,0,0,13,26,3 ème
PARIS,PARIS,0750793E,16,16,0,0,7,9,3 ème
PARIS,PARIS,0752192A,117,114,0,3,52,65,3 ème
PARIS,PARIS,0752317L,116,116,0,0,53,63,3 ème
PARIS,PARIS,0752870M,275,275,0,0,102,173,3 ème
PARIS,PARIS,0752897S,153,153,0,0,98,55,3 ème
PARIS,PARIS,0752918P,160,160,0,0,97,63,3 ème
PARIS,PARIS,0755779Z,123,110,13,0,56,67,3 ème
PARIS,PARIS,0752195D,86,86,0,0,48,38,3 ème
PARIS,PARIS,0750575T,100,98,0,2,43,57,3 ème
PARIS,PARIS,0751707Y,105,89,14,2,59,46,3 ème
PARIS,PARIS,0753938Y,110,110,0,0,48,62,3 ème
PARIS,PARIS,0754004V,109,109,0,0,53,56,3 ème
PARIS,PARIS,0750552T,116,116,0,0,54,62,3 ème
PARIS,PARIS,0752198G,125,108,15,2,51,74,3 ème
PARIS,PARIS,0753939Z,83,83,0,0,43,40,3 ème
PARIS,PARIS,0752525M,120,116,0,4,58,62,3 ème
PARIS,PARIS,0752920S,149,149,0,0,77,72,3 ème
PARIS,PARIS,0752186U,120,116,0,4,61,59,3 ème
PARIS,PARIS,0752531U,93,87,0,6,42,51,3 ème
PARIS,PARIS,0752925X,88,88,0,0,42,46,3 ème
PARIS,PARIS,0754008Z,21,19,0,2,4,17,3 ème
PARIS,PARIS,0754029X,14,14,0,0,3,11,3 ème
PARIS,PARIS,0753854G,25,25,0,0,25,0,3 ème
PARIS,PARIS,0751791P,204,204,0,0,95,109,3 ème
PARIS,PARIS,0752529S,115,115,0,0,65,50,3 ème
PARIS,PARIS,0752532V,135,135,0,0,67,68,3 ème
PARIS,PARIS,0752916M,20,9,0,11,10,10,3 ème
ESSONNE,BONDOUFLE,0911340M,147,146,0,1,72,75,3 ème
ESSONNE,BRETIGNY-SUR-ORGE,0911039K,242,239,0,3,122,120,3 ème
ESSONNE,CROSNE,0910979V,254,248,0,6,114,140,3 ème
ESSONNE,DOURDAN,0911491B,205,182,18,5,80,125,3 ème
ESSONNE,DRAVEIL,0910830H,96,96,0,0,44,52,3 ème
ESSONNE,DRAVEIL,0910973N,170,152,16,2,74,96,3 ème
ESSONNE,EPINAY-SOUS-SENART,0911397Z,165,162,0,3,88,77,3 ème
ESSONNE,ETAMPES,0910717K,144,144,0,0,70,74,3 ème
ESSONNE,ETAMPES,0911150F,166,163,0,3,85,81,3 ème
ESSONNE,ETAMPES,0911401D,45,45,0,0,22,23,3 ème
ESSONNE,GRIGNY,0911253T,175,172,0,3,86,89,3 ème
ESSONNE,IGNY,0911824N,49,49,0,0,18,31,3 ème
ESSONNE,LES ULIS,0911334F,186,163,16,7,80,106,3 ème
ESSONNE,LONGJUMEAU,0910718L,178,178,0,0,91,87,3 ème
ESSONNE,MASSY,0910624J,122,118,0,4,55,67,3 ème
ESSONNE,ORSAY,0910968H,148,146,0,2,79,69,3 ème
ESSONNE,PALAISEAU,0910045E,113,113,0,0,63,50,3 ème
ESSONNE,PALAISEAU,0912321D,20,20,0,0,4,16,3 ème
ESSONNE,PARAY-VIEILLE-POSTE,0911441X,131,131,0,0,71,60,3 ème
ESSONNE,SAINT-CHERON,0911256W,167,165,0,2,85,82,3 ème
ESSONNE,SAINT-MICHEL-SUR-ORGE,0910775Y,201,201,0,0,98,103,3 ème
ESSONNE,SAULX-LES-CHARTREUX,0911029Z,162,145,15,2,82,80,3 ème
ESSONNE,VERRIERES-LE-BUISSON,0910057T,157,157,0,0,77,80,3 ème
ESSONNE,VIGNEUX-SUR-SEINE,0910776Z,179,174,0,5,90,89,3 ème
ESSONNE,VIRY-CHATILLON,0910060W,117,117,0,0,53,64,3 ème
ESSONNE,YERRES,0910756C,24,24,0,0,7,17,3 ème
HAUTS-DE-SEINE,ANTONY,0921170X,142,141,0,1,68,74,3 ème
HAUTS-DE-SEINE,ASNIERES-SUR-SEINE,0921547G,107,105,0,2,52,55,3 ème
HAUTS-DE-SEINE,BAGNEUX,0921168V,103,95,8,0,50,53,3 ème
HAUTS-DE-SEINE,CHATENAY-MALABRY,0921179G,85,81,0,4,42,43,3 ème
HAUTS-DE-SEINE,CHATILLON,0921354X,142,142,0,0,76,66,3 ème
HAUTS-DE-SEINE,COURBEVOIE,0920999L,119,119,0,0,55,64,3 ème
HAUTS-DE-SEINE,FONTENAY-AUX-ROSES,0920963X,7,5,0,2,4,3,3 ème
HAUTS-DE-SEINE,GENNEVILLIERS,0921157H,252,250,0,2,119,133,3 ème
HAUTS-DE-SEINE,LA GARENNE-COLOMBES,0922645A,121,118,0,3,62,59,3 ème
HAUTS-DE-SEINE,LEVALLOIS-PERRET,0921393P,178,175,0,3,95,83,3 ème
HAUTS-DE-SEINE,MALAKOFF,0921165S,107,104,0,3,51,56,3 ème
HAUTS-DE-SEINE,MEUDON,0922450N,229,229,0,0,115,114,3 ème
HAUTS-DE-SEINE,MONTROUGE,0921504K,122,122,0,0,63,59,3 ème
HAUTS-DE-SEINE,NANTERRE,0921394R,115,100,11,4,63,52,3 ème
HAUTS-DE-SEINE,NANTERRE,0922579D,25,25,0,0,16,9,3 ème
HAUTS-DE-SEINE,NEUILLY-SUR-SEINE,0921780K,151,151,0,0,64,87,3 ème
HAUTS-DE-SEINE,NEUILLY-SUR-SEINE,0921913E,191,191,0,0,96,95,3 ème
HAUTS-DE-SEINE,NEUILLY-SUR-SEINE,0921914F,198,194,0,4,94,104,3 ème
HAUTS-DE-SEINE,RUEIL-MALMAISON,0921501G,148,148,0,0,70,78,3 ème
HAUTS-DE-SEINE,SAINT-CLOUD,0921591E,209,209,0,0,122,87,3 ème
HAUTS-DE-SEINE,SEVRES,0920936T,33,33,0,0,12,21,3 ème
HAUTS-DE-SEINE,SURESNES,0920885M,114,107,7,0,59,55,3 ème
HAUTS-DE-SEINE,SURESNES,0921178F,106,106,0,0,57,49,3 ème
HAUTS-DE-SEINE,VAUCRESSON,0921919L,35,35,0,0,16,19,3 ème
HAUTS-DE-SEINE,VILLENEUVE-LA-GARENNE,0921159K,183,177,0,6,92,91,3 ème
VAL-D'OISE,ARGENTEUIL,0950788R,115,110,0,5,58,57,3 ème
VAL-D'OISE,ARGENTEUIL,0950885W,121,117,0,4,57,64,3 ème
VAL-D'OISE,ARGENTEUIL,0950886X,142,126,14,2,74,68,3 ème
VAL-D'OISE,BESSANCOURT,0951400F,120,119,0,1,60,60,3 ème
VAL-D'OISE,CERGY,0951964U,161,160,0,1,78,83,3 ème
VAL-D'OISE,CORMEILLES-EN-PARISIS,0952236P,89,85,0,4,38,51,3 ème
VAL-D'OISE,EAUBONNE,0950892D,130,130,0,0,47,83,3 ème
VAL-D'OISE,ERAGNY,0951194G,137,131,0,6,62,75,3 ème
VAL-D'OISE,GONESSE,0950025L,180,178,0,2,93,87,3 ème
VAL-D'OISE,GONESSE,0951142A,176,158,14,4,87,89,3 ème
VAL-D'OISE,GOUSSAINVILLE,0951921X,158,158,0,0,84,74,3 ème
VAL-D'OISE,JOUY-LE-MOUTIER,0951801S,103,99,0,4,45,58,3 ème
VAL-D'OISE,LOUVRES,0952145R,116,116,0,0,53,63,3 ème
VAL-D'OISE,MAGNY-EN-VEXIN,0951102G,128,124,0,4,64,64,3 ème
VAL-D'OISE,MARLY-LA-VILLE,0951919V,120,120,0,0,53,67,3 ème
VAL-D'OISE,MONTMAGNY,0951141Z,161,159,0,2,73,88,3 ème
VAL-D'OISE,MONTMAGNY,0952010U,8,8,0,0,0,8,3 ème
VAL-D'OISE,MONTMORENCY,0950891C,140,129,11,0,79,61,3 ème
VAL-D'OISE,OSNY,0951403J,136,134,0,2,61,75,3 ème
VAL-D'OISE,PONTOISE,0950896H,145,126,14,5,71,74,3 ème
VAL-D'OISE,SAINT-BRICE-SOUS-FORET,0950931W,132,132,0,0,54,78,3 ème
VAL-D'OISE,SAINT-LEU-LA-FORET,0950748X,156,156,0,0,67,89,3 ème
VAL-D'OISE,SAINT-LEU-LA-FORET,0950763N,175,175,0,0,96,79,3 ème
VAL-D'OISE,TAVERNY,0950945L,151,136,15,0,77,74,3 ème
VAL-D'OISE,VIARMES,0951052C,154,154,0,0,77,77,3 ème
VAL-D'OISE,VILLIERS-LE-BEL,0950939E,154,136,17,1,83,71,3 ème
YVELINES,ACHERES,0783248G,144,128,14,2,72,72,3 ème
YVELINES,BOIS-D'ARCY,0780261K,194,192,0,2,89,105,3 ème
YVELINES,BONNIERES-SUR-SEINE,0783300N,61,61,0,0,26,35,3 ème
YVELINES,CARRIERES-SUR-SEINE,0780033M,182,182,0,0,86,96,3 ème
YVELINES,CONFLANS-SAINTE-HONORINE,0781985J,122,122,0,0,61,61,3 ème
YVELINES,JOUARS-PONTCHARTRAIN,0781632A,127,126,0,1,59,68,3 ème
YVELINES,LA CELLE-SAINT-CLOUD,0780504Z,113,113,0,0,53,60,3 ème
YVELINES,LE MESNIL-SAINT-DENIS,0783342J,102,102,0,0,50,52,3 ème
YVELINES,LE PECQ,0780263M,149,137,12,0,74,75,3 ème
YVELINES,LE PECQ,0783215W,101,97,0,4,43,58,3 ème
YVELINES,LES CLAYES-SOUS-BOIS,0780760C,132,130,0,2,73,59,3 ème
YVELINES,LE VESINET,0781594J,171,170,0,1,85,86,3 ème
YVELINES,MAISONS-LAFFITTE,0783156G,153,151,0,2,74,79,3 ème
YVELINES,MAULE,0780709X,193,193,0,0,107,86,3 ème
YVELINES,MONTESSON,0780578E,161,157,0,4,81,80,3 ème
YVELINES,POISSY,0781591F,143,143,0,0,72,71,3 ème
YVELINES,SAINT-ARNOULT-EN-YVELINES,0780712A,161,161,0,0,92,69,3 ème
YVELINES,SAINT-CYR-L'ECOLE,0782593V,22,22,0,0,9,13,3 ème
YVELINES,SARTROUVILLE,0780258G,184,172,12,0,95,89,3 ème
YVELINES,TRAPPES,0780514K,172,172,0,0,83,89,3 ème
YVELINES,TRAPPES,0780584L,22,22,0,0,11,11,3 ème
YVELINES,VERSAILLES,0780580G,135,135,0,0,56,79,3 ème
YVELINES,VERSAILLES,0780718G,110,106,0,4,61,49,3 ème
YVELINES,VERSAILLES,0781597M,391,388,0,3,165,226,3 ème
YVELINES,VERSAILLES,0783295H,243,242,0,1,117,126,3 ème
YVELINES,VOISINS-LE-BRETONNEUX,0781570H,116,116,0,0,48,68,3 ème
LA REUNION,LA POSSESSION,9741236A,191,189,0,2,93,98,3 ème
LA REUNION,LE PORT,9741313J,161,125,30,6,65,96,3 ème
LA REUNION,LE TAMPON,9740620F,212,205,0,7,98,114,3 ème
LA REUNION,LE TAMPON,9740652R,248,206,32,10,111,137,3 ème
LA REUNION,LE TAMPON,9741088P,79,78,0,1,45,34,3 ème
LA REUNION,LE TAMPON,9741262D,185,182,0,3,107,78,3 ème
LA REUNION,L'ETANG-SALE,9740813R,164,161,0,3,82,82,3 ème
LA REUNION,SAINT-ANDRE,9741261C,196,189,0,7,101,95,3 ème
LA REUNION,SAINT-BENOIT,9741366S,185,181,0,4,86,99,3 ème
LA REUNION,SAINT-BENOIT,9741546M,167,151,16,0,74,93,3 ème
LA REUNION,SAINT-DENIS,9740042C,188,177,6,5,96,92,3 ème
LA REUNION,SAINT-DENIS,9741208V,118,114,0,4,53,65,3 ème
LA REUNION,SAINTE-MARIE,9740022F,143,138,0,5,56,87,3 ème
LA REUNION,SAINTE-SUZANNE,9741237B,201,199,0,2,101,100,3 ème
LA REUNION,SAINT-JOSEPH,9740578K,259,255,0,4,130,129,3 ème
LA REUNION,SAINT-LOUIS,9740012V,170,166,0,4,82,88,3 ème
LA REUNION,SAINT-LOUIS,9740091F,187,180,0,7,94,93,3 ème
LA REUNION,SAINT-PIERRE,9741630D,64,64,0,0,37,27,3 ème
MARTINIQUE,GROS-MORNE,9720012F,78,72,6,0,34,44,3 ème
MARTINIQUE,LA TRINITE,9720025V,79,73,0,6,38,41,3 ème
MARTINIQUE,LA TRINITE,9720351Z,77,61,16,0,35,42,3 ème
MARTINIQUE,LE LORRAIN,9720726G,7,7,0,0,1,6,3 ème
MARTINIQUE,LE MARIN,9720468B,12,12,0,0,4,8,3 ème
MARTINIQUE,LE ROBERT,9720861D,101,79,17,5,46,55,3 ème
MARTINIQUE,LES ANSES-D'ARLET,9720565G,43,35,8,0,12,31,3 ème
MARTINIQUE,RIVIERE-SALEE,9720725F,13,13,0,0,5,8,3 ème
MARTINIQUE,SAINTE-LUCE,9720449F,77,73,0,4,36,41,3 ème
MARTINIQUE,SAINTE-LUCE,9720776L,103,103,0,0,55,48,3 ème
MARTINIQUE,SAINT-ESPRIT,9720020P,93,91,0,2,42,51,3 ème
MAYOTTE,MAMOUDZOU,9760009F,403,400,0,3,209,194,3 ème
MAYOTTE,MAMOUDZOU,9760368W,408,365,31,12,204,204,3 ème
MAYOTTE,OUANGANI,9760371Z,331,298,30,3,167,164,3 ème
MAYOTTE,PAMANDZI,9760183V,324,321,0,3,161,163,3 ème
MAYOTTE,SADA,9760180S,269,265,0,4,122,147,3 ème
CALVADOS,BLAINVILLE-SUR-ORNE,0141940H,66,62,0,4,28,38,3 ème
CALVADOS,CAEN,0140019V,24,24,0,0,12,12,3 ème
CALVADOS,CAEN,0141160K,202,202,0,0,108,94,3 ème
CALVADOS,CAEN,0141212S,102,100,0,2,50,52,3 ème
CALVADOS,CAEN,0141313B,84,79,0,5,40,44,3 ème
CALVADOS,DEAUVILLE,0141192V,22,22,0,0,9,13,3 ème
CALVADOS,DIVES-SUR-MER,0141270E,82,70,12,0,48,34,3 ème
CALVADOS,DOUVRES-LA-DELIVRANDE,0140049C,126,126,0,0,73,53,3 ème
CALVADOS,DOZULE,0140050D,68,63,0,5,40,28,3 ème
CALVADOS,FLEURY-SUR-ORNE,0141553M,115,112,0,3,58,57,3 ème
CALVADOS,HONFLEUR,0141168U,17,17,0,0,6,11,3 ème
CALVADOS,HONFLEUR,0141765T,123,123,0,0,57,66,3 ème
CALVADOS,LISIEUX,0141135H,114,102,12,0,63,51,3 ème
CALVADOS,LISIEUX,0141315D,55,54,0,1,21,34,3 ème
CALVADOS,LISIEUX,0141862Y,121,121,0,0,65,56,3 ème
CALVADOS,SAINT-PIERRE-EN-AUGE,0141226G,78,78,0,0,44,34,3 ème
CALVADOS,SAINT-PIERRE-EN-AUGE,0141272G,98,93,0,5,51,47,3 ème
CALVADOS,TILLY-SUR-SEULLES,0140081M,96,96,0,0,42,54,3 ème
CALVADOS,VIRE NORMANDIE,0141864A,48,48,0,0,26,22,3 ème
CALVADOS,VIRE NORMANDIE,0142145F,67,62,0,5,33,34,3 ème
CALVADOS,VIRE NORMANDIE,0142178S,24,24,0,0,13,11,3 ème
EURE,BEAUMONT-LE-ROGER,0271267F,117,113,0,4,66,51,3 ème
EURE,BERNAY,0271448C,71,71,0,0,34,37,3 ème
EURE,BERNAY,0271581X,24,24,0,0,9,15,3 ème
EURE,BRETEUIL,0270008M,77,77,0,0,30,47,3 ème
EURE,BRIONNE,0270010P,136,120,15,1,65,71,3 ème
EURE,CONCHES-EN-OUCHE,0271094T,157,154,0,3,74,83,3 ème
EURE,ETREPAGNY,0271106F,117,114,0,3,56,61,3 ème
EURE,EVREUX,0270020A,111,111,0,0,66,45,3 ème
EURE,EVREUX,0271070S,23,23,0,0,7,16,3 ème
EURE,GAILLON,0270025F,125,120,0,5,63,62,3 ème
EURE,GISORS,0271047S,83,83,0,0,41,42,3 ème
EURE,LOUVIERS,0271398Y,121,121,0,0,57,64,3 ème
EURE,MESNILS-SUR-ITON,0271060F,136,136,0,0,74,62,3 ème
EURE,NONANCOURT,0270033P,184,184,0,0,106,78,3 ème
EURE,THIBERVILLE,0271099Y,55,55,0,0,28,27,3 ème
EURE,VERNEUIL D'AVRE ET D'ITON,0270043A,156,139,16,1,74,82,3 ème
EURE,VERNON,0271289E,131,116,15,0,72,59,3 ème
EURE,VERNON,0271399Z,84,81,0,3,41,43,3 ème
MANCHE,AGNEAUX,0501701C,135,135,0,0,67,68,3 ème
MANCHE,CARENTAN-LES-MARAIS,0500012S,86,83,0,3,51,35,3 ème
MANCHE,CHERBOURG-EN-COTENTIN,0500034R,91,91,0,0,40,51,3 ème
MANCHE,CHERBOURG-EN-COTENTIN,0500062W,96,95,0,1,36,60,3 ème
MANCHE,CHERBOURG-EN-COTENTIN,0501788X,14,14,0,0,10,4,3 ème
MANCHE,MONTEBOURG,0501201J,27,27,0,0,14,13,3 ème
MANCHE,PORT-BAIL-SUR-MER,0501217B,38,38,0,0,18,20,3 ème
MANCHE,SAINT-CLAIR-SUR-L'ELLE,0500059T,71,70,0,1,30,41,3 ème
MANCHE,SAINT-LO,0500094F,98,95,0,3,47,51,3 ème
MANCHE,SAINT-LO,0500150S,93,88,0,5,49,44,3 ème
MANCHE,SAINT-LO,0501789Y,17,17,0,0,11,6,3 ème
MANCHE,SAINT-PIERRE-EGLISE,0500069D,64,64,0,0,31,33,3 ème
MANCHE,SAINT-SAUVEUR-LE-VICOMTE,0500072G,43,41,0,2,22,21,3 ème
MANCHE,SAINT-SAUVEUR-VILLAGES,0500071F,69,69,0,0,38,31,3 ème
MANCHE,VALOGNES,0500096H,120,118,0,2,68,52,3 ème
ORNE,ALENCON,0610002W,15,15,0,0,7,8,3 ème
ORNE,ATHIS-VAL DE ROUVRE,0610051Z,66,66,0,0,40,26,3 ème
ORNE,GACE,0610958K,68,68,0,0,28,40,3 ème
ORNE,GIEL-COURTEILLES,0610699D,8,8,0,0,3,5,3 ème
ORNE,LA FERRIERE-AUX-ETANGS,0610017M,60,60,0,0,41,19,3 ème
ORNE,L'AIGLE,0610026X,20,20,0,0,4,16,3 ème
ORNE,VAL-AU-PERCHE,0610959L,69,69,0,0,42,27,3 ème
SEINE MARITIME,BOLBEC,0760013B,24,24,0,0,12,12,3 ème
SEINE MARITIME,BUCHY,0761952J,149,143,0,6,88,61,3 ème
SEINE MARITIME,DARNETAL,0760021K,128,128,0,0,66,62,3 ème
SEINE MARITIME,DIEPPE,0761703N,77,60,12,5,35,42,3 ème
SEINE MARITIME,DIEPPE,0761786D,106,105,0,1,59,47,3 ème
SEINE MARITIME,EPOUVILLE,0762598L,145,145,0,0,72,73,3 ème
SEINE MARITIME,GODERVILLE,0761741E,137,121,14,2,71,66,3 ème
SEINE MARITIME,ISNEAUVILLE,0763368Y,138,138,0,0,62,76,3 ème
SEINE MARITIME,LE HAVRE,0762127Z,69,69,0,0,30,39,3 ème
SEINE MARITIME,LE HAVRE,0762173Z,77,68,9,0,31,46,3 ème
SEINE MARITIME,LE PETIT-QUEVILLY,0760087G,22,22,0,0,5,17,3 ème
SEINE MARITIME,LE PETIT-QUEVILLY,0761949F,136,136,0,0,69,67,3 ème
SEINE MARITIME,LE TREPORT,0760114L,24,24,0,0,18,6,3 ème
SEINE MARITIME,MAROMME,0760075U,160,138,16,6,90,70,3 ème
SEINE MARITIME,MONTIVILLIERS,0762227H,151,136,15,0,70,81,3 ème
SEINE MARITIME,ROUEN,0760172Z,149,145,0,4,78,71,3 ème
SEINE MARITIME,ROUEN,0762290B,83,83,0,0,42,41,3 ème
SEINE MARITIME,SAINTE-ADRESSE,0761735Y,53,53,0,0,31,22,3 ème
SEINE MARITIME,SOTTEVILLE-LES-ROUEN,0760173A,107,101,0,6,48,59,3 ème
DORDOGNE,BERGERAC,0241136E,122,122,0,0,81,41,3 ème
DORDOGNE,LANOUAILLE,0240015L,35,35,0,0,15,20,3 ème
DORDOGNE,LE BUGUE,0240011G,63,60,0,3,29,34,3 ème
DORDOGNE,PERIGUEUX,0240052B,101,101,0,0,43,58,3 ème
DORDOGNE,RIBERAC,0240050Z,20,20,0,0,8,12,3 ème
DORDOGNE,SIGOULES-ET-FLAUGEAC,0240924Z,54,47,7,0,29,25,3 ème
DORDOGNE,THIVIERS,0240040N,94,87,6,1,47,47,3 ème
DORDOGNE,TRELISSAC,0240112S,11,0,11,0,5,6,3 ème
GIRONDE,BEGLES,0331882S,14,14,0,0,6,8,3 ème
GIRONDE,BLANQUEFORT,0330018R,22,22,0,0,4,18,3 ème
GIRONDE,BLANQUEFORT,0331548D,27,27,0,0,16,11,3 ème
GIRONDE,BORDEAUX,0330066T,147,143,0,4,79,68,3 ème
GIRONDE,BORDEAUX,0330142A,12,12,0,0,5,7,3 ème
GIRONDE,BORDEAUX,0331513R,79,79,0,0,39,40,3 ème
GIRONDE,BORDEAUX,0332492E,187,187,0,0,87,100,3 ème
GIRONDE,BORDEAUX,0332497K,24,24,0,0,11,13,3 ème
GIRONDE,BRANNE,0330058J,134,130,0,4,64,70,3 ème
GIRONDE,CESTAS,0332342S,201,201,0,0,105,96,3 ème
GIRONDE,EYSINES,0331739L,11,0,11,0,4,7,3 ème
GIRONDE,FLOIRAC,0331419N,136,135,0,1,81,55,3 ème
GIRONDE,GRADIGNAN,0332190B,158,136,15,7,67,91,3 ème
GIRONDE,GUJAN-MESTRAS,0331759H,225,208,16,1,108,117,3 ème
GIRONDE,LANGON,0330084M,184,161,17,6,101,83,3 ème
GIRONDE,LANGON,0331527F,41,41,0,0,16,25,3 ème
GIRONDE,LE PIAN-SUR-GARONNE,0332934K,129,125,0,4,56,73,3 ème
GIRONDE,LESPARRE-MEDOC,0331891B,146,141,0,5,74,72,3 ème
GIRONDE,LIBOURNE,0330091V,190,170,14,6,101,89,3 ème
GIRONDE,LIBOURNE,0331507J,174,174,0,0,83,91,3 ème
GIRONDE,LUSSAC,0330093X,74,74,0,0,41,33,3 ème
GIRONDE,MARCHEPRIME,0333121N,150,150,0,0,71,79,3 ème
GIRONDE,MARSAS,0333484H,124,124,0,0,64,60,3 ème
GIRONDE,PAUILLAC,0330103H,192,174,15,3,85,107,3 ème
GIRONDE,PESSAC,0330106L,130,127,0,3,70,60,3 ème
GIRONDE,SAINTE-FOY-LA-GRANDE,0331531K,44,44,0,0,23,21,3 ème
GIRONDE,SAINT-MEDARD-DE-GUIZIERES,0331532L,70,70,0,0,45,25,3 ème
GIRONDE,SAINT-SELVE,0333528F,0,0,0,0,0,0,3 ème
GIRONDE,SOULAC-SUR-MER,0330125G,62,62,0,0,31,31,3 ème
GIRONDE,TALENCE,0332195G,212,208,0,4,74,138,3 ème
GIRONDE,VILLENAVE-D'ORNON,0330132P,172,169,0,3,81,91,3 ème
LANDES,AIRE-SUR-L'ADOUR,0400047J,20,20,0,0,12,8,3 ème
LANDES,AIRE-SUR-L'ADOUR,0400090F,95,93,0,2,43,52,3 ème
LANDES,AMOU,0400003L,77,77,0,0,32,45,3 ème
LANDES,ANGRESSE,0401091U,115,112,0,3,60,55,3 ème
LANDES,BISCARROSSE,0401048X,85,85,0,0,40,45,3 ème
LANDES,DAX,0400740M,132,123,0,9,54,78,3 ème
LANDES,HAGETMAU,0400727Y,108,95,11,2,61,47,3 ème
LANDES,LABENNE,0401014K,150,148,0,2,86,64,3 ème
LANDES,MONT-DE-MARSAN,0400019D,22,22,0,0,2,20,3 ème
LANDES,MONT-DE-MARSAN,0400774Z,96,92,0,4,52,44,3 ème
LANDES,MONT-DE-MARSAN,0400779E,135,133,0,2,66,69,3 ème
LANDES,MONT-DE-MARSAN,0400858R,102,101,0,1,50,52,3 ème
LANDES,MORCENX-LA-NOUVELLE,0400097N,20,18,0,2,3,17,3 ème
LANDES,MUGRON,0400025K,73,68,0,5,44,29,3 ème
LANDES,POUILLON,0400032T,113,112,0,1,56,57,3 ème
LOT-ET-GARONNE,AGEN,0470061L,109,107,0,2,53,56,3 ème
LOT-ET-GARONNE,FOULAYRONNES,0470782V,22,22,0,0,0,22,3 ème
LOT-ET-GARONNE,LAVARDAC,0470775M,65,51,10,4,30,35,3 ème
LOT-ET-GARONNE,MARMANDE,0470069V,83,83,0,0,34,49,3 ème
LOT-ET-GARONNE,VILLENEUVE-SUR-LOT,0470049Y,112,108,0,4,57,55,3 ème
LOT-ET-GARONNE,VILLENEUVE-SUR-LOT,0470753N,16,0,16,0,2,14,3 ème
PYRENEES-ATLANTIQUES,ANGLET,0640003F,148,146,0,2,71,77,3 ème
PYRENEES-ATLANTIQUES,ARTHEZ-DE-BEARN,0640005H,36,36,0,0,18,18,3 ème
PYRENEES-ATLANTIQUES,BAYONNE,0640013S,24,23,0,1,11,13,3 ème
PYRENEES-ATLANTIQUES,BAYONNE,0640141F,56,56,0,0,24,32,3 ème
PYRENEES-ATLANTIQUES,BEDOUS,0640016V,22,22,0,0,10,12,3 ème
PYRENEES-ATLANTIQUES,BILLERE,0640606L,154,147,0,7,67,87,3 ème
PYRENEES-ATLANTIQUES,CAMBO-LES-BAINS,0641702C,79,76,0,3,39,40,3 ème
PYRENEES-ATLANTIQUES,HASPARREN,0641393S,119,116,0,3,65,54,3 ème
PYRENEES-ATLANTIQUES,HENDAYE,0640228A,171,168,0,3,86,85,3 ème
PYRENEES-ATLANTIQUES,LARCEVEAU-ARROS-CIBITS,0642006H,52,49,0,3,30,22,3 ème
PYRENEES-ATLANTIQUES,MONEIN,0640041X,95,95,0,0,47,48,3 ème
PYRENEES-ATLANTIQUES,OLORON-SAINTE-MARIE,0640211G,127,110,13,4,75,52,3 ème
PYRENEES-ATLANTIQUES,ORTHEZ,0640053K,23,23,0,0,10,13,3 ème
PYRENEES-ATLANTIQUES,ORTHEZ,0640214K,87,69,15,3,28,59,3 ème
PYRENEES-ATLANTIQUES,ORTHEZ,0641560Y,109,109,0,0,54,55,3 ème
PYRENEES-ATLANTIQUES,PAU,0641660G,122,122,0,0,68,54,3 ème
PYRENEES-ATLANTIQUES,PAU,0642010M,24,24,0,0,13,11,3 ème
PYRENEES-ATLANTIQUES,PAU,0642011N,10,10,0,0,0,10,3 ème
PYRENEES-ATLANTIQUES,PONTACQ,0640062V,82,80,0,2,42,40,3 ème
PYRENEES-ATLANTIQUES,SAINT-JEAN-DE-LUZ,0640163E,105,102,0,3,58,47,3 ème
PYRENEES-ATLANTIQUES,SAINT-JEAN-DE-LUZ,0641661H,150,150,0,0,62,88,3 ème
PYRENEES-ATLANTIQUES,SAINT-PALAIS,0640168K,31,31,0,0,12,19,3 ème
PYRENEES-ATLANTIQUES,SAINT-PALAIS,0641232S,75,74,0,1,35,40,3 ème
PYRENEES-ATLANTIQUES,SALIES-DE-BEARN,0640071E,59,56,0,3,24,35,3 ème
PYRENEES-ATLANTIQUES,SAUVETERRE-DE-BEARN,0640073G,49,49,0,0,20,29,3 ème
PYRENEES-ATLANTIQUES,SERRES-CASTET,0641780M,194,186,0,8,96,98,3 ème
CORREZE,ALLASSAC,0190001Y,126,126,0,0,54,72,3 ème
CORREZE,BEAULIEU-SUR-DORDOGNE,0190004B,45,45,0,0,22,23,3 ème
CORREZE,BEYNAT,0190006D,47,43,0,4,21,26,3 ème
CORREZE,BRIVE-LA-GAILLARDE,0190065T,36,33,0,3,9,27,3 ème
CORREZE,BRIVE-LA-GAILLARDE,0190671B,110,109,0,1,59,51,3 ème
CORREZE,BRIVE-LA-GAILLARDE,0190701J,23,23,0,0,2,21,3 ème
CORREZE,BRIVE-LA-GAILLARDE,0190723H,121,121,0,0,55,66,3 ème
CORREZE,BRIVE-LA-GAILLARDE,0190780V,137,129,8,0,55,82,3 ème
CORREZE,MEYSSAC,0190026A,52,52,0,0,28,24,3 ème
CORREZE,SEILHAC,0190030E,79,79,0,0,47,32,3 ème
CREUSE,AHUN,0230001B,37,36,0,1,22,15,3 ème
CREUSE,AUZANCES,0230004E,35,35,0,0,16,19,3 ème
CREUSE,BOUSSAC,0230009K,39,39,0,0,19,20,3 ème
HAUTE-VIENNE,BELLAC,0870004G,16,16,0,0,5,11,3 ème
HAUTE-VIENNE,CHALUS,0870007K,67,67,0,0,36,31,3 ème
HAUTE-VIENNE,LIMOGES,0870117E,151,129,17,5,58,93,3 ème
HAUTE-VIENNE,LIMOGES,0870909R,108,108,0,0,55,53,3 ème
HAUTE-VIENNE,LIMOGES,0875023M,24,24,0,0,11,13,3 ème
HAUTE-VIENNE,PIERRE-BUFFIERE,0870036S,90,90,0,0,45,45,3 ème
HAUTE-VIENNE,SAINT-JUNIEN,0870734A,101,101,0,0,55,46,3 ème
CHARENTE,ANGOULEME,0160047P,21,21,0,0,1,20,3 ème
CHARENTE,ANGOULEME,0160050T,114,114,0,0,59,55,3 ème
CHARENTE,BARBEZIEUX-SAINT-HILAIRE,0161049D,44,44,0,0,25,19,3 ème
CHARENTE,CHALAIS,0160015E,52,52,0,0,27,25,3 ème
CHARENTE,CHASSENEUIL-SUR-BONNIEURE,0160048R,15,15,0,0,2,13,3 ème
CHARENTE,COGNAC,0160117R,126,106,16,4,46,80,3 ème
CHARENTE,GOND-PONTOUVRE,0160106D,101,84,16,1,61,40,3 ème
CHARENTE,JARNAC,0160027T,105,104,0,1,49,56,3 ème
CHARENTE,MONTEMBOEUF,0160031X,33,33,0,0,17,16,3 ème
CHARENTE,MONTMOREAU,0160032Y,62,61,0,1,27,35,3 ème
CHARENTE,ROUILLAC,0160034A,94,90,0,4,55,39,3 ème
CHARENTE,RUELLE-SUR-TOUVRE,0160036C,18,18,0,0,2,16,3 ème
CHARENTE,SEGONZAC,0160042J,84,84,0,0,46,38,3 ème
CHARENTE,SOYAUX,0160100X,99,71,28,0,47,52,3 ème
CHARENTE,SOYAUX,0160862A,21,21,0,0,1,20,3 ème
CHARENTE,VILLEFAGNAN,0160115N,38,38,0,0,22,16,3 ème
CHARENTE-MARITIME,AIGREFEUILLE-D'AUNIS,0170110C,34,30,0,4,17,17,3 ème
CHARENTE-MARITIME,AIGREFEUILLE-D'AUNIS,0171129K,182,178,0,4,80,102,3 ème
CHARENTE-MARITIME,DOMPIERRE-SUR-MER,0171210Y,209,209,0,0,108,101,3 ème
CHARENTE-MARITIME,GEMOZAC,0170009T,112,112,0,0,51,61,3 ème
CHARENTE-MARITIME,LA JARRIE,0170010U,167,167,0,0,73,94,3 ème
CHARENTE-MARITIME,LA ROCHELLE,0170088D,137,131,0,6,69,68,3 ème
CHARENTE-MARITIME,MARANS,0170112E,40,40,0,0,17,23,3 ème
CHARENTE-MARITIME,PONS,0170020E,24,24,0,0,4,20,3 ème
CHARENTE-MARITIME,SAINT-AIGULIN,0170048K,55,55,0,0,30,25,3 ème
CHARENTE-MARITIME,SAINT-JEAN-D'ANGELY,0170051N,22,22,0,0,13,9,3 ème
CHARENTE-MARITIME,SAINT-JEAN-D'ANGELY,0170118L,34,34,0,0,14,20,3 ème
CHARENTE-MARITIME,TONNAY-CHARENTE,0170072L,114,114,0,0,55,59,3 ème
DEUX-SEVRES,AIRVAULT,0790059K,15,15,0,0,6,9,3 ème
DEUX-SEVRES,AIRVAULT,0790704L,66,66,0,0,33,33,3 ème
DEUX-SEVRES,BRESSUIRE,0790080H,23,23,0,0,12,11,3 ème
DEUX-SEVRES,BRESSUIRE,0791014Y,113,113,0,0,48,65,3 ème
DEUX-SEVRES,CERIZAY,0790945Y,80,61,15,4,33,47,3 ème
DEUX-SEVRES,CHEF-BOUTONNE,0790014L,44,44,0,0,33,11,3 ème
DEUX-SEVRES,COULONGES-SUR-L'AUTIZE,0790016N,103,103,0,0,51,52,3 ème
DEUX-SEVRES,LORETZ-D'ARGENTON,0790004A,35,35,0,0,16,19,3 ème
DEUX-SEVRES,MAULEON,0790065S,129,129,0,0,75,54,3 ème
DEUX-SEVRES,MENIGOUTE,0790020T,39,39,0,0,16,23,3 ème
DEUX-SEVRES,NIORT,0790043T,23,23,0,0,8,15,3 ème
DEUX-SEVRES,SAINT-MAIXENT-L'ECOLE,0790978J,147,131,16,0,73,74,3 ème
DEUX-SEVRES,SECONDIGNY,0790034H,52,52,0,0,30,22,3 ème
DEUX-SEVRES,THENEZAY,0790035J,53,53,0,0,26,27,3 ème
DEUX-SEVRES,THOUARS,0790038M,24,24,0,0,6,18,3 ème
DEUX-SEVRES,THOUARS,0790708R,88,86,0,2,45,43,3 ème
VIENNE,CHATELLERAULT,0860006P,22,22,0,0,12,10,3 ème
VIENNE,CHAUVIGNY,0860792U,171,160,10,1,68,103,3 ème
VIENNE,GENCAY,0860016A,96,94,0,2,49,47,3 ème
VIENNE,LATILLE,0860019D,99,99,0,0,58,41,3 ème
VIENNE,L'ISLE-JOURDAIN,0860017B,46,46,0,0,23,23,3 ème
VIENNE,NEUVILLE-DE-POITOU,0860032T,163,158,0,5,81,82,3 ème
VIENNE,POITIERS,0860076R,186,170,16,0,92,94,3 ème
VIENNE,POITIERS,0860823C,19,19,0,0,6,13,3 ème
VIENNE,VALENCE-EN-POITOU,0860762L,33,33,0,0,21,12,3 ème
AUDE,BRAM,0110676A,160,156,0,4,79,81,3 ème
AUDE,CARCASSONNE,0110665N,197,197,0,0,103,94,3 ème
AUDE,CASTELNAUDARY,0110011C,84,84,0,0,44,40,3 ème
AUDE,COUIZA,0110015G,59,59,0,0,26,33,3 ème
AUDE,LIMOUX,0110019L,15,15,0,0,7,8,3 ème
AUDE,LIMOUX,0110052X,30,30,0,0,15,15,3 ème
AUDE,NARBONNE,0110788X,123,101,16,6,70,53,3 ème
GARD,BAGNOLS-SUR-CEZE,0300088H,123,123,0,0,58,65,3 ème
GARD,BESSEGES,0300013B,47,46,0,1,21,26,3 ème
GARD,BOUILLARGUES,0301209B,192,192,0,0,103,89,3 ème
GARD,BRIGNON,0301246S,188,188,0,0,104,84,3 ème
GARD,GALLARGUES-LE-MONTUEUX,0301816L,162,162,0,0,67,95,3 ème
GARD,GENOLHAC,0300016E,20,20,0,0,11,9,3 ème
GARD,LA GRAND-COMBE,0300091L,22,22,0,0,11,11,3 ème
GARD,LEDIGNAN,0301747L,81,81,0,0,51,30,3 ème
GARD,LE MARTINET,0300020J,31,31,0,0,17,14,3 ème
GARD,MARGUERITTES,0301245R,189,172,16,1,95,94,3 ème
GARD,NIMES,0300057Z,22,22,0,0,11,11,3 ème
GARD,NIMES,0300059B,137,133,0,4,71,66,3 ème
GARD,NIMES,0300141R,175,152,22,1,84,91,3 ème
GARD,NIMES,0300996V,19,11,0,8,9,10,3 ème
GARD,NIMES,0301270T,25,25,0,0,1,24,3 ème
GARD,ROCHEFORT-DU-GARD,0301656M,150,145,0,5,64,86,3 ème
GARD,SAINT-AMBROIX,0300099V,47,32,15,0,25,22,3 ème
GARD,VESTRIC-ET-CANDIAC,0301653J,144,144,0,0,77,67,3 ème
HERAULT,AGDE,0341893Y,136,120,16,0,62,74,3 ème
HERAULT,BAILLARGUES,0341577E,126,124,0,2,55,71,3 ème
HERAULT,BEDARIEUX,0340006X,21,21,0,0,8,13,3 ème
HERAULT,BEDARIEUX,0340888F,6,6,0,0,6,0,3 ème
HERAULT,BESSAN,0340008Z,127,123,0,4,71,56,3 ème
HERAULT,BEZIERS,0340011C,48,48,0,0,20,28,3 ème
HERAULT,BEZIERS,0340118U,150,150,0,0,78,72,3 ème
HERAULT,BEZIERS,0340836Z,164,145,16,3,90,74,3 ème
HERAULT,BEZIERS,0341066Z,217,195,16,6,105,112,3 ème
HERAULT,BEZIERS,0342132H,186,165,14,7,85,101,3 ème
HERAULT,CASTELNAU-LE-LEZ,0340086J,196,193,0,3,95,101,3 ème
HERAULT,FABREGUES,0342077Y,157,154,0,3,76,81,3 ème
HERAULT,GANGES,0341424N,144,143,0,1,73,71,3 ème
HERAULT,GIGNAC,0342436N,22,22,0,0,11,11,3 ème
HERAULT,JACOU,0342036D,210,210,0,0,104,106,3 ème
HERAULT,LE CRES,0341363X,201,178,16,7,85,116,3 ème
HERAULT,LUNEL,0340030Y,47,47,0,0,22,25,3 ème
HERAULT,LUNEL,0341825Z,205,189,16,0,88,117,3 ème
HERAULT,LUNEL,0342090M,24,24,0,0,13,11,3 ème
HERAULT,MEZE,0340973Y,141,140,0,1,78,63,3 ème
HERAULT,MONTPELLIER,0340043M,56,56,0,0,15,41,3 ème
HERAULT,MONTPELLIER,0340048T,166,166,0,0,86,80,3 ème
HERAULT,MONTPELLIER,0340051W,112,105,0,7,43,69,3 ème
HERAULT,MONTPELLIER,0340053Y,222,200,17,5,105,117,3 ème
HERAULT,MONTPELLIER,0340111L,115,115,0,0,59,56,3 ème
HERAULT,MONTPELLIER,0340899T,125,125,0,0,60,65,3 ème
HERAULT,MONTPELLIER,0341277D,179,161,16,2,82,97,3 ème
HERAULT,MONTPELLIER,0341421K,289,288,0,1,144,145,3 ème
HERAULT,MONTPELLIER,0341726S,10,0,10,0,5,5,3 ème
HERAULT,MONTPELLIER,0342488V,0,0,0,0,0,0,3 ème
HERAULT,MURVIEL-LES-BEZIERS,0340054Z,114,110,0,4,62,52,3 ème
HERAULT,QUARANTE,0340063J,73,68,0,5,36,37,3 ème
HERAULT,SAINT-ANDRE-DE-SANGONIS,0342186S,186,171,15,0,101,85,3 ème
HERAULT,SAINT-GEORGES-D'ORQUES,0340908C,95,95,0,0,51,44,3 ème
LOZERE,MARVEJOLS,0480005V,76,56,14,6,35,41,3 ème
LOZERE,MENDE,0480025S,16,16,0,0,8,8,3 ème
PYRENEES-ORIENTALES,ESPIRA-DE-L'AGLY,0660065M,94,86,8,0,37,57,3 ème
PYRENEES-ORIENTALES,FONT-ROMEU-ODEILLO-VIA,0660634F,101,101,0,0,45,56,3 ème
PYRENEES-ORIENTALES,PERPIGNAN,0660062J,123,123,0,0,66,57,3 ème
PYRENEES-ORIENTALES,PRADES,0660022R,153,132,16,5,76,77,3 ème
PYRENEES-ORIENTALES,SAINT-ANDRE,0660865G,151,151,0,0,86,65,3 ème
PYRENEES-ORIENTALES,SAINT-LAURENT-DE-LA-SALANQUE,0660028X,232,229,0,3,114,118,3 ème
PYRENEES-ORIENTALES,VILLELONGUE-DELS-MONTS,0660026V,51,51,0,0,11,40,3 ème
ARIEGE,AX-LES-THERMES,0090001C,33,33,0,0,13,20,3 ème
ARIEGE,FOIX,0090478W,216,214,0,2,116,100,3 ème
ARIEGE,LAVELANET,0090007J,61,61,0,0,29,32,3 ème
ARIEGE,MAZERES,0090012P,70,68,0,2,38,32,3 ème
ARIEGE,MIREPOIX,0090573Z,131,114,15,2,64,67,3 ème
ARIEGE,SAINT-GIRONS,0090019X,19,19,0,0,4,15,3 ème
AVEYRON,LAISSAC-SEVERAC L'EGLISE,0120078V,31,31,0,0,14,17,3 ème
AVEYRON,MILLAU,0120014A,14,14,0,0,4,10,3 ème
AVEYRON,MILLAU,0120878P,272,253,15,4,137,135,3 ème
AVEYRON,ONET-LE-CHATEAU,0121273U,115,110,0,5,52,63,3 ème
AVEYRON,PONT-DE-SALARS,0120018E,82,79,0,3,36,46,3 ème
AVEYRON,RIEUPEYROUX,0120020G,30,29,0,1,17,13,3 ème
AVEYRON,RIGNAC,0120021H,88,88,0,0,45,43,3 ème
AVEYRON,VILLEFRANCHE-DE-ROUERGUE,0121255Z,78,77,0,1,38,40,3 ème
GERS,EAUZE,0320052H,42,42,0,0,21,21,3 ème
GERS,FLEURANCE,0320012P,67,64,0,3,27,40,3 ème
GERS,LECTOURE,0320017V,112,98,11,3,57,55,3 ème
GERS,MARCIAC,0320019X,47,47,0,0,23,24,3 ème
GERS,MAUVEZIN,0320021Z,90,89,0,1,54,36,3 ème
GERS,NOGARO,0320027F,84,69,12,3,44,40,3 ème
GERS,SAMATAN,0320030J,24,24,0,0,11,13,3 ème
GERS,SAMATAN,0320031K,89,88,0,1,35,54,3 ème
HAUTE-GARONNE,AUTERIVE,0310084Y,231,214,14,3,116,115,3 ème
HAUTE-GARONNE,AYGUESVIVES,0311573S,191,188,0,3,93,98,3 ème
HAUTE-GARONNE,BOULOGNE-SUR-GESSE,0310007P,48,48,0,0,26,22,3 ème
HAUTE-GARONNE,CASTELGINEST,0311720B,163,160,0,3,87,76,3 ème
HAUTE-GARONNE,ESCALQUENS,0313010D,110,110,0,0,58,52,3 ème
HAUTE-GARONNE,FONTENILLES,0312743N,155,152,0,3,75,80,3 ème
HAUTE-GARONNE,FROUZINS,0311915N,198,197,0,1,97,101,3 ème
HAUTE-GARONNE,GOURDAN-POLIGNAN,0310017A,25,25,0,0,5,20,3 ème
HAUTE-GARONNE,LABARTHE-SUR-LEZE,0312843X,178,176,0,2,96,82,3 ème
HAUTE-GARONNE,LAUNAGUET,0312139G,117,106,0,11,52,65,3 ème
HAUTE-GARONNE,MONTREJEAU,0310023G,69,66,0,3,31,38,3 ème
HAUTE-GARONNE,MURET,0311130K,138,138,0,0,79,59,3 ème
HAUTE-GARONNE,QUINT-FONSEGRIVES,0312762J,118,118,0,0,63,55,3 ème
HAUTE-GARONNE,SAINT-GAUDENS,0311851U,113,106,0,7,57,56,3 ème
HAUTE-GARONNE,SAINT-GAUDENS,0311968W,70,70,0,0,33,37,3 ème
HAUTE-GARONNE,SAINT-LYS,0311772H,143,138,0,5,58,85,3 ème
HAUTE-GARONNE,SAINT-ORENS-DE-GAMEVILLE,0311850T,204,200,0,4,97,107,3 ème
HAUTE-GARONNE,SAINT-PIERRE-DE-LAGES,0312609T,129,123,0,6,62,67,3 ème
HAUTE-GARONNE,TOULOUSE,0310040A,22,22,0,0,13,9,3 ème
HAUTE-GARONNE,TOULOUSE,0310044E,25,25,0,0,9,16,3 ème
HAUTE-GARONNE,TOULOUSE,0310046G,22,22,0,0,14,8,3 ème
HAUTE-GARONNE,TOULOUSE,0310053P,17,17,0,0,3,14,3 ème
HAUTE-GARONNE,TOULOUSE,0310091F,24,23,0,1,5,19,3 ème
HAUTE-GARONNE,TOULOUSE,0311168B,60,60,0,0,40,20,3 ème
HAUTE-GARONNE,TOULOUSE,0311232W,75,75,0,0,38,37,3 ème
HAUTE-GARONNE,TOULOUSE,0311328A,149,143,0,6,57,92,3 ème
HAUTE-GARONNE,TOULOUSE,0311333F,161,141,13,7,81,80,3 ème
HAUTE-GARONNE,TOULOUSE,0312065B,14,14,0,0,2,12,3 ème
HAUTE-GARONNE,TOULOUSE,0313079D,0,0,0,0,0,0,3 ème
HAUTE-GARONNE,TOURNEFEUILLE,0311688S,217,213,0,4,104,113,3 ème
HAUTE-GARONNE,TOURNEFEUILLE,0312307P,200,195,0,5,94,106,3 ème
HAUTES-PYRENEES,ARREAU,0650003A,71,71,0,0,33,38,3 ème
HAUTES-PYRENEES,BAGNERES-DE-BIGORRE,0650005C,20,20,0,0,7,13,3 ème
HAUTES-PYRENEES,BAGNERES-DE-BIGORRE,0650738Z,26,26,0,0,16,10,3 ème
HAUTES-PYRENEES,LANNEMEZAN,0650084N,119,105,8,6,60,59,3 ème
HAUTES-PYRENEES,LOURDES,0650014M,20,19,0,1,9,11,3 ème
HAUTES-PYRENEES,MONLEON-MAGNOAC,0650878B,65,65,0,0,27,38,3 ème
HAUTES-PYRENEES,SAINT-LAURENT-DE-NESTE,0650022W,63,63,0,0,34,29,3 ème
HAUTES-PYRENEES,TARBES,0650033H,59,55,0,4,29,30,3 ème
HAUTES-PYRENEES,TARBES,0650050B,92,88,0,4,51,41,3 ème
HAUTES-PYRENEES,TARBES,0650067V,36,33,0,3,10,26,3 ème
HAUTES-PYRENEES,TARBES,0651004N,111,111,0,0,58,53,3 ème
HAUTES-PYRENEES,VIC-EN-BIGORRE,0650838H,154,139,13,2,74,80,3 ème
LOT,CAHORS,0460050E,11,10,0,1,5,6,3 ème
LOT,CAHORS,0460051F,15,15,0,0,8,7,3 ème
LOT,CAHORS,0460620Z,66,66,0,0,33,33,3 ème
LOT,GOURDON,0460592U,116,101,14,1,62,54,3 ème
LOT,LALBENQUE,0460734Y,38,38,0,0,19,19,3 ème
LOT,SOUILLAC,0460028F,10,10,0,0,2,8,3 ème
TARN,ALBAN,0810002M,49,49,0,0,17,32,3 ème
TARN,ALBI,0811030E,189,158,30,1,91,98,3 ème
TARN,ALBI,0811062P,102,102,0,0,47,55,3 ème
TARN,ALBI,0811197L,173,156,16,1,87,86,3 ème
TARN,BLAYE-LES-MINES,0810788S,144,126,17,1,75,69,3 ème
TARN,BRASSAC,0810008U,54,54,0,0,26,28,3 ème
TARN,CASTRES,0810061B,147,109,33,5,77,70,3 ème
TARN,CASTRES,0810105Z,22,22,0,0,6,16,3 ème
TARN,CASTRES,0810113H,22,22,0,0,13,9,3 ème
TARN,CASTRES,0810959C,22,22,0,0,8,14,3 ème
TARN,CORDES-SUR-CIEL,0810019F,66,66,0,0,36,30,3 ème
TARN,DOURGNE,0810020G,88,88,0,0,47,41,3 ème
TARN,MAZAMET,0811067V,75,75,0,0,35,40,3 ème
TARN,PUYLAURENS,0810036Z,95,95,0,0,52,43,3 ème
TARN,REALMONT,0810038B,114,110,0,4,47,67,3 ème
TARN-ET-GARONNE,CAUSSADE,0820007M,205,182,17,6,108,97,3 ème
TARN-ET-GARONNE,LABASTIDE-SAINT-PIERRE,0820823Z,140,137,0,3,70,70,3 ème
TARN-ET-GARONNE,MONTAUBAN,0820022D,264,261,0,3,125,139,3 ème
TARN-ET-GARONNE,MONTAUBAN,0820052L,107,106,0,1,61,46,3 ème
TARN-ET-GARONNE,MONTAUBAN,0820061W,22,22,0,0,7,15,3 ème
TARN-ET-GARONNE,MONTAUBAN,0820588U,330,302,17,11,154,176,3 ème
TARN-ET-GARONNE,MONTAUBAN,0820896D,136,113,17,6,65,71,3 ème
LOIRE-ATLANTIQUE,AIGREFEUILLE-SUR-MAINE,0442542Z,144,143,0,1,80,64,3 ème
LOIRE-ATLANTIQUE,BOUAYE,0440184L,100,100,0,0,52,48,3 ème
LOIRE-ATLANTIQUE,BOUGUENAIS,0441656L,24,24,0,0,8,16,3 ème
LOIRE-ATLANTIQUE,CLISSON,0440188R,127,127,0,0,67,60,3 ème
LOIRE-ATLANTIQUE,LA BAULE-ESCOUBLAC,0441822S,143,139,0,4,71,72,3 ème
LOIRE-ATLANTIQUE,LA MONTAGNE,0440198B,71,71,0,0,29,42,3 ème
LOIRE-ATLANTIQUE,LE LOROUX-BOTTEREAU,0441686U,140,134,0,6,60,80,3 ème
LOIRE-ATLANTIQUE,LE POULIGUEN,0440061C,36,36,0,0,14,22,3 ème
LOIRE-ATLANTIQUE,MISSILLAC,0441917V,82,76,0,6,42,40,3 ème
LOIRE-ATLANTIQUE,NANTES,0440028S,135,135,0,0,70,65,3 ème
LOIRE-ATLANTIQUE,NANTES,0440030U,24,24,0,0,1,23,3 ème
LOIRE-ATLANTIQUE,NANTES,0440045K,194,192,0,2,108,86,3 ème
LOIRE-ATLANTIQUE,NANTES,0440536U,112,112,0,0,59,53,3 ème
LOIRE-ATLANTIQUE,NANTES,0441934N,123,123,0,0,64,59,3 ème
LOIRE-ATLANTIQUE,NORT-SUR-ERDRE,0440221B,134,134,0,0,62,72,3 ème
LOIRE-ATLANTIQUE,NOZAY,0440292D,125,119,0,6,71,54,3 ème
LOIRE-ATLANTIQUE,REZE,0440231M,68,68,0,0,23,45,3 ème
LOIRE-ATLANTIQUE,SAINTE-LUCE-SUR-LOIRE,0441724K,132,113,15,4,68,64,3 ème
LOIRE-ATLANTIQUE,SAINT-HERBLAIN,0441940V,206,206,0,0,105,101,3 ème
LOIRE-ATLANTIQUE,SAINT-NAZAIRE,0440307V,24,24,0,0,11,13,3 ème
LOIRE-ATLANTIQUE,SAINT-NAZAIRE,0440315D,24,24,0,0,4,20,3 ème
LOIRE-ATLANTIQUE,SAINT-NAZAIRE,0440350S,126,124,0,2,60,66,3 ème
LOIRE-ATLANTIQUE,SAINT-PHILBERT-DE-GRAND-LIEU,0440239W,176,172,0,4,82,94,3 ème
LOIRE-ATLANTIQUE,SAINT-PHILBERT-DE-GRAND-LIEU,0442782K,86,84,0,2,42,44,3 ème
LOIRE-ATLANTIQUE,SAINT-SEBASTIEN-SUR-LOIRE,0440279P,20,20,0,0,8,12,3 ème
LOIRE-ATLANTIQUE,SAINT-SEBASTIEN-SUR-LOIRE,0440537V,24,24,0,0,7,17,3 ème
LOIRE-ATLANTIQUE,VERTOU,0440244B,286,286,0,0,134,152,3 ème
MAINE-ET-LOIRE,ANGERS,0490060Z,72,72,0,0,40,32,3 ème
MAINE-ET-LOIRE,ANGERS,0490845C,60,60,0,0,26,34,3 ème
MAINE-ET-LOIRE,ANGERS,0490953V,94,78,14,2,39,55,3 ème
MAINE-ET-LOIRE,ANGERS,0491764B,91,71,16,4,37,54,3 ème
MAINE-ET-LOIRE,AVRILLE,0490801E,24,24,0,0,10,14,3 ème
MAINE-ET-LOIRE,BEAUPREAU-EN-MAUGES,0490903R,40,40,0,0,2,38,3 ème
MAINE-ET-LOIRE,CHOLET,0491025Y,102,102,0,0,47,55,3 ème
MAINE-ET-LOIRE,CHOLET,0491026Z,110,107,0,3,63,47,3 ème
MAINE-ET-LOIRE,LYS-HAUT-LAYON,0491707P,70,70,0,0,50,20,3 ème
MAINE-ET-LOIRE,MAULEVRIER,0490868C,102,102,0,0,50,52,3 ème
MAINE-ET-LOIRE,MONTREUIL-JUIGNE,0490032U,165,163,0,2,83,82,3 ème
MAINE-ET-LOIRE,MONTREVAULT-SUR-EVRE,0490034W,84,81,0,3,49,35,3 ème
MAINE-ET-LOIRE,SAUMUR,0490042E,58,56,0,2,29,29,3 ème
MAINE-ET-LOIRE,SAUMUR,0490960C,90,88,0,2,45,45,3 ème
MAINE-ET-LOIRE,SAUMUR,0491930G,184,172,12,0,91,93,3 ème
MAINE-ET-LOIRE,SEGRE-EN-ANJOU BLEU,0490962E,145,125,16,4,68,77,3 ème
MAYENNE,ANDOUILLE,0530002P,74,74,0,0,34,40,3 ème
MAYENNE,CHATEAU-GONTIER-SUR-MAYENNE,0530874M,107,107,0,0,58,49,3 ème
MAYENNE,EVRON,0530059B,99,99,0,0,43,56,3 ème
MAYENNE,GORRON,0530793Z,28,28,0,0,12,16,3 ème
MAYENNE,LASSAY-LES-CHATEAUX,0530803K,41,41,0,0,22,19,3 ème
MAYENNE,LAVAL,0530061D,196,180,16,0,105,91,3 ème
MAYENNE,LAVAL,0530875N,236,233,0,3,117,119,3 ème
MAYENNE,MAYENNE,0530826K,99,98,0,1,57,42,3 ème
MAYENNE,MESLAY-DU-MAINE,0530791X,63,63,0,0,35,28,3 ème
MAYENNE,MONTSURS,0530064G,41,41,0,0,15,26,3 ème
MAYENNE,MONTSURS,0530792Y,51,51,0,0,30,21,3 ème
MAYENNE,RENAZE,0530584X,53,53,0,0,21,32,3 ème
MAYENNE,VILLAINES-LA-JUHEL,0530025P,28,26,0,2,16,12,3 ème
SARTHE,ALLONNES,0721224P,78,77,0,1,29,49,3 ème
SARTHE,CERANS-FOULLETOURTE,0721483W,96,96,0,0,53,43,3 ème
SARTHE,CHANGE,0720920J,16,0,16,0,5,11,3 ème
SARTHE,LA CHARTRE-SUR-LE-LOIR,0720011W,52,52,0,0,31,21,3 ème
SARTHE,LA FLECHE,0720021G,48,48,0,0,15,33,3 ème
SARTHE,LA FLECHE,0721405L,102,102,0,0,46,56,3 ème
SARTHE,MONTVAL-SUR-LOIR,0720804H,29,29,0,0,15,14,3 ème
SARTHE,PARIGNE-L'EVEQUE,0720847E,135,119,15,1,64,71,3 ème
SARTHE,PRUILLE-LE-CHETIF,0720811R,83,71,12,0,37,46,3 ème
SARTHE,PRUILLE-LE-CHETIF,0721478R,26,26,0,0,7,19,3 ème
SARTHE,SABLE-SUR-SARTHE,0720048L,46,46,0,0,17,29,3 ème
SARTHE,SAINTE-JAMME-SUR-SARTHE,0721042S,97,97,0,0,52,45,3 ème
SARTHE,SILLE-LE-GUILLAUME,0721365T,63,63,0,0,30,33,3 ème
VENDEE,BENET,0850092N,75,75,0,0,46,29,3 ème
VENDEE,BENET,0851145H,73,73,0,0,44,29,3 ème
VENDEE,CHANTONNAY,0850145W,116,101,15,0,50,66,3 ème
VENDEE,ESSARTS EN BOCAGE,0851647D,125,125,0,0,68,57,3 ème
VENDEE,LA ROCHE-SUR-YON,0850130E,44,44,0,0,21,23,3 ème
VENDEE,LA ROCHE-SUR-YON,0850604V,98,76,17,5,37,61,3 ème
VENDEE,LES ACHARDS,0850106D,123,123,0,0,57,66,3 ème
VENDEE,LES HERBIERS,0851193K,174,153,20,1,89,85,3 ème
VENDEE,MONTAIGU-VENDEE,0850136L,20,20,0,0,5,15,3 ème
VENDEE,MONTAIGU-VENDEE,0850639H,146,133,13,0,76,70,3 ème
VENDEE,MONTAIGU-VENDEE,0851704R,0,0,0,0,0,0,3 ème
VENDEE,NOIRMOUTIER-EN-L'ILE,0851144G,51,51,0,0,23,28,3 ème
VENDEE,SAINT-HILAIRE-DES-LOGES,0851195M,47,47,0,0,30,17,3 ème
VENDEE,SAINT-JEAN-DE-MONTS,0850039F,133,133,0,0,75,58,3 ème
VENDEE,SAINT-LAURENT-SUR-SEVRE,0851293U,171,171,0,0,88,83,3 ème
ALPES-DE-HTE-PROVENCE,MANOSQUE,0040013T,79,76,0,3,38,41,3 ème
ALPES-DE-HTE-PROVENCE,MANOSQUE,0040587S,65,65,0,0,31,34,3 ème
ALPES-DE-HTE-PROVENCE,SAINTE-TULLE,0040524Y,129,124,0,5,58,71,3 ème
ALPES-DE-HTE-PROVENCE,SEYNE,0040021B,30,29,0,1,15,15,3 ème
BOUCHES-DU-RHONE,AIX-EN-PROVENCE,0131711P,179,179,0,0,96,83,3 ème
BOUCHES-DU-RHONE,AIX-EN-PROVENCE,0132917A,255,255,0,0,137,118,3 ème
BOUCHES-DU-RHONE,AIX-EN-PROVENCE,0133397X,105,105,0,0,46,59,3 ème
BOUCHES-DU-RHONE,AIX-EN-PROVENCE,0134094E,175,175,0,0,90,85,3 ème
BOUCHES-DU-RHONE,AIX-EN-PROVENCE,0134342Z,88,88,0,0,45,43,3 ème
BOUCHES-DU-RHONE,ARLES,0131609D,162,156,0,6,83,79,3 ème
BOUCHES-DU-RHONE,ARLES,0131746C,173,149,24,0,70,103,3 ème
BOUCHES-DU-RHONE,AUBAGNE,0131364M,90,90,0,0,59,31,3 ème
BOUCHES-DU-RHONE,AUBAGNE,0132412B,183,156,26,1,91,92,3 ème
BOUCHES-DU-RHONE,CABRIES,0133115R,157,157,0,0,67,90,3 ème
BOUCHES-DU-RHONE,EYGUIERES,0133790Z,117,117,0,0,58,59,3 ème
BOUCHES-DU-RHONE,FOS-SUR-MER,0132634T,193,191,0,2,95,98,3 ème
BOUCHES-DU-RHONE,GREASQUE,0130028K,215,214,0,1,100,115,3 ème
BOUCHES-DU-RHONE,ISTRES,0131888G,128,128,0,0,69,59,3 ème
BOUCHES-DU-RHONE,ISTRES,0132276D,24,24,0,0,3,21,3 ème
BOUCHES-DU-RHONE,LA CIOTAT,0131883B,111,111,0,0,61,50,3 ème
BOUCHES-DU-RHONE,LA CIOTAT,0132786H,193,176,16,1,89,104,3 ème
BOUCHES-DU-RHONE,LAMBESC,0131259Y,104,104,0,0,56,48,3 ème
BOUCHES-DU-RHONE,LANCON-PROVENCE,0134431W,0,0,0,0,0,0,3 ème
BOUCHES-DU-RHONE,LE PUY-SAINTE-REPARADE,0133992U,144,144,0,0,78,66,3 ème
BOUCHES-DU-RHONE,MARIGNANE,0131607B,195,195,0,0,106,89,3 ème
BOUCHES-DU-RHONE,MARIGNANE,0131608C,223,190,32,1,96,127,3 ème
BOUCHES-DU-RHONE,MARSEILLE,0133544G,29,29,0,0,13,16,3 ème
BOUCHES-DU-RHONE,MARSEILLE,0130057S,35,35,0,0,3,32,3 ème
BOUCHES-DU-RHONE,MARSEILLE,0131968U,154,134,14,6,74,80,3 ème
BOUCHES-DU-RHONE,MARSEILLE,0130050J,13,13,0,0,2,11,3 ème
BOUCHES-DU-RHONE,MARSEILLE,0132790M,8,8,0,0,2,6,3 ème
BOUCHES-DU-RHONE,MARSEILLE,0131703F,149,126,23,0,74,75,3 ème
BOUCHES-DU-RHONE,MARSEILLE,0132408X,119,119,0,0,53,66,3 ème
BOUCHES-DU-RHONE,MARSEILLE,0133986M,58,58,0,0,42,16,3 ème
BOUCHES-DU-RHONE,MARSEILLE,0134101M,32,32,0,0,11,21,3 ème
BOUCHES-DU-RHONE,MARSEILLE,0131932E,227,227,0,0,121,106,3 ème
BOUCHES-DU-RHONE,MARSEILLE,0132950L,74,62,12,0,34,40,3 ème
BOUCHES-DU-RHONE,MARSEILLE,0133278T,53,53,0,0,28,25,3 ème
BOUCHES-DU-RHONE,MARSEILLE,0133788X,152,147,0,5,77,75,3 ème
BOUCHES-DU-RHONE,MARSEILLE,0131264D,144,141,0,3,65,79,3 ème
BOUCHES-DU-RHONE,MARSEILLE,0130079R,116,116,0,0,64,52,3 ème
BOUCHES-DU-RHONE,MARSEILLE,0131441W,27,27,0,0,9,18,3 ème
BOUCHES-DU-RHONE,MARSEILLE,0132911U,94,94,0,0,60,34,3 ème
BOUCHES-DU-RHONE,MARSEILLE,0130054N,11,11,0,0,0,11,3 ème
BOUCHES-DU-RHONE,MARSEILLE,0131603X,130,130,0,0,49,81,3 ème
BOUCHES-DU-RHONE,MARSEILLE,0131927Z,150,150,0,0,76,74,3 ème
BOUCHES-DU-RHONE,MARSEILLE,0130084W,116,114,0,2,51,65,3 ème
BOUCHES-DU-RHONE,MARSEILLE,0130139F,71,70,0,1,32,39,3 ème
BOUCHES-DU-RHONE,PEYROLLES-EN-PROVENCE,0131723C,143,143,0,0,72,71,3 ème
BOUCHES-DU-RHONE,ROGNES,0133287C,131,128,0,3,60,71,3 ème
BOUCHES-DU-RHONE,ROQUEVAIRE,0130156Z,180,180,0,0,94,86,3 ème
BOUCHES-DU-RHONE,ROUSSET,0133451F,142,138,0,4,56,86,3 ème
BOUCHES-DU-RHONE,SAINT-CHAMAS,0130158B,118,118,0,0,65,53,3 ème
BOUCHES-DU-RHONE,SAINT-MITRE-LES-REMPARTS,0131367R,60,60,0,0,29,31,3 ème
BOUCHES-DU-RHONE,SALON-DE-PROVENCE,0132789L,150,150,0,0,75,75,3 ème
BOUCHES-DU-RHONE,SALON-DE-PROVENCE,0133492A,174,174,0,0,90,84,3 ème
BOUCHES-DU-RHONE,TARASCON,0131611F,165,149,16,0,85,80,3 ème
BOUCHES-DU-RHONE,VITROLLES,0132214L,122,122,0,0,68,54,3 ème
BOUCHES-DU-RHONE,VITROLLES,0132411A,209,196,13,0,93,116,3 ème
BOUCHES-DU-RHONE,VITROLLES,0133352Y,106,106,0,0,54,52,3 ème
HAUTES-ALPES,LARAGNE-MONTEGLIN,0050452P,78,77,0,1,38,40,3 ème
VAUCLUSE,APT,0840001V,23,23,0,0,10,13,3 ème
VAUCLUSE,APT,0840759U,214,202,8,4,120,94,3 ème
VAUCLUSE,AVIGNON,0840007B,166,166,0,0,76,90,3 ème
VAUCLUSE,AVIGNON,0840042P,40,40,0,0,5,35,3 ème
VAUCLUSE,AVIGNON,0840940R,22,17,0,5,4,18,3 ème
VAUCLUSE,BOLLENE,0840437U,174,155,18,1,95,79,3 ème
VAUCLUSE,CARPENTRAS,0840852V,109,109,0,0,0,109,3 ème
VAUCLUSE,CAVAILLON,0840079E,146,146,0,0,70,76,3 ème
VAUCLUSE,LA TOUR-D'AIGUES,0841027K,170,165,0,5,76,94,3 ème
VAUCLUSE,L'ISLE-SUR-LA-SORGUE,0840021S,36,36,0,0,12,24,3 ème
VAUCLUSE,ORANGE,0840764Z,187,186,0,1,101,86,3 ème
VAUCLUSE,SAINTE-CECILE-LES-VIGNES,0841099N,126,122,0,4,66,60,3 ème
VAUCLUSE,SORGUES,0840033E,110,106,0,4,59,51,3 ème
VAUCLUSE,VALREAS,0840714V,61,61,0,0,34,27,3 ème
VAUCLUSE,VALREAS,0840716X,132,117,15,0,68,64,3 ème
VAUCLUSE,VEDENE,0840039L,24,24,0,0,7,17,3 ème
ALPES-MARITIMES,ANTIBES,0060083H,143,143,0,0,80,63,3 ème
ALPES-MARITIMES,ANTIBES,0061456A,86,86,0,0,41,45,3 ème
ALPES-MARITIMES,CARROS,0061130W,207,183,12,12,96,111,3 ème
ALPES-MARITIMES,GRASSE,0061244V,213,191,15,7,114,99,3 ème
ALPES-MARITIMES,GRASSE,0061668F,128,108,14,6,64,64,3 ème
ALPES-MARITIMES,LA COLLE-SUR-LOUP,0061376N,211,210,0,1,103,108,3 ème
ALPES-MARITIMES,MENTON,0061238N,176,176,0,0,80,96,3 ème
ALPES-MARITIMES,NICE,0060084J,169,162,0,7,89,80,3 ème
ALPES-MARITIMES,NICE,0060086L,178,177,0,1,85,93,3 ème
ALPES-MARITIMES,NICE,0060676C,86,85,0,1,42,44,3 ème
ALPES-MARITIMES,NICE,0061001F,180,160,17,3,101,79,3 ème
ALPES-MARITIMES,NICE,0061003H,131,124,0,7,60,71,3 ème
ALPES-MARITIMES,NICE,0061339Y,238,236,0,2,121,117,3 ème
ALPES-MARITIMES,NICE,0061460E,188,188,0,0,112,76,3 ème
ALPES-MARITIMES,SAINT-JEANNET,0061666D,199,191,8,0,112,87,3 ème
ALPES-MARITIMES,VALBONNE,0062011D,186,186,0,0,98,88,3 ème
ALPES-MARITIMES,VALLAURIS,0061211J,237,213,16,8,108,129,3 ème
VAR,BARJOLS,0830928H,159,147,10,2,81,78,3 ème
VAR,BRIGNOLES,0830833E,194,194,0,0,86,108,3 ème
VAR,FREJUS,0830823U,239,195,35,9,111,128,3 ème
VAR,FREJUS,0830960T,37,37,0,0,7,30,3 ème
VAR,HYERES,0830028E,178,178,0,0,86,92,3 ème
VAR,HYERES,0830832D,109,105,0,4,51,58,3 ème
VAR,HYERES,0831186N,186,181,0,5,92,94,3 ème
VAR,LA CRAU,0830147J,37,37,0,0,14,23,3 ème
VAR,LA GARDE,0830179U,205,205,0,0,92,113,3 ème
VAR,LA SEYNE-SUR-MER,0830830B,126,126,0,0,71,55,3 ème
VAR,LA SEYNE-SUR-MER,0830923C,23,23,0,0,7,16,3 ème
VAR,LE BEAUSSET,0831056X,146,146,0,0,70,76,3 ème
VAR,LES ARCS,0830001A,181,181,0,0,79,102,3 ème
VAR,ROQUEBRUNE-SUR-ARGENS,0831474B,181,181,0,0,96,85,3 ème
VAR,SAINT-CYR-SUR-MER,0830038R,105,105,0,0,43,62,3 ème
VAR,SAINT-MAXIMIN-LA-SAINTE-BAUME,0830959S,153,153,0,0,70,83,3 ème
VAR,SAINT-RAPHAEL,0831116M,202,202,0,0,84,118,3 ème
VAR,TOULON,0830058M,40,40,0,0,1,39,3 ème
VAR,TOULON,0830059N,25,25,0,0,14,11,3 ème
VAR,TOULON,0830110U,151,151,0,0,71,80,3 ème
VAR,TOULON,0830111V,89,87,0,2,45,44,3 ème
VAR,TOULON,0830162A,144,143,0,1,65,79,3 ème
VAR,TOULON,0830926F,199,199,0,0,101,98,3 ème
VAR,TOULON,0831115L,79,77,0,2,33,46,3 ème
VAR,VIDAUBAN,0831379Y,147,147,0,0,75,72,3 ème
ALLIER,BELLENAVES,0030001K,80,77,0,3,40,40,3 ème
ALLIER,BELLERIVE-SUR-ALLIER,0030002L,87,87,0,0,44,43,3 ème
ALLIER,COMMENTRY,0030890B,67,54,13,0,34,33,3 ème
ALLIER,COMMENTRY,0031044U,23,23,0,0,15,8,3 ème
ALLIER,CUSSET,0030979Y,102,102,0,0,53,49,3 ème
ALLIER,DOYET,0030015A,22,22,0,0,9,13,3 ème
ALLIER,MONTLUCON,0030030S,79,71,0,8,39,40,3 ème
ALLIER,MONTLUCON,0030091H,118,117,0,1,65,53,3 ème
ALLIER,MONTMARAULT,0030035X,34,33,0,1,22,12,3 ème
ALLIER,MOULINS,0030039B,135,132,0,3,60,75,3 ème
ALLIER,SAINT-GERMAIN-DES-FOSSES,0030043F,82,80,0,2,46,36,3 ème
ALLIER,SAINT-POURCAIN-SUR-SIOULE,0030104X,33,33,0,0,15,18,3 ème
ALLIER,SAINT-POURCAIN-SUR-SIOULE,0030892D,104,104,0,0,61,43,3 ème
ALLIER,VARENNES-SUR-ALLIER,0030048L,104,71,30,3,48,56,3 ème
ALLIER,VICHY,0030049M,66,59,0,7,38,28,3 ème
CANTAL,ALLANCHE,0150001V,15,15,0,0,4,11,3 ème
CANTAL,CONDAT,0150011F,21,21,0,0,14,7,3 ème
CANTAL,MONTSALVY,0150020R,33,33,0,0,16,17,3 ème
CANTAL,RIOM-ES-MONTAGNES,0150027Y,31,31,0,0,13,18,3 ème
CANTAL,SAINT-FLOUR,0150053B,43,41,0,2,24,19,3 ème
CANTAL,YDES,0150034F,46,46,0,0,24,22,3 ème
HAUTE-LOIRE,BRIOUDE,0430854V,85,80,0,5,50,35,3 ème
HAUTE-LOIRE,BRIOUDE,0430898T,107,104,0,3,51,56,3 ème
HAUTE-LOIRE,LE PUY-EN-VELAY,0430902X,99,99,0,0,56,43,3 ème
HAUTE-LOIRE,MONISTROL-SUR-LOIRE,0430663M,156,148,0,8,88,68,3 ème
HAUTE-LOIRE,RETOURNAC,0430026V,73,73,0,0,43,30,3 ème
HAUTE-LOIRE,SAINT-JULIEN-CHAPTEUIL,0430086K,43,43,0,0,22,21,3 ème
HAUTE-LOIRE,SAUGUES,0430032B,15,15,0,0,9,6,3 ème
HAUTE-LOIRE,YSSINGEAUX,0430909E,78,76,0,2,33,45,3 ème
PUY-DE-DOME,AUBIERE,0631081H,61,53,0,8,36,25,3 ème
PUY-DE-DOME,BESSE-ET-SAINT-ANASTAISE,0630008S,53,53,0,0,23,30,3 ème
PUY-DE-DOME,BILLOM,0630009T,193,193,0,0,89,104,3 ème
PUY-DE-DOME,CLERMONT-FERRAND,0630024J,39,39,0,0,15,24,3 ème
PUY-DE-DOME,CLERMONT-FERRAND,0631085M,174,174,0,0,85,89,3 ème
PUY-DE-DOME,CLERMONT-FERRAND,0631086N,142,142,0,0,55,87,3 ème
PUY-DE-DOME,CLERMONT-FERRAND,0631502R,96,89,0,7,48,48,3 ème
PUY-DE-DOME,CLERMONT-FERRAND,0631731P,147,147,0,0,75,72,3 ème
PUY-DE-DOME,CLERMONT-FERRAND,0631773K,133,129,0,4,66,67,3 ème
PUY-DE-DOME,COURPIERE,0631523N,76,72,0,4,40,36,3 ème
PUY-DE-DOME,COURPIERE,0631733S,60,60,0,0,33,27,3 ème
PUY-DE-DOME,ISSOIRE,0630041C,33,33,0,0,5,28,3 ème
PUY-DE-DOME,RIOM,0631763Z,201,163,31,7,94,107,3 ème
PUY-DE-DOME,SAINT-ELOY-LES-MINES,0630060Y,64,60,0,4,34,30,3 ème
ARDECHE,ANNONAY,0070100W,57,56,0,1,24,33,3 ème
ARDECHE,ANNONAY,0071156U,197,173,18,6,102,95,3 ème
ARDECHE,GUILHERAND-GRANGES,0070011Z,137,136,0,1,65,72,3 ème
ARDECHE,JOYEUSE,0070012A,70,66,0,4,34,36,3 ème
ARDECHE,LAMASTRE,0071168G,25,25,0,0,11,14,3 ème
ARDECHE,LARGENTIERE,0070017F,51,51,0,0,27,24,3 ème
ARDECHE,SAINT-PERAY,0071320X,147,129,16,2,69,78,3 ème
ARDECHE,SATILLIEU,0070086F,63,63,0,0,30,33,3 ème
ARDECHE,TOURNON-SUR-RHONE,0071192H,123,123,0,0,71,52,3 ème
DROME,BOURG-DE-PEAGE,0260001K,209,202,0,7,109,100,3 ème
DROME,CLEON-D'ANDRAN,0260005P,123,123,0,0,74,49,3 ème
DROME,DIEULEFIT,0260009U,77,77,0,0,41,36,3 ème
DROME,MONTELIMAR,0260045H,169,167,0,2,84,85,3 ème
DROME,MONTELIMAR,0261086P,171,170,0,1,92,79,3 ème
DROME,PORTES-LES-VALENCE,0260021G,169,163,0,6,87,82,3 ème
DROME,ROMANS-SUR-ISERE,0261091V,63,62,0,1,24,39,3 ème
DROME,SAINT-DONAT-SUR-L'HERBASSE,0260026M,109,109,0,0,54,55,3 ème
DROME,SAINT-RAMBERT-D'ALBON,0260101U,107,105,0,2,51,56,3 ème
DROME,SUZE-LA-ROUSSE,0260033V,62,62,0,0,28,34,3 ème
DROME,VALENCE,0261100E,27,27,0,0,12,15,3 ème
HAUTE SAVOIE,ANNECY,0740065U,109,107,0,2,56,53,3 ème
HAUTE SAVOIE,ANNECY,0740106N,117,117,0,0,58,59,3 ème
HAUTE SAVOIE,ANNECY,0740930J,159,158,0,1,73,86,3 ème
HAUTE SAVOIE,ANNECY,0741278M,183,181,0,2,99,84,3 ème
HAUTE SAVOIE,ANNEMASSE,0741476C,20,20,0,0,4,16,3 ème
HAUTE SAVOIE,BONNEVILLE,0740157U,169,166,0,3,84,85,3 ème
HAUTE SAVOIE,CHAMONIX-MONT-BLANC,0740110T,44,44,0,0,19,25,3 ème
HAUTE SAVOIE,CLUSES,0740143D,23,23,0,0,13,10,3 ème
HAUTE SAVOIE,COLLONGES-SOUS-SALEVE,0740114X,50,50,0,0,30,20,3 ème
HAUTE SAVOIE,FRANGY,0740024Z,123,123,0,0,52,71,3 ème
HAUTE SAVOIE,GAILLARD,0741097R,124,121,0,3,56,68,3 ème
HAUTE SAVOIE,LA ROCHE-SUR-FORON,0740931K,203,187,16,0,105,98,3 ème
HAUTE SAVOIE,LA ROCHE-SUR-FORON,0741286W,24,24,0,0,10,14,3 ème
HAUTE SAVOIE,MARGENCEL,0741666J,162,128,32,2,78,84,3 ème
HAUTE SAVOIE,MEGEVE,0740026B,73,73,0,0,42,31,3 ème
HAUTE SAVOIE,POISY,0741699V,111,110,0,1,59,52,3 ème
HAUTE SAVOIE,RUMILLY,0740032H,159,142,15,2,83,76,3 ème
HAUTE SAVOIE,SAINT-GERVAIS-LES-BAINS,0740095B,23,23,0,0,9,14,3 ème
HAUTE SAVOIE,SAINT-JEOIRE,0740035L,147,145,0,2,75,72,3 ème
HAUTE SAVOIE,SAINT-JEOIRE,0740152N,23,23,0,0,0,23,3 ème
HAUTE SAVOIE,SAINT-JULIEN-EN-GENEVOIS,0740038P,203,189,14,0,107,96,3 ème
HAUTE SAVOIE,SALLANCHES,0741281R,92,89,0,3,45,47,3 ème
HAUTE SAVOIE,TANINGES,0740043V,98,98,0,0,42,56,3 ème
HAUTE SAVOIE,THONON-LES-BAINS,0740102J,154,154,0,0,80,74,3 ème
HAUTE SAVOIE,THONON-LES-BAINS,0741227G,226,220,0,6,103,123,3 ème
HAUTE SAVOIE,THONON-LES-BAINS,0741341F,238,218,17,3,114,124,3 ème
HAUTE SAVOIE,VILLE-LA-GRAND,0740910M,257,226,27,4,102,155,3 ème
ISERE,BEAUREPAIRE,0381685A,39,39,0,0,18,21,3 ème
ISERE,BOURGOIN-JALLIEU,0381658W,143,143,0,0,73,70,3 ème
ISERE,BOURGOIN-JALLIEU,0382174G,229,193,32,4,106,123,3 ème
ISERE,CHARVIEU-CHAVAGNEUX,0380011F,134,132,0,2,65,69,3 ème
ISERE,ECHIROLLES,0381903M,94,73,16,5,48,46,3 ème
ISERE,FONTAINE,0381810L,138,117,15,6,70,68,3 ème
ISERE,GIERES,0380025W,164,162,0,2,84,80,3 ème
ISERE,GRENOBLE,0380032D,15,15,0,0,7,8,3 ème
ISERE,GRENOBLE,0381758E,59,59,0,0,26,33,3 ème
ISERE,GRENOBLE,0381780D,122,122,0,0,75,47,3 ème
ISERE,GRENOBLE,0382114S,158,155,0,3,72,86,3 ème
ISERE,GRENOBLE,0383437E,14,0,14,0,4,10,3 ème
ISERE,LA COTE-SAINT-ANDRE,0382893N,10,10,0,0,3,7,3 ème
ISERE,LA MURE,0382426F,126,115,8,3,68,58,3 ème
ISERE,LA TRONCHE,0381630R,10,10,0,0,8,2,3 ème
ISERE,LE PONT-DE-BEAUVOISIN,0382427G,111,108,0,3,54,57,3 ème
ISERE,LE PONT-DE-CLAIX,0380013H,100,100,0,0,57,43,3 ème
ISERE,LES AVENIERES VEYRINS-THUELLIN,0380004Y,114,114,0,0,57,57,3 ème
ISERE,MONTALIEU-VERCIEU,0380045T,172,172,0,0,73,99,3 ème
ISERE,SAINT-ETIENNE-DE-SAINT-GEOIRS,0380059H,165,165,0,0,89,76,3 ème
ISERE,SAINT-MARTIN-D'HERES,0380357G,111,93,14,4,43,68,3 ème
ISERE,SAINT-MARTIN-LE-VINOUX,0382036G,143,134,7,2,63,80,3 ème
ISERE,SALAISE-SUR-SANNE,0383253E,182,182,0,0,95,87,3 ème
ISERE,VARCES-ALLIERES-ET-RISSET,0383260M,117,117,0,0,56,61,3 ème
ISERE,VIENNE,0382430K,145,145,0,0,78,67,3 ème
ISERE,VINAY,0380087N,149,144,0,5,79,70,3 ème
ISERE,VOIRON,0381809K,21,21,0,0,15,6,3 ème
SAVOIE,AIME-LA-PLAGNE,0730002F,87,87,0,0,43,44,3 ème
SAVOIE,AIX-LES-BAINS,0730791N,114,114,0,0,63,51,3 ème
SAVOIE,AIX-LES-BAINS,0731204M,105,105,0,0,56,49,3 ème
SAVOIE,ALBERTVILLE,0730760E,14,14,0,0,7,7,3 ème
SAVOIE,BARBERAZ,0730772T,22,22,0,0,13,9,3 ème
SAVOIE,BEAUFORT,0730007L,48,48,0,0,19,29,3 ème
SAVOIE,CHAMBERY,0730811K,15,0,15,0,9,6,3 ème
SAVOIE,MONTMELIAN,0731044N,216,200,16,0,94,122,3 ème
AIN,ARTEMARE,0010794H,70,67,0,3,36,34,3 ème
AIN,BAGE-DOMMARTIN,0010005A,129,129,0,0,65,64,3 ème
AIN,BELLEY,0011150V,88,88,0,0,43,45,3 ème
AIN,DAGNEUX,0011142L,128,128,0,0,63,65,3 ème
AIN,GEX,0010024W,180,163,15,2,96,84,3 ème
AIN,PERONNAS,0010938P,168,136,30,2,75,93,3 ème
AIN,PONCIN,0010036J,96,95,0,1,48,48,3 ème
AIN,TREVOUX,0010097A,144,144,0,0,60,84,3 ème
LOIRE,BOURG-ARGENTAL,0420003A,47,47,0,0,20,27,3 ème
LOIRE,CHAZELLES-SUR-LYON,0420011J,106,106,0,0,53,53,3 ème
LOIRE,LA PACAUDIERE,0421456E,46,46,0,0,23,23,3 ème
LOIRE,LE COTEAU,0421084A,148,131,16,1,75,73,3 ème
LOIRE,MONTBRISON,0421454C,343,302,33,8,163,180,3 ème
LOIRE,NOIRETABLE,0420022W,38,38,0,0,17,21,3 ème
LOIRE,RIVE-DE-GIER,0421172W,196,165,31,0,97,99,3 ème
LOIRE,ROANNE,0420987V,19,19,0,0,8,11,3 ème
LOIRE,SAINT-CHAMOND,0421486M,102,99,0,3,54,48,3 ème
LOIRE,SAINT-ETIENNE,0420049A,24,24,0,0,17,7,3 ème
LOIRE,SAINT-ETIENNE,0421176A,118,96,16,6,61,57,3 ème
LOIRE,SAINT-ETIENNE,0421686E,94,77,16,1,49,45,3 ème
LOIRE,SAINT-ETIENNE,0421804H,177,177,0,0,93,84,3 ème
LOIRE,SAINT-JUST-EN-CHEVALET,0420062P,46,46,0,0,19,27,3 ème
LOIRE,SAINT-JUST-EN-CHEVALET,0421061A,27,27,0,0,6,21,3 ème
RHONE,BRIGNAIS,0692582G,114,112,0,2,49,65,3 ème
RHONE,CALUIRE-ET-CUIRE,0691728D,133,113,15,5,65,68,3 ème
RHONE,CALUIRE-ET-CUIRE,0692968B,42,42,0,0,7,35,3 ème
RHONE,CHAPONNAY,0693243A,167,167,0,0,101,66,3 ème
RHONE,CHATILLON,0693975W,176,173,0,3,96,80,3 ème
RHONE,CIVRIEUX-D'AZERGUES,0690584K,80,74,0,6,31,49,3 ème
RHONE,CONDRIEU,0690587N,87,87,0,0,41,46,3 ème
RHONE,CORBAS,0692898A,117,115,0,2,57,60,3 ème
RHONE,COURS,0690016T,52,52,0,0,32,20,3 ème
RHONE,COURS,0690590S,14,14,0,0,2,12,3 ème
RHONE,DECINES-CHARPIEU,0694185Z,66,66,0,0,47,19,3 ème
RHONE,DEUX-GROSNES,0690070B,47,47,0,0,26,21,3 ème
RHONE,FRANCHEVILLE,0694151M,165,162,0,3,90,75,3 ème
RHONE,GENAS,0691650U,168,167,0,1,100,68,3 ème
RHONE,IRIGNY,0691824H,152,148,0,4,64,88,3 ème
RHONE,L'ARBRESLE,0690578D,99,99,0,0,47,52,3 ème
RHONE,LYON,0692929J,243,243,0,0,97,146,3 ème
RHONE,LYON,0694191F,177,177,0,0,84,93,3 ème
RHONE,LYON,0690641X,45,44,0,1,24,21,3 ème
RHONE,LYON,0690698J,29,29,0,0,12,17,3 ème
RHONE,LYON,0692505Y,174,174,0,0,78,96,3 ème
RHONE,LYON,0691798E,139,137,0,2,65,74,3 ème
RHONE,LYON,0692920Z,167,167,0,0,76,91,3 ème
RHONE,LYON,0692339T,248,228,16,4,111,137,3 ème
RHONE,LYON,0692922B,121,121,0,0,54,67,3 ème
RHONE,LYON,0693479G,192,192,0,0,104,88,3 ème
RHONE,LYON,0692340U,169,152,16,1,87,82,3 ème
RHONE,LYON,0692940W,209,209,0,0,115,94,3 ème
RHONE,LYON,0692698H,207,207,0,0,110,97,3 ème
RHONE,NEUVILLE-SUR-SAONE,0692941X,270,270,0,0,142,128,3 ème
RHONE,OULLINS,0691673U,82,80,0,2,24,58,3 ème
RHONE,RILLIEUX-LA-PAPE,0691498D,141,138,0,3,70,71,3 ème
RHONE,RILLIEUX-LA-PAPE,0692159X,154,137,17,0,75,79,3 ème
RHONE,SAINT-DIDIER-AU-MONT-D'OR,0690546U,148,144,0,4,71,77,3 ème
RHONE,SAINT-LAURENT-DE-MURE,0692865P,216,216,0,0,103,113,3 ème
RHONE,SAINT-PRIEST,0694312M,53,53,0,0,33,20,3 ème
RHONE,TASSIN-LA-DEMI-LUNE,0692163B,150,148,0,2,68,82,3 ème
RHONE,VAL D'OINGT,0690580F,71,71,0,0,31,40,3 ème
RHONE,VAUGNERAY,0690621A,127,123,0,4,69,58,3 ème
RHONE,VAULX-EN-VELIN,0692336P,142,123,16,3,66,76,3 ème
RHONE,VENISSIEUX,0690551Z,159,159,0,0,94,65,3 ème
RHONE,VILLEFRANCHE-SUR-SAONE,0690099H,137,117,16,4,62,75,3 ème
RHONE,VILLEFRANCHE-SUR-SAONE,0693375U,73,68,0,5,38,35,3 ème
RHONE,VILLEURBANNE,0690047B,22,22,0,0,9,13,3 ème
RHONE,VILLEURBANNE,0690107S,24,24,0,0,7,17,3 ème
RHONE,VILLEURBANNE,0690626F,119,107,11,1,72,47,3 ème
RHONE,VILLEURBANNE,0692337R,139,134,0,5,66,73,3 ème
RHONE,VILLEURBANNE,0693093M,110,104,0,6,50,60,3 ème
RHONE,VILLEURBANNE,0694296V,116,116,0,0,58,58,3 ème
DOUBS,AMANCEY,0251048D,14,14,0,0,7,7,3 ème
DOUBS,AUDINCOURT,0250001R,24,24,0,0,9,15,3 ème
DOUBS,BESANCON,0250013D,24,24,0,0,2,22,3 ème
DOUBS,BESANCON,0251079M,24,24,0,0,12,12,3 ème
DOUBS,BESANCON,0251080N,159,138,16,5,74,85,3 ème
DOUBS,BESANCON,0251127P,144,140,0,4,77,67,3 ème
DOUBS,LEVIER,0251069B,40,40,0,0,21,19,3 ème
DOUBS,MOUTHE,0250040H,99,99,0,0,41,58,3 ème
DOUBS,ORNANS,0251129S,124,123,0,1,54,70,3 ème
DOUBS,ROULANS,0250051V,133,133,0,0,50,83,3 ème
DOUBS,SAINT-VIT,0251394E,199,175,24,0,96,103,3 ème
DOUBS,VERCEL-VILLEDIEU-LE-CAMP,0251062U,42,42,0,0,21,21,3 ème
HAUTE-SAONE,DAMPIERRE-SUR-SALON,0700004Z,82,82,0,0,43,39,3 ème
HAUTE-SAONE,FOUGEROLLES-SAINT-VALBERT,0700007C,45,41,0,4,22,23,3 ème
HAUTE-SAONE,GRAY,0700011G,24,24,0,0,4,20,3 ème
HAUTE-SAONE,LURE,0700018P,24,24,0,0,0,24,3 ème
HAUTE-SAONE,LURE,0700076C,26,26,0,0,11,15,3 ème
HAUTE-SAONE,MARNAY,0700026Y,107,107,0,0,49,58,3 ème
HAUTE-SAONE,RIOZ,0700029B,193,193,0,0,96,97,3 ème
HAUTE-SAONE,SAINT-LOUP-SUR-SEMOUSE,0700788B,74,74,0,0,43,31,3 ème
HAUTE-SAONE,VESOUL,0700786Z,145,113,29,3,68,77,3 ème
HAUTE-SAONE,VILLERSEXEL,0700077D,15,0,15,0,8,7,3 ème
JURA,ARBOIS,0390960G,48,48,0,0,26,22,3 ème
JURA,CHAMPAGNOLE,0390961H,117,117,0,0,54,63,3 ème
JURA,DAMPARIS,0390010Z,53,53,0,0,26,27,3 ème
JURA,DOLE,0390797E,125,120,0,5,52,73,3 ème
JURA,DOLE,0391002C,188,169,17,2,83,105,3 ème
JURA,FRAISANS,0390016F,91,91,0,0,40,51,3 ème
JURA,LONS-LE-SAUNIER,0390907Z,151,115,32,4,70,81,3 ème
JURA,ORGELET,0390031X,48,45,0,3,22,26,3 ème
JURA,SAINT-AMOUR,0390914G,19,19,0,0,4,15,3 ème
JURA,SAINT-CLAUDE,0390071R,62,62,0,0,29,33,3 ème
JURA,VOITEUR,0390073T,23,23,0,0,12,11,3 ème
TERRITOIRE DE BELFORT,BAVILLIERS,0900355X,24,24,0,0,3,21,3 ème
TERRITOIRE DE BELFORT,BEAUCOURT,0900275K,102,98,0,4,55,47,3 ème
TERRITOIRE DE BELFORT,DANJOUTIN,0900237U,140,136,0,4,68,72,3 ème
TERRITOIRE DE BELFORT,DELLE,0900007U,132,118,14,0,71,61,3 ème
TERRITOIRE DE BELFORT,DELLE,0900019G,15,15,0,0,8,7,3 ème
COTE D'OR,ARNAY-LE-DUC,0210001M,40,40,0,0,22,18,3 ème
COTE D'OR,BROCHON,0211140A,148,148,0,0,74,74,3 ème
COTE D'OR,CHENOVE,0211225T,76,47,23,6,35,41,3 ème
COTE D'OR,CHEVIGNY-SAINT-SAUVEUR,0211137X,237,232,0,5,120,117,3 ème
COTE D'OR,DIJON,0210019G,24,24,0,0,11,13,3 ème
COTE D'OR,DIJON,0210025N,79,78,0,1,39,40,3 ème
COTE D'OR,DIJON,0211070Z,292,274,15,3,127,165,3 ème
COTE D'OR,MARSANNAY-LA-COTE,0211391Y,76,75,0,1,37,39,3 ème
COTE D'OR,MONTBARD,0210034Y,63,59,0,4,30,33,3 ème
COTE D'OR,NOLAY,0210037B,40,40,0,0,20,20,3 ème
COTE D'OR,PONTAILLER-SUR-SAONE,0210040E,89,89,0,0,48,41,3 ème
COTE D'OR,SEMUR-EN-AUXOIS,0210047M,14,14,0,0,3,11,3 ème
COTE D'OR,TALANT,0211523S,91,85,0,6,50,41,3 ème
NIEVRE,DORNES,0580019F,28,28,0,0,17,11,3 ème
NIEVRE,IMPHY,0580618G,55,51,0,4,30,25,3 ème
NIEVRE,LUZY,0580619H,33,33,0,0,20,13,3 ème
NIEVRE,MOULINS-ENGILBERT,0580030T,34,34,0,0,16,18,3 ème
NIEVRE,VARENNES-VAUZELLES,0580620J,120,102,16,2,64,56,3 ème
SAONE-ET-LOIRE,CHAGNY,0710009Z,150,148,0,2,69,81,3 ème
SAONE-ET-LOIRE,CHALON-SUR-SAONE,0710012C,23,23,0,0,2,21,3 ème
SAONE-ET-LOIRE,CHAUFFAILLES,0710021M,81,81,0,0,45,36,3 ème
SAONE-ET-LOIRE,DIGOIN,0711136Z,106,106,0,0,41,65,3 ème
SAONE-ET-LOIRE,LUGNY,0710044M,106,105,0,1,48,58,3 ème
SAONE-ET-LOIRE,MACON,0711054K,223,204,16,3,105,118,3 ème
SAONE-ET-LOIRE,MATOUR,0710053X,70,70,0,0,36,34,3 ème
SAONE-ET-LOIRE,MONTCEAU-LES-MINES,0711135Y,103,100,0,3,46,57,3 ème
SAONE-ET-LOIRE,PARAY-LE-MONIAL,0711314T,82,82,0,0,47,35,3 ème
SAONE-ET-LOIRE,SAINT-GENGOUX-LE-NATIONAL,0710064J,63,63,0,0,34,29,3 ème
SAONE-ET-LOIRE,TOURNUS,0710535W,88,87,0,1,39,49,3 ème
YONNE,ANCY-LE-FRANC,0890979F,60,60,0,0,30,30,3 ème
YONNE,BRIENON-SUR-ARMANCON,0891057R,68,68,0,0,42,26,3 ème
YONNE,PONT-SUR-YONNE,0890823L,148,134,14,0,73,75,3 ème
YONNE,SENS,0890030Z,127,126,0,1,58,69,3 ème
YONNE,VERMENTON,0890037G,64,64,0,0,25,39,3 ème
COTES D'ARMOR,BROONS,0220136D,50,50,0,0,25,25,3 ème
COTES D'ARMOR,CORLAY,0220009R,16,16,0,0,3,13,3 ème
COTES D'ARMOR,DINAN,0221744B,101,99,0,2,52,49,3 ème
COTES D'ARMOR,GOUAREC,0221745C,0,0,0,0,0,0,3 ème
COTES D'ARMOR,GUERLEDAN,0220150U,39,39,0,0,19,20,3 ème
COTES D'ARMOR,LAMBALLE-ARMOR,0220142K,213,209,0,4,96,117,3 ème
COTES D'ARMOR,LAMBALLE-ARMOR,0220196U,24,24,0,0,9,15,3 ème
COTES D'ARMOR,LE MENE,0220008P,46,46,0,0,23,23,3 ème
COTES D'ARMOR,PLERIN,0220134B,75,75,0,0,39,36,3 ème
COTES D'ARMOR,PLOUER-SUR-RANCE,0220161F,37,37,0,0,20,17,3 ème
COTES D'ARMOR,SAINT-BRIEUC,0220071H,18,18,0,0,4,14,3 ème
COTES D'ARMOR,SAINT-BRIEUC,0220184F,93,77,16,0,43,50,3 ème
COTES D'ARMOR,SAINT-NICOLAS-DU-PELEM,0220061X,26,26,0,0,15,11,3 ème
COTES D'ARMOR,SAINT-QUAY-PORTRIEUX,0220063Z,110,110,0,0,55,55,3 ème
COTES D'ARMOR,SAINT-QUAY-PORTRIEUX,0220176X,44,44,0,0,26,18,3 ème
FINISTERE,BREST,0290012F,23,23,0,0,10,13,3 ème
FINISTERE,BREST,0290236Z,38,38,0,0,23,15,3 ème
FINISTERE,BREST,0291661Y,99,83,16,0,43,56,3 ème
FINISTERE,BREST,0291869Z,220,220,0,0,107,113,3 ème
FINISTERE,CARHAIX-PLOUGUER,0290247L,58,58,0,0,32,26,3 ème
FINISTERE,CONCARNEAU,0290031B,95,93,0,2,53,42,3 ème
FINISTERE,CROZON,0290032C,99,99,0,0,57,42,3 ème
FINISTERE,DOUARNENEZ,0290260A,69,69,0,0,39,30,3 ème
FINISTERE,GUERLESQUIN,0290039K,50,50,0,0,16,34,3 ème
FINISTERE,GUILERS,0291713E,38,38,0,0,18,20,3 ème
FINISTERE,GUIPAVAS,0291655S,99,95,0,4,53,46,3 ème
FINISTERE,HUELGOAT,0290148D,33,33,0,0,15,18,3 ème
FINISTERE,LANDERNEAU,0290045S,239,223,16,0,120,119,3 ème
FINISTERE,LE RELECQ-KERHUON,0292055B,69,69,0,0,37,32,3 ème
FINISTERE,MOELAN-SUR-MER,0291717J,93,93,0,0,36,57,3 ème
FINISTERE,MORLAIX,0291104T,53,51,0,2,26,27,3 ème
FINISTERE,PLABENNEC,0290286D,127,124,0,3,67,60,3 ème
FINISTERE,PLOUDALMEZEAU,0290065N,107,107,0,0,58,49,3 ème
FINISTERE,PLOUGASTEL-DAOULAS,0291928N,110,105,0,5,52,58,3 ème
FINISTERE,PLOUHINEC,0290330B,59,59,0,0,32,27,3 ème
FINISTERE,PLOUNEOUR-MENEZ,0290058F,65,65,0,0,33,32,3 ème
FINISTERE,PLOUZANE,0291753Y,95,95,0,0,47,48,3 ème
FINISTERE,PONT-AVEN,0290301V,22,22,0,0,17,5,3 ème
FINISTERE,PONT-L'ABBE,0290168A,28,24,0,4,8,20,3 ème
FINISTERE,QUIMPER,0290071V,19,19,0,0,2,17,3 ème
FINISTERE,QUIMPER,0290320R,99,99,0,0,56,43,3 ème
FINISTERE,QUIMPERLE,0290107J,83,78,0,5,46,37,3 ème
FINISTERE,SAINT-MARTIN-DES-CHAMPS,0290083H,49,48,0,1,31,18,3 ème
ILLE-ET-VILAINE,BREAL-SOUS-MONTFORT,0352958A,109,109,0,0,58,51,3 ème
ILLE-ET-VILAINE,CANCALE,0350853M,52,52,0,0,26,26,3 ème
ILLE-ET-VILAINE,CESSON-SEVIGNE,0353006C,0,0,0,0,0,0,3 ème
ILLE-ET-VILAINE,CHATEAUBOURG,0352448W,160,160,0,0,87,73,3 ème
ILLE-ET-VILAINE,COMBOURG,0350707D,144,144,0,0,66,78,3 ème
ILLE-ET-VILAINE,CREVIN,0352860U,135,135,0,0,69,66,3 ème
ILLE-ET-VILAINE,DINARD,0351795L,178,178,0,0,85,93,3 ème
ILLE-ET-VILAINE,FOUGERES,0350770X,237,237,0,0,123,114,3 ème
ILLE-ET-VILAINE,FOUGERES,0350967L,100,71,27,2,50,50,3 ème
ILLE-ET-VILAINE,GUICHEN,0351881E,192,188,0,4,90,102,3 ème
ILLE-ET-VILAINE,LA GUERCHE-DE-BRETAGNE,0350863Y,139,139,0,0,66,73,3 ème
ILLE-ET-VILAINE,MARTIGNE-FERCHAUD,0350868D,67,67,0,0,33,34,3 ème
ILLE-ET-VILAINE,MELESSE,0352183H,88,88,0,0,42,46,3 ème
ILLE-ET-VILAINE,MONTFORT-SUR-MEU,0350872H,167,164,0,3,84,83,3 ème
ILLE-ET-VILAINE,MONTFORT-SUR-MEU,0351791G,188,158,30,0,89,99,3 ème
ILLE-ET-VILAINE,PIPRIAC,0350875L,117,113,0,4,65,52,3 ème
ILLE-ET-VILAINE,PLEINE-FOUGERES,0350021H,46,46,0,0,22,24,3 ème
ILLE-ET-VILAINE,PLEINE-FOUGERES,0350877N,46,46,0,0,23,23,3 ème
ILLE-ET-VILAINE,PLELAN-LE-GRAND,0350878P,67,67,0,0,41,26,3 ème
ILLE-ET-VILAINE,REDON,0350102W,23,23,0,0,6,17,3 ème
ILLE-ET-VILAINE,RENNES,0350031U,32,32,0,0,3,29,3 ème
ILLE-ET-VILAINE,RENNES,0350760L,111,108,0,3,49,62,3 ème
ILLE-ET-VILAINE,RENNES,0350776D,18,18,0,0,6,12,3 ème
ILLE-ET-VILAINE,RENNES,0350835T,106,102,0,4,51,55,3 ème
ILLE-ET-VILAINE,RENNES,0351054F,23,23,0,0,12,11,3 ème
ILLE-ET-VILAINE,RENNES,0352071L,47,47,0,0,33,14,3 ème
ILLE-ET-VILAINE,SAINT-MALO,0350785N,101,101,0,0,46,55,3 ème
ILLE-ET-VILAINE,TINTENIAC,0350050P,12,12,0,0,1,11,3 ème
ILLE-ET-VILAINE,VAL D'ANAST,0350017D,100,100,0,0,42,58,3 ème
ILLE-ET-VILAINE,VITRE,0350808N,22,22,0,0,5,17,3 ème
ILLE-ET-VILAINE,VITRE,0352008T,97,97,0,0,43,54,3 ème
MORBIHAN,BAUD,0561386C,118,118,0,0,52,66,3 ème
MORBIHAN,BAUD,0561399S,71,71,0,0,35,36,3 ème
MORBIHAN,ETEL,0560009F,108,108,0,0,51,57,3 ème
MORBIHAN,GOURIN,0561383Z,52,50,0,2,20,32,3 ème
MORBIHAN,GROIX,0561352R,6,6,0,0,3,3,3 ème
MORBIHAN,GUER,0560061M,125,125,0,0,62,63,3 ème
MORBIHAN,LA GACILLY,0561400T,103,103,0,0,53,50,3 ème
MORBIHAN,LE PALAIS,0560034H,32,32,0,0,12,20,3 ème
MORBIHAN,LORIENT,0560149H,146,143,0,3,75,71,3 ème
MORBIHAN,PLESCOP,0561931V,125,122,0,3,48,77,3 ème
MORBIHAN,PLOERMEL,0560108N,205,186,14,5,112,93,3 ème
MORBIHAN,PLUVIGNER,0561356V,155,155,0,0,70,85,3 ème
MORBIHAN,QUESTEMBERT,0561641E,23,23,0,0,5,18,3 ème
MORBIHAN,QUEVEN,0561384A,172,154,12,6,75,97,3 ème
MORBIHAN,VANNES,0560118Z,248,226,22,0,134,114,3 ème
CHER,BOURGES,0180593X,121,102,16,3,57,64,3 ème
CHER,BOURGES,0180766K,57,57,0,0,25,32,3 ème
CHER,BOURGES,0180796T,212,212,0,0,104,108,3 ème
CHER,BOURGES,0180823X,8,0,0,8,6,2,3 ème
CHER,CHATEAUMEILLANT,0180013S,62,57,5,0,22,40,3 ème
CHER,LA GUERCHE-SUR-L'AUBOIS,0180710Z,69,61,4,4,28,41,3 ème
CHER,MEHUN-SUR-YEVRE,0180586P,116,114,0,2,46,70,3 ème
CHER,SAINT-GERMAIN-DU-PUY,0180732Y,127,115,8,4,57,70,3 ème
CHER,SANCOINS,0180033N,36,36,0,0,22,14,3 ème
CHER,VIERZON,0180036S,24,24,0,0,6,18,3 ème
CHER,VIERZON,0180572Z,21,21,0,0,19,2,3 ème
EURE-ET-LOIR,AUTHON-DU-PERCHE,0280002A,47,47,0,0,16,31,3 ème
EURE-ET-LOIR,BU,0281095N,109,108,0,1,55,54,3 ème
EURE-ET-LOIR,CHARTRES,0280691Z,19,19,0,0,10,9,3 ème
EURE-ET-LOIR,CHARTRES,0280993C,149,149,0,0,74,75,3 ème
EURE-ET-LOIR,CHATEAUDUN,0280918W,88,62,26,0,46,42,3 ème
EURE-ET-LOIR,ILLIERS-COMBRAY,0280702L,135,132,0,3,59,76,3 ème
EURE-ET-LOIR,LES VILLAGES VOVEENS,0280040S,120,116,0,4,66,54,3 ème
EURE-ET-LOIR,LUCE,0280657M,119,87,30,2,63,56,3 ème
EURE-ET-LOIR,LUISANT,0281043G,205,203,0,2,101,104,3 ème
EURE-ET-LOIR,NOGENT-LE-ROI,0280035L,185,182,0,3,94,91,3 ème
EURE-ET-LOIR,SAINT-MAURICE-SAINT-GERMAIN,0280684S,97,95,0,2,14,83,3 ème
EURE-ET-LOIR,SAINT-PREST,0281055V,194,187,0,7,94,100,3 ème
EURE-ET-LOIR,SENONCHES,0280887M,72,72,0,0,40,32,3 ème
INDRE,AIGURANDE,0360001F,32,32,0,0,19,13,3 ème
INDRE,ARGENTON-SUR-CREUSE,0360003H,15,15,0,0,8,7,3 ème
INDRE,BUZANCAIS,0360511K,28,28,0,0,13,15,3 ème
INDRE,ISSOUDUN,0360024F,13,13,0,0,6,7,3 ème
INDRE,LE BLANC,0360005K,15,15,0,0,4,11,3 ème
INDRE,LE BLANC,0360719L,76,64,10,2,40,36,3 ème
INDRE,LEVROUX,0360028K,68,68,0,0,29,39,3 ème
INDRE,NEUVY-SAINT-SEPULCHRE,0360030M,67,64,0,3,28,39,3 ème
INDRE,VALENCAY,0360525A,59,53,0,6,28,31,3 ème
INDRE-ET-LOIRE,AMBOISE,0371325P,70,70,0,0,41,29,3 ème
INDRE-ET-LOIRE,FONDETTES,0371397T,138,138,0,0,70,68,3 ème
INDRE-ET-LOIRE,LOCHES,0370016S,23,23,0,0,6,17,3 ème
INDRE-ET-LOIRE,SAINTE-MAURE-DE-TOURAINE,0371101W,112,95,14,3,55,57,3 ème
INDRE-ET-LOIRE,SAINT-PIERRE-DES-CORPS,0371391L,78,78,0,0,43,35,3 ème
INDRE-ET-LOIRE,TOURS,0370040T,24,24,0,0,8,16,3 ème
INDRE-ET-LOIRE,TOURS,0370045Y,131,131,0,0,67,64,3 ème
INDRE-ET-LOIRE,TOURS,0370732V,111,111,0,0,49,62,3 ème
INDRE-ET-LOIRE,TOURS,0370757X,23,23,0,0,8,15,3 ème
INDRE-ET-LOIRE,TOURS,0370884K,138,138,0,0,67,71,3 ème
INDRE-ET-LOIRE,TOURS,0370991B,119,98,17,4,47,72,3 ème
INDRE-ET-LOIRE,TOURS,0371158H,81,81,0,0,41,40,3 ème
LOIRET,AMILLY,0450937Z,191,171,15,5,84,107,3 ème
LOIRET,BEAUNE-LA-ROLANDE,0450006M,126,122,0,4,61,65,3 ème
LOIRET,BELLEGARDE,0450007N,113,95,13,5,57,56,3 ème
LOIRET,COURTENAY,0451173F,124,122,0,2,56,68,3 ème
LOIRET,FERRIERES-EN-GATINAIS,0450022E,178,170,0,8,86,92,3 ème
LOIRET,GIEN,0451245J,103,96,0,7,55,48,3 ème
LOIRET,LA CHAPELLE-SAINT-MESMIN,0451035F,113,109,0,4,48,65,3 ème
LOIRET,LES BORDES,0451608D,102,100,0,2,49,53,3 ème
LOIRET,MONTARGIS,0450041A,108,104,0,4,43,65,3 ème
LOIRET,OLIVET,0450047G,191,191,0,0,88,103,3 ème
LOIRET,ORLEANS,0450786K,8,8,0,0,1,7,3 ème
LOIRET,ORLEANS,0450939B,148,139,0,9,74,74,3 ème
LOIRET,ORLEANS,0451316L,103,102,0,1,48,55,3 ème
LOIRET,ORLEANS,0451590J,30,30,0,0,15,15,3 ème
LOIRET,PATAY,0450061X,128,128,0,0,56,72,3 ème
LOIRET,PITHIVIERS,0450750W,23,23,0,0,11,12,3 ème
LOIRET,PITHIVIERS,0451788Z,121,113,5,3,52,69,3 ème
LOIRET,SAINT-DENIS-EN-VAL,0451660K,119,116,0,3,59,60,3 ème
LOIRET,TIGY,0451449F,116,115,0,1,67,49,3 ème
LOIR-ET-CHER,BLOIS,0410003F,140,115,24,1,75,65,3 ème
LOIR-ET-CHER,BLOIS,0410918A,130,130,0,0,65,65,3 ème
LOIR-ET-CHER,MONTOIRE-SUR-LE-LOIR,0410566T,103,85,16,2,51,52,3 ème
LOIR-ET-CHER,NEUNG-SUR-BEUVRON,0410035R,61,59,0,2,33,28,3 ème
LOIR-ET-CHER,OUCQUES LA NOUVELLE,0410015U,69,68,0,1,32,37,3 ème
LOIR-ET-CHER,SAINT-LAURENT-NOUAN,0410914W,108,92,15,1,54,54,3 ème
LOIR-ET-CHER,SALBRIS,0410686Y,20,20,0,0,17,3,3 ème
LOIR-ET-CHER,SALBRIS,0410717G,87,83,0,4,45,42,3 ème
LOIR-ET-CHER,VENDOME,0410768M,198,170,24,4,87,111,3 ème
CORSE-DU-SUD,AJACCIO,6200011T,204,204,0,0,98,106,3 ème
CORSE-DU-SUD,AJACCIO,6200084X,178,178,0,0,66,112,3 ème
CORSE-DU-SUD,AJACCIO,6200636X,31,0,31,0,11,20,3 ème
CORSE-DU-SUD,PORTO-VECCHIO,6200697N,150,129,15,6,80,70,3 ème
CORSE-DU-SUD,VICO,6200048H,23,23,0,0,10,13,3 ème
HAUTE-CORSE,CERVIONE,7200020J,67,66,1,0,39,28,3 ème
HAUTE-CORSE,L'ILE-ROUSSE,7200025P,118,114,2,2,59,59,3 ème
MEURTHE-ET-MOSELLE,ART-SUR-MEURTHE,0541344T,26,26,0,0,2,24,3 ème
MEURTHE-ET-MOSELLE,BENAMENIL,0540004L,67,66,0,1,27,40,3 ème
MEURTHE-ET-MOSELLE,DOMMARTEMONT,0541706L,98,77,16,5,47,51,3 ème
MEURTHE-ET-MOSELLE,JARNY,0540076P,24,24,0,0,9,15,3 ème
MEURTHE-ET-MOSELLE,JARVILLE-LA-MALGRANGE,0541306B,240,240,0,0,134,106,3 ème
MEURTHE-ET-MOSELLE,JARVILLE-LA-MALGRANGE,0541817G,114,93,16,5,54,60,3 ème
MEURTHE-ET-MOSELLE,LAXOU,0542262R,23,23,0,0,5,18,3 ème
MEURTHE-ET-MOSELLE,LIVERDUN,0541284C,116,116,0,0,60,56,3 ème
MEURTHE-ET-MOSELLE,LONGUYON,0542349K,96,96,0,0,42,54,3 ème
MEURTHE-ET-MOSELLE,LONGWY,0541288G,111,108,0,3,45,66,3 ème
MEURTHE-ET-MOSELLE,LUDRES,0542189L,145,144,0,1,66,79,3 ème
MEURTHE-ET-MOSELLE,NANCY,0540082W,24,24,0,0,15,9,3 ème
MEURTHE-ET-MOSELLE,NANCY,0540106X,151,148,0,3,76,75,3 ème
MEURTHE-ET-MOSELLE,REHON,0541336J,75,75,0,0,40,35,3 ème
MEURTHE-ET-MOSELLE,SAINT-NICOLAS-DE-PORT,0541572R,90,85,0,5,46,44,3 ème
MEURTHE-ET-MOSELLE,TOUL,0541210X,111,107,0,4,56,55,3 ème
MEURTHE-ET-MOSELLE,VAL DE BRIEY,0540115G,112,111,0,1,46,66,3 ème
MEURTHE-ET-MOSELLE,VEZELISE,0540071J,104,104,0,0,48,56,3 ème
MEUSE,BAR-LE-DUC,0550003E,13,13,0,0,10,3,3 ème
MEUSE,BAR-LE-DUC,0550004F,11,11,0,0,0,11,3 ème
MEUSE,STENAY,0550020Y,85,72,11,2,47,38,3 ème
MEUSE,VERDUN,0550026E,22,22,0,0,12,10,3 ème
MEUSE,VERDUN,0550055L,46,46,0,0,22,24,3 ème
MOSELLE,ALGRANGE,0570241C,27,27,0,0,27,0,3 ème
MOSELLE,AUMETZ,0572583Y,66,66,0,0,37,29,3 ème
MOSELLE,BOUZONVILLE,0570012D,138,138,0,0,63,75,3 ème
MOSELLE,DELME,0570020M,88,87,0,1,30,58,3 ème
MOSELLE,FAREBERSVILLER,0572023P,128,117,9,2,61,67,3 ème
MOSELLE,FOLSCHVILLER,0572187T,78,74,0,4,36,42,3 ème
MOSELLE,FORBACH,0572180K,123,102,14,7,60,63,3 ème
MOSELLE,FREYMING-MERLEBACH,0573491K,14,14,0,0,6,8,3 ème
MOSELLE,GROSBLIEDERSTROFF,0572363J,100,96,0,4,44,56,3 ème
MOSELLE,LONGEVILLE-LES-SAINT-AVOLD,0572360F,64,63,0,1,32,32,3 ème
MOSELLE,LORQUIN,0570328X,61,61,0,0,32,29,3 ème
MOSELLE,MARLY,0573211F,23,23,0,0,0,23,3 ème
MOSELLE,METZ,0570283Y,42,42,0,0,22,20,3 ème
MOSELLE,METZ,0572168X,101,101,0,0,53,48,3 ème
MOSELLE,SAINT-AVOLD,0572488V,135,118,15,2,59,76,3 ème
MOSELLE,SARREBOURG,0570213X,37,37,0,0,19,18,3 ème
MOSELLE,THIONVILLE,0572811W,128,128,0,0,54,74,3 ème
MOSELLE,VERNY,0573754W,143,142,0,1,75,68,3 ème
MOSELLE,WOIPPY,0572582X,120,115,0,5,61,59,3 ème
VOSGES,CAPAVENIR VOSGES,0881147U,127,108,16,3,60,67,3 ème
VOSGES,CHARMES,0881145S,101,84,12,5,50,51,3 ème
VOSGES,CHATEL-SUR-MOSELLE,0880418B,107,105,0,2,60,47,3 ème
VOSGES,EPINAL,0880149J,73,73,0,0,37,36,3 ème
VOSGES,LE THILLOT,0880065T,77,70,5,2,32,45,3 ème
VOSGES,RAMBERVILLERS,0880045W,86,85,0,1,49,37,3 ème
VOSGES,RAON-L'ETAPE,0881120P,132,114,15,3,57,75,3 ème
VOSGES,REMIREMONT,0881140L,16,16,0,0,8,8,3 ème
VOSGES,SAINT-DIE-DES-VOSGES,0880151L,149,130,16,3,59,90,3 ème
VOSGES,SAINT-DIE-DES-VOSGES,0881447V,59,54,0,5,35,24,3 ème
VOSGES,SENONES,0881101U,54,54,0,0,33,21,3 ème
VOSGES,VITTEL,0880156S,86,80,0,6,51,35,3 ème
ARDENNES,CARIGNAN,0081099B,88,84,4,0,44,44,3 ème
ARDENNES,CHARLEVILLE-MEZIERES,0080010T,23,23,0,0,19,4,3 ème
ARDENNES,CHARLEVILLE-MEZIERES,0080035V,100,97,0,3,45,55,3 ème
ARDENNES,CHARLEVILLE-MEZIERES,0080068F,52,50,0,2,25,27,3 ème
ARDENNES,JUNIVILLE,0080021E,84,84,0,0,36,48,3 ème
ARDENNES,NOUZONVILLE,0080036W,93,81,12,0,48,45,3 ème
ARDENNES,SEDAN,0080048J,23,23,0,0,15,8,3 ème
ARDENNES,VIREUX-WALLERAND,0080052N,45,45,0,0,21,24,3 ème
ARDENNES,VRIGNE AUX BOIS,0080839U,83,67,12,4,40,43,3 ème
AUBE,BAR-SUR-SEINE,0100005B,149,139,8,2,75,74,3 ème
AUBE,BOUILLY,0100765C,147,138,9,0,65,82,3 ème
AUBE,LUSIGNY-SUR-BARSE,0100033G,117,117,0,0,57,60,3 ème
AUBE,PONT-SAINTE-MARIE,0101031S,170,159,10,1,74,96,3 ème
AUBE,ROMILLY-SUR-SEINE,0100016N,24,24,0,0,9,15,3 ème
AUBE,ROMILLY-SUR-SEINE,0100787B,152,150,0,2,62,90,3 ème
AUBE,ROMILLY-SUR-SEINE,0100905E,137,121,16,0,66,71,3 ème
AUBE,SAINTE-SAVINE,0100664T,163,163,0,0,85,78,3 ème
HAUTE-MARNE,CHATEAUVILLAIN,0520006Z,50,50,0,0,28,22,3 ème
HAUTE-MARNE,CHAUMONT,0520966T,75,75,0,0,34,41,3 ème
HAUTE-MARNE,DOULAINCOURT-SAUCOURT,0520014H,52,52,0,0,25,27,3 ème
HAUTE-MARNE,FRONCLES,0520018M,38,38,0,0,20,18,3 ème
HAUTE-MARNE,LANGRES,0520021R,11,11,0,0,8,3,3 ème
HAUTE-MARNE,LA PORTE DU DER,0520022S,67,67,0,0,39,28,3 ème
HAUTE-MARNE,SAINT-DIZIER,0520692V,17,17,0,0,8,9,3 ème
HAUTE-MARNE,SAINT-DIZIER,0520968V,104,104,0,0,48,56,3 ème
HAUTE-MARNE,WASSY,0520032C,11,11,0,0,3,8,3 ème
MARNE,ANGLURE,0510001Z,75,75,0,0,37,38,3 ème
MARNE,CHALONS-EN-CHAMPAGNE,0511106A,8,0,8,0,4,4,3 ème
MARNE,CHALONS-EN-CHAMPAGNE,0511147V,16,16,0,0,5,11,3 ème
MARNE,FAGNIERES,0511472Y,125,106,16,3,57,68,3 ème
MARNE,GUEUX,0511564Y,134,134,0,0,63,71,3 ème
MARNE,MONTMIRAIL,0511177C,37,37,0,0,18,19,3 ème
MARNE,REIMS,0511801F,193,193,0,0,90,103,3 ème
MARNE,SAINT-MEMMIE,0511216V,159,142,16,1,74,85,3 ème
MARNE,VITRY-LE-FRANCOIS,0511144S,78,78,0,0,35,43,3 ème
MARNE,WITRY-LES-REIMS,0512014M,102,98,0,4,51,51,3 ème
BAS-RHIN,CHATENOIS,0671962U,122,122,0,0,62,60,3 ème
BAS-RHIN,DRULINGEN,0670014B,82,80,0,2,38,44,3 ème
BAS-RHIN,ERSTEIN,0670017E,219,195,24,0,95,124,3 ème
BAS-RHIN,GERSTHEIM,0672135G,91,91,0,0,43,48,3 ème
BAS-RHIN,HOERDT,0672012Y,91,91,0,0,48,43,3 ème
BAS-RHIN,ILLKIRCH-GRAFFENSTADEN,0672194W,167,148,16,3,68,99,3 ème
BAS-RHIN,LAUTERBOURG,0671688W,66,66,0,0,37,29,3 ème
BAS-RHIN,LINGOLSHEIM,0671690Y,109,91,16,2,54,55,3 ème
BAS-RHIN,MARMOUTIER,0671985U,89,87,0,2,48,41,3 ème
BAS-RHIN,MATZENHEIM,0671604E,97,97,0,0,40,57,3 ème
BAS-RHIN,MOLSHEIM,0672606U,169,139,29,1,84,85,3 ème
BAS-RHIN,NIEDERBRONN-LES-BAINS,0671738A,85,85,0,0,36,49,3 ème
BAS-RHIN,REICHSHOFFEN,0671595V,100,84,14,2,50,50,3 ème
BAS-RHIN,SAVERNE,0671987W,114,112,0,2,53,61,3 ème
BAS-RHIN,SCHILTIGHEIM,0670089H,24,24,0,0,4,20,3 ème
BAS-RHIN,SELESTAT,0671830A,182,164,13,5,98,84,3 ème
BAS-RHIN,SOUFFELWEYERSHEIM,0672254L,142,141,0,1,59,83,3 ème
BAS-RHIN,STRASBOURG,0670085D,24,24,0,0,0,24,3 ème
BAS-RHIN,STRASBOURG,0671508A,143,143,0,0,68,75,3 ème
BAS-RHIN,STRASBOURG,0671594U,153,151,0,2,60,93,3 ème
BAS-RHIN,STRASBOURG,0671620X,118,118,0,0,61,57,3 ème
BAS-RHIN,STRASBOURG,0671636P,38,38,0,0,14,24,3 ème
BAS-RHIN,STRASBOURG,0672128Z,141,139,0,2,70,71,3 ème
BAS-RHIN,STRASBOURG,0672304R,56,56,0,0,24,32,3 ème
BAS-RHIN,VAL-DE-MODER,0671598Y,118,114,0,4,59,59,3 ème
BAS-RHIN,VENDENHEIM,0672658A,75,75,0,0,35,40,3 ème
BAS-RHIN,VILLE,0671601B,120,120,0,0,55,65,3 ème
BAS-RHIN,WISSEMBOURG,0671984T,160,137,15,8,75,85,3 ème
HAUT-RHIN,ALTKIRCH,0681373Y,166,144,21,1,71,95,3 ème
HAUT-RHIN,FERRETTE,0680014W,93,93,0,0,56,37,3 ème
HAUT-RHIN,FORTSCHWIHR,0681190Z,175,175,0,0,93,82,3 ème
HAUT-RHIN,HUNINGUE,0680020C,156,141,15,0,64,92,3 ème
HAUT-RHIN,MULHOUSE,0680105V,143,141,0,2,78,65,3 ème
HAUT-RHIN,MULHOUSE,0680135C,199,199,0,0,97,102,3 ème
HAUT-RHIN,MULHOUSE,0681768C,23,23,0,0,13,10,3 ème
HAUT-RHIN,MULHOUSE,0681961M,117,109,0,8,53,64,3 ème
HAUT-RHIN,SAINT-AMARIN,0680064A,91,91,0,0,37,54,3 ème
HAUT-RHIN,SAINT-LOUIS,0680066C,48,48,0,0,12,36,3 ème
HAUT-RHIN,SIERENTZ,0681269K,110,110,0,0,61,49,3 ème
HAUT-RHIN,SOULTZ-HAUT-RHIN,0680128V,106,105,0,1,45,61,3 ème
HAUT-RHIN,VOLGELSHEIM,0681125D,159,127,26,6,68,91,3 ème
HAUT-RHIN,WITTELSHEIM,0681322T,76,73,0,3,48,28,3 ème
HAUT-RHIN,WITTENHEIM,0680161F,57,42,15,0,19,38,3 ème
GUADELOUPE,BASSE-TERRE,9710482X,95,78,13,4,37,58,3 ème
GUADELOUPE,CAPESTERRE-BELLE-EAU,9710406P,112,92,17,3,57,55,3 ème
GUADELOUPE,CAPESTERRE-BELLE-EAU,9710418C,12,12,0,0,1,11,3 ème
GUADELOUPE,LAMENTIN,9710086S,158,140,17,1,68,90,3 ème
GUADELOUPE,LAMENTIN,9710090W,13,13,0,0,7,6,3 ème
GUADELOUPE,LE GOSIER,9710039R,244,233,10,1,122,122,3 ème
GUADELOUPE,LES ABYMES,9710826W,154,151,0,3,70,84,3 ème
GUADELOUPE,LES ABYMES,9710938T,185,185,0,0,90,95,3 ème
GUADELOUPE,MORNE-A-L'EAU,9710403L,173,155,16,2,87,86,3 ème
GUADELOUPE,POINTE-A-PITRE,9710073C,92,89,0,3,46,46,3 ème
GUADELOUPE,SAINTE-ROSE,9710023Y,139,119,14,6,67,72,3 ème
GUADELOUPE,SAINTE-ROSE,9711181G,103,103,0,0,46,57,3 ème
GUADELOUPE,SAINT-LOUIS,9710037N,27,19,8,0,9,18,3 ème
GUADELOUPE,VIEUX-HABITANTS,9710045X,77,72,0,5,32,45,3 ème
GUYANE,CAYENNE,9730020J,260,227,18,15,128,132,3 ème
GUYANE,CAYENNE,9730083C,320,286,23,11,151,169,3 ème
GUYANE,CAYENNE,9730247F,224,213,0,11,115,109,3 ème
GUYANE,CAYENNE,9730479H,38,38,0,0,17,21,3 ème
GUYANE,GRAND-SANTI,9730380A,133,119,8,6,67,66,3 ème
GUYANE,KOUROU,9730483M,120,113,0,7,64,56,3 ème
GUYANE,MACOURIA,9730206L,204,196,0,8,97,107,3 ème
GUYANE,MANA,9730373T,145,140,0,5,65,80,3 ème
GUYANE,MATOURY,9730307W,263,229,33,1,135,128,3 ème
GUYANE,PAPAICHTON,9730381B,46,33,12,1,21,25,3 ème
GUYANE,REMIRE-MONTJOLY,9730179G,264,224,36,4,120,144,3 ème
GUYANE,SAINT-GEORGES,9730173A,184,175,9,0,99,85,3 ème
GUYANE,SAINT-LAURENT-DU-MARONI,9730110G,254,230,21,3,125,129,3 ème
GUYANE,SAINT-LAURENT-DU-MARONI,9730348R,214,198,0,16,100,114,3 ème
AISNE,CHARMES,0020467X,17,17,0,0,3,14,3 ème
AISNE,CHATEAU-THIERRY,0021939X,17,17,0,0,2,15,3 ème
AISNE,CORBENY,0020017H,69,69,0,0,40,29,3 ème
AISNE,FLAVY-LE-MARTEL,0021593W,101,101,0,0,59,42,3 ème
AISNE,HARLY,0021534G,112,110,0,2,44,68,3 ème
AISNE,HIRSON,0020075W,118,92,15,11,58,60,3 ème
AISNE,HIRSON,0020089L,16,16,0,0,6,10,3 ème
AISNE,RIBEMONT,0021689A,84,81,0,3,48,36,3 ème
AISNE,SAINT-QUENTIN,0020056A,76,55,16,5,30,46,3 ème
AISNE,SAINT-QUENTIN,0020473D,208,208,0,0,107,101,3 ème
AISNE,SAINT-QUENTIN,0022042J,15,15,0,0,12,3,3 ème
AISNE,SOISSONS,0020492Z,12,11,0,1,6,6,3 ème
AISNE,SOISSONS,0022044L,17,15,0,2,4,13,3 ème
AISNE,TERGNIER,0020063H,186,157,24,5,92,94,3 ème
AISNE,VERVINS,0020067M,109,86,16,7,50,59,3 ème
AISNE,VILLENEUVE-SUR-AISNE,0020029W,64,64,0,0,31,33,3 ème
AISNE,VILLERS-COTTERETS,0021989B,87,87,0,0,32,55,3 ème
OISE,BEAUVAIS,0600002B,23,23,0,0,6,17,3 ème
OISE,BEAUVAIS,0601189S,134,131,0,3,62,72,3 ème
OISE,BRENOUILLE,0601786R,114,109,0,5,51,63,3 ème
OISE,BRESLES,0601424X,144,140,0,4,61,83,3 ème
OISE,BRETEUIL,0601153C,17,12,3,2,7,10,3 ème
OISE,CHAMBLY,0600060P,152,152,0,0,83,69,3 ème
OISE,COMPIEGNE,0601295G,90,90,0,0,40,50,3 ème
OISE,COMPIEGNE,0601366J,136,133,0,3,70,66,3 ème
OISE,CREPY-EN-VALOIS,0601294F,177,175,0,2,86,91,3 ème
OISE,CREVECOEUR-LE-GRAND,0600027D,107,92,11,4,59,48,3 ème
OISE,LAMORLAYE,0601872J,139,139,0,0,68,71,3 ème
OISE,MOUY,0601293E,151,146,0,5,70,81,3 ème
OISE,PONT-SAINTE-MAXENCE,0601147W,140,140,0,0,72,68,3 ème
OISE,RIBECOURT-DRESLINCOURT,0601822E,16,16,0,0,7,9,3 ème
OISE,SAINT-AUBIN-EN-BRAY,0601292D,145,141,0,4,70,75,3 ème
OISE,SAINT-JUST-EN-CHAUSSEE,0601445V,173,154,15,4,88,85,3 ème
OISE,SAINT-LEU-D'ESSERENT,0601409F,147,142,0,5,70,77,3 ème
SOMME,ALBERT,0801218P,65,63,0,2,23,42,3 ème
SOMME,AMIENS,0800019L,123,105,16,2,68,55,3 ème
SOMME,AMIENS,0800020M,117,115,0,2,53,64,3 ème
SOMME,AMIENS,0801194N,14,14,0,0,3,11,3 ème
SOMME,AMIENS,0801219R,182,182,0,0,92,90,3 ème
SOMME,AMIENS,0801946F,18,18,0,0,5,13,3 ème
SOMME,BRAY-SUR-SOMME,0800023R,23,23,0,0,11,12,3 ème
SOMME,CHAULNES,0801536K,88,88,0,0,46,42,3 ème
SOMME,CONTY,0800025T,83,81,0,2,41,42,3 ème
SOMME,CORBIE,0801478X,76,76,0,0,33,43,3 ème
SOMME,CRECY-EN-PONTHIEU,0800027V,59,54,0,5,30,29,3 ème
SOMME,FLIXECOURT,0801487G,71,71,0,0,31,40,3 ème
SOMME,HAM,0800036E,125,102,16,7,74,51,3 ème
SOMME,LONGPRE-LES-CORPS-SAINTS,0800037F,62,58,0,4,33,29,3 ème
SOMME,MONTDIDIER,0801225X,98,96,0,2,42,56,3 ème
NORD,ARMENTIERES,0590257J,24,24,0,0,13,11,3 ème
NORD,ARMENTIERES,0594397J,108,103,0,5,51,57,3 ème
NORD,AVESNELLES,0595176F,128,116,10,2,69,59,3 ème
NORD,BAILLEUL,0593063J,31,31,0,0,8,23,3 ème
NORD,BAILLEUL,0594636U,196,187,5,4,97,99,3 ème
NORD,BAVAY,0592924H,17,17,0,0,6,11,3 ème
NORD,BERGUES,0593479L,69,69,0,0,36,33,3 ème
NORD,BERLAIMONT,0594415D,64,64,0,0,31,33,3 ème
NORD,BEUVRAGES,0594301E,114,102,10,2,50,64,3 ème
NORD,CAMBRAI,0593487V,124,121,0,3,70,54,3 ème
NORD,CAMBRAI,0593488W,136,119,15,2,67,69,3 ème
NORD,CAMBRAI,0595175E,125,119,0,6,60,65,3 ème
NORD,CAPPELLE-EN-PEVELE,0596873A,156,156,0,0,85,71,3 ème
NORD,CAUDRY,0590044C,24,24,0,0,12,12,3 ème
NORD,COUDEKERQUE-BRANCHE,0590263R,24,24,0,0,4,20,3 ème
NORD,COUDEKERQUE-BRANCHE,0594295Y,33,32,0,1,17,16,3 ème
NORD,CROIX,0593239A,132,129,0,3,60,72,3 ème
NORD,DENAIN,0592962Z,69,66,0,3,28,41,3 ème
NORD,DOUAI,0590068D,162,158,0,4,78,84,3 ème
NORD,DOUAI,0592941B,137,130,0,7,62,75,3 ème
NORD,DOUAI,0595387K,200,199,0,1,103,97,3 ème
NORD,DUNKERQUE,0590164H,61,57,0,4,33,28,3 ème
NORD,DUNKERQUE,0593101A,98,98,0,0,41,57,3 ème
NORD,FACHES-THUMESNIL,0593476H,107,107,0,0,62,45,3 ème
NORD,FOURMIES,0590083V,23,23,0,0,10,13,3 ème
NORD,FOURMIES,0593252P,102,82,16,4,48,54,3 ème
NORD,GRANDE-SYNTHE,0595782P,85,81,0,4,46,39,3 ème
NORD,HALLUIN,0590091D,113,100,10,3,56,57,3 ème
NORD,HAUBOURDIN,0593127D,72,67,0,5,38,34,3 ème
NORD,HAUTMONT,0590098L,23,23,0,0,7,16,3 ème
NORD,HAZEBROUCK,0593077Z,13,13,0,0,0,13,3 ème
NORD,HEM,0595630Z,89,89,0,0,45,44,3 ème
NORD,JEUMONT,0592712C,23,23,0,0,4,19,3 ème
NORD,LA MADELEINE,0593658F,97,85,9,3,43,54,3 ème
NORD,LESQUIN,0592889V,167,167,0,0,83,84,3 ème
NORD,LILLE,0590115E,104,102,0,2,45,59,3 ème
NORD,LILLE,0590131X,110,109,0,1,51,59,3 ème
NORD,LILLE,0590266U,24,24,0,0,9,15,3 ème
NORD,LILLE,0593027V,32,32,0,0,4,28,3 ème
NORD,LILLE,0594288R,107,107,0,0,50,57,3 ème
NORD,LILLE,0594523W,70,68,0,2,35,35,3 ème
NORD,LILLE,0596177U,60,60,0,0,25,35,3 ème
NORD,LILLE,0597004T,127,127,0,0,72,55,3 ème
NORD,LINSELLES,0592895B,137,137,0,0,82,55,3 ème
NORD,LOOS,0593660H,60,60,0,0,34,26,3 ème
NORD,MARCQ-EN-BAROEUL,0593227M,148,148,0,0,79,69,3 ème
NORD,MASNIERES,0593683H,88,88,0,0,51,37,3 ème
NORD,MASNY,0593483R,117,115,0,2,60,57,3 ème
NORD,MAUBEUGE,0594362W,137,128,7,2,74,63,3 ème
NORD,MAUBEUGE,0595399Y,136,136,0,0,74,62,3 ème
NORD,MONS-EN-BAROEUL,0593178J,128,117,11,0,68,60,3 ème
NORD,MONS-EN-BAROEUL,0593218C,111,111,0,0,55,56,3 ème
NORD,PERENCHIES,0594628K,102,100,0,2,50,52,3 ème
NORD,RAISMES,0594408W,95,76,15,4,48,47,3 ème
NORD,RONCQ,0593668S,72,72,0,0,45,27,3 ème
NORD,ROOST-WARENDIN,0593251N,147,128,14,5,71,76,3 ème
NORD,ROUBAIX,0590189K,24,24,0,0,13,11,3 ème
NORD,ROUBAIX,0592905M,86,74,12,0,39,47,3 ème
NORD,ROUBAIX,0593667R,152,132,16,4,79,73,3 ème
NORD,ROUBAIX,0594634S,107,90,16,1,50,57,3 ème
NORD,SAINT-AMAND-LES-EAUX,0595400Z,209,209,0,0,102,107,3 ème
NORD,SAINT-ANDRE-LEZ-LILLE,0592911U,77,77,0,0,34,43,3 ème
NORD,SIN-LE-NOBLE,0593185S,161,146,15,0,79,82,3 ème
NORD,SOMAIN,0597055Y,209,209,0,0,116,93,3 ème
NORD,THUMERIES,0590211J,150,150,0,0,80,70,3 ème
NORD,TOURCOING,0592714E,98,82,14,2,41,57,3 ème
NORD,TOURCOING,0592966D,26,26,0,0,6,20,3 ème
NORD,TOURCOING,0593149C,106,104,0,2,57,49,3 ème
NORD,TOURCOING,0593150D,94,94,0,0,42,52,3 ème
NORD,TOURCOING,0593152F,32,32,0,0,17,15,3 ème
NORD,VALENCIENNES,0592967E,48,48,0,0,32,16,3 ème
NORD,VALENCIENNES,0592969G,42,39,0,3,9,33,3 ème
NORD,VALENCIENNES,0593155J,236,219,15,2,113,123,3 ème
NORD,VALENCIENNES,0595173C,88,88,0,0,44,44,3 ème
NORD,VILLENEUVE-D'ASCQ,0595656C,70,70,0,0,38,32,3 ème
NORD,WATTEN,0593159N,73,67,0,6,25,48,3 ème
NORD,WATTRELOS,0593242D,123,105,13,5,67,56,3 ème
NORD,WORMHOUT,0595856V,24,24,0,0,13,11,3 ème
PAS-DE-CALAIS,AIRE-SUR-LA-LYS,0622094P,149,129,16,4,69,80,3 ème
PAS-DE-CALAIS,ARDRES,0620004T,194,194,0,0,116,78,3 ème
PAS-DE-CALAIS,ARDRES,0622123W,107,101,0,6,54,53,3 ème
PAS-DE-CALAIS,AUBIGNY-EN-ARTOIS,0620016F,115,115,0,0,56,59,3 ème
PAS-DE-CALAIS,BERCK,0620229M,10,10,0,0,3,7,3 ème
PAS-DE-CALAIS,BETHUNE,0622089J,24,24,0,0,11,13,3 ème
PAS-DE-CALAIS,BOULOGNE-SUR-MER,0620199E,121,116,0,5,66,55,3 ème
PAS-DE-CALAIS,BOULOGNE-SUR-MER,0622131E,44,44,0,0,18,26,3 ème
PAS-DE-CALAIS,BOULOGNE-SUR-MER,0623571V,93,93,0,0,54,39,3 ème
PAS-DE-CALAIS,BOUVIGNY-BOYEFFLES,0622108E,131,131,0,0,65,66,3 ème
PAS-DE-CALAIS,BRUAY-LA-BUISSIERE,0620198D,104,104,0,0,48,56,3 ème
PAS-DE-CALAIS,CALAIS,0620188T,24,24,0,0,9,15,3 ème
PAS-DE-CALAIS,CALAIS,0622099V,23,0,23,0,4,19,3 ème
PAS-DE-CALAIS,DIVION,0620079Z,112,109,0,3,54,58,3 ème
PAS-DE-CALAIS,ETAPLES,0620187S,20,20,0,0,2,18,3 ème
PAS-DE-CALAIS,ETAPLES,0622192W,32,32,0,0,20,12,3 ème
PAS-DE-CALAIS,FREVENT,0622261W,93,83,10,0,47,46,3 ème
PAS-DE-CALAIS,GUINES,0622150A,34,32,0,2,18,16,3 ème
PAS-DE-CALAIS,HARNES,0622791X,131,110,17,4,67,64,3 ème
PAS-DE-CALAIS,HESDIN,0620099W,100,86,14,0,41,59,3 ème
PAS-DE-CALAIS,ISBERGUES,0620136L,103,103,0,0,45,58,3 ème
PAS-DE-CALAIS,LENS,0622418S,200,183,17,0,107,93,3 ème
PAS-DE-CALAIS,LENS,0623864N,24,24,0,0,8,16,3 ème
PAS-DE-CALAIS,LIEVIN,0620190V,24,24,0,0,8,16,3 ème
PAS-DE-CALAIS,LIEVIN,0620219B,101,84,14,3,49,52,3 ème
PAS-DE-CALAIS,LIEVIN,0622086F,157,147,0,10,69,88,3 ème
PAS-DE-CALAIS,MARQUISE,0620131F,24,24,0,0,6,18,3 ème
PAS-DE-CALAIS,MARQUISE,0622143T,66,66,0,0,27,39,3 ème
PAS-DE-CALAIS,MAZINGARBE,0622087G,111,111,0,0,54,57,3 ème
PAS-DE-CALAIS,MERICOURT,0622262X,150,132,14,4,83,67,3 ème
PAS-DE-CALAIS,MONTIGNY-EN-GOHELLE,0622423X,85,85,0,0,43,42,3 ème
PAS-DE-CALAIS,NOEUX-LES-MINES,0624440P,24,24,0,0,8,16,3 ème
PAS-DE-CALAIS,OUTREAU,0620154F,162,162,0,0,85,77,3 ème
PAS-DE-CALAIS,ROUVROY,0620158K,133,133,0,0,64,69,3 ème
PAS-DE-CALAIS,SAINT-MARTIN-BOULOGNE,0622198C,49,49,0,0,26,23,3 ème
PAS-DE-CALAIS,SAINT-NICOLAS,0623014P,193,172,16,5,87,106,3 ème
PAS-DE-CALAIS,SAINT-OMER,0622907Y,85,66,17,2,43,42,3 ème
PAS-DE-CALAIS,SAINT-POL-SUR-TERNOISE,0622121U,33,33,0,0,12,21,3 ème
PAS-DE-CALAIS,VITRY-EN-ARTOIS,0622084D,171,151,16,4,81,90,3 ème
PAS-DE-CALAIS,WIMILLE,0622299M,102,94,8,0,52,50,3 ème
PAS-DE-CALAIS,WINGLES,0620180J,140,122,17,1,73,67,3 ème
SEINE-ET-MARNE,BRIE-COMTE-ROBERT,0771363N,216,197,17,2,109,107,3 ème
SEINE-ET-MARNE,BRIE-COMTE-ROBERT,0771993Y,100,100,0,0,59,41,3 ème
SEINE-ET-MARNE,BUSSY-SAINT-GEORGES,0772413E,152,152,0,0,71,81,3 ème
SEINE-ET-MARNE,BUSSY-SAINT-GEORGES,0772588V,141,138,0,3,59,82,3 ème
SEINE-ET-MARNE,CHAMPS-SUR-MARNE,0772330P,115,115,0,0,59,56,3 ème
SEINE-ET-MARNE,CHATEAU-LANDON,0770010T,81,81,0,0,41,40,3 ème
SEINE-ET-MARNE,CHELLES,0770013W,172,172,0,0,89,83,3 ème
SEINE-ET-MARNE,COMBS-LA-VILLE,0771475K,179,162,16,1,87,92,3 ème
SEINE-ET-MARNE,COULOMMIERS,0771513B,151,127,24,0,77,74,3 ème
SEINE-ET-MARNE,COURTRY,0772396L,155,151,0,4,70,85,3 ème
SEINE-ET-MARNE,DAMMARIE-LES-LYS,0770019C,176,140,30,6,92,84,3 ème
SEINE-ET-MARNE,FONTAINEBLEAU,0771925Z,169,169,0,0,93,76,3 ème
SEINE-ET-MARNE,GRETZ-ARMAINVILLIERS,0772189L,150,144,0,6,66,84,3 ème
SEINE-ET-MARNE,LA CHAPELLE-LA-REINE,0770009S,118,115,0,3,65,53,3 ème
SEINE-ET-MARNE,LA FERTE-SOUS-JOUARRE,0770024H,215,213,0,2,106,109,3 ème
SEINE-ET-MARNE,LE MEE-SUR-SEINE,0771337K,223,223,0,0,125,98,3 ème
SEINE-ET-MARNE,LIEUSAINT,0772128V,106,103,0,3,56,50,3 ème
SEINE-ET-MARNE,MELUN,0771238C,19,19,0,0,7,12,3 ème
SEINE-ET-MARNE,MELUN,0771762X,174,172,0,2,87,87,3 ème
SEINE-ET-MARNE,MONTEREAU-FAULT-YONNE,0770938B,22,22,0,0,12,10,3 ème
SEINE-ET-MARNE,MONTEREAU-FAULT-YONNE,0771567K,217,183,30,4,113,104,3 ème
SEINE-ET-MARNE,MOUROUX,0772247Z,93,88,0,5,45,48,3 ème
SEINE-ET-MARNE,NANTEUIL-LES-MEAUX,0772499Y,169,166,0,3,71,98,3 ème
SEINE-ET-MARNE,NEMOURS,0771621U,89,89,0,0,52,37,3 ème
SEINE-ET-MARNE,PONTAULT-COMBAULT,0771419Z,193,193,0,0,91,102,3 ème
SEINE-ET-MARNE,PROVINS,0771336J,23,23,0,0,7,16,3 ème
SEINE-ET-MARNE,PROVINS,0771515D,141,137,0,4,66,75,3 ème
SEINE-ET-MARNE,SAINT-PIERRE-LES-NEMOURS,0772574E,83,80,0,3,38,45,3 ème
SEINE-ET-MARNE,SAVIGNY-LE-TEMPLE,0771960M,187,153,30,4,94,93,3 ème
SEINE-ET-MARNE,SOURDUN,0772737G,77,77,0,0,38,39,3 ème
SEINE-ET-MARNE,THORIGNY-SUR-MARNE,0770944H,24,24,0,0,9,15,3 ème
SEINE-ET-MARNE,THORIGNY-SUR-MARNE,0771472G,173,173,0,0,78,95,3 ème
SEINE-ET-MARNE,TORCY,0772482E,92,92,0,0,44,48,3 ème
SEINE-ET-MARNE,VARENNES-SUR-SEINE,0770053P,127,125,0,2,63,64,3 ème
SEINE-ET-MARNE,VILLIERS-SAINT-GEORGES,0770059W,93,86,0,7,44,49,3 ème
SEINE-SAINT-DENIS,AUBERVILLIERS,0931184G,179,164,15,0,86,93,3 ème
SEINE-SAINT-DENIS,AUBERVILLIERS,0931186J,160,160,0,0,76,84,3 ème
SEINE-SAINT-DENIS,AUBERVILLIERS,0932272P,132,118,14,0,67,65,3 ème
SEINE-SAINT-DENIS,BAGNOLET,0930936M,11,11,0,0,6,5,3 ème
SEINE-SAINT-DENIS,BOBIGNY,0931198X,19,19,0,0,10,9,3 ème
SEINE-SAINT-DENIS,BONDY,0931005M,163,162,0,1,74,89,3 ème
SEINE-SAINT-DENIS,BONDY,0931612X,135,121,14,0,80,55,3 ème
SEINE-SAINT-DENIS,BONDY,0932282A,10,10,0,0,3,7,3 ème
SEINE-SAINT-DENIS,DRANCY,0931201A,158,157,0,1,81,77,3 ème
SEINE-SAINT-DENIS,DRANCY,0932229T,14,14,0,0,3,11,3 ème
SEINE-SAINT-DENIS,DUGNY,0932126F,9,9,0,0,7,2,3 ème
SEINE-SAINT-DENIS,EPINAY-SUR-SEINE,0931428X,175,175,0,0,80,95,3 ème
SEINE-SAINT-DENIS,GAGNY,0930898W,159,157,0,2,79,80,3 ème
SEINE-SAINT-DENIS,GOURNAY-SUR-MARNE,0931382X,109,109,0,0,56,53,3 ème
SEINE-SAINT-DENIS,LE PRE-SAINT-GERVAIS,0931219V,129,129,0,0,69,60,3 ème
SEINE-SAINT-DENIS,LE RAINCY,0930969Y,156,156,0,0,82,74,3 ème
SEINE-SAINT-DENIS,LE RAINCY,0932302X,24,24,0,0,24,0,3 ème
SEINE-SAINT-DENIS,LIVRY-GARGAN,0930619T,242,240,0,2,120,122,3 ème
SEINE-SAINT-DENIS,LIVRY-GARGAN,0932454M,186,186,0,0,94,92,3 ème
SEINE-SAINT-DENIS,MONTREUIL,0931213N,119,119,0,0,56,63,3 ème
SEINE-SAINT-DENIS,MONTREUIL,0932579Y,115,115,0,0,46,69,3 ème
SEINE-SAINT-DENIS,NOISY-LE-GRAND,0931705Y,173,173,0,0,90,83,3 ème
SEINE-SAINT-DENIS,NOISY-LE-GRAND,0932333F,127,125,0,2,56,71,3 ème
SEINE-SAINT-DENIS,NOISY-LE-GRAND,0932581A,101,97,0,4,53,48,3 ème
SEINE-SAINT-DENIS,PIERREFITTE-SUR-SEINE,0931224A,171,171,0,0,87,84,3 ème
SEINE-SAINT-DENIS,ROMAINVILLE,0931222Y,91,88,0,3,45,46,3 ème
SEINE-SAINT-DENIS,ROSNY-SOUS-BOIS,0931739K,14,14,0,0,7,7,3 ème
SEINE-SAINT-DENIS,SAINT-DENIS,0930865K,135,132,0,3,78,57,3 ème
SEINE-SAINT-DENIS,SAINT-DENIS,0931229F,173,161,12,0,90,83,3 ème
SEINE-SAINT-DENIS,SAINT-DENIS,0931230G,117,117,0,0,56,61,3 ème
SEINE-SAINT-DENIS,SAINT-OUEN,0932261C,124,121,0,3,56,68,3 ème
SEINE-SAINT-DENIS,TREMBLAY-EN-FRANCE,0931149U,217,214,0,3,107,110,3 ème
SEINE-SAINT-DENIS,VAUJOURS,0930921W,213,213,0,0,114,99,3 ème
SEINE-SAINT-DENIS,VILLEMOMBLE,0931227D,166,163,0,3,77,89,3 ème
SEINE-SAINT-DENIS,VILLEPINTE,0932038K,159,159,0,0,78,81,3 ème
VAL-DE-MARNE,ALFORTVILLE,0941022A,160,145,15,0,76,84,3 ème
VAL-DE-MARNE,ARCUEIL,0941971G,183,164,16,3,71,112,3 ème
VAL-DE-MARNE,BOISSY-SAINT-LEGER,0940612E,123,120,0,3,59,64,3 ème
VAL-DE-MARNE,CHAMPIGNY-SUR-MARNE,0941015T,178,163,15,0,86,92,3 ème
VAL-DE-MARNE,CHENNEVIERES-SUR-MARNE,0941348E,140,126,14,0,67,73,3 ème
VAL-DE-MARNE,CRETEIL,0940006W,167,146,16,5,76,91,3 ème
VAL-DE-MARNE,CRETEIL,0940031Y,103,103,0,0,47,56,3 ème
VAL-DE-MARNE,CRETEIL,0940100Y,103,103,0,0,37,66,3 ème
VAL-DE-MARNE,CRETEIL,0941102M,118,115,0,3,59,59,3 ème
VAL-DE-MARNE,CRETEIL,0941614U,49,49,0,0,49,0,3 ème
VAL-DE-MARNE,GENTILLY,0940134K,23,23,0,0,7,16,3 ème
VAL-DE-MARNE,IVRY-SUR-SEINE,0941025D,137,121,16,0,58,79,3 ème
VAL-DE-MARNE,IVRY-SUR-SEINE,0941601E,137,135,0,2,66,71,3 ème
VAL-DE-MARNE,JOINVILLE-LE-PONT,0940012C,127,127,0,0,64,63,3 ème
VAL-DE-MARNE,LE PERREUX-SUR-MARNE,0940788W,148,145,0,3,78,70,3 ème
VAL-DE-MARNE,LE PLESSIS-TREVISE,0941221S,185,185,0,0,87,98,3 ème
VAL-DE-MARNE,L'HAY-LES-ROSES,0940583Y,156,137,15,4,69,87,3 ème
VAL-DE-MARNE,MAISONS-ALFORT,0941024C,56,56,0,0,19,37,3 ème
VAL-DE-MARNE,MAISONS-ALFORT,0941355M,24,24,0,0,7,17,3 ème
VAL-DE-MARNE,NOGENT-SUR-MARNE,0941714C,229,229,0,0,109,120,3 ème
VAL-DE-MARNE,RUNGIS,0940072T,88,88,0,0,39,49,3 ème
VAL-DE-MARNE,SAINT-MAUR-DES-FOSSES,0940140S,10,10,0,0,1,9,3 ème
VAL-DE-MARNE,SAINT-MAUR-DES-FOSSES,0940552P,209,209,0,0,129,80,3 ème
VAL-DE-MARNE,SAINT-MAUR-DES-FOSSES,0940569H,179,179,0,0,97,82,3 ème
VAL-DE-MARNE,SAINT-MAUR-DES-FOSSES,0941600D,149,149,0,0,80,69,3 ème
VAL-DE-MARNE,VALENTON,0941052H,115,115,0,0,64,51,3 ème
VAL-DE-MARNE,VILLEJUIF,0941038T,106,106,0,0,50,56,3 ème
VAL-DE-MARNE,VILLENEUVE-SAINT-GEORGES,0940749D,149,146,0,3,79,70,3 ème
VAL-DE-MARNE,VILLENEUVE-SAINT-GEORGES,0940792A,121,118,0,3,61,60,3 ème
VAL-DE-MARNE,VITRY-SUR-SEINE,0941033M,109,93,16,0,46,63,3 ème
VAL-DE-MARNE,VITRY-SUR-SEINE,0941224V,127,111,16,0,58,69,3 ème
PARIS,PARIS,0750776L,23,23,0,0,18,5,3 ème
PARIS,PARIS,0752829T,84,80,0,4,38,46,3 ème
PARIS,PARIS,0755778Y,70,70,0,0,29,41,3 ème
PARIS,PARIS,0750607C,136,134,0,2,58,78,3 ème
PARIS,PARIS,0750778N,41,41,0,0,18,23,3 ème
PARIS,PARIS,0752536Z,109,109,0,0,41,68,3 ème
PARIS,PARIS,0753896C,231,224,0,7,120,111,3 ème
PARIS,PARIS,0754853T,83,83,0,0,41,42,3 ème
PARIS,PARIS,0752316K,111,109,0,2,57,54,3 ème
PARIS,PARIS,0753982W,117,117,0,0,49,68,3 ème
PARIS,PARIS,0754924V,15,15,0,0,8,7,3 ème
PARIS,PARIS,0750445B,147,131,16,0,78,69,3 ème
PARIS,PARIS,0750463W,15,15,0,0,2,13,3 ème
PARIS,PARIS,0752543G,90,90,0,0,36,54,3 ème
PARIS,PARIS,0752846L,34,34,0,0,11,23,3 ème
PARIS,PARIS,0751708Z,5,5,0,0,0,5,3 ème
PARIS,PARIS,0752318M,139,135,0,4,68,71,3 ème
PARIS,PARIS,0752545J,173,168,0,5,89,84,3 ème
PARIS,PARIS,0752546K,184,179,0,5,98,86,3 ème
PARIS,PARIS,0753992G,55,55,0,0,22,33,3 ème
PARIS,PARIS,0754475G,14,14,0,0,4,10,3 ème
PARIS,PARIS,0752919R,60,60,0,0,34,26,3 ème
PARIS,PARIS,0752936J,136,136,0,0,68,68,3 ème
PARIS,PARIS,0752554U,219,216,0,3,123,96,3 ème
PARIS,PARIS,0753350J,32,32,0,0,15,17,3 ème
PARIS,PARIS,0750429J,107,106,0,1,43,64,3 ème
PARIS,PARIS,0752196E,109,96,13,0,57,52,3 ème
PARIS,PARIS,0750650Z,15,15,0,0,7,8,3 ème
PARIS,PARIS,0751706X,105,101,0,4,53,52,3 ème
PARIS,PARIS,0755052J,32,32,0,0,11,21,3 ème
PARIS,PARIS,0753046D,117,117,0,0,62,55,3 ème
PARIS,PARIS,0754005W,128,128,0,0,60,68,3 ème
PARIS,PARIS,0755029J,28,28,0,0,0,28,3 ème
PARIS,PARIS,0752693V,108,107,0,1,61,47,3 ème
PARIS,PARIS,0753965C,57,57,0,0,28,29,3 ème
PARIS,PARIS,0750407K,54,52,0,2,33,21,3 ème
PARIS,PARIS,0753967E,110,110,0,0,47,63,3 ème
PARIS,PARIS,0752527P,154,151,0,3,81,73,3 ème
PARIS,PARIS,0752528R,156,153,0,3,71,85,3 ème
PARIS,PARIS,0752882A,118,118,0,0,50,68,3 ème
PARIS,PARIS,0752912H,91,91,0,0,40,51,3 ème
PARIS,PARIS,0752961L,20,20,0,0,6,14,3 ème
PARIS,PARIS,0752533W,110,107,0,3,56,54,3 ème
ESSONNE,ATHIS-MONS,0911027X,198,182,16,0,92,106,3 ème
ESSONNE,BALLANCOURT-SUR-ESSONNE,0910773W,179,172,0,7,105,74,3 ème
ESSONNE,CORBEIL-ESSONNES,0911570M,150,134,16,0,74,76,3 ème
ESSONNE,DOURDAN,0911940P,118,112,0,6,62,56,3 ème
ESSONNE,ETAMPES,0911402E,190,166,17,7,84,106,3 ème
ESSONNE,EVRY-COURCOURONNES,0910021D,186,173,13,0,92,94,3 ème
ESSONNE,EVRY-COURCOURONNES,0911748F,204,204,0,0,97,107,3 ème
ESSONNE,GRIGNY,0911036G,142,124,16,2,72,70,3 ème
ESSONNE,LA FERTE-ALAIS,0910977T,121,117,0,4,55,66,3 ème
ESSONNE,LE MEREVILLOIS,0911403F,148,146,0,2,88,60,3 ème
ESSONNE,MASSY,0910859P,187,168,16,3,107,80,3 ème
ESSONNE,MASSY,0911031B,176,176,0,0,85,91,3 ème
ESSONNE,MONTGERON,0910677S,156,152,0,4,73,83,3 ème
ESSONNE,MONTLHERY,0910980W,63,63,0,0,22,41,3 ème
ESSONNE,MORSANG-SUR-ORGE,0910042B,191,167,16,8,93,98,3 ème
ESSONNE,SAINTE-GENEVIEVE-DES-BOIS,0910860R,204,198,0,6,98,106,3 ème
ESSONNE,SAINT-GERMAIN-LES-CORBEIL,0911341N,255,252,0,3,114,141,3 ème
ESSONNE,SAINT-PIERRE-DU-PERRAY,0911948Y,145,144,0,1,60,85,3 ème
ESSONNE,SAVIGNY-SUR-ORGE,0910836P,51,51,0,0,27,24,3 ème
ESSONNE,VERRIERES-LE-BUISSON,0911601W,28,28,0,0,11,17,3 ème
HAUTS-DE-SEINE,ANTONY,0921786S,170,169,0,1,85,85,3 ème
HAUTS-DE-SEINE,ASNIERES-SUR-SEINE,0920890T,151,151,0,0,67,84,3 ème
HAUTS-DE-SEINE,ASNIERES-SUR-SEINE,0922256C,47,47,0,0,25,22,3 ème
HAUTS-DE-SEINE,ASNIERES-SUR-SEINE,0922565N,180,177,0,3,86,94,3 ème
HAUTS-DE-SEINE,BAGNEUX,0921631Y,123,123,0,0,60,63,3 ème
HAUTS-DE-SEINE,BOULOGNE-BILLANCOURT,0920902F,166,166,0,0,94,72,3 ème
HAUTS-DE-SEINE,BOULOGNE-BILLANCOURT,0921238W,114,110,0,4,54,60,3 ème
HAUTS-DE-SEINE,BOULOGNE-BILLANCOURT,0921904V,110,110,0,0,56,54,3 ème
HAUTS-DE-SEINE,BOURG-LA-REINE,0921242A,195,179,16,0,78,117,3 ème
HAUTS-DE-SEINE,BOURG-LA-REINE,0921905W,226,226,0,0,121,105,3 ème
HAUTS-DE-SEINE,CHATENAY-MALABRY,0921180H,96,96,0,0,46,50,3 ème
HAUTS-DE-SEINE,CHAVILLE,0920689Z,174,174,0,0,84,90,3 ème
HAUTS-DE-SEINE,CHAVILLE,0921907Y,162,159,0,3,84,78,3 ème
HAUTS-DE-SEINE,CLAMART,0920653K,176,173,0,3,77,99,3 ème
HAUTS-DE-SEINE,COLOMBES,0920626F,116,116,0,0,49,67,3 ème
HAUTS-DE-SEINE,COLOMBES,0921160L,179,179,0,0,82,97,3 ème
HAUTS-DE-SEINE,COURBEVOIE,0922578C,166,166,0,0,80,86,3 ème
HAUTS-DE-SEINE,LE PLESSIS-ROBINSON,0920624D,143,135,8,0,61,82,3 ème
HAUTS-DE-SEINE,LEVALLOIS-PERRET,0921391M,111,110,0,1,55,56,3 ème
HAUTS-DE-SEINE,MALAKOFF,0921012A,110,107,0,3,50,60,3 ème
HAUTS-DE-SEINE,NEUILLY-SUR-SEINE,0920985W,8,8,0,0,1,7,3 ème
HAUTS-DE-SEINE,PUTEAUX,0921219A,118,116,0,2,48,70,3 ème
HAUTS-DE-SEINE,PUTEAUX,0922731U,107,107,0,0,58,49,3 ème
HAUTS-DE-SEINE,RUEIL-MALMAISON,0921018G,147,147,0,0,92,55,3 ème
HAUTS-DE-SEINE,RUEIL-MALMAISON,0921590D,146,135,11,0,69,77,3 ème
HAUTS-DE-SEINE,RUEIL-MALMAISON,0921916H,185,185,0,0,185,0,3 ème
VAL-D'OISE,BEAUMONT-SUR-OISE,0950751A,62,62,0,0,36,26,3 ème
VAL-D'OISE,BEAUMONT-SUR-OISE,0951748J,24,24,0,0,6,18,3 ème
VAL-D'OISE,BRAY-ET-LU,0952079U,82,82,0,0,43,39,3 ème
VAL-D'OISE,CERGY,0950937C,220,203,14,3,110,110,3 ème
VAL-D'OISE,CERGY,0951697D,201,181,16,4,86,115,3 ème
VAL-D'OISE,CHARS,0951282C,24,24,0,0,8,16,3 ème
VAL-D'OISE,CORMEILLES-EN-PARISIS,0950656X,21,21,0,0,5,16,3 ème
VAL-D'OISE,CORMEILLES-EN-PARISIS,0950790T,73,73,0,0,32,41,3 ème
VAL-D'OISE,CORMEILLES-EN-PARISIS,0951099D,155,154,0,1,76,79,3 ème
VAL-D'OISE,CORMEILLES-EN-PARISIS,0952045G,126,121,0,5,54,72,3 ème
VAL-D'OISE,DOMONT,0951220K,18,18,0,0,0,18,3 ème
VAL-D'OISE,EAUBONNE,0950893E,166,161,0,5,83,83,3 ème
VAL-D'OISE,ECOUEN,0950941G,99,84,11,4,46,53,3 ème
VAL-D'OISE,ERAGNY,0951672B,114,113,0,1,54,60,3 ème
VAL-D'OISE,ERMONT,0950019E,164,160,0,4,67,97,3 ème
VAL-D'OISE,FOSSES,0950926R,219,206,13,0,103,116,3 ème
VAL-D'OISE,L'ISLE-ADAM,0950898K,200,188,9,3,109,91,3 ème
VAL-D'OISE,MENUCOURT,0951233Z,114,114,0,0,48,66,3 ème
VAL-D'OISE,MONTSOULT,0951051B,169,169,0,0,76,93,3 ème
VAL-D'OISE,OSNY,0950760K,142,142,0,0,84,58,3 ème
VAL-D'OISE,PONTOISE,0951943W,52,52,0,0,29,23,3 ème
VAL-D'OISE,SAINT-GRATIEN,0951190C,160,141,16,3,81,79,3 ème
VAL-D'OISE,SAINT-OUEN-L'AUMONE,0950039B,117,117,0,0,59,58,3 ème
VAL-D'OISE,SANNOIS,0950805J,20,20,0,0,1,19,3 ème
VAL-D'OISE,SANNOIS,0951754R,117,117,0,0,52,65,3 ème
VAL-D'OISE,SARCELLES,0950723V,208,205,0,3,109,99,3 ème
VAL-D'OISE,SARCELLES,0951509Z,169,169,0,0,86,83,3 ème
VAL-D'OISE,SOISY-SOUS-MONTMORENCY,0951352D,110,95,10,5,59,51,3 ème
VAL-D'OISE,VAUREAL,0951705M,143,137,0,6,79,64,3 ème
VAL-D'OISE,VIGNY,0952080V,140,140,0,0,69,71,3 ème
YVELINES,ANDRESY,0780002D,192,192,0,0,89,103,3 ème
YVELINES,BOUGIVAL,0783301P,94,94,0,0,51,43,3 ème
YVELINES,CHANTELOUP-LES-VIGNES,0781986K,76,76,0,0,43,33,3 ème
YVELINES,CHATOU,0780507C,139,125,12,2,56,83,3 ème
YVELINES,COIGNIERES,0781511U,91,89,0,2,49,42,3 ème
YVELINES,CONFLANS-SAINTE-HONORINE,0780050F,185,181,0,4,101,84,3 ème
YVELINES,CONFLANS-SAINTE-HONORINE,0783447Y,46,46,0,0,14,32,3 ème
YVELINES,EPONE,0780656P,172,171,0,1,90,82,3 ème
YVELINES,FEUCHEROLLES,0781863B,141,141,0,0,58,83,3 ème
YVELINES,GUYANCOURT,0781695U,126,111,15,0,58,68,3 ème
YVELINES,ISSOU,0781885A,161,161,0,0,83,78,3 ème
YVELINES,LES CLAYES-SOUS-BOIS,0783251K,130,130,0,0,52,78,3 ème
YVELINES,MAGNY-LES-HAMEAUX,0781171Z,107,107,0,0,58,49,3 ème
YVELINES,MANTES-LA-VILLE,0780116C,196,194,0,2,101,95,3 ème
YVELINES,MONTESSON,0783339F,133,133,0,0,61,72,3 ème
YVELINES,MONTIGNY-LE-BRETONNEUX,0781818C,120,120,0,0,52,68,3 ème
YVELINES,NOISY-LE-ROI,0780179W,173,155,14,4,77,96,3 ème
YVELINES,PLAISIR,0780761D,193,192,0,1,94,99,3 ème
YVELINES,POISSY,0780264N,137,121,15,1,76,61,3 ème
YVELINES,SAINT-CYR-L'ECOLE,0780186D,145,144,0,1,70,75,3 ème
YVELINES,SAINT-GERMAIN-EN-LAYE,0781589D,195,195,0,0,104,91,3 ème
YVELINES,SAINT-GERMAIN-EN-LAYE,0783307W,139,139,0,0,59,80,3 ème
YVELINES,SAINT-GERMAIN-EN-LAYE,0783547G,162,162,0,0,91,71,3 ème
YVELINES,TRAPPES,0780273Y,14,14,0,0,4,10,3 ème
YVELINES,TRIEL-SUR-SEINE,0780573Z,162,160,0,2,72,90,3 ème
YVELINES,VERNOUILLET,0780845V,98,98,0,0,42,56,3 ème
YVELINES,VERSAILLES,0781107E,223,223,0,0,115,108,3 ème
YVELINES,VIROFLAY,0780184B,175,175,0,0,88,87,3 ème
LA REUNION,BRAS-PANON,9740046G,226,224,0,2,120,106,3 ème
LA REUNION,LE TAMPON,9740036W,185,151,33,1,91,94,3 ème
LA REUNION,SAINT-ANDRE,9740599H,178,174,0,4,94,84,3 ème
LA REUNION,SAINT-ANDRE,9741386N,214,211,0,3,109,105,3 ème
LA REUNION,SAINT-DENIS,9740081V,245,245,0,0,124,121,3 ème
LA REUNION,SAINT-DENIS,9740572D,247,215,28,4,101,146,3 ème
LA REUNION,SAINT-DENIS,9740618D,167,149,15,3,78,89,3 ème
LA REUNION,SAINT-DENIS,9740734E,107,88,16,3,46,61,3 ème
LA REUNION,SAINT-DENIS,9741654E,26,26,0,0,15,11,3 ème
LA REUNION,SAINTE-ROSE,9740044E,104,101,0,3,54,50,3 ème
LA REUNION,SAINT-JOSEPH,9741047V,160,157,0,3,90,70,3 ème
LA REUNION,SAINT-LEU,9741048W,233,198,32,3,110,123,3 ème
LA REUNION,SAINT-LOUIS,9740011U,258,241,14,3,134,124,3 ème
LA REUNION,SAINT-PAUL,9740093H,213,179,30,4,99,114,3 ème
LA REUNION,SAINT-PAUL,9741190A,165,162,0,3,82,83,3 ème
LA REUNION,SAINT-PHILIPPE,9740468R,72,71,0,1,31,41,3 ème
MARTINIQUE,DUCOS,9720469C,212,193,19,0,110,102,3 ème
MARTINIQUE,FORT-DE-FRANCE,9720052Z,62,55,0,7,30,32,3 ème
MARTINIQUE,FORT-DE-FRANCE,9720084J,65,51,10,4,29,36,3 ème
MARTINIQUE,FORT-DE-FRANCE,9720429J,10,10,0,0,4,6,3 ème
MARTINIQUE,FORT-DE-FRANCE,9720501M,14,14,0,0,9,5,3 ème
MARTINIQUE,LE CARBET,9720008B,78,78,0,0,37,41,3 ème
MARTINIQUE,LE FRANCOIS,9720771F,11,11,0,0,6,5,3 ème
MARTINIQUE,RIVIERE-PILOTE,9720017L,137,114,15,8,64,73,3 ème
MARTINIQUE,RIVIERE-SALEE,9720448E,104,81,15,8,49,55,3 ème
MARTINIQUE,SAINTE-MARIE,9720842H,56,56,0,0,30,26,3 ème
MARTINIQUE,SAINT-JOSEPH,9720021R,163,146,14,3,78,85,3 ème
MARTINIQUE,SAINT-PIERRE,9720446C,61,44,13,4,26,35,3 ème
MAYOTTE,BOUENI,9760379H,191,155,33,3,92,99,3 ème
MAYOTTE,CHICONI,9760119A,257,256,0,1,124,133,3 ème
MAYOTTE,DEMBENI,9760245M,462,457,0,5,237,225,3 ème
MAYOTTE,KOUNGOU,9760369X,448,415,28,5,217,231,3 ème
MAYOTTE,MAMOUDZOU,9760308F,462,453,0,9,247,215,3 ème
